collect_day,good_id,pum_id,pum_name,good_name,sales_price,discount_price,benifit
2018-06-01,374588084,E011020,침대,침대/싱글/슈퍼싱글침대/퀸침대/침대프레임/주문제작,218000,208000,-10000
2018-06-01,1693157851,C013010,점퍼,[구김스] 1178_ 플라이 날개 트레이닝 집업,78000,54600,-23400
2018-06-01,1970226423,C013050,운동복,요가복/헬스복/운동복/트레이닝바지/트레이닝복세트,18000,14900,-3100
2018-06-01,175416592,E011030,거실장,[PookShuim] 푹쉼 렌 천연가죽 전동 리클라이너 6인용 소파 (양쪽형),2100000,2100000,0
2018-06-01,175416593,E011030,거실장,[PookShuim] 푹쉼 렌 천연가죽 리클라이너 4인용 소파 (양쪽형) 컵홀더포함,1970000,1970000,0
2018-06-01,451174237,C012060,여자내의,세븐데이 멜빵청미니스커트 SD-9101,23730,23730,0
2018-06-01,175416591,E011030,거실장,[PookShuim] 푹쉼 렌 천연가죽 전동 리클라이너 6인용 소파 (양쪽형) 컵홀더포함,2330000,2330000,0
2018-06-01,1766109399,L021020,장신구,럭셔리 특가 최신상 40종 고급 실버반지 (svr13) 커플반지 선물 골드조아,25000,25000,0
2018-06-01,164541234,E041050,냄비,이모션 스텐 편수냄비 16cm TPOT-EM16 [모든 가열기구 사용]/ 테팔,27000,26730,-270
2018-06-01,1148035361,A011080,밀가루,특가 즉석 쌀국수 5개 얼큰하고 구수한 해물맛 김치,8400,8200,-200
2018-06-01,502896220,L021010,손목시계,BELCARINO 남성시계 유로스타일 시계 MV2097025BR 패,68500,68500,0
2018-06-01,114293213,E061020,섬유유연제,샤프란 아로마 한장씩뽑아쓰는 섬유유연제 30/50매,3750,3750,0
2018-06-01,1566792585,A011080,밀가루,온참 예산국수 선물세트(3개 1세트) /국수 소면,15000,14800,-200
2018-06-01,1037982350,A022030,생수,진로석수2L x12병 500MLx40병 다이아몬드EC 생수 샘물,7900,7400,-500
2018-06-01,1764421263,C013010,점퍼,여성아크네무스탕 명품무스탕 맞춤무스탕점퍼,989500,989500,0
2018-06-01,570543282,C013020,티셔츠,반팔티/프린트티/무지면티/국산/남자티/여름면티셔츠,8900,8900,0
2018-06-01,1778144971,C021020,구두,[잭앤질]잭앤질 국내산 소가죽 남성구두(J64-095M),49800,47310,-2490
2018-06-01,145784983,A021010,커피,비앤그린 리브퓨어 그린커피빈 생원두가루캡슐 사은품,58000,58000,0
2018-06-01,1784833952,C014020,유아복,아동바지 플라워통바지 KIDBOK-200 유아바지 긴바지,16780,16780,0
2018-06-01,1936493252,C012040,여자학생복,[케네스레이디]허리포인트니트티셔츠[EKPOGI0100](의정부점),15000,12170,-2830
2018-06-01,414979321,C013050,운동복,푸조 남여공용 니트 트레이닝 세트(FZ134-4) 남녀공용,65310,65310,0
2018-06-01,492695691,C012040,여자학생복,[블루종]썸머 카사리 배색 가오리 니트_[B1806KN103B]/ 블루종,24500,19600,-4900
2018-06-01,492695694,C012040,여자학생복,[블루종]다이아 그물망 가오리 니트_[B1806KN105B]/ 블루종,35000,28000,-7000
2018-06-01,1433939082,F012020,생리대,[위스퍼]순면감촉 피부애 슈퍼슬림 중형 36Px2팩,17600,17600,0
2018-06-01,248192471,L021030,가방,[대구백화점 I관] [랩](기존가:49 000원)심플 숄더백(AG2ABS6A),49000,45080,-3920
2018-06-01,1245449005,D031010,주택수선재료,엔씨 수성 세라믹 방수 페인트 무란새(백색) 18리터,82890,82890,0
2018-06-01,1111264209,A017010,배추,얼갈이배추-1kg.2kg.4kg,6900,6900,0
2018-06-01,1394683083,C013010,점퍼,푸론디 원버튼 롱자켓 여성쟈켓 DM-3840,71020,67470,-3550
2018-06-01,2146360623,L012010,면도기,쉬크 쉐이빙 폼X3개/쉐이브가드/프리미엄면도기증정,9900,9900,0
2018-06-01,2021432912,A017300,미역,우체국 직송/대천김 재래김/파래김 35봉/,40500,39500,-1000
2018-06-01,739009104,L012030,칫솔,시스테마 치석케어 콤팩트 x 8개 칫솔 치약,11900,11900,0
2018-06-01,1196861554,A011120,두부,포스트 아몬드 후레이크1kgx2개+증정[시리얼/씨리얼],16900,16900,0
2018-06-01,1534217694,I031040,생화,오늘만특가! 라이언스톰 트윈연결 침낭 캠핑용품 담요,34900,29060,-5840
2018-06-01,1537555302,F012030,안경,카본안경테/우드뿔테/티타늄안경/베타뿔테안경,49000,49000,0
2018-06-01,955773550,F012020,생리대,바디피트 유기농 순면 대형_20P,11300,4990,-6310
2018-06-01,2098156606,E031130,보온매트,#TV홈쇼핑정품#순면 황토 소프트매트 퀸(145x200)2인,168000,166320,-1680
2018-06-01,1537555307,F012030,안경,빈티지/울템/안경/안경테/뿔테안경/빅사이즈/뿔테,19800,19800,0
2018-06-01,10521200,A019070,양념소스,청우 양념치킨 순한맛소스 2.1kg,5900,5900,0
2018-06-01,492695687,C012040,여자학생복,[블루종]투웨이 가오리 니트_[B1806KN101B]/ 블루종,27000,21600,-5400
2018-06-01,899493607,L012060,샴푸,애경 케라시스 데미지클리닉 샴푸 (750ML),13500,4990,-8510
2018-06-01,539236980,C021040,실내화,망사 여성 키높이 하이탑 스니커즈 통굽 웨지운동화,34500,34500,0
2018-06-01,899493606,L012060,샴푸,애경 케라시스 볼륨 클리닉 샴푸 (750ML),13500,4990,-8510
2018-06-01,1579871280,A018110,물엿,백설 돼지갈비양념/돼지불고기양념/소불고기양념/소갈비양념 2.45kg,8300,8300,0
2018-06-01,734298653,C012060,여자내의,오프라 맥시 롱스커트 DM-3800 롱스커트 주름스커트,10070,9770,-300
2018-06-01,1025592911,E011060,의자,사무용 회의용 의자 컴퓨터 책상 학생 인테리어 공부,12900,12900,0
2018-06-01,1177823376,A012060,햄및베이컨,사조 베이콘(베이컨)1kg 소시지 수제햄 가공육 햄 냉,33370,33370,0
2018-06-01,896755721,A019010,고춧가루,한생 하늘정성 고춧가루 (중간맛/1kg),31900,31900,0
2018-06-01,5400607,A018020,사탕,[농심]츄파춥스 리필팩 1봉120입 막대사탕 캔디 간식,14200,14200,0
2018-06-01,399677362,C013020,티셔츠,T1934-전사나염 넥프릴 오버핏 티셔츠 셔링티셔츠 반,44060,44060,0
2018-06-01,664234075,E011070,식탁,베스트리빙 데미안 6인 대리석 식탁세트/에코/코코/토,359000,291600,-67400
2018-06-01,665395982,C012040,여자학생복,라인 프릴블라우스NWBLID0700,49800,49800,0
2018-06-01,1370297644,E011040,소파,원스 1인용 접이식 패브릭 소파/1인용 소파,84900,74900,-10000
2018-06-01,1384219326,A011170,떡,코리원/아하 맛있는 치즈떡 1kg/떡볶이/치즈떡/바우네,4000,3900,-100
2018-06-01,2029302399,A017200,토마토,가지 2입 /볶음/조림,4530,4530,0
2018-06-01,1271277710,C011020,남자상의,여름 강아지 마 싱글수트-연베이지 리즈코 남자옷도매,193900,174510,-19390
2018-06-01,753104443,C013010,점퍼,대박 기능성 쿨 쿨론 쿨링 냉장고 반팔 티 티셔츠,2900,2900,0
2018-06-01,1035499184,I011030,사진기,니콘 D7500 body 정품 새상품+사은품+이벤트 명품,1146590,1146590,0
2018-06-01,1667547466,A022050,탄산음료,[로리나] 로리나 핑크 레몬 에이드 330ml x 12병,26300,26300,0
2018-06-01,782111362,A014010,우유,(특가)파스퇴르 바른목장 멸균우유 두유 초코 바나나,13070,13070,0
2018-06-01,1368727754,A011010,쌀,경기미20kg / 쌀20kg,50500,50500,0
2018-06-01,1375226450,A016160,과일가공품,블루베리(건조 한끼 350g)X6,110790,110790,0
2018-06-01,1920121165,C012040,여자학생복,그로 헤티그로백1.0 6 18m 유아 의류 아동 실내 어린,103060,103060,0
2018-06-01,736898050,C013010,점퍼,남자 자켓/블레이져/정장/수트/캐주얼/남성/세트/봄,62000,57800,-4200
2018-06-01,1957000144,A015020,식용유,데시에르토 유기농 엑스트라 버진 올리브 오일/한정판,45000,39700,-5300
2018-06-01,938774617,E031090,공기청정기,[발뮤다]한정 리미티드에디션! [공식수입원] 발뮤다 에어엔진 공기청정기 화이트x샴페,729000,509000,-220000
2018-06-01,784762351,C013020,티셔츠,[M.K] 펑키 로봇 후드 티셔츠 (3-24개월) 201965 아기티셔츠,17440,15530,-1910
2018-06-01,1466170422,A011160,빵,[1+1]삼립 밤만쥬 50입(총 100입)무료배송,10000,10000,0
2018-06-01,535038041,A019130,스프,보노스프 12봉+머그컵 증정/죽/간식/치즈/크림/옥수수,13900,13900,0
2018-06-01,1136125863,E061010,세탁세제,애경 울샴푸 아웃도어 세제 용기 800ml / 리필 1000ml,8200,8200,0
2018-06-01,50667192,C013060,등산복,여름 남성 등산바지 등산복 작업복바지 작업복 반바지,13800,13800,0
2018-06-01,1486758220,C012020,원피스,[나이스클랍]윙스 원피스 (N163MSE002)(인천점),39000,34810,-4190
2018-06-01,1073115412,F012020,생리대,생리대 바디피트 귀애랑 대형 5팩 총90매,16900,16900,0
2018-06-01,1154026135,C013010,점퍼,(보니알렉스) 셔링 코튼 혼방 사파리 점퍼(BBFZ580C)/ 보니알렉스,29900,26910,-2990
2018-06-01,1776152092,A022010,주스,프레주 제주감귤 1.5L x 12펫 감귤주스 감귤 쥬스 음료/ 일화,14900,14900,0
2018-06-01,120705530,A022050,탄산음료,미닛메이드 스파클링 청포도 345ml x24can,15500,15500,0
2018-06-01,492705549,C013040,청바지,여름작업복/청남방/청건빵/청조끼/청바지/유니폼/용접,15800,15800,0
2018-06-01,1775130890,F011130,홍삼,정관장 활기단(3.75*10),30000,30000,0
2018-06-01,2096911434,C011030,남자학생복,FSSF18017 가로배색 셔츠 기본남성셔츠 남자기본셔츠,38000,37620,-380
2018-06-01,1778707701,L021020,장신구,[바보사랑]CTN-10202,70000,70000,0
2018-06-01,946851578,E011030,거실장,블리스 화장대/거실장/장식장/수납장/TV장/TV대,33900,30900,-3000
2018-06-01,988900178,F011150,건강기능식품,종근당 어린이 홍삼 20ml X 30포,35000,29900,-5100
2018-06-01,751104776,C012020,원피스,[로엠][로엠] (앵커) 자켓형 코트 RMJH811100,69300,60300,-9000
2018-06-01,988900176,F011150,건강기능식품,종근당 칼슘 마그네슘 360정 6개월분,39000,20900,-18100
2018-06-01,1537555338,F012030,안경,최신모델/안경테/빅사이즈/라식라섹/UV선글라스,20000,19800,-200
2018-06-01,734007352,E021010,침구,[뜨란채]누빔커버 요매트 세트/요커버+요솜/누빔 요매트 디럭스 싱글,52800,51220,-1580
2018-06-01,2089089292,E061010,세탁세제,[화야] 세탁세제/섬유유연제 가정용/업소용/말통/락스,7490,7490,0
2018-06-01,1448181066,A017160,오이,착한송이버섯(송향) 고급형500G,23000,20700,-2300
2018-06-01,997895115,A016060,감,프리미엄 1호 40개 1.9kg~2.2kg 반건시/감말랭이/반건,93600,93600,0
2018-06-01,1260630644,A019020,참깨,볶음참깨 (삼진 1k) X10,106240,94560,-11680
2018-06-01,2020008425,A018040,아이스크림,(롯데제과)본젤라또프리미엄바닐라아이스크림5리터,25000,25000,0
2018-06-01,2123873352,C013030,스웨터,DTG1521 오비 빅 니트 803 패션용루즈핏니트 여성루즈,51110,51110,0
2018-06-01,474743788,C012040,여자학생복,[톰앤래빗] 스트라이프린넨셔츠(2color) 셔츠/남방,29800,29800,0
2018-06-01,1808192857,A016120,바나나,다이아몬드 필리핀 바나나 13kg,27900,27900,0
2018-06-01,379184413,C013010,점퍼,18 FW 신상 헬리오스 다운재킷 KEF2004 ./ 네파키즈,159000,135150,-23850
2018-06-01,1723998802,C011030,남자학생복,[지오다노] 348503 여 포플린 루즈핏 셔츠/ 지오다노,19000,15390,-3610
2018-06-01,1857041322,A022050,탄산음료,탑씨 1.5/페트음료/탄산음료/콜라/사이다/음료수,11400,11400,0
2018-06-01,1804741651,E031040,전기레인지,데이킵스 냉장고정리 8P,28780,28780,0
2018-06-01,1778707723,L021020,장신구,[바보사랑]CTN-10314-1,70000,70000,0
2018-06-01,1778707724,L021020,장신구,[바보사랑]CTN-10366-W,60000,60000,0
2018-06-01,1822906118,C013020,티셔츠,폴로 아베크롬비 홀리스터맨투맨라운드티주니어긴팔티,34900,34900,0
2018-06-01,1778707725,L021020,장신구,[바보사랑]CTN-10366-P,60000,60000,0
2018-06-01,366103654,C014020,유아복,아동바지 플라워통바지 KIDBOK-200 긴아동바지 통바지,16940,16440,-500
2018-06-01,1239938142,E041020,컵,인증받은 포토 머그컵 결혼 선물 답례품 주문제작,6800,6800,0
2018-06-01,666021688,A011130,시리얼,백설 부침가루 1kgx10개,27180,27180,0
2018-06-01,505644093,C013020,티셔츠,격자무늬니트뷔스티에/슬리브리스/끈나시/크롭나시,6900,6900,0
2018-06-01,1034247609,A018070,파이,롯데제과 몽쉘2종+초코파이_총4개,21000,9900,-11100
2018-06-01,956846867,A022030,생수,[롯데]롯데 아이시스8.0 (500ML*20개입),8600,7000,-1600
2018-06-01,2088281187,A012060,햄및베이컨,(냉동)사조남부햄 베이콘(베이컨)1kgX8개 사조남부햄,181300,181300,0
2018-06-01,988900154,F011150,건강기능식품,종근당 N아세틸글루코사민 90정 3개월분,39000,25000,-14000
2018-06-01,64893125,C011050,남자내의,[지오다노][롯데특가] 남녀 여름 버뮤다 팬츠 묶음 택1/ 지오다노,14000,11340,-2660
2018-06-01,742108274,A011090,국수,동남아라면 베트남쌀국수 미고랭 포보 태국 수입/라면,570,570,0
2018-06-01,353433983,A012010,국산쇠고기,대관령한우 스페셜 3호,294330,294330,0
2018-06-01,532350141,C013010,점퍼,핸드메이드 BU무스탕 카라탈부착 스타일엔터 메리노베이비 무스탕자켓 남자무스탕점퍼,960000,960000,0
2018-06-01,1264967151,C014010,아동복,[네파키즈] 18SS 네오프린트 믹스바람막이 KED0603(본점),69000,63590,-5410
2018-06-01,2003768717,C012060,여자내의,밴딩 기모 가죽 바지 레깅스 팬츠 스키니 여성 여자,18960,18960,0
2018-06-01,1189603661,E041050,냄비,신일 업소용 통3중 전골냄비 스텐냄비 모음,18500,18130,-370
2018-06-01,35945076,A018100,꿀,생 로얄제리 1kg/대용량/꿀/건강식품/효도선물,82000,82000,0
2018-06-01,988900151,F011150,건강기능식품,종근당 쏘팔메토 골드업 3개월분 500mg 90SC,45000,27900,-17100
2018-06-01,1992771632,C013020,티셔츠,아베크롬비 여성 85 깊은 브이넥 면 티 신축성 춘추,26440,26440,0
2018-06-01,1218107200,A013070,굴,노바시새우 30미 300g / 노바시 튀김새우 새우튀김,7600,7600,0
2018-06-01,566554782,C013040,청바지,캐주얼 스트레이트 트레이닝 팬츠_QATPX1811GR/ 베네통키즈,29000,21750,-7250
2018-06-01,404612452,C013010,점퍼,[대구백화점 I관] [HUM]오버 숄더 박스핏 점퍼(FHMECUN501M),79900,65520,-14380
2018-06-01,10067983,A022010,주스,포도주스(롯데 1.5L)X12/ 식자재 전문,63500,63500,0
2018-06-01,1373358699,C013020,티셔츠,[필골드] SL3002n3004 폴라 티셔츠 6종중택일,25800,25800,0
2018-06-01,223512714,C013010,점퍼,몽클레어 17FW 집업 84960 00 8098W 778,755100,755100,0
2018-06-01,1608282554,L021020,장신구,실버)볼 포인트 목걸이 20대 30대 선물 추천 기념일,21880,21880,0
2018-06-01,693818329,C011030,남자학생복,여름신상 솔리드남방 7부 스판 반팔셔츠 50여종 체크,14700,14700,0
2018-06-01,1052344897,C013050,운동복,아이스쿨 고탄력바지/트레이닝바지/운동복/헬스복,9900,9900,0
2018-06-01,2073934914,C013010,점퍼,남자청자켓 기획 포켓 워싱 데님자켓 데님자켓 캐주얼,28190,28190,0
2018-06-01,1315019640,I011030,사진기,니콘 D810 정품 최신시리얼 새상품+이벤트 명품마을,2548700,2548700,0
2018-06-01,1230863538,I012010,컴퓨터,대우루컴즈 Q265FU 리니지M 롤 피파 게이밍 컴퓨터,385000,375000,-10000
2018-06-01,451115893,A019010,고춧가루,B고운 보통맛 고추가루 1kg2개 가루 고추가루 고운고,37220,33500,-3720
2018-06-01,617483682,I031010,장난감,[야야] 폴리 소프트 지붕차 헬로키티 소프트 지붕차,81700,76800,-4900
2018-06-01,2059813006,C014010,아동복,[꼬망스]여아레이소프트프릴윙티셔츠(C1821T157_21),21700,19530,-2170
2018-06-01,1149708451,L021030,가방,남성가방 서류가방 캐쥬얼 브리프케이스 C1450,17600,17600,0
2018-06-01,1992771688,C013020,티셔츠,폴로 여성 85 긴팔 라운드 면 스판 티 봄 가을 굿,16750,16750,0
2018-06-01,1745578498,A013170,생선통조림,(유동공식몰)순살왕꼬막+왕꼬막n골뱅이280g,9900,9900,0
2018-06-01,2039226862,I053030,복사용지,스마트카피 A4 복사용지(A4용지) 80g 2500매 2BOX,40110,34500,-5610
2018-06-01,1583321486,C013020,티셔츠,(4926상)랩스타일 산전산후 수유가능한 면스판 임부상,17700,17170,-530
2018-06-01,504262797,E031010,전기밥솥,쿠쿠 내솥 CRP-HNXT107FW 빠른배송,61950,61950,0
2018-06-01,1537459441,E021010,침구,금주특가}청량감 좋은 여름이불세트/누빔이불+베개,25000,16900,-8100
2018-06-01,1344325104,C013040,청바지,피핀 드벤시 일자 밴딩진 #73515/ 피핀,25200,19910,-5290
2018-06-01,1120270116,E031080,선풍기,이노크아든_ 콘센트형 미니 온풍기 IA-WH500W (490w),39800,39800,0
2018-06-01,1120270115,E031080,선풍기,신일 컨벡션히터 SEH-C200MH,105000,105000,0
2018-06-01,1364916561,A011170,떡,[모시로만]모싯잎깨송편10개(400g) x 6팩,34900,31410,-3490
2018-06-01,1113119040,I031040,생화,휴몬트무릎보호대/등산용품/관절보호대/무릎보호대,9900,9900,0
2018-06-01,853187756,A018080,설탕,정품100% 스테비아 1kg/최신5월미국직수입(홈쇼핑),28700,28700,0
2018-06-01,900391990,E061020,섬유유연제,[아토세이프] 유아용 섬유 유연제 (2L*4개),21900,10900,-11000
2018-06-01,540343175,E061100,습기제거제,신발냄새제거/깔창/신발깔창/부츠/탈취제/발냄새/운동화끈/운동화/신발건조기/구두/스,8000,7900,-100
2018-06-01,539043659,A013170,생선통조림,라이트100g*15캔+들기름김식탁김6봉+카놀라유500ml,22900,22900,0
2018-06-01,47475777,I011010,TV,(할인특가)모넥스 65인치 커브드 UHD TV 삼성패널,759000,759000,0
2018-06-01,2124454778,C012040,여자학생복,수지네 일본 구제 브라운 패딩조끼 여성 M 17-43,13670,13670,0
2018-06-01,2088354683,C021040,실내화,PUMA 푸마 여성 메쉬 스니커즈 2종 택1,59000,26900,-32100
2018-06-01,1056080038,E031070,에어컨,[신일산업] 타워팬 타워형선풍기 신일 선풍기 SIF-DS80,55000,52250,-2750
2018-06-01,1121644621,C011050,남자내의,[캘빈클라인진] 남성 스퀘어 반팔티셔츠(4AOKQ93),35100,29490,-5610
2018-06-01,385501881,C011030,남자학생복,자이언트 프린팅 오픈카라 반팔셔츠,32580,30630,-1950
2018-06-01,986309172,A019180,즉석식품,CJ햇반 컵반 고추장나물비빔밥 229G,2580,2380,-200
2018-06-01,1717190962,A014020,분유,[아이배냇] 순산양유아식 4단계 800g,32900,32900,0
2018-06-01,19961581,C011030,남자학생복,[TI FOR MEN] 티아이포맨 모혼방 스트라이프 버튼 베,18100,15930,-2170
2018-06-01,1154026158,C013010,점퍼,(보니알렉스) 코튼 집업 점퍼(BBUZ600A)/ 보니알렉스,23800,21420,-2380
2018-06-01,1216707322,A016060,감,달콤샤르르 자연그대로 만든 아이스 홍시 100개(컵)/,118050,106250,-11800
2018-06-01,1120270149,E031130,보온매트,이노크아든_ 항균 워셔블 온열매트 해피니스/퀸더블(투난방) IA-EMF8002D,89600,89600,0
2018-06-01,1120270148,E031130,보온매트,이노크아든_ 항균 워셔블 온열매트 해피니스/더블(원난방) IA-EMF8000D,80100,80100,0
2018-06-01,417622906,A011140,부침가루,스틱치즈케익/플레인/블루베리/초코/고구마,14000,14000,0
2018-06-01,1883887267,F012020,생리대,좋은느낌 좋은순면 19매X3팩 구성 견본증정,13500,13500,0
2018-06-01,1120270147,E031130,보온매트,이노크아든_ 항균 워셔블 온열매트 해피니스/싱글 IA-EMF8000S,70500,70500,0
2018-06-01,1120270146,E031130,보온매트,이노크아든_ 항균 워셔블 온열매트 해피니스/미니싱글 IA-EMF8000S,59500,59500,0
2018-06-01,986309174,A019180,즉석식품,CJ햇반 컵반 강된장보리비빔밥 280G,2580,2380,-200
2018-06-01,481470195,E011060,의자,2018년 신형 펠비스튜너 바른자세방석 골반 방석 학생,36800,36800,0
2018-06-01,1322131037,E061040,부엌용세제,NEW프릴주방세제2개/다양한구성/주방세제/참그린,9200,9200,0
2018-06-01,511853174,A012050,소시지,[칼집 낸]모듬 빌소시지 1kg/5가지맛/청양고추/불갈비,7900,7900,0
2018-06-01,1373356002,C013020,티셔츠,[필골드] SL3003 탐 라인 폴라 티셔츠,22800,22800,0
2018-06-01,1603446560,C011030,남자학생복,롤프 남성 롱가디건 골지 숄 간절기 아우터 외투 자켓,44500,44500,0
2018-06-01,562985809,E011050,책상,코너높이조절책상R 블랙브라운 블랙 베칸트 160x110 c,1168670,1040120,-128550
2018-06-01,1790560590,F012020,생리대,NEW 템포 레귤러 10매x1박스+슈퍼10매x3박스(총40매)/ 템포,14700,13820,-880
2018-06-01,553088440,C011030,남자학생복,[지오다노]남 저지 루즈핏 엘보슬리브 티 027901S,10000,8000,-2000
2018-06-01,494599402,C012060,여자내의,(더틸버리) 데님 집업 스커트 TI4M0SK53/ 더틸버리,63200,56880,-6320
2018-06-01,1790560592,F012020,생리대,NEW 템포 슈퍼 10매 x 4박스(총40매)/ 템포,14700,13680,-1020
2018-06-01,1053297872,A016100,수박,[신세계몰][K-애플수박] 사과처럼 깎아먹는 고당도 미니애플수박 2.5kg내외(2~3입),20600,20600,0
2018-06-01,1739479836,A019110,드레싱,움트리 매운닭발양념 제육볶음양념 포천소불고기양념,8000,8000,0
2018-06-01,950516465,E061030,전구,LG칩 LED형광등 PL 36W 55W 대체 LED전구 조명 방등,9450,9450,0
2018-06-01,877778506,A011090,국수,농심 육개장사발면/김치사발면 86gx24개 골라담기,15900,15900,0
2018-06-01,952881966,A011090,국수,[농심]농심 올리브 짜파게티140G*5입*8팩,31120,31120,0
2018-06-01,1527525639,C013050,운동복,트레이닝복세트/운동복/트레이닝복/츄리닝/여자,26800,26800,0
2018-06-01,1412627697,C013010,점퍼,영문후드지퍼야상/오버핏/박스핏/트렌치코트/사파리..,15900,15900,0
2018-06-01,1596054770,C021040,실내화,윌슨 엠플리필 amplifeel 테니스화(WRS322840) 차콜,218120,185410,-32710
2018-06-01,210781521,E031020,가스레인지,SK매직 GOR-S2200안심센서 가스오븐+4구레인지+그릴,604400,568140,-36260
2018-06-01,282588961,I031040,생화,360도 회전의자/캠핑의자/접이식의자/낚시의자/레져,39900,36710,-3190
2018-06-01,350250519,C012060,여자내의,SK1030-데일리 20대 30대 예쁜스커트 사각 체크 모직,20480,20480,0
2018-06-01,411003343,C012060,여자내의,KD 아그네 투피스 SET 니트스커트 겨울정장 여성의류,97970,97970,0
2018-06-01,492695660,C012040,여자학생복,[블루종]물결 밑단 그물망 니트_[B1806KN3732B]/ 블루종,24500,19600,-4900
2018-06-01,355504537,C012040,여자학생복,빅사이즈민짱/핫한셔츠남방모음/블라우스/스트라이프,30900,30900,0
2018-06-01,492695663,C012060,여자내의,[블루종]뮤즈 나염 텐션 스커트_[B1806SK071B]/ 블루종,62000,49600,-12400
2018-06-01,492695662,C012060,여자내의,[블루종]옆리본 린넨 나염 스커트_[B1806SK072B]/ 블루종,49800,39840,-9960
2018-06-01,352492515,C014020,유아복,아동 유아 러블리 반팔 티셔츠 브이 셔링티 15~17호,13900,13900,0
2018-06-01,1245704822,A017210,파,새콤달콤 찰 토마토 3Kg/5Kg,9900,8900,-1000
2018-06-01,421684398,I031040,생화,접이식 캠핑의자 낚시 미니의자 등산 간이보조 야외,1900,1700,-200
2018-06-01,1534230640,C014020,유아복,[디플랜][디플랜] 라인나염티셔츠 O WHITE,5000,4750,-250
2018-06-01,1371466819,F012020,생리대,(청결티슈증정) 시크릿데이 NEW러브&러브코튼 생리대,9900,9900,0
2018-06-01,438263752,C012040,여자학생복,(예사랑)여성 인견 블라우스 16YB01,79000,78210,-790
2018-06-01,892714143,C011030,남자학생복,[인터페이스] 가볍게 걸치는 니트/가디건/후리스 모든,17700,17700,0
2018-06-01,1276111657,C012030,여자상의,oo01 7부소매 스트랩 단가라 ops - 오렌지 7부원피스,19560,19560,0
2018-06-01,1126201311,C013010,점퍼,[모다아울렛][YK]쉬폰 레이스샤링점퍼Y182c114a,49900,44910,-4990
2018-06-01,1773943070,C013010,점퍼,카모시스루집업/망사집업/밀리터리집업/프린트자켓,7900,7900,0
2018-06-01,1455597941,I031010,장난감,북미 PSN 플레이스테이션 네트워크 카드 20달러 코드,29900,29900,0
2018-06-01,1069582319,C012020,원피스,[패션플러스][ego(에고)]주머니장식 캐시미어 롱베스트 EPCKVE027,59000,56050,-2950
2018-06-01,168474969,L021020,장신구,초커목걸이 체인초커 가죽초커 레이스초커 태슬초커 F,12950,12950,0
2018-06-01,492695656,C012040,여자학생복,[블루종]썸머 카사리 가오리 니트_[B1806KN097B]/ 블루종,16000,12800,-3200
2018-06-01,214580779,A019090,카레,[3 000원쿠폰]오뚜기 3분카레/짜장 200g*24입 모음전,26800,26800,0
2018-06-01,2074682543,C012060,여자내의,[톰보이]플리츠 미들 스커트(9106132821),47700,40550,-7150
2018-06-01,244200399,E021020,커튼,다양한 디자인 대형 거실커튼(400cm이상) 면 창 커튼,94800,87220,-7580
2018-06-01,533158295,C012060,여자내의,[체리코코] mindy pants/린넨팬츠/일자핏/밴딩/하이웨스트,31000,31000,0
2018-06-01,2145477078,E011070,식탁,유러피안 아일랜드 식탁 홈바 쿡탑매립 가능,234000,210600,-23400
2018-06-01,214156175,D031010,주택수선재료,순앤수 내부용 4L KS 2급 순수 최고급형 수성페인트,10900,10900,0
2018-06-01,317024751,C012040,여자학생복,체크 숄 머플러 스타일 코디 패션 여성 가디건 담요,17890,17890,0
2018-06-01,618760687,L021020,장신구,스와로브스키 은침귀걸이 이어링 귀고리 유색 크리스탈 여성악세사리선물 패션쥬얼리,24800,24060,-740
2018-06-01,391923099,C012040,여자학생복,BL182-스트라이프 패턴 블라우스 여자카라블라우스 여,29010,29010,0
2018-06-01,919555120,A013140,북어채,용대리 황태포 38-40cm 5미 명태포 황태 북어포,14500,13780,-720
2018-06-01,106733747,A021010,커피,엔잭타 라이트블렌드2.5g×30포 수입커피 커피,99000,98000,-1000
2018-06-01,1820835664,D031010,주택수선재료,흑색 검정색 락카페인트 목재 철재 CL440 4L 조색,29000,29000,0
2018-06-01,378086121,C013050,운동복,싼타페더프라임 리무진 콘솔박스 팔걸이 쿠션 자동차,61430,55960,-5470
2018-06-01,1014305458,C013040,청바지,올젠 솔리드 면팬츠 3종택1(ZOY1PP1103)MDOZ,36000,36000,0
2018-06-01,1557341655,E061020,섬유유연제,컨센서스 대용량 섬유유연제 / 세탁세제 5.5L,11900,11900,0
2018-06-01,1865986986,C021040,실내화,윌슨 러쉬 프로2.5 테니스화(WRS322630) 그레이,159730,148550,-11180
2018-06-01,476826332,C012040,여자학생복,지나블리스 스트라이프 벨티드 롱 셔츠 1803092,19800,19800,0
2018-06-01,1292589192,C013020,티셔츠,기모목폴라티셔츠/긴목/반목/고급스판양면/남자/여자/,6000,5900,-100
2018-06-01,1153136776,C012040,여자학생복,[세인트마리]엘버 여름 골지 트임 가디건,49600,44640,-4960
2018-06-01,349476275,C013020,티셔츠,[LAP] #핫한반팔T 모음 18종택1(LAP_0416)/ 랩,11000,9900,-1100
2018-06-01,895621462,A016100,수박,수박 6호 (7kg미만/통),29900,14900,-15000
2018-06-01,1181792559,C012060,여자내의,[레코브]체크 머메이드 스커트 (LU3186SK552X)(의정부점),31800,26220,-5580
2018-06-01,895621463,A016100,수박,수박 5호 (6kg미만/통),12900,12900,0
2018-06-01,349887886,C013050,운동복,아디다스 여성 아디제로 트랙자켓(CE0330) 여성트레이,154370,137390,-16980
2018-06-01,1757307178,E041010,식기,[키친아트] 2+2양푼이 세트 믹싱볼3P SET 쌀세척볼,4700,4330,-370
2018-06-01,632866969,A011170,떡,전북고창 울어매 모시잎개떡 75개(25개 3팩) / 삼경복,66000,58080,-7920
2018-06-01,1378481200,L021020,장신구,엥게이지 게르마늄 볼드 은반지 실버반지 순은반지,35000,33000,-2000
2018-06-01,90334606,E031080,선풍기,일렉트로룩스_PTC미니온풍기히터 EPH-1816MWBO,60700,60700,0
2018-06-01,1571830418,C013050,운동복,보급형 성에제거기 플라스틱끌 -차량용품 제설 껌제거 작업끌 성애제거기,2800,2470,-330
2018-06-01,1010197704,A013020,명태,영광 법성포 황토굴비 실속 2호,85000,74000,-11000
2018-06-01,1757310885,A019110,드레싱,코리원/오뚜기 오쉐프 갈릭치즈드레싱 1kg/샐러드,6000,5900,-100
2018-06-01,1546573255,I011010,TV,55인치 UHD TV 55PUN6102/61 IPS패널 방문출장A/S보증,539000,539000,0
2018-06-01,1143958453,C012060,여자내의,[화이트폭스]플라워레이스머메이드롱스커트,27000,24030,-2970
2018-06-01,388008502,I031070,애완동물관리비,당구대천코팅제/당구쵸크/당구재료/당구큐대/당구용품,11000,9740,-1260
2018-06-01,1731630791,A022050,탄산음료,탑씨170mlX30캔/캔커피/콜라/사이다/음료수/주스,5900,5900,0
2018-06-01,501727629,A016110,딸기,세미원 냉동 딸기 1kg 2개,25480,25480,0
2018-06-01,713513953,A011120,두부,콘푸라이트 콘푸로스트 600g 아몬드 후레이크 시리얼,3100,3100,0
2018-06-01,1199983474,C013020,티셔츠,여성 여름 메쉬소재 집업 가디건(P0X1227)/ 임페리얼,53100,44610,-8490
2018-06-01,530506891,C012060,여자내의,허리조절 기모 스판 교복치마 블랙 교복 예쁜교복 교,49840,48350,-1490
2018-06-01,1125538668,I053020,스케치북,올페이퍼/스케치북/전문가용/2절/3절/4절/5절/8절/A4,2800,2800,0
2018-06-01,1653236078,C014010,아동복,(숲자람) 기능성 키즈 바람막이 유아용바람막이 여아,74080,74080,0
2018-06-01,1409313722,C013040,청바지,디젤 아동 신장150 정도 청바지 정품 깨끗/41,35000,34650,-350
2018-06-01,959232098,I053010,공책,아이디얼 양장노트 25절 그리드노트 격자 방안 모눈,8390,8390,0
2018-06-01,247946172,D031010,주택수선재료,자연 페인트 친환경페인트 벽지 대용 풀바른벽지 황토,41800,41800,0
2018-06-01,1999726683,C013010,점퍼,[FRJ]남여 라이프스타일 아우터 F62M-MM013A외4종 모음전,29000,23780,-5220
2018-06-01,1039081101,G011070,자전거,알톤 로드마스터 827HA/하이브리드형/DP780 포스코소,315000,277830,-37170
2018-06-01,1147662905,A021010,커피,카누 아이스 미니 100T+머그 또는 텀블러 증정,18500,18500,0
2018-06-01,39732397,E011050,책상,상일리베가구 아이언 이동식 4단 서랍장/철제책상,47620,41430,-6190
2018-06-01,583803213,A016090,참외,성주꿀참외 10kg/7kg이내(크기랜덤)특가,14900,10900,-4000
2018-06-01,402600786,C012030,여자상의,[라라엘]여름신상/원피스/블라우스/스커트,9900,9900,0
2018-06-01,1589398601,C012060,여자내의,쿨팬츠/몸빼바지/9부 바지 쿨원단 냉장고,2500,2500,0
2018-06-01,607101263,A011170,떡,[국산 떡국떡 1kg]떡국 떡볶이떡 가래떡 명절 조랭이떡 반찬 고구마 설날 라면,1900,1900,0
2018-06-01,1608282619,L021020,장신구,실버)스퀘어 샷 체인 목걸이 20대 30대 여자 여성 예,20850,20850,0
2018-06-01,93361837,C013040,청바지,제이로드 명품급1 남자 청바지 카고바지 찢어진 면바,36900,36900,0
2018-06-01,1362760487,A017040,양배추,부추 4kg 1박스 두리반농산,12000,12000,0
2018-06-01,289399786,A017180,호박,시골맛 아주매운 중식용 고추가루 2.5kg,47100,45690,-1410
2018-06-01,1969609510,I011030,사진기,소니 사이버샷 DSC-RX100M5 정품 명품마을,1282990,1282990,0
2018-06-01,415967226,C013010,점퍼,빅사이즈 바람막이 7095-7102 바람막이 야상 점퍼 남,94370,92490,-1880
2018-06-01,1111699922,C012040,여자학생복,DRM0130R 브이넥 언발 조끼 803,44550,39650,-4900
2018-06-01,431677034,C013040,청바지,신상특가 L~4XL 밴딩바지 팬츠 빅사이즈 스키니진 롱,27800,24800,-3000
2018-06-01,1690540707,A012010,국산쇠고기,축협 1등급 한우선물세트 갈비 등심 추석선물세트 택1,175000,173250,-1750
2018-06-01,680681775,A019140,이유식,맘마밀 안심이유식6개월//9개월//12개월(100gX10팩),17900,17900,0
2018-06-01,805525005,I031040,생화,[SOS긴급구호세트] 구급 구급함 구급가방 미니구급함 구급용품 여행용구급함 응급용품,26500,25400,-1100
2018-06-01,448401844,C013050,운동복,DYT 오픈져지(GLS-642) 남성의류 트레이닝복상의 스포,85720,85720,0
2018-06-01,95253669,C014020,유아복,여름 유아 아동 상하복 티 바지 세트 남아/여아/의류/,10000,9900,-100
2018-06-01,274605899,C015020,모자,큰모자 빅사이즈 남자모자 볼캡 군모 스냅백 여름모자,16500,16500,0
2018-06-01,931265745,F012020,생리대,에리에르 엘리스 생리대 6팩 전상품 모음전,23900,23900,0
2018-06-01,758926829,E021010,침구,순면 차렵이불+요토퍼+베개/이불세트/패드세트,59900,59900,0
2018-06-01,350093106,L021030,가방,주말초특가 여성가방 잇백/에코백/신상/미니백/숄더,14800,14800,0
2018-06-01,1182889950,C015040,장갑,다용도 레져장갑/포츠장갑/등산장갑/바이크장갑/자전,5000,4480,-520
2018-06-01,1720058706,C012040,여자학생복,어깨리본 롱니트(NK7WP529)/ 온앤온,99000,79200,-19800
2018-06-01,1469304885,A019040,소금,9회 인산죽염 / 인산자죽염 (230g분말/240g고체),54000,54000,0
2018-06-01,2023179405,E031080,선풍기,최신형 원적외선 전기온풍기 3.0kw (HV-3100) - 난로,428950,381770,-47180
2018-06-01,1779514165,L021020,장신구,[바보사랑]액세서리키친 [925 Silver] Alphabet cubic line 이니셜목걸이 A350315,29900,29900,0
2018-06-01,1779514166,L021020,장신구,[바보사랑][액세서리키친] 925실버 Alphabet 이니셜 귀걸이 A11677,9900,9900,0
2018-06-01,1218707005,E031140,비데,노비타 테라피비데 BD-TE80M {사은품 증정} 방수비데,379000,379000,0
2018-06-01,1492681825,E031120,믹서,델리시아 프리미엄 6날 오토펄스 믹서기 IKFM-2000,129000,89000,-40000
2018-06-01,1654070155,E031070,에어컨,[퀸센스] 16형(40cm) 벽걸이형 선풍기 QSF-K400,19800,19800,0
2018-06-01,1332810051,L021010,손목시계,엠콜로정품 MC8848 스위스센서 등산용손목시계 고도계 기압계 나침반 날씨예측,119000,119000,0
2018-06-01,1630115576,E011050,책상,흔들림이없는책상 조립은초간편 60~240cm 학생 사무용,39000,39000,0
2018-06-01,1203376456,I031040,생화,겨울은 보온 여름은 보냉 인기상품 텀블러,25900,23830,-2070
2018-06-01,1010291084,A011160,빵,[아레바로스] 밀또띠아10인치,13000,10000,-3000
2018-06-01,540634948,E061010,세탁세제,특가! 한입 액체세제 일반용/드럼용 3Lx4개/ 엘지생활건강,16900,16900,0
2018-06-01,1184527492,C012030,여자상의,퍼플스완 미미네 홀터넥 레이스 원피스,41900,41900,0
2018-06-01,1451556359,C013050,운동복,선글라스 클립 썬글라스 안경 메모 홀더 자동차용품,3880,3500,-380
2018-06-01,715633438,E011020,침대,인쏘노 레나 RENA 평상형 침대 + 매트리스 포함 (Q),278070,278070,0
2018-06-01,2042360267,C012060,여자내의,오프라 맥시 롱스커트 DM-3800,14380,14380,0
2018-06-01,352717100,A012010,국산쇠고기,대관령한우 우족세트,153490,153490,0
2018-06-01,1668273766,F011130,홍삼,한삼인 굿데이스틱(10ML*60입),41890,41890,0
2018-06-01,1387704911,C013010,점퍼,AGC여성 기모 후드 집업점퍼 AG집업점퍼후드점퍼후드,26230,26230,0
2018-06-01,1884767264,C012040,여자학생복,빅사이즈블라우스/쉬폰/프릴/롱/빅사이즈여성의류 B4,29800,29800,0
2018-06-01,1779514157,L021020,장신구,[바보사랑][액세서리키친] 925실버 Heiley 원석 팔찌 A060615,29900,29900,0
2018-06-01,1374309500,A016060,감,상주전통곶감 꽁꽁얼린홍시3kg17-25과 개별포장 곶감/,36600,36600,0
2018-06-01,507886084,C015020,모자,[간쓰리] 2018신상 디자이너 스냅백 남녀공용,24800,24800,0
2018-06-01,1451052414,A011080,밀가루,70년전통 구포국수 오색면 선물세트 답례품 소면 국수,9900,9900,0
2018-06-01,1779514158,L021020,장신구,[바보사랑]925실버 Milly 원석 팔찌 A016869,35900,35900,0
2018-06-01,603497387,A013170,생선통조림,오뚜기 참치/고추참치 100g 10개,13900,13900,0
2018-06-01,1779514159,L021020,장신구,[바보사랑]925실버Kyle 2 set 팔찌 A030515,19900,19900,0
2018-06-01,1010291083,A011160,빵,[아레바로스] 밀또띠아12인치,18200,14000,-4200
2018-06-01,1146214475,G011070,자전거,지오닉스 여성용자전거 에브리타임 24/26인치 7단,93700,84330,-9370
2018-06-01,570939209,C012060,여자내의,[나인(NAIN)] [온라인전용]심플세미 부츠컷 팬츠(PT-3267),19800,18810,-990
2018-06-01,1741454045,A017010,배추,동수농원 시래기(건무청) 100g * (10봉/20봉) 자연건조[삶지않음]/청정지역 물맑은 양,35000,35000,0
2018-06-01,480097284,C013040,청바지,청멜빵바지 [5호~15호] 유아 남아 여아 어린이 멜빵,18000,18000,0
2018-06-01,696990311,C011050,남자내의,남성 냉장고바지 여름 몸빼 미키 일바지 남자배기팬츠,6500,6500,0
2018-06-01,1779514160,L021020,장신구,[바보사랑]925실버가죽팔찌-2 Braided 8컬러 A010415,19900,19900,0
2018-06-01,1779514163,L021020,장신구,[바보사랑]925실버6종 Simpatico 팔찌 A016853,39900,39900,0
2018-06-01,1779514164,L021020,장신구,[바보사랑]925실버 이니셜 팔찌 A016781,25900,25900,0
2018-06-01,1185299055,C012040,여자학생복,[블루종][블루종]러블리 레이스 진주 가디건_[B1806CD032B],35000,33250,-1750
2018-06-01,1779514162,L021020,장신구,[바보사랑]925실버 Allie color tie 팔찌-Star A016889,19900,19900,0
2018-06-01,2120569039,A012010,국산쇠고기,[무항생제] 이유식용 우둔살 300g 1등급,18700,18700,0
2018-06-01,548719024,C013050,운동복,K-345 스타렉스 2004후사경 차량안전용후사경 후사경,25520,22780,-2740
2018-06-01,441842707,A015020,식용유,해표카놀라유900mlx12개(box),64980,64980,0
2018-06-01,898021167,E011010,장롱,배송비할인! 장인가구아이브 스타일 옷장 드레스룸,118910,118910,0
2018-06-01,1052596528,C012040,여자학생복,빅사이즈 DWW0113 골지 라운드 조끼 801 빅사이즈베스,30280,30280,0
2018-06-01,1010197767,A016050,밤,청도 하트반건시 1호,56000,53000,-3000
2018-06-01,390191163,C012060,여자내의,[막스까르띠지오]단추장식 포켓 7부팬츠,76000,72200,-3800
2018-06-01,491717669,C012020,원피스,말표구두약 이코노 흑색 40g,1940,1940,0
2018-06-01,370660690,C021020,구두,남성구두 정장구두 양지퍼구두 지압건강구 황토발1001,52960,52960,0
2018-06-01,1263823502,L021030,가방,"[타거스 정품]Targus TBB013AP 15.6"" Spruce Ecosmart Backpack (Black)",89000,79000,-10000
2018-06-01,1305998150,C013010,점퍼,남자 바람막이 야상 JM03 WS바람막이점퍼야상남자 바,80560,80560,0
2018-06-01,988121797,F011150,건강기능식품,[CJ직배송]팻다운 파워번마스터(100ml) x10병,22000,9900,-12100
2018-06-01,988121798,F011150,건강기능식품,[CJ직배송]팻다운 파워번마스터(100ml) x30병,66000,24900,-41100
2018-06-01,1126404172,E021020,커튼,/롤러블라인드 화이트 스콕스클뢰베르 100x195 cm/ 블,56280,50090,-6190
2018-06-01,483146201,C013010,점퍼,스타일엔터 핸드메이드 무스탕추천 S-78 여성무스탕자켓 무스탕코트 카멜브라운 (주문,1378000,1378000,0
2018-06-01,1706204634,C015030,넥타이,남자 남성 나비넥타이 보타이 37종류,2800,2800,0
2018-06-01,1702780655,A012010,국산쇠고기,[한우갈비세트 3kg+양념]구이세트1.8kg/한우선물세트,211000,204670,-6330
2018-06-01,2024011433,C021040,실내화,윌슨 러쉬 프로2.5 테니스화 ( WRS322630 ) 그레이,137290,137290,0
2018-06-01,877071806,A017160,오이,노루궁뎅이버섯 생버섯(1kg),19900,19900,0
2018-06-01,1779514191,L021020,장신구,[바보사랑][액세서리키친] 925실버 Simpatico 진주목걸이 A4168522,39900,39900,0
2018-06-01,246456943,A017140,콩나물,[거시기장터]반딧불이약초명가 6년근 약도라지 1kg,24300,24300,0
2018-06-01,245851634,C012040,여자학생복,빅사이즈 포켓데님롱원피스 WW1704 빅사이즈 여성의류,52800,51750,-1050
2018-06-01,1240161662,C013020,티셔츠,~5XL/빅사이즈 민소매티/나시티/프린트/무지/단가라,15900,15900,0
2018-06-01,1335848034,E011040,소파,인텍스 1인용쇼파/빈레스체어/울트라라운지/에어체어,23500,23500,0
2018-06-01,956952154,C014020,유아복,[디플랜][디플랜] 럽러플티셔츠 O WHITE,5000,4750,-250
2018-06-01,1981559850,C012060,여자내의,[나인(NAIN)]캐주얼 사파리 팬츠(PT-3177)(센텀시티점),59000,54370,-4630
2018-06-01,1389258153,A019040,소금,천연양념salt 저염소금,8300,8300,0
2018-06-01,534352419,A018010,초콜릿,[특가]인기초콜릿5종/가나/크런키/abc초콜릿/간식,6900,6900,0
2018-06-01,1311412174,C015020,모자,신상 군모 모음전 남자군모 여자군모 여성군모 캡모자,9900,9900,0
2018-06-01,1351380225,E031070,에어컨,DWF-3322WS SIF-16CSH 천정형 선풍기 천장용,34000,34000,0
2018-06-01,425772853,L012040,치약,페리오치약120g X 30개/2080/진지발리스/잇몸,9900,7900,-2000
2018-06-01,892535430,A018100,꿀,콤비타 마누카허니 로젠지(캔디) 레몬 180g,18900,18900,0
2018-06-01,958689190,F012020,생리대,[유한킴벌리]유한킴벌리 애니데이 일반 팬티라이너(90p),8470,6300,-2170
2018-06-01,1139642111,A013020,명태,두레생협 대구토막(450g 러시아산) 대구 요리용대구,29820,29820,0
2018-06-01,958689191,F012020,생리대,[유한킴벌리]유한킴벌리 애니데이 무향 롱 팬티라이너(75P),8470,6300,-2170
2018-06-01,838438085,A013070,굴,바다해 랍스타테일 랍스터 4-5oz 랍스터 꼬리살,10000,10000,0
2018-06-01,1389824460,I031040,생화,루어낚시대/바다 민물 선상 문어 루어대/쭈꾸미낚시대,38000,34960,-3040
2018-06-01,893356693,C013020,티셔츠,[블루독베이비]품목20%할인PK)로고포인트티셔츠(48319-332-07)[갤러리아],30400,24020,-6380
2018-06-01,1625881307,C014020,유아복,[30%쿠폰]프리미에쥬르外_여름내의/상하복/반팔/바지,9600,9600,0
2018-06-01,1043769316,A017040,양배추,머위대4kg좌우 두리반농산,8500,8500,0
2018-06-01,116521128,E061010,세탁세제,무료/샤크린 파워 20kg 1통/액체 세제/일반/드럼 세탁기/겸용/라벤더 향/세탁/빨래/업,31510,31510,0
2018-06-01,1009578236,A011090,국수,농심 컵라면 큰사발/소컵 육개장 너구리 신라면 짜파,17400,17400,0
2018-06-01,2028157162,C013020,티셔츠,[더커버][더커버] 소프트 퍼 라글란 터틀넥 T,15000,12450,-2550
2018-06-01,1166095089,I031040,생화,버팔로 프리미엄 캠핑 체어 모음전,33670,33670,0
2018-06-01,166807757,E061060,살충제,강력한 킬파프 초파리트랩 15ml 벌레약 겔타입약 구제,13950,13950,0
2018-06-01,1505188916,A014050,달걀,칠보산 자연방사) 청란 / 청계란 / 유정란 / 달걀,14500,13050,-1450
2018-06-01,1452833446,E061010,세탁세제,퍼실 센서티브 젤 세탁세제 1.35L * 8통 + 버넬 센서티브 1L * 4개,65800,65800,0
2018-06-01,260005148,A022030,생수,트레비 500ml x 20펫 탄산수/씨그램/탄산음료,15420,14500,-920
2018-06-01,590798508,E041010,식기,예담은/방짜/유기/삼족오/방짜유기/그릇/세트/예단/혼수/반상기/세트/부부반상기/단반,680000,660000,-20000
2018-06-01,1778707760,L021020,장신구,[바보사랑]CTS-2042,120000,120000,0
2018-06-01,872115903,F012010,종이기저귀,[2018 ALL NEW] 보솜이 디오가닉 밴드 신생아 56매,15900,10900,-5000
2018-06-01,1778707761,L021020,장신구,[바보사랑]CTS-20103,120000,120000,0
2018-06-01,1778707762,L021020,장신구,[바보사랑]CTS-20114-B,120000,120000,0
2018-06-01,121441199,A018080,설탕,에리스리톨 위드 스테비아 설탕 가루 500g 분말,16900,16900,0
2018-06-01,1778707763,L021020,장신구,[바보사랑]CTS-20114-P,120000,120000,0
2018-06-01,1353957273,E011010,장롱,장인가구아이브 스밈 프리미엄 옷장 싱글장 장롱,66550,59900,-6650
2018-06-01,456396900,C013050,운동복,킹포스 자동차 파워핸들/메탈 그립 보조핸들봉 파워봉,6440,6250,-190
2018-06-01,1394658061,C013030,스웨터,파란십자군 구제 니트 여성티셔츠DK-2082,53400,50730,-2670
2018-06-01,993952085,F012020,생리대,깨끗한나라 릴리안 순수한면 슈퍼가드 중형16Px5팩,7900,7900,0
2018-06-01,266575310,C015040,장갑,애니멀 변신 벙어리 장갑 방한용장갑 예쁜장갑 워머장,12370,12130,-240
2018-06-01,1450098075,C013050,운동복,타이어/마모/뎁스/depth/깊이/디지털/게이지/gauge,14900,14900,0
2018-06-01,1060986768,F011130,홍삼,. [선물세트][1+1] 김정환홍삼 절편+젤리 선물세트 .,66000,66000,0
2018-06-01,1108779534,E011040,소파,1인소파 패브릭소파 안락소파 독서소파,88800,88800,0
2018-06-01,1778707759,L021020,장신구,[바보사랑]CTS-2032,150000,150000,0
2018-06-01,1552721247,F012020,생리대,바디피트 불록맞춤 최대200개입 귀애랑 팬티라이너 한,10900,10900,0
2018-06-01,137382852,C011030,남자학생복,[에이치커넥트]여성 3칼라 기본 반팔티 (30070-131-404-05),5000,4000,-1000
2018-06-01,230926930,C012040,여자학생복,[이사베이]라운드넥 펀칭 심플 가디건 (VMCCB2981)_S2X5,39900,37910,-1990
2018-06-01,922821008,L012030,칫솔,카카오프렌즈 여행용 세면도구 칫솔 치약 양치세트,3500,3400,-100
2018-06-01,1056043043,E011020,침대,2018년형_FPL 가죽 무중력 전동 모션베드 2종 SS/Q/K,599280,599280,0
2018-06-01,985179502,A014010,우유,(가정배달) 서울우유 1급A우유 나백1000ml,34200,34200,0
2018-06-01,1779636778,C011050,남자내의,[쇼타임] HL612쿨마린넨9부 여름 마바지 밴딩 남자 남성,17800,17800,0
2018-06-01,368140385,C013020,티셔츠,(3+1) 비비안 임산부용 30D/80D 팬티스타킹/레깅스 (3개 구매시 1개 더 드려요),7900,7800,-100
2018-06-01,1490605475,E031070,에어컨,듀플렉스 타워형 선풍기 DP-70TF/타워팬/120분타이머,25500,25500,0
2018-06-01,473403251,C012020,원피스,[KEITH]카치온폴리 K7MA377-37,156000,146640,-9360
2018-06-01,925957561,C013010,점퍼,아디다스 아디제로 트랙자켓 ( S99687 ),129260,129260,0
2018-06-01,440083114,C013020,티셔츠,셔링미니슬림티(RDD_1603) 큰옷 여성의류빅사이즈 박,15700,15700,0
2018-06-01,989047117,A011010,쌀,초L프라임)얼굴이 보이는 무농약쌀 4KG,19900,19900,0
2018-06-01,183721234,C013020,티셔츠,봄신상 카라티/남자옷/긴팔/단가라티/커플단체티,13800,13800,0
2018-06-01,1190437872,A012050,소시지,목우촌 혼신 못말리는청춘 소시지600g(30개),24000,24000,0
2018-06-01,1026771437,F012030,안경,선글라스증정 18신상 남자 여자 리비에 잘생김 안경테,29610,29610,0
2018-06-01,1157161141,C012040,여자학생복,KKWG1685 여 사선랩단가라후드긴팔울니트가디건,29400,23520,-5880
2018-06-01,896669196,A017100,당근,알배기배추(통),1790,1790,0
2018-06-01,582406306,C013020,티셔츠,프루브 오버핏 기본티셔츠 트레이닝반 긴바지,14000,9800,-4200
2018-06-01,323326030,L021020,장신구,무료배송 92.5 SILVER 은반지링 실버팔찌 발찌 귀걸이,7900,7900,0
2018-06-01,1316071974,C012060,여자내의,플레어 가죽 스커트-m1072 래더스커트 가죽치마 여성,19770,19770,0
2018-06-01,1914227823,F011120,인삼,(장생농산장수산삼 7년근 10주(10뿌리) 8년근 부모님,333970,323960,-10010
2018-06-01,1778707791,L021020,장신구,[바보사랑]CTE-21269-1,50000,50000,0
2018-06-01,1778707792,L021020,장신구,[바보사랑]CTE-20595-1,60000,60000,0
2018-06-01,1778707793,L021020,장신구,[바보사랑]CTE-20610-1,50000,50000,0
2018-06-01,1778707794,L021020,장신구,[바보사랑]CTE-20907-1,60000,60000,0
2018-06-01,598886450,C014020,유아복,[백화점SAY][블랙야크키즈]초경량 스타일 후드일체형 바람막이[BK맥스자켓],35000,29630,-5370
2018-06-01,1451172422,A017120,고구마,맛있는 감자 3kg/5kg/10kg/9900원/품질엄선/특가,9900,9900,0
2018-06-01,391119642,C015030,넥타이,산책하는강아지넥타이 (자동) 편한자동넥타이 자동남,20490,20490,0
2018-06-01,1432592270,E031110,청소기,스팀청소기 FSMH1621CC/델타헤드+패드총5장,169000,157170,-11830
2018-06-01,1730399122,C011050,남자내의,(체크9부바지)넓고 편안한 바짓단 남여공용 9부바지,10630,9470,-1160
2018-06-01,2006230939,C012030,여자상의,데일리앤 바캉스원피스 여름스커트 롱원피스 비치웨어,17800,17800,0
2018-06-01,325015105,A019180,즉석식품,춘권피/또띠아/생크림/사워크림/콘킹소세지/무염버터,4500,4500,0
2018-06-01,1601733343,C013060,등산복,쿨론 라운드티 기능성 반팔 나시 민소매 단체복 티,5900,5900,0
2018-06-01,476635552,C011050,남자내의,[해리슨옴므]28크로바 5부 냉장고바지 DI1135,17300,12980,-4320
2018-06-01,26063189,A018110,물엿,오뚜기 물엿8kg (이온엿)/몽고물엿8kg(국내제조),9400,9400,0
2018-06-01,1406323729,E041020,컵,머그컵 커피잔 머그잔 물컵 변색머그 인쇄 무지 칼라,1090,1090,0
2018-06-01,192789703,C012040,여자학생복,여름조끼/쉬폰조끼,8700,8700,0
2018-06-01,1094623855,A011110,당면,국내산 도토리전분 도토리 묵말랭이250g 2개,65720,65720,0
2018-06-01,8269331,A021010,커피,10+1 행사 원두커피 1kg 당일 로스팅 사은품 증정,7500,7500,0
2018-06-01,958689160,A018080,설탕,백설 자일로스 갈색설탕 5KG,15980,13900,-2080
2018-06-01,1126288911,C013050,운동복,DYTMCN 옐로우 맥스 긴팔 져지 긴팔슈트 자전거져지,148090,148090,0
2018-06-01,1374442227,C013010,점퍼,[제이알주니어] 마일드점퍼(아이보리_카키_곤색),14900,11920,-2980
2018-06-01,1810514018,A021020,차,일회용 종이컵 커피컵 테이크아웃컵 물컵 자판기용,29000,29000,0
2018-06-01,685404216,A012060,햄및베이컨,롯데 런천미트 200g x 10캔 외 통조림 로스팜 참치,17900,17900,0
2018-06-01,1810949702,D031010,주택수선재료,황토벽지 20kg(18리터)/황토페인트/친환경/황토세상,59800,59800,0
2018-06-01,264575528,E031130,보온매트,허준 구들장 카페트매트 1인-6인용 전기장판 전기매트,115000,113850,-1150
2018-06-01,644186196,C011030,남자학생복,봄신상 스트라이프셔츠/도트/패턴/체크/데님/남자,10000,8900,-1100
2018-06-01,456418789,C013050,운동복,메탈킹 자동차 파워핸들/그립 핸들봉 보조핸들 파워봉,6480,6290,-190
2018-06-01,1458715253,E021010,침구,[슈에뜨룸]시어서커 토퍼세트/여름이불세트/침대패드,42900,42900,0
2018-06-01,813376430,C013050,운동복,[고바이카]레인OK성에제거/결빙방지/겨울차량용품/성에/성에칼/성애/앞유리/자동차용품,6900,6800,-100
2018-06-01,402697895,C021010,아동화,W스타일 아동운동화 축구화 슬립온 여름 아동화 샌들,24900,21900,-3000
2018-06-01,1012604428,F011150,건강기능식품,여명808 119ml x 1개 / 여명 / 숙취해소 / 음주전후,3000,3000,0
2018-06-01,2033187728,A013170,생선통조림,유동 번데기12캔/자연산 유동골뱅이400g2캔/번데기탕,12900,12900,0
2018-06-01,425387795,E061060,살충제,페스트세븐킬420ml/바퀴벌레약/살충제,6500,6500,0
2018-06-01,1252911154,C013020,티셔츠,빅사이즈/제이스타일 홀드스 단가라 스판 끈 나시/ 제이스타일,17300,13330,-3970
2018-06-01,1425900687,C011050,남자내의,아스토레 와이드 디렉션 팬츠(GRY)-기모 남자트레이닝,56490,55370,-1120
2018-06-01,149390934,C015040,장갑,스포츠장갑 엠보싱장갑 작업 운동 등산 행사장갑,1000,1000,0
2018-06-01,1373910369,C013040,청바지,제이로드 남자청바지 44종 카고바지 빅사이즈 밴딩,15900,15900,0
2018-06-01,1010173742,A018030,껌,롯데 자일리톨 후레쉬민트 리필 138G,4000,3290,-710
2018-06-01,72610506,C021040,실내화,나이키 운동화/에어맥스 테아 탄준 루나/런닝화 보드,39900,35720,-4180
2018-06-01,245731661,C013010,점퍼,빅사이즈 숏블링시보리점퍼 CM1703 빅사이즈 여성의류,83670,82000,-1670
2018-06-01,1003011681,F011130,홍삼,[풍기인삼] 홍미삼 300g (1등급),110000,110000,0
2018-06-01,1003011680,F011130,홍삼,[황풍정] 홍삼정 올데이 300ml (100mlx30포),110000,110000,0
2018-06-01,773911556,C011050,남자내의,[나쁜남자] P2284 닉 와이드 밴딩슬랙스 크롭팬츠,21900,21900,0
2018-06-01,1694900242,A022040,기능성음료,파워오투500ml 24PET/오렌지레몬/애플키위/스포츠레몬,29500,29500,0
2018-06-01,1310042830,E011040,소파,국내제작 디자인 3인용쇼파 공장직판특가! 후기확인필,189800,189800,0
2018-06-01,958689189,F012020,생리대,[유한킴벌리]유한킴벌리 좋은느낌 오가닉커버 롱 팬티라이너 (36P),5390,5390,0
2018-06-01,1409398879,C013020,티셔츠,(아띠벗) 봄신상/M~2XL/티셔츠빅사이즈여성의류,17800,11800,-6000
2018-06-01,925367265,C013020,티셔츠,커터앤벅 남성 스판 카라 반팔티셔츠 - 1472-101-62,44900,39900,-5000
2018-06-01,1412049368,A013060,게,[지금이제철]통찜으로 먹는 고소한 총알오징어1kg,15900,15900,0
2018-06-01,1024758902,C012060,여자내의,SK934-데일리 20대 30대 예쁜스커트 레더 지퍼 플레어,27360,26000,-1360
2018-06-01,1985248634,A011120,두부,켈로그 1+1/씨리얼/시리얼/간식/그래놀라/콘푸로스트/,8400,7900,-500
2018-06-01,577958895,C012060,여자내의,다미엔 밴딩 후레아 청롱스커트-청치마 DM-5038 여성,21020,21020,0
2018-06-01,1357829974,F012050,의료측정기,그린닥터 혈당측정기 혈당시험지100+멸균침110+솜100,41930,39000,-2930
2018-06-01,2104176442,C013010,점퍼,남자 바람막이 야상 JM08 WS바람막이점퍼야상남자 바,93480,93480,0
2018-06-01,1812203303,L021060,유모차,[앙팡스] 앙팡스 E스윙유모차 (색상선택),69000,69000,0
2018-06-01,1590410499,C011030,남자학생복,[후아유](여성)W 라운드넥 자수 가디건 / WHCK82211C,19900,17520,-2380
2018-06-01,1319768667,E061060,살충제,쥐포수 끈끈이 10개입 - 쥐약 바퀴벌레 파리 개미 쥐,18930,18930,0
2018-06-01,17863553,C014010,아동복,[아동반팔남방]와이셔츠 정장 남아정장 남아와이셔츠,24900,24900,0
2018-06-01,1755222152,E061020,섬유유연제,피죤 섬유유연제 1600ml 2100ml 3100ml/리치퍼퓸,8500,8500,0
2018-06-01,1362613190,L012030,칫솔,GUM 버틀러 검 칫솔 #407 #409 #411 #124 #308 12개,24960,24960,0
2018-06-01,838054134,E051030,디지털도어록,퍼팩트 글라스2/유리문도어락/ 강화유리/도어락,60000,60000,0
2018-06-01,1065748648,E031130,보온매트,2017년형 이메텍 프리미엄 전기요 2인용(ITD-391),101370,101370,0
2018-06-01,1065748645,E031130,보온매트,이메텍 프리미엄 전기요 인텔리히팅 플러스 2인용 H5613,125550,125550,0
2018-06-01,771742412,E031120,믹서,JM3013 [브라운] 믹서기 [0.6L/미니블렌더/다지기]dk,48500,44920,-3580
2018-06-01,1550468361,C013040,청바지,여름신상/남자반바지/7부바지/빅사이즈/청반바지/남성,12800,12800,0
2018-06-01,1065748644,E031130,보온매트,이메텍 프리미엄 전기요 인텔리히팅 플러스 1인용 H5611,82770,82770,0
2018-06-01,2106357461,A022050,탄산음료,뚱캔 칠성사이다 코카 콜라 펩시 맥콜 웰치스 환타,13900,13900,0
2018-06-01,1266607379,I012010,컴퓨터,윈도우7/10정품  깨끗한 삼성중고컴퓨터 복원솔루션,150000,139000,-11000
2018-06-01,1696914313,C012060,여자내의,와이드 밴딩 팬츠(TWWSLH20010)/ 리스트,49000,44100,-4900
2018-06-01,608849775,C013040,청바지,[게스] 게스키즈 지퍼 포인트 제깅스 G76KSP020,99000,59400,-39600
2018-06-01,1065748616,E031130,보온매트,2018년형 신형 인텔리히트 이매텍 프리미엄 전기요 2인용 (IMD-437),138570,138570,0
2018-06-01,1003011658,F011130,홍삼,고려 홍삼정과 800g,100000,100000,0
2018-06-01,1065748617,E031130,보온매트,2018년형 신형 인텔리히트 이메텍 프리미엄 전기요 1인용(IMD-436),119970,119970,0
2018-06-01,1003011657,F011130,홍삼,고려 홍삼정과 400g,58000,58000,0
2018-06-01,1205258740,A017100,당근,(전남오픈마켓/풍년명가)무청시래기/배추우거지 10kg,16900,16900,0
2018-06-01,1003011656,F011130,홍삼,[황풍정] 홍삼양갱 810g (45gx18개입),53000,53000,0
2018-06-01,1790787310,C013050,운동복,[월드프로119]차량용소화기-휴대용소화기-미니소화기-간이소화기-안전용품-소화기-로체,10500,9480,-1020
2018-06-01,1003011655,F011130,홍삼,고려홍삼절편 200g (20gx10본),45000,45000,0
2018-06-01,871894233,C013050,운동복,SM6 핸들커버/D컷,27000,24840,-2160
2018-06-01,2112867935,E011070,식탁,파스타 2S광파오븐아일랜드식탁/홈바/수납장/전자렌지,180000,129600,-50400
2018-06-01,911707480,I012010,컴퓨터,[E]Z70EV-AR75S2/7세대/i5/8G/256G+1TB/키보드+마우스,978000,929100,-48900
2018-06-01,625883024,I012060,저장장치,ABKO HACKER K660 축교환 완전방수 게이밍 카일광축,58400,54900,-3500
2018-06-01,1043420161,A021010,커피,[illy]일리 캡슐커피 12종 18T 21T 국내총알 당일배송,10790,10790,0
2018-06-01,1341709586,C013050,운동복,후미 사각지대미러 확대경 후사경 와이드 후미사각지,22600,20590,-2010
2018-06-01,1003011654,F011130,홍삼,[천제인] 홍삼절편 200g (20gx10본),50000,50000,0
2018-06-01,501644808,C012060,여자내의,빅사이즈/제이스타일 리오드 도트 프릴 롱스커트/ 제이스타일,26300,20260,-6040
2018-06-01,581514555,A013130,오징어채,무배 대용량 국내가공 진미채 / 1kg 특가판매,19900,19900,0
2018-06-01,987204851,A016160,과일가공품,골드파인애플 (대/통),4990,4990,0
2018-06-01,1613983818,E011070,식탁,레이디가구 더키친 아일랜드 식탁 홈바 주방 수납,321500,289350,-32150
2018-06-01,1494644318,C013010,점퍼,[포에버21]봄버 자켓/FOREVER21/점퍼/누빔점퍼,47900,23950,-23950
2018-06-01,1260101870,C021020,구두,VA-095 남성구두 로퍼 정장화 신발 남성신발 신발 로,49480,49480,0
2018-06-01,463652884,C013010,점퍼,푸조 큘팅 자켓(FZ715-4),57750,51400,-6350
2018-06-01,380807165,A019030,생강,하지카미 (생강순 605g) X10,282890,251780,-31110
2018-06-01,1358083080,F011150,건강기능식품,세노비스 키즈스노우 프로바이오틱스40개,17900,17900,0
2018-06-01,1065748621,E031130,보온매트,2018년형 이메텍 프리미엄 전기요 2인용(IMS-427),169260,169260,0
2018-06-01,1778707820,L021020,장신구,[바보사랑]CTE-20601-1,50000,50000,0
2018-06-01,1065748620,E031130,보온매트,2018년형 신형 인텔리히트 이메텍 프리미엄 전기요 1인용(IHC-417),128340,128340,0
2018-06-01,982910493,E021020,커튼,[BHF]북유럽st 솔리드/패턴 암막커튼1장2장,13900,12790,-1110
2018-06-01,946417619,A011090,국수,[당일출고/무료배송]농심 신라면 20개(선물용/일반용),15850,15850,0
2018-06-01,997895050,A016060,감,으뜸 3호 반건시종이상자+보자기 70g-75g x 30개 반건,93600,93600,0
2018-06-01,1778707818,L021020,장신구,[바보사랑]CTE-20598-1,50000,50000,0
2018-06-01,1916193519,A014030,치즈,코리원/썬리취 펜시 체다 치즈 2kg/눈꽃/치즈/스노우,21900,21900,0
2018-06-01,1778707819,L021020,장신구,[바보사랑]CTE-20598-2,50000,50000,0
2018-06-01,360257767,C011050,남자내의,여름 남자 카고바지/빅사이즈/스판슬랙스/면바지/린넨,17800,17800,0
2018-06-01,1875788841,L012030,칫솔,일회용칫솔/미세모/성인칫솔/모텔/펜션/여행용/업소용,3800,3700,-100
2018-06-01,987322091,A019170,냉동식품,CJ 고메치킨 핫스파이시 550G,7990,6290,-1700
2018-06-01,1470450886,A011170,떡,[사평기정떡]3代에 걸친 손맛 그대로~ 개별3호 (3.5kg)32조각,25900,24740,-1160
2018-06-01,1252935272,C012060,여자내의,빅사이즈/제이스타일라니든 체크 버튼 프릴 스커트/ 제이스타일,40100,30880,-9220
2018-06-01,1065748618,E031130,보온매트,2018년형 신형 일텔리히트 이메텍 프리미엄 전기요 2인용(GVO-425),202740,202740,0
2018-06-01,1778707816,L021020,장신구,[바보사랑]CTE-20451-1,50000,50000,0
2018-06-01,1065748619,E031130,보온매트,2018년형 신형 인텔리히트 이메텍 프리미엄 전기요 2인용(IHC-418),184140,184140,0
2018-06-01,1778707817,L021020,장신구,[바보사랑]CTE-20451-2,50000,50000,0
2018-06-01,1346903213,C013050,운동복,자동차 광택패드 광택기/컴파운드/흡집제거/3 4 5인치,3100,3100,0
2018-06-01,2023540368,C011050,남자내의,남 테이퍼드 슬랙스 117911/ 지오다노,20000,16400,-3600
2018-06-01,1579439937,E061060,살충제,컴배트 좀벌레싹 오렌지향 콤보팩(옷장4/서랍8) x2개,13900,13900,0
2018-06-01,761761705,L012090,기초화장품,(30%특가)반트365 포맨 파워풀 워터 크림/올인원/남성,38000,26600,-11400
2018-06-01,1170280657,C012060,여자내의,[나무그림]플레어A라인_오픈청SK(티)/C18SMG0Y007L1,29000,23780,-5220
2018-06-01,1060516773,L012060,샴푸,(1+1) 하수오 트리트먼트 vs 아르간오일 헤어팩,15000,14800,-200
2018-06-01,1778707821,L021020,장신구,[바보사랑]CTE-20601-2,50000,50000,0
2018-06-01,1778707822,L021020,장신구,[바보사랑]CTE-20281-1,60000,60000,0
2018-06-01,467571980,A018100,꿀,가가농장 국산 병벌집꿀 1.2kg,33000,33000,0
2018-06-01,1104055404,F012010,종이기저귀,[2018 NEW] 보솜이 디오가닉 밴드/팬티 기저귀 1팩,15900,10900,-5000
2018-06-01,1196618332,C013050,운동복,커스커즈 3D 루프백 대용량 수납공간 320L 차량용루프,221600,201840,-19760
2018-06-01,441156455,A011170,떡,(냉장)두솔 초밥나라600g(초밥용유부)x5개,49530,49530,0
2018-06-01,662112091,C013010,점퍼,자켓 후드 사파리 트렌치코트 야상 여성 여자 점퍼 봄,39900,39900,0
2018-06-01,270674322,E061060,살충제,컴배트 홈키파홈매트 바퀴벌레약개미약좀벌레싹살충제,5700,5700,0
2018-06-01,1537555455,F012030,안경,울템/안경/국산/빅사이즈/뿔테/안경테/빈티지/금속테,20000,19800,-200
2018-06-01,720085560,A014040,발효유,[매일유업] 매일 휘피 휘핑크림 1L 1박스-12개,52920,52920,0
2018-06-01,420865780,L012060,샴푸,[아모레퍼시픽] 아모스 퓨어스마트 샴푸 /스마트 팩,13900,13900,0
2018-06-01,296285966,I053010,공책,GT 모닝 초등 3-6 알림장 좁은칸 남 학교알림장 초등,5230,5230,0
2018-06-01,1436954014,E061010,세탁세제,코코워시 세탁세제 3200ml x 4개 자연유래성분세제,8900,8900,0
2018-06-01,1211984704,L021030,가방,데일리챠 배낭백팩 (입점특가)국내생산/튼튼/학생백팩,20000,20000,0
2018-06-01,371647571,C013040,청바지,레깅스 쓰리버튼 벨트 기모 가죽 가죽레깅스 레깅스,41570,41570,0
2018-06-01,1543245019,C015030,넥타이,당일발송 5+1 신상넥타이 자동 수동 슬림넥타이,2800,2800,0
2018-06-01,977341154,F011150,건강기능식품,든든한 한끼 선식 미숫가루 (고소한맛/달콤한맛),1890,1890,0
2018-06-01,415101274,C013050,운동복,푸조 남녀공용 니트 트레이닝 세트(FZ132-2) 트레이닝,63430,63430,0
2018-06-01,142745981,C013010,점퍼,[게스진] NI2W2880 남여공용 올드스쿨 줄배색 바람막이 점퍼,44500,36050,-8450
2018-06-01,1880427205,F011150,건강기능식품,선물포장/데일리베스트 프로바이오틱스/100억유산균,39900,39900,0
2018-06-01,989047121,A011010,쌀,L'grow 고시히카리 5KG,19900,19900,0
2018-06-01,635986472,E061060,살충제,[정품] 롱다운플러스 / 바퀴벌레 모기 파리 개미 방역,30500,30500,0
2018-06-01,989047123,E051020,건전지,[에너자이져]에너자이저 AAA 18입 + 핑크퐁 밴드 증정,11900,8990,-2910
2018-06-01,373373419,C012040,여자학생복,레이스 소매 물결 블라우스 (TZ-BQT0059)/ 비키,35000,29750,-5250
2018-06-01,1202689608,A021010,커피,맥심 아이스 커피믹스110T,15900,15900,0
2018-06-01,1230838494,I012010,컴퓨터,대우루컴즈 Q265FU 정품 윈도우 게이밍 컴퓨터,385000,375000,-10000
2018-06-01,1399949182,A022030,생수,[백산수] 백산수 2리터 12병,10790,9900,-890
2018-06-01,959439825,A013150,어묵,[CJ]CJ 안심부산어묵종합 (266G*2),3990,3990,0
2018-06-01,1608282495,L021020,장신구,실버)보닌 목걸이 20대 30대 여친선물 추천 기념일 생,17760,17760,0
2018-06-01,1632416571,F012020,생리대,[화이트] 생리대 입는 오버나이트 중형 8개입 x3개,23900,23900,0
2018-06-01,781987090,C011030,남자학생복,[헤르본]2018년 여름반소매신상 셔츠 특가세일!!,15900,15900,0
2018-06-01,716128511,G022020,자동차타이어,마제스티솔루스 KU50 무료장착 225/55R17 일산타이어,145000,120620,-24380
2018-06-01,141877782,C012040,여자학생복,꾸제꾸제/METROCITY 반폴라 니트/여성 L/울혼방/스웨터/골프/세일/브랜드/빈티지/중고,19900,19900,0
2018-06-01,1712305802,A018010,초콜릿,무료배송/초콜렛/가나/크런키/ABC/스니커즈/트윅스,12300,12300,0
2018-06-01,1750846526,D031010,주택수선재료,노루페인트 순앤수100 친환경 내부용 수성페인트 4L,9900,9900,0
2018-06-01,608333830,F012020,생리대,한결 중형 16Px4팩+중형8P(총72P)/생리대,11500,11500,0
2018-06-01,1877176750,E031110,청소기,[샤오미] 샤오미 스마트 로봇청소기 2세대 물걸레청소 한글지원,590000,590000,0
2018-06-01,2026578682,C015030,넥타이,솔리드 넥타이 보타이 국내 자체공장 단체 샤틴펄원단,3500,3500,0
2018-06-01,2086330892,C013010,점퍼,아디다스 유소년 콘디보16 스타디움자켓 ( AB3152 ),146380,146380,0
2018-06-01,2142490683,C013050,운동복,범퍼보호필름,2900,2800,-100
2018-06-01,2142490686,C013050,운동복,범퍼보호필름 범퍼가드필름 범퍼보호스티커,2900,2800,-100
2018-06-01,901197302,E061020,섬유유연제,다우니 블루 1L+1L기획,8900,8900,0
2018-06-01,901197303,E061020,섬유유연제,다우니 핑크 1L+1L기획,8900,8900,0
2018-06-01,901197304,E061020,섬유유연제,다우니 퍼플 1L+1L기획,8900,8900,0
2018-06-01,1971814161,L021030,가방,노트북 파우치 LG 삼성 맥북 가방 케이스 11~15.6인치,13900,13900,0
2018-06-01,1397266888,A019020,참깨,두레생협 참깨(300g 국산) 참깨 영양참깨 가정영양잡,25070,25070,0
2018-06-01,1322674630,A018110,물엿,두레촌/명인쌀조청/조청/현미조청/유기농조청,7900,7900,0
2018-06-01,197202430,A013170,생선통조림,동원 자연산 골뱅이 400g,5080,5080,0
2018-06-01,2029326270,A017150,버섯,꼬불꼬불 곱슬이콩나물 1kg,2810,2810,0
2018-06-01,601806309,E031020,가스레인지,/동우환풍기 250mm/ 가정용환풍기 일반환풍기 화장실,36800,35600,-1200
2018-06-01,1342171816,C012040,여자학생복,수지네 일본 구제 브라운패턴 면 조끼 여성 S 19-36,16040,16040,0
2018-06-01,1558150683,C012060,여자내의,[리스트]베이직 스판팬츠 TWWSLH60170,30000,30000,0
2018-06-01,118163277,E011030,거실장,[PookShuim] 푹쉼 마쥬로 FPL가죽 3인용 수납소파 (오리털 내장),650000,650000,0
2018-06-01,984491177,A022020,두유,정식품 베지밀B 고칼슘 190ML*16,15180,8000,-7180
2018-06-01,1608282433,L021020,장신구,실버)바이 슬림 목걸이 20대 30대 여친선물 추천 기념,19820,19820,0
2018-06-01,1376674838,E041010,식기,폴라브 도자기 예쁜 일본그릇 면기 공기 대접 5P세트,25000,21850,-3150
2018-06-01,1473885773,A013010,갈치,제주 은갈치(대) 5마리(1마리당350g내외 선물포장),167920,167920,0
2018-06-01,355469768,L012030,칫솔,오랄비 크로스액션3개/클래식칫솔8개/펄사/컴플리트/프로플렉스/메디안칫솔/치약/전동,7900,7900,0
2018-06-01,732357946,A019090,카레,SB골든카레 220g 중간맛/일본카레,3050,3050,0
2018-06-01,860262177,A013090,전복,(맛나)재첩살(중국산)700g,8100,7290,-810
2018-06-01,504619385,L021010,손목시계,멀티라운드패션 화이트 손목 시계 패션아이템 가죽시,133940,133940,0
2018-06-01,1332716873,C012040,여자학생복,NnF 여성 쿨컬러 스카시 앙상블 4종세트,58000,58000,0
2018-06-01,728256162,L012030,칫솔,유아칫솔x10개+치약 페리오/어린이치약/어린이칫솔,16800,16800,0
2018-06-01,1449819849,C013050,운동복,유니언잭 차량용 컵홀더 트레이/논슬립매트/컵받침대,1800,1650,-150
2018-06-01,331501650,C013020,티셔츠,래비티 18SS LOVE 컬렉션 티셔츠 4종,68000,68000,0
2018-06-01,450284991,C011020,남자상의,봄/정장세트/남성정장자켓/수트/양복세트/옴므,148900,148900,0
2018-06-01,1905785164,E061050,청소용세제,아스토니쉬 곰팡이 제거클리너 욕실클리너 현진포커스,13000,12800,-200
2018-06-01,1609233589,A013070,굴,[대한민국수산]통영 자연산 대하10마리,20900,20190,-710
2018-06-01,1799241557,F012020,생리대,늘산뜻한 일반 라이너 20p x 10팩 /팬티라이너/ 예지미인,14000,14000,0
2018-06-01,256305973,C013010,점퍼,이중포인트자켓 LS1610 심플빅사이즈재킷 큰옷자켓 임,65220,65220,0
2018-06-01,1597906431,C012060,여자내의,푸조 여성 워테레깅스(S26-1),28540,26260,-2280
2018-06-01,987322032,A022030,생수,[정기배송]제주삼다수 2L*6입*2묶음,11640,11640,0
2018-06-01,2102318781,I031040,생화,NS블랙홀 서프 원투낚시대 /바다낚시/원투낚시/서프 2,48000,48000,0
2018-06-01,1984427567,A019170,냉동식품,[동원]개성 왕새우만두 315gx4봉+개성교자만두600gx4봉 +(증정) 개성왕만두350g +카놀,17700,17000,-700
2018-06-01,175416620,E011030,거실장,[PookShuim] 푹쉼 렌 천연가죽 리클라이너 3인용 소파 (양쪽형),1370000,1370000,0
2018-06-01,1596821332,A018010,초콜릿,삼진[찰떡파이]50개입1통 간식 초콜릿,12900,12900,0
2018-06-01,1810445957,A011160,빵,선미 쌀핫도그믹스 10kg(2.5kgx4),25000,25000,0
2018-06-01,2101749327,G011070,자전거,[아펙스] 여성용자전거 24/26인치 1단/7단/자전거,87000,87000,0
2018-06-01,837620493,C014010,아동복,[블루독아동/키즈6]남아) 7부치노팬츠(28375-411-01∼3)기본/반바지/스판/허리밴드/면,85000,70550,-14450
2018-06-01,226921189,A017280,김,다인 단무지 일식 압축 꼬들채 슬라이스 홀 쫄 알밥,3900,3900,0
2018-06-01,1740971094,A011170,떡,개별포장떡 찹쌀떡/두텁떡/콩찰떡/직장인간식/간식/,6900,6900,0
2018-06-01,1520641544,I031040,생화,스노우라인 큐브익스펜더 테이블 L6/버너플레이트증정,98700,87850,-10850
2018-06-01,456071671,C013020,티셔츠,[폴햄]폴햄 코튼 오버핏 스트라이프 반팔티 PHY2TR3060,19900,19900,0
2018-06-01,2077946169,A013100,마른멸치,청정지역 완도 전복 활전복 1kg 꼬마전복 특대전복,34800,34800,0
2018-06-01,296285932,I053010,공책,GT 모닝 초등 3-6 알림장 좁은칸 여 어린이알림장 캐,5230,5230,0
2018-06-01,252761868,C012060,여자내의,빅사이즈/이중/리본/랩/스커트 이중리본랩스커트 빅사,41980,40730,-1250
2018-06-01,1214181707,I011030,사진기,#NAME?,856000,802560,-53440
2018-06-01,195415091,C012060,여자내의,SK1028-데일리 20대 30대 예쁜스커트 스티치 절개 니,20680,19650,-1030
2018-06-01,568458658,E041020,컵,우드/컵받침/모음/트레이/코스터/카페컵받침/잔받침,3200,3200,0
2018-06-01,42806532,A013090,전복,건 홍합살 바지락 1Kg /꼬막 홍합 꼴뚜기 조개 조개살,18900,18900,0
2018-06-01,1385738764,A011160,빵,안흥찐빵마을 국산팥 수제 안흥찐빵 1.5kg 30개 간식,28650,28650,0
2018-06-01,1629464699,A013100,마른멸치,100% 완도산 참전복 1kg 8미부터 20~25미 산소포장,32500,32500,0
2018-06-01,1262040086,C021020,구두,VA-136 국내산 건강화 천연가죽 슬립온 효도선물 남성,65910,65910,0
2018-06-01,657231313,A011180,파스타면,면사랑 크림우동 까르보나라맛 X 10개 면사랑 해물볶,31830,31200,-630
2018-06-01,822467824,L021010,손목시계,특별구성기획 이태리브랜드 메탈 남성손목시계 27종,99000,99000,0
2018-06-01,1228149030,C021040,실내화,[푸마] RBR RIDER 레드불 라이더 남성용 운동화 305924 01,119000,59500,-59500
2018-06-01,1309531283,C013050,운동복,dd98 슬림핏 트레이닝복 네이비 츄리닝 트레이닝복상,19460,19460,0
2018-06-01,2135484436,A019070,양념소스,(참소당 찌개소스2kg)김치찌개 부대찌개소스 찌개양념,15900,15900,0
2018-06-01,1183395346,C013020,티셔츠,플레이키즈프로 리바이스키즈 리바이스 배트윙VNM13QTS57 반팔,17000,17000,0
2018-06-01,221798233,L012030,칫솔,래디어스 토츠 플러스 퓨어베이비 칫솔x6+케이스/홀더,22500,22500,0
2018-06-01,1584019297,A022030,생수,아이시스8.0 생수 2L*24펫/ 롯데칠성몰,17800,17800,0
2018-06-01,451115743,C013030,스웨터,BIGWM WN 601 (남) 빅사이즈 벌집꽈베기라운드긴팔니,48720,48720,0
2018-06-01,300685039,A013070,굴,훈훈수산 활 랍스타 특품 1마리,60000,60000,0
2018-06-01,952881843,A011090,국수,[농심]농심 안성탕면 125G*5입*8팩,25200,23920,-1280
2018-06-01,2057766554,I031040,생화,접이식 캠핑의자 야전침대 낚시 야외 간이침대 보조,23900,21280,-2620
2018-06-01,2000093234,E061020,섬유유연제,F C 베이비전용 섬유유연제 bottle 빨레세제 아기전용,21300,21300,0
2018-06-01,560956058,C013010,점퍼,[VOV]투톤 박시 후드 점퍼 [7125320054](경기점),88000,78540,-9460
2018-06-01,288865231,E011060,의자,BEST 인기 고급형 의자 책상의자 컴퓨터의자 학생의자,42900,39900,-3000
2018-06-01,386513837,E021020,커튼,암막포인트커튼 아일렛형 65x170cm 커튼,7230,7230,0
2018-06-01,956425925,E011050,책상,LOIS 테이블/1인용컴퓨터책상/2인용컴퓨터책상/의자/컴퓨터테이블/본체수납/모니터받침,69000,68310,-690
2018-06-01,1511045297,G011070,자전거,[삼천리]NEXT 시애틀D [문바이크] 2015년 하이브리드자전거 21단 700C 드롭바형 로드,159000,143100,-15900
2018-06-01,620518349,L021020,장신구,스와로브스키스톤 귀걸이 이어링 귀고리 은침 유색보석 비즈 실버 패션귀걸이 악세사리,11700,11350,-350
2018-06-01,108948174,C013050,운동복,야토 자동차 루프백 NW300L RV용 캠핑 가방 루프박스,85700,78070,-7630
2018-06-01,445516020,C012020,원피스,A라인 더블 버튼 코트(Z174MSG517)/ 쥬크,259000,220150,-38850
2018-06-01,1065748678,E031130,보온매트,2018년형 이메텍 전기요 전용 별무늬 커버 (2인용 순면 100%),32370,32370,0
2018-06-01,1432773368,A019180,즉석식품,[외갓집] 참이맛 감자탕 800gx3 무료배송 (상온보관),15400,15400,0
2018-06-01,1065748676,E031130,보온매트,2108년형 이메텍 전기요 전용 누비 커버 (2인용 순면100%),32370,32370,0
2018-06-01,489753791,E041050,냄비,네오플램 인덕션 3PLY 스텐냄비/밀크팬/이유식냄비,25900,24900,-1000
2018-06-01,1065748677,E031130,보온매트,2108년형 이메텍 전기요 전용 별무늬 커버(1인용 순면 100%),27720,27720,0
2018-06-01,1702743535,G011070,자전거,시애틀모던M 18년 하이브리드26인치 135cm부터사용,128900,116010,-12890
2018-06-01,1266671987,C012060,여자내의,KD 아그네 투피스 SET 겨울투피스 투피스 니트스커트,97970,97970,0
2018-06-01,1065748675,E031130,보온매트,2108년형 이메텍 전기요 전용 누비 커버 (1인용 순면100%),27720,27720,0
2018-06-01,1185361640,C012020,원피스,[쉬즈미스][쉬즈미스][균일]썸머 자켓점퍼코트 아우터,27900,26510,-1390
2018-06-01,287145868,I011030,사진기,후지필름 X-A10 16-50mm kit 카메라X-A3셀카5월행사,529000,358340,-170660
2018-06-01,9115865,A012010,국산쇠고기,[무항생제 한우선물세트] 한우 갈비 3호 4kg,411500,411500,0
2018-06-01,975583731,C011050,남자내의,카고바지/면바지/빅사이즈/청바지/작업복/건빵바지,19800,13800,-6000
2018-06-01,672398431,C012040,여자학생복,[모다아울렛][꼼빠니아]핀턱 주름핏 모던 블라우스(CA6S3WRB040블랙),15000,15000,0
2018-06-01,902978298,F012050,의료측정기,맥시마 혈당측정기+시험지60+멸균침110+솜100+사은품,19350,18000,-1350
2018-06-01,132054811,A018030,껌,푸른농장 해태아이스쿨리필82g+21g/레드루비/자일리톨,3200,3200,0
2018-06-01,587952583,C013060,등산복,텐제로 여름 쿨티셔츠/반팔티셔츠/반바지,8900,8900,0
2018-06-01,1968695733,C011030,남자학생복,(ACC(필골드) DB-002 청스판 절개라인 셔츠,42960,38240,-4720
2018-06-01,1980822472,A021010,커피,맥심 모카골드 라이트360T,33800,33800,0
2018-06-01,1760589623,L012060,샴푸,사은품증정)올뉴TS샴푸 500ml+500ml+샘플/탈모TS샴푸,29800,29800,0
2018-06-01,1065748681,E031130,보온매트,이메텍 프리미엄 풋워머 인텔리히팅 (G0020)/인공지능기 족욕기,91140,91140,0
2018-06-01,803371593,C012040,여자학생복,SI 빗살무늬 블라우스 SUBAC2420 US,48970,48970,0
2018-06-01,2132158591,C011030,남자학생복,[코디갤러리]by STCO 뱀부소재 믹스 프린트 셔츠1_CDSEA16TPL,11880,11290,-590
2018-06-01,134005540,C011030,남자학생복,[행텐] 여성 프린트 뷔스티에(10130-120-622-46)NC아울렛,39800,9000,-30800
2018-06-01,1649752552,A011110,당면,국내산 도토리전분 도토리 묵말랭이 250g,35130,35130,0
2018-06-01,379160527,C013020,티셔츠,랄프로렌 폴로 반팔 기본 빅포니 카라티 /남녀공용,39000,39000,0
2018-06-01,444528149,A015020,식용유,맑은식용유 1.8L 튀김용식용유 콩식용유 대두유 오일,9700,9600,-100
2018-06-01,1377241833,C012040,여자학생복,[부루앤쥬디][18년 여름] 기본 브이넥 니트 B1KE1PO003[갤러리아],19900,17910,-1990
2018-06-01,225345546,A018010,초콜릿,컬렉션 정품 페레로로쉐 3T(48개)/5T(60개),22800,22800,0
2018-06-01,1643902091,A022010,주스,가야 종합음료 180mlx12병x4세트 건강세트/행복세트,30640,30640,0
2018-06-01,1427649607,C011050,남자내의,DIPP2078M 커플기모남자기획셋트-바지단품 바지 남자,23260,23260,0
2018-06-01,513517329,C013020,티셔츠,[빈폴아웃도어]라이트 핑크 여성 COOLHAN 한지 솔리드 칼라 티셔츠 (BO8342C01Y),69300,54750,-14550
2018-06-01,1065748650,E031130,보온매트,2017년형 이메텍 프리미엄 전기요 2인용(ITH-387),101370,101370,0
2018-06-01,1065748651,E031130,보온매트,2017년형 이메텍 프리미엄 전기요 1인용(ITH-386),73470,73470,0
2018-06-01,2020106854,C013040,청바지,빅톤 여름철원단/남자 스판 일자진/빅사이즈/중년남성,37800,37800,0
2018-06-01,983356137,A016100,수박,[참예과] 아삭아삭 하우스 꿀 수박 5~6kg내외,19900,10400,-9500
2018-06-01,887040796,C012040,여자학생복,(해외직배송) 넥 조끼 원피스 세트,48700,48700,0
2018-06-01,530421430,C011030,남자학생복,오투아이스_쿨링프리미엄얼음조끼 쿨링조끼 얼음조끼,61510,59670,-1840
2018-06-01,175416616,E011030,거실장,[PookShuim] 푹쉼 렌 천연가죽 리클라이너 4인용 소파 (양쪽형),1740000,1740000,0
2018-06-01,876970297,E031010,전기밥솥,위니아 딤채쿡레트로 IH전기압력밥솥 EDCH-C0606DRV,270000,253800,-16200
2018-06-01,175416618,E011030,거실장,[PookShuim] 푹쉼 렌 천연가죽 리클라이너 3인용 소파 (양쪽형) 컵홀더포함,1600000,1600000,0
2018-06-01,602701717,I012060,저장장치,삼성전자 正品 USB/PS2 마우스/아이리버 마우스모음전,10910,7900,-3010
2018-06-01,445516050,C012020,원피스,핸드메이드 가디건 스타일 코트(Z174MSG519)/ 쥬크,179000,152150,-26850
2018-06-01,1030615279,A013090,전복,싱싱하고 알이꽉찬 푸짐한 러시아가리비 1kg,17000,17000,0
2018-06-01,166795135,C012060,여자내의,리즘 주름 롱스커트 SD-9028 롱치마 긴치마,18200,17660,-540
2018-06-01,1259868433,C012020,원피스,[미틈몰]예쁜원피스/홀복/미니/시스루/클럽의상/플레어/결혼식/레이스/섹시/쉬폰/랩/셔,29800,29800,0
2018-06-01,2003443674,C013010,점퍼,[모다아울렛][후라밍고]자수펀칭점퍼(F3072060민트 블랙),159200,140100,-19100
2018-06-01,1094621096,A011110,당면,웅부도토리 묵말랭이 250g-국내산 도토리,35840,35840,0
2018-06-01,1450027790,C012020,원피스,(해외직배송)여성 꽃프린트 트렌치 코트 프린팅코트,77220,67960,-9260
2018-06-01,483087391,C013010,점퍼,핸드메이드 여성무스탕코트 K'브랜드44~88사이즈별 맞춤제작(100%리얼무스탕/3색상),1369000,1369000,0
2018-06-01,1429625527,F012020,생리대,데이위드 유기농 생리대 16px2팩+워시샘플/팬티라이너,11900,11900,0
2018-06-01,990158455,F012010,종이기저귀,군기저귀 팬티형 XL 특대형 남 38매 3팩,42500,42500,0
2018-06-01,1044493114,I031040,생화,빈슨메시프 레아 침낭-가성비 최강KC인증 사계절 캠핑,15800,14150,-1650
2018-06-01,1942075166,C013020,티셔츠,[디데무]스팽글별반팔티셔츠(LW1703903),23100,20560,-2540
2018-06-01,1035703329,A022050,탄산음료,롯데칠성몰 탄산 칠성스트롱사이다 400mlx12펫,11900,11900,0
2018-06-01,1325387518,E031030,전자레인지,[삼성전자] [공식파트너] 삼성 전자레인지 MS23K3523AK 무료배송,105400,93900,-11500
2018-06-01,854488817,A019060,된장,CJ 조미류 모음,2450,2450,0
2018-06-01,1665307946,A022010,주스,스프라이트 블랙보리 1.5L/쥬스/음료수/탄산수/업소용,14780,14780,0
2018-06-01,944790300,A013070,굴,건해삼(채 러시아 600g)X3 해삼 서해삼치 업소 건조해,284150,284150,0
2018-06-01,1831050548,I031070,애완동물관리비,휴대용 계수기/카운터기/수동 인원체크기/숫자세기,2300,1950,-350
2018-06-01,650973464,C013020,티셔츠,앨빈클로 정품 반팔 브이넥 티셔츠 남녀공용 헨리넥,16900,9900,-7000
2018-06-01,820140375,F012030,안경,[본사직영정품] 원형 안경테 메탈 하금테 동그란 뿔테,25900,25900,0
2018-06-01,1217398818,E011020,침대,스마트시스템 스틸 침대프레임(SS) 프레임세트 침대,417610,405090,-12520
2018-06-01,1977145096,E061030,전구,LED등기구/LED조명/방등 거실등/led형광등,6800,5490,-1310
2018-06-01,25797494,C013020,티셔츠,(도도한걸)티셔츠/롱티/원피스티/세트/후드티/니트,9900,9900,0
2018-06-01,1010173842,A012040,닭고기,초L프레시)훈제닭가슴살 100G,1990,1990,0
2018-06-01,1204508568,C012040,여자학생복,밍크털오픈조끼 BR1712 퍼조끼 여성베스트 털조끼 오,141510,137270,-4240
2018-06-01,368791486,C021020,구두,남성구두 MA95 천연가죽 2.5cm 슬립 정장 신사화 남성,53390,53390,0
2018-06-01,1126862273,A016020,배,품질엄선 당도 높은 추황배/신고배 5kg 특가,8900,8900,0
2018-06-01,581864429,C013010,점퍼,봄 여름/남성/남자/점퍼/남방/카라티/정장/골프/바지,39800,39800,0
2018-06-01,418250736,E031070,에어컨,ABFW-1474R 아기바람 벽걸이리모컨 선풍기,73900,70210,-3690
2018-06-01,1353357743,C013020,티셔츠,베이직 후드티 LTT0033 여성티셔츠 여성후드티,26120,25600,-520
2018-06-01,334324878,C014010,아동복,어린이 방한 마스크 WT0119 샐리캣마스크,8720,8720,0
2018-06-01,36984334,C011050,남자내의,[게스] 남녀 린넨반바지 2종 택1 (여24 남34 size특가),20400,20000,-400
2018-06-01,87152620,C012040,여자학생복,[하루메이비] M324 로즈자수 장식 스트라이프 롱 셔츠,42900,42900,0
2018-06-01,1701731637,C013010,점퍼,[네파키즈]NEPA 네파 키즈 바람막이 자켓,32900,31260,-1640
2018-06-01,716919097,C013050,운동복,아디다스/나이키/초특가/38종/트레이닝복/세트/츄리닝,39000,39000,0
2018-06-01,1351583061,C014010,아동복,아동팬티 터닝메카드W히어로즈3종세트 어린이팬티 남,9430,9430,0
2018-06-01,1010173836,A012040,닭고기,초L프레시)로즈마리닭가슴살 100G,1990,1990,0
2018-06-01,451081977,A011100,라면,할매손 콩국수용면3kg2개 국수 콩국수용면 할매손 할,36330,32700,-3630
2018-06-01,113099108,E031070,에어컨,코멕스 날개없는선풍기 타워형선풍기 타워팬 선풍기,57800,57800,0
2018-06-01,1010173839,A012040,닭고기,초L프레시)탄두리닭가슴살 100G,1990,1990,0
2018-06-01,716501586,I031040,생화,160도 무중력의자 야전침대 수면의자 접이식의자 낚시,39900,36710,-3190
2018-06-01,941080702,A011160,빵,샤니/핫도그빵 (6개입x6봉 36개)/참깨빵/햄버거/소스,6600,6600,0
2018-06-01,492117879,F011150,건강기능식품,[뉴팜] 헬퍼장 베이비앤키즈 생유산균 90포,18800,18800,0
2018-06-01,2099590670,C013020,티셔츠,mm17 러플 반폴라 TOP_화이트 티셔츠 긴팔티셔츠 긴팔,16090,16090,0
2018-06-01,1519725737,C013050,운동복,카본 범퍼윙 가드 대 중 소 중 택1 범퍼가드 자동차범,20230,18430,-1800
2018-06-01,749438308,A017280,김,초생강(백색 참존 1.2k)X10,33110,33110,0
2018-06-01,418703009,C015030,넥타이,(색상 : 네이비) BTIE_090 검은꽃 보타이 미,13420,13420,0
2018-06-01,1468410192,A012010,국산쇠고기,[무항생제] 불고기 400g 1등급,21500,21500,0
2018-06-01,1497044225,A021020,차,오뚜기 크리미 1kg 원두용 프림 프리마 원두전지분,3920,3920,0
2018-06-01,48510642,C011030,남자학생복,[윈지마켓]베이직 잔체크 슬림 셔츠 긴팔셔츠 슬림셔츠 셔츠 남자셔츠 남성의류 상품다,29600,26640,-2960
2018-06-01,1826201599,A017230,마늘,2018년 햇양파10kg중-7900원/햇감자10kg-12900원판매,9900,9900,0
2018-06-01,451081976,A019100,식초,오뚜기 식당용케찹(캔)3.3kg2개 케찹 식당용케찹 케？R,19750,17780,-1970
2018-06-01,972556620,C013010,점퍼,[블루독](IV)바람막이야상점퍼(27415-110-01),76000,58520,-17480
2018-06-01,1111577498,C012020,원피스,[올리비아로렌] 솔리드 베이직 팬츠 VOCGBRM3281,14800,13920,-880
2018-06-01,923847509,A019180,즉석식품,임성근의 고기듬뿍 나주곰탕 11팩,59900,56900,-3000
2018-06-01,746162848,E021010,침구,수퍼클래스 1.5cm 3D MESH 유아동매트 SCS13-1116 수,131260,119560,-11700
2018-06-01,2083950005,C012060,여자내의,무비 카브라 린넨 원피스- 린넨원피스 마원피스 오버,59800,50830,-8970
2018-06-01,252577104,A016040,포도,동원)황도 슬라이스 400g x 12개 사시사철 맛있는,41360,41360,0
2018-06-01,783135114,D031010,주택수선재료,연두하우스 _ 현관문 시트지 100x210 /접착_ 물시트지,34900,34900,0
2018-06-01,1366617567,C011050,남자내의,여름/반바지/빅사이즈/남자/남성/밴딩/린넨/슬랙스,19800,19800,0
2018-06-01,1520425660,C013020,티셔츠,여름나시티3800무료배송/골지/망고/남녀공용,3800,3800,0
2018-06-01,976835765,C012030,여자상의,[하랑이플] 냉장고반팔원피스/빅사이즈원피스/여름원피스/엄마옷,9900,9900,0
2018-06-01,492778489,C012060,여자내의,메롱샵 헤일리데님_SK/스커트/ 메롱샵,22900,18780,-4120
2018-06-01,248419607,C013010,점퍼,[하프클럽/SHES MISS]쉬즈미스 /엔터식스/ 옆트임 싱글 트렌치코트 swwbyi20020,124000,114080,-9920
2018-06-01,633950541,A011040,보리쌀,2018년 첫 출하 국내산 껍질 햇 완두콩 2kg 산지직송,13900,13900,0
2018-06-01,940222771,C014020,유아복,디미엘 팬츠_UR73SL558 팬츠 면바지 아동복 남녀공용,15690,15690,0
2018-06-01,447819212,I031040,생화,회전/사각/폴딩파라솔/모기장/파라솔/대형파라솔,162000,144990,-17010
2018-06-01,1911825653,C013050,운동복,삼우산기 분말소화기 0.7kg 축압식 차량용 올국산,19000,17020,-1980
2018-06-01,1309136703,A014030,치즈,파마산 블렌드 골드 227g 삼조 치즈 가루,3780,3780,0
2018-06-01,1861740106,A016030,복숭아,황도캔(슬라이스 삼아 2.96K)X6개/황도캔 복숭아캔 황,55260,51950,-3310
2018-06-01,2039718672,C013020,티셔츠,[주끌로] 여름 신상 티셔츠/팬츠! 스토어 10%쿠폰,9900,9900,0
2018-06-01,1750388127,C012060,여자내의,[공구우먼] 베이링 버튼 청치마 28642 빅사이즈여성의류 스커트,27000,27000,0
2018-06-01,851187988,E011050,책상,[EONC]최고의독서실책상/실속형 /우등생/+LED형광등,63400,63400,0
2018-06-01,917352682,E011050,책상,컴퓨터책상 학생책상 사무용책상 책상세트 1인 2인용,69000,69000,0
2018-06-01,1367282430,A022050,탄산음료,음료수모음 칠성사이다 코카콜라 미닛메이드 레쓰비,5900,5900,0
2018-06-01,952881867,A011090,국수,[농심]농심 신라면 120G(30입/박스),20400,20400,0
2018-06-01,1956974229,C012040,여자학생복,[화이트폭스] 여름신상 린넨셔츠/롱/루즈핏/체크/마,10500,10500,0
2018-06-01,952881868,A011090,국수,[농심]농심신라면120G*5입*8팩,27040,25000,-2040
2018-06-01,499988964,C012040,여자학생복,[IFNE(이프네)]플라워트임로브가디건(DI5WCD09)[갤러리아],22000,18700,-3300
2018-06-01,36781877,F012020,생리대,릴리안 초흡수 대형 14P x 1팩,1950,1950,0
2018-06-01,529214067,C013020,티셔츠,여성 골프웨어 긴팔 티셔츠 기능성 언더웨어 골프의류,19800,18800,-1000
2018-06-01,152006948,A013160,맛살,한성 크래미(F2) 1kg2개,52180,52180,0
2018-06-01,900474761,A013070,굴,껍질벗긴새우(냉/베트남),499,400,-99
2018-06-01,194631011,L012010,면도기,도루코 일회용면도기 100EA 원터치포장 1회용두날 2중,7500,7400,-100
2018-06-01,467845290,C011020,남자상의,(남자옷도매)클래시컬 투버튼수트 (M-2XL) 네이비 남,314320,314320,0
2018-06-01,1258099594,A018080,설탕,미국산 에리스리톨 위드 스테비아 1kg,25900,25900,0
2018-06-01,398712311,A021010,커피,마이카페 이태리 트롬베타 캡슐50개/네스프레소호환,29000,26500,-2500
2018-06-01,988121674,F011150,건강기능식품,[CJ직배송]BYO장유산균(냉장) 60캡슐 X2개_4개월분,139600,26400,-113200
2018-06-01,986214249,A011060,땅콩,[참다올잡곡세트]불후애명곡1호,20800,16000,-4800
2018-06-01,1305482244,C013010,점퍼,[네파키즈] KDF2003-105 알라스카 구스 다운 자켓,151890,151890,0
2018-06-01,1048784151,C013010,점퍼,[데일리스트/앤섬] 양포켓 시스루 베스트 MDTQCSM4151,31300,29430,-1870
2018-06-01,554279019,C012040,여자학생복,수지네 일본 구제 화이트스트라이프 면 조끼 여성 M 2,14060,14060,0
2018-06-01,1240653619,I031010,장난감,(스텝2 사파리웨곤(new))대형완구 푸시카 지붕차 승용,467180,457840,-9340
2018-06-01,764124775,A013160,맛살,한성 크래미(F2) 1kg2개,52180,52180,0
2018-06-01,894501701,C013010,점퍼,간절기[네오프렌 항공점퍼/블루종]멋쟁이들의 필수아,27700,27700,0
2018-06-01,1896790858,C013010,점퍼,에어워크 아웃도어점퍼/바람막이/윈드자켓/단체복,40800,32800,-8000
2018-06-01,827227077,C014010,아동복,[아이러브제이] 여름 글로우 리본 블라우스 JNUTO02-WA,12250,11090,-1160
2018-06-01,1468473744,A012010,국산쇠고기,[무항생제] 불고기 600g 2등급,29500,29500,0
2018-06-01,947141311,L021030,가방,서류가방 남자가방 정장가방 크로스백 브리프케이스,37500,37500,0
2018-06-01,1637009182,I031010,장난감,더뻔뻔 레고듀플로 놀이판 블럭판 레고판 조립판 밑판,900,900,0
2018-06-01,1486447631,A011030,찹쌀,보리쌀 (1K) X10,55750,49620,-6130
2018-06-01,1305254710,D031010,주택수선재료,던롭 DR100 2kg 초속경 고강도 콘크리트 몰탈,9000,9000,0
2018-06-01,1695688947,L012110,색조화장품,2018 베리떼 더블컷 선스틱 더블 이펙트 18g+18g,20800,20800,0
2018-06-01,1577305683,E031120,믹서,해피콜 초고속블랜더 액슬림z HC-BL5000 분쇄컨테이너,319900,319900,0
2018-06-01,1080782327,L021030,가방,독일 RivaCase/리바케이스 16인치 17인치 노트북가방 모음/리바케이스 노트북배낭/노트,59000,57820,-1180
2018-06-01,143204764,A019080,고추장,해찬들 만능 요리장!,4380,4380,0
2018-06-01,1505656900,A022010,주스,웅진식품 자연은 70일 망고 (1.5LX4펫)/ 웅진식품,8900,8730,-170
2018-06-01,746389398,A013150,어묵,[부산3대어묵] 점보 미도바 5종 25개 (2.5kg),52900,47560,-5340
2018-06-01,665285495,C011050,남자내의,조군샵 남여공용 소프트밴딩 데님 하프팬츠 ELJG3269,17290,17290,0
2018-06-01,492778459,C012040,여자학생복,메롱샵 레이스뷔스티에_[단독진행]/베스트/ 메롱샵,8000,6560,-1440
2018-06-01,308535865,C012020,원피스,[대구백화점 I관] [지-컷]레이블트렌치코트(7217216005),161460,135630,-25830
2018-06-01,492778457,C012060,여자내의,메롱샵 비엔토롱데님sk_[단독진행]/스커트/ 메롱샵,16000,13120,-2880
2018-06-01,114702824,C013020,티셔츠,빅사이즈 루즈핏기본맨투맨 WW01909 미시옷 임부복 루,27390,27390,0
2018-06-01,2097457922,C014010,아동복,[노스페이스] 키즈 플라워 포인트 짚 업 래쉬가드 NJ5JJ06SDGY,62400,59910,-2490
2018-06-01,2019019601,C014010,아동복,아자브키즈 원피스 가디건 멜빵 리본 치랭스 여아,9800,9800,0
2018-06-01,1259722098,F012050,의료측정기,로슈 퍼포마난 혈당측정기+측정지60+침110+솜100,61000,61000,0
2018-06-01,1353632003,E041070,밀폐용기,메탈락 원형 스텐 밀폐용기 직사각형 스텐 밀폐용기,8000,7360,-640
2018-06-01,1833566310,L012090,기초화장품,설화수예서트윈케이크/파운데이션/설화수스킨커버리필,31500,31500,0
2018-06-01,457288875,C014020,유아복,[프렌치캣] 여름특가 (보라다이마루바지(Q33DSO020)[갤러리아],9000,6930,-2070
2018-06-01,958572909,A021010,커피,[동서]동서 맥심 아이스 믹스 작은컵용 20T*13G,5980,4900,-1080
2018-06-01,1003011593,E011030,거실장,[채우리] 시아 스틸 2단 옷걸이 행거,112000,112000,0
2018-06-01,182312430,C013010,점퍼,바람막이/점퍼/후드점퍼/야상/남자점퍼/남성/블루종,59800,39800,-20000
2018-06-01,1003011592,E011030,거실장,[채우리] 시아 스틸 6단 수납 행거,154000,154000,0
2018-06-01,584707332,F012010,종이기저귀,하기스 굿나이트/어린이안심팬티/야뇨증/중형/대형,36900,36900,0
2018-06-01,1188074451,C012020,원피스,KAA-C192 쉬폰가디건숄 숄가디건 숄원피스 비치롱가디,14870,14430,-440
2018-06-01,1186385102,I011020,영상음향기기,비비텍 DX281ST 밝기3000 고해상도 단초점 빔프로젝터,749000,699000,-50000
2018-06-01,247128081,C012060,여자내의,니혼 큐티 8부롤업 멜빵청바지 SD-4087 멜빵바지 멜빵청바지 청반바지 청바지 스키니진,37440,33330,-4110
2018-06-01,207560046,C013020,티셔츠,[앨빈클로]공용 후드집업 커플 후드 맨투맨 무지 기모,29000,19900,-9100
2018-06-01,1079839340,A014020,분유,[아이배냇]순산양유아식 3단계 800g,32900,32900,0
2018-06-01,1395636356,C012030,여자상의,페르먼 후드 청롱원피스 DM-6638/청원피스 데님원피스,31800,30210,-1590
2018-06-01,460263090,C014020,유아복,아동바지 배기바지 은하수 KIDBOK-30 반바지 긴바지,11050,11050,0
2018-06-01,917109555,C011050,남자내의,슈프림 트레이닝바지 팬츠 추리닝 츄리닝바지 남자 성,20800,20800,0
2018-06-01,1398048249,A011020,현미,두레생협 찹쌀백미(4kg 유기) 가정용백미 찹쌀백미 찹,50490,50490,0
2018-06-01,432978210,L012110,색조화장품,시세이도 파란자차 선크림/선스틱/스틱파운데이션,32300,32300,0
2018-06-01,300626636,C012020,원피스,[쉬즈미스][쉬즈미스] 탈착 스트랩 솔리드 셔츠_SWWSTI10010_DG,138600,117810,-20790
2018-06-01,328331303,C012040,여자학생복,[대구백화점 II관] [탑걸]스티치 미니 가디건(TIZ4GD707F),29000,24940,-4060
2018-06-01,687705041,C011020,남자상의,세빈옴므/결혼식하객패션정장/면접정장/수트/정장,78900,78900,0
2018-06-01,1278221839,A014040,발효유,서울우유 비요뜨 4종 초코/그레크런치/베리,1380,1380,0
2018-06-01,457982064,L012030,칫솔,(오랄비특가) 지라이프X20개 /2080/치솔/칫솔/미세모,7900,6600,-1300
2018-06-01,1842381555,C013010,점퍼,사파리 옷 수선 접착 테이프 패치 패딩 야상 점퍼,9000,9000,0
2018-06-01,1011207657,F011150,건강기능식품,[코오롱제약] 슬림업 워터젤리 석류맛 - 10팩,40000,12900,-27100
2018-06-01,1011207658,F011150,건강기능식품,[일양약품] 와일드 쾌변 젤리컷 (20gX14포) - 1박스(2주분),40000,14900,-25100
2018-06-01,1840065029,C012030,여자상의,로로텐 롱/미니/쉬폰/레이스/원피스/빅사이즈여성의류,23900,23900,0
2018-06-01,1011207656,F011150,건강기능식품,[코오롱제약] 슬림업 워터젤리 레몬맛 - 10팩,40000,12900,-27100
2018-06-01,1945391255,C013020,티셔츠,[SOUP]피쉬포인트티 SU4ST45,39200,33320,-5880
2018-06-01,1011207653,F011150,건강기능식품,[내츄럴플러스] 양배추환 스틱 100 (30포) - 2박스,30000,15900,-14100
2018-06-01,547516438,A018110,물엿,시아스 키위 드레싱 골드 2kg/천연향신료사용/샐러드/야채/키위농축액/맘스맘/오뚜기/,8300,8300,0
2018-06-01,1428735960,F012020,생리대,[무료배송][위스퍼]신제품 보송보송케어 울트라 날개중형 36P 3팩 / 생리대 / 여성용품,24200,23390,-810
2018-06-01,2113228330,I053010,공책,힐링 컬러링북 3000/색칠공부/도안/,3000,2400,-600
2018-06-01,988926867,E061050,청소용세제,[홈스타] 미스터 홈스타 향락스 주거세제 1Lx2개,7800,4000,-3800
2018-06-01,1545223334,A018080,설탕,설탕 3kg 하얀설탕 갈색설탕 3kg 큐원설탕 백설탕,3590,3590,0
2018-06-01,387393260,C021040,실내화,아키클래식 운동화 스니커즈 신발 슬립온,29900,29900,0
2018-06-01,988926869,E061050,청소용세제,[홈스타] 바르기만 곰팡이싹120MLx3개,11700,9900,-1800
2018-06-01,988926868,E061050,청소용세제,[홈스타] 바르기만 곰팡이싹120MLx2개,7800,6600,-1200
2018-06-01,1003011591,E011030,거실장,[채우리] 시아 스틸 심플 행거,64000,64000,0
2018-06-01,2116806162,C013040,청바지,[청바지]32~46인치 빅사이즈60종/면바지/기모바지,27280,27280,0
2018-06-01,1460562353,C012020,원피스,[보니알렉스](보니알렉스)루즈 와이드 트위드 코트(BAHY104A),35500,31240,-4260
2018-06-01,532350168,C013010,점퍼,핸드메이드 라이더무스탕자켓 남성무스탕자켓 빅사이즈남자무스탕(국내제작/90~120맞,899000,899000,0
2018-06-01,1603688887,F012030,안경,더블리츠 시크라운드 동글이 블루라이트 차단 안경 UV,40000,40000,0
2018-06-01,1847985525,C013040,청바지,로로텐 청바지/슬림핏/스키니/밴딩/팬츠 빅사이즈,19800,19800,0
2018-06-01,1582656348,C011030,남자학생복,여름 반팔셔츠/남방 7부 린넨 롤업 헨리넥 남자 남성,15900,15900,0
2018-06-01,1811803073,C013040,청바지,[쥬시쥬디]데님오버롤 7부 기장 점프수트(JROP322R)(강남점),49000,41650,-7350
2018-06-01,572846789,C013010,점퍼,반폴라보아털집업 GY1712 반폴라집업 여자집업 캐쥬얼,55820,55820,0
2018-06-01,342679929,F011150,건강기능식품,암웨이 뉴트리라이트 더블엑스 리필 종합비타민무기질,76500,76500,0
2018-06-01,1923654975,C011030,남자학생복,신상 셔츠모음/체크/남방/와이셔츠/오버핏/청/남자,9900,9900,0
2018-06-01,1834434185,F012020,생리대,좋은느낌 좋은순면 울트라 날개 중형 57매,13500,13500,0
2018-06-01,1011207660,F011150,건강기능식품,[일양약품] 와일드 쾌변 젤리컷 (20gX14포) - 2박스,80000,26900,-53100
2018-06-01,532350173,C013010,점퍼,BU무스탕 카라탈부착 핸드메이드 스타일엔터 메리노베이비 무스탕자켓 남자무스탕점퍼,960000,960000,0
2018-06-01,308667575,C012030,여자상의,럭셔리 정장원피스/결혼식/레이스/롱/플라워/쉬폰,34800,34800,0
2018-06-01,747811868,A022050,탄산음료,롯데칠성몰 트레비 355mlx24캔(레몬/라임),12000,12000,0
2018-06-01,1095635727,A013080,조개,국내산 새꼬막 1.5kg (상) 새벽조업후 발송 산지,32970,32970,0
2018-06-01,900474793,A011180,파스타면,농심 순한 너구리 120G*5입,3790,3790,0
2018-06-01,900474792,A011090,국수,[농심]농심 새우탕 큰사발 (115G),1090,1090,0
2018-06-01,906043457,C011030,남자학생복,빅사이즈/남자/체크남방/셔츠/스트라이프/무지/차이나,13000,12800,-200
2018-06-01,551808727,E041070,밀폐용기,더치병/페트병/공병/유리병/플라스틱병/생수병/패트병,1100,920,-180
2018-06-01,533496513,I031040,생화,[카르닉] 해먹스탠드/해먹거치대/해먹세트/캠핑용품,42900,39470,-3430
2018-06-01,972243723,L012060,샴푸,려 자양윤모 샴푸 400ml x 3개/지성/중건성/민감성,14900,14900,0
2018-06-01,986155411,A011080,밀가루,[백설]백설 제일제면소 소면_200G,990,990,0
2018-06-01,1326806428,C013010,점퍼,인조이 롱 점퍼 블랙 롱점퍼 여성점퍼 여자롱점퍼 시,25450,25450,0
2018-06-01,2091969846,A022040,기능성음료,포카리스웨트 500mlx20펫 토레타/게토레이/파워에이드,19900,19900,0
2018-06-01,900474790,A011090,국수,[농심]농심 육개장 큰사발 (110G),1090,1090,0
2018-06-01,345163651,C011030,남자학생복,남성/남자/반팔/차이나/셔츠/여름/마/체크/중년/남방,16900,16900,0
2018-06-01,1441418799,A011140,부침가루,신라명과 한눈애바나나 빵 22g x 16개입 바나나맛 빵,9190,9190,0
2018-06-01,199779168,C013020,티셔츠,여름신상랩티댄스복파티블라우스리본웨딩이쁜셔링티,12900,12900,0
2018-06-01,1056814779,C014010,아동복,아둘 쥬니어 미키 랍빠 핫팬츠 반팔티 상하세트 28,19100,19100,0
2018-06-01,289182365,C011030,남자학생복,S/S 신상셔츠/반팔/오버핏/커플/린넨/데님/옥스포드,13900,13900,0
2018-06-01,1376192392,C011050,남자내의,[하프클럽/BASSO homme]베이지 면스판 베이직 노턱 하프 캐주얼팬츠 (WSQ2PH65A),19900,18710,-1190
2018-06-01,202004493,A019010,고춧가루,국내산 정읍청결 고추사랑 고춧가루 1kg,20900,20900,0
2018-06-01,1804741745,E031040,전기레인지,데이킵스 냉장고문짝정리 8P,27280,27280,0
2018-06-01,1938892533,E061030,전구,LED T5/간접조명/슬림형광등/등기구/LED조명/전구,3650,3290,-360
2018-06-01,585073446,C013050,운동복,노옵션 균일가 슈퍼렉스 아동 래쉬가드 보드숏 수영복,4000,3900,-100
2018-06-01,1011207688,F011150,건강기능식품,[일동] 하이브리드 에너지젤 깔라만시 - 1박스(총10포),35000,21900,-13100
2018-06-01,1011207689,F011150,건강기능식품,[일동] 하이브리드 에너지젤 청포도 - 1박스(총10포),35000,21900,-13100
2018-06-01,1011207686,F011150,건강기능식품,[일동] 하이브리드 에너지젤 사과 - 1박스(총10포),35000,21900,-13100
2018-06-01,1162020082,E021010,침구,겨울왕국 면기모 패드 - 뷰티선샤인 (064187) 캐릭터,63540,57880,-5660
2018-06-01,521102325,C013050,운동복,[사랑손님]자동차 안전 삼각대/삼각뿔/경광봉/표지판/안전봉/차량용/자동차용/교통 안,3100,3000,-100
2018-06-01,1011207685,F011150,건강기능식품,[일동] 하이브리드 에너지젤 꿀홍삼 - 1박스(총10포),35000,21900,-13100
2018-06-01,747688045,A014020,분유,[니플4개] 일동후디스 트루맘 액상분유 2 3단계 24입,31900,31900,0
2018-06-01,1011207683,F011150,건강기능식품,[대웅] 백수오 (70mlX30포) - 1박스,50000,24900,-25100
2018-06-01,331226979,C013040,청바지,코코얀 남아 제깅스/아동 데님 청바지,23100,22600,-500
2018-06-01,1648835289,C011030,남자학생복,따뜻한 방한 나시 / 남자 겨울 정장 이너,13900,13900,0
2018-06-01,1334812143,C013050,운동복,S/S 밴딩 요가 숏 트레이닝팬츠의모든것 만원이상무배,6900,6900,0
2018-06-01,312573167,C021010,아동화,세일 까꿍쿨링 베이비 유아동 망사슬립온 아쿠아신발,17500,17500,0
2018-06-01,1793297610,C013020,티셔츠,아동반팔티 티셔츠 상하복 팬츠 남아의류 아동복 옷,10250,9950,-300
2018-06-01,60362166,A018110,물엿,[두레촌] 식품 명인 도라지 조청 세트 (6병) 쌀 생강 물엿 꿀,64900,64900,0
2018-06-01,633325941,C011020,남자상의,봄여름 슬랙스 남자바지 3040세대 남자 정장바지,32800,32800,0
2018-06-01,1944692598,L012060,샴푸,려 진생보 샴푸 400ml x3개/자양윤모 3종x3개/진결모,13900,13900,0
2018-06-01,2046949110,C012020,원피스,[모조에스핀]포켓 포인트 롱자켓_S174MSF019(MA1),169000,160550,-8450
2018-06-01,950590350,L012060,샴푸,닥터포헤어 폴리젠 플러스 샴푸 500ml 2개 + 200ml,32000,32000,0
2018-06-01,879105382,E061010,세탁세제,엘지생활건강 테크 수퍼타이 표백플러스 리필 10kg p,10210,10210,0
2018-06-01,1083831375,C012060,여자내의,[앤썸][데일리스트앤섬] 베이직 솔리드 슬림핏 팬츠 MVGDLQM3352,15000,13500,-1500
2018-06-01,337049723,C011030,남자학생복,18년 S/S 인기상품전 구김없는 레귤러핏 남방 10종 택1(선물포장가능)/ 닥스(셔츠),60000,49200,-10800
2018-06-01,1079866992,A014020,분유,[아이배냇]순산양분유 1단계 800g,32900,32900,0
2018-06-01,1650488329,C011030,남자학생복,패딩 발수제 발수스프레이 의류 자켓 패딩 다운 조끼,20000,20000,0
2018-06-01,353034406,A021010,커피,핑거루트 600g 분말 가루 환 티백 보이차 풋사과분말,7000,6900,-100
2018-06-01,605284938,I053040,기타문구,카카오프렌즈 점착메모지 포스트잇/카카오 포스트잇,1310,1310,0
2018-06-01,238617843,C013050,운동복,도난방지 타이어 에어 밸브캡 / 타이어캡 자동차 차량,5320,5320,0
2018-06-01,1011089667,E061020,섬유유연제,[LG]LG)샤프란진드기제거(자스민&머스크)3.1L,2990,2500,-490
2018-06-01,1040383171,E061010,세탁세제,암웨이/SA8 프리미엄 세탁세제/1kg/3kg/최저가,12900,12900,0
2018-06-01,853861930,A021010,커피,더치커피/원두/아메리카/더치원액/액상커피/커피파우,29800,29800,0
2018-06-01,450162577,C015040,장갑,아놀드파마_APGW_BY1212-1(여성가죽장갑) 장갑 여자가,21010,18910,-2100
2018-06-01,677557778,E021020,커튼,[파스텔데코] 로맨틱 우아함 겸비한 이중커튼 레이스,39900,36710,-3190
2018-06-01,574932727,A012050,소시지,렉커 화이트소시지 뉴른베르거 생소시지(400g)/국산돈,5300,5300,0
2018-06-01,459264431,E041010,식기,[키친아트] 키친아트스텐채망 중6117 채망 채반 스텐채반 소쿠리 주방채반,12300,9300,-3000
2018-06-01,1749255146,A014050,달걀,무항생제 HACCP 특란 계란 한판 30알,4800,4800,0
2018-06-01,1438824488,C012020,원피스,파파야 루즈핏 면 체크재킷 CNIRCT002B,30800,30800,0
2018-06-01,1125272023,I053010,공책,9800 마이플랜 밴딩노트 학생노트 유선노트 밴딩공책,12840,12840,0
2018-06-01,1043387969,C011030,남자학생복,초특가 봄신상 롱 숄 남성 남자 가디건 자켓 후드,30000,16800,-13200
2018-06-01,1868406156,C013020,티셔츠,수아 여름 신상 여성 롱 티셔츠/프린팅 티셔츠/반팔티,4900,4900,0
2018-06-01,720815297,L021030,가방,보카시 빨대가방 스트롱바구니 스트로우 비치백 왕골,16000,16000,0
2018-06-01,29559717,A014020,분유,아이배냇 순산양분유 1/2/3/4단계 800g3캔 산양분유,92900,92900,0
2018-06-01,1238098508,C012060,여자내의,[크로커다일레이디스]미디 주름 페미닌 스커트_K7M7,17900,17010,-890
2018-06-01,1767256620,C015030,넥타이,[나쁜남자] 모직넥타이 셋트 행커치프 울 코튼넥타이,13900,13900,0
2018-06-01,652385363,C013040,청바지,봄 가을 신상 찢어진 헤짐 스트레이트 청바지,19900,19900,0
2018-06-01,422226122,I031040,생화,[NALGENE] 날진 트라이탄 루프통 0.5L 물병 - 친환경 아웃도어 물통,14000,11160,-2840
2018-06-01,1477547013,E021010,침구,곰돌이3 아동 아사 60수 리플 여름 홑이불 베개 세트(,41040,33610,-7430
2018-06-01,554402810,C012040,여자학생복,봄 여름 루즈핏 66 77 빅사이즈 체크 롱 남방 셔츠,19900,19900,0
2018-06-01,450162580,C013010,점퍼,K2 S 무스탕 5 라이더점퍼,100650,100650,0
2018-06-01,261717660,E021010,침구,[아망떼] 풍기인견 100% 여름 인견 이불세트/패드,22900,22900,0
2018-06-01,1285045842,C013020,티셔츠,[케이투(의류)]남성 여성용 BOOST:D아이스 반팔 짚업 티셔츠 KWM18295 KMM18294,39000,31980,-7020
2018-06-01,515255502,C011030,남자학생복,롤프 남성 후드베스트 롱조끼 롱가디건 블랙 검정 긴,29500,29500,0
2018-06-01,1236131193,A021010,커피,네스카페쿨 커피믹스 1kg/냉커피/커피믹스/자판기커피,5700,5700,0
2018-06-01,577045931,L012110,색조화장품,[아이오페] 아이오페 UV쉴드선프로텍터EX선크림/SPF50+PA++++60ml,15200,15200,0
2018-06-01,373924470,C013020,티셔츠,여름신상/반팔티/반팔카라티/7부티/티셔츠/카라티,15800,14800,-1000
2018-06-01,2085783139,A018100,꿀,오리진 비프로폴리스스프레이x30ml 프로폴리스 목건강,47000,46530,-470
2018-06-01,1804356821,L021020,장신구,[바보사랑]데일리 귀걸이 6종 세트 15번,6320,6320,0
2018-06-01,2004323747,C013050,운동복,에탄올 워셔액 1.8L x12개(1박스) 무료배송~ -KS인증-,19800,19800,0
2018-06-01,1967524107,F011150,건강기능식품,바이오가이아 프로텍티스 베이비 드롭 5ml 1통 유산균,31000,31000,0
2018-06-01,1804356822,L021020,장신구,[바보사랑]데일리 귀걸이 6종 세트 14번,6320,6320,0
2018-06-01,632984424,C011030,남자학생복,패딩점퍼 빅사이즈 3023 MK 3021 빅사이즈,119040,114280,-4760
2018-06-01,1804356820,L021020,장신구,[바보사랑]데일리 귀걸이 6종 세트 16번,6320,6320,0
2018-06-01,1977652703,C012040,여자학생복,스카시짜임가디건 (J11PCD076)/ 매그제이(MAGJAY),23000,20700,-2300
2018-06-01,252689898,L021060,유모차,2018 아발론 슈퍼라이트 휴대용 유모차,74000,74000,0
2018-06-01,2120883021,C012060,여자내의,세로절개훌스커트 MAR101S 빅사이즈롱치마 롱스커트,34500,34500,0
2018-06-01,1551060015,E041050,냄비,업소용 유진 경질 전골 국수 매운탕 수육 냄비 곱창팬,9900,9900,0
2018-06-01,2088820128,A013150,어묵,부산/장돌이어묵/수제종합 500g/수제어묵/부산어묵,5000,5000,0
2018-06-01,550471118,C012060,여자내의,버드월 3버튼 기모 가죽바지 SD 5059,22280,22280,0
2018-06-01,2021143991,E031120,믹서,[신일산업] 강력모터/스무디/얼음분쇄 신일믹서기 SMX-150DNS,78000,71900,-6100
2018-06-01,1011185803,F011150,건강기능식품,[올즙] 올바른 도라지배스틱 30포 x 2박스,50000,37800,-12200
2018-06-01,1037235390,C021020,구두,[금강제화] 남성 리갈201 비브람솔 구두 MMX5025FG11(본점),250200,218430,-31770
2018-06-01,1492485006,C011050,남자내의,청반바지/빅사이즈/청바지/여름바지/밴딩/남성/남자,15900,15900,0
2018-06-01,850205133,E031120,믹서,[윌파] 윌파 1000W 초고속 미니 믹서기 HB-230 초고속 블렌더,64900,64900,0
2018-06-01,1479525543,F011150,건강기능식품,뚜레반 검은콩미숫가루1kgx3봉,10900,10900,0
2018-06-01,1252935370,C012060,여자내의,빅사이즈/제이스타일 카디븐 린넨 슬릿 롱 스커트/ 제이스타일,36600,28920,-7680
2018-06-01,518497365,C013010,점퍼,[시에로][17S/S] 베이직 롱 항공점퍼 (SD2JPF125)[갤러리아],179400,138140,-41260
2018-06-01,1271155076,A022030,생수,삼다수 500ml x 40개 /20개 / 2L x 12개 생수 샘물,15900,15900,0
2018-06-01,981598406,E061090,방향제,페브리즈 에어 다우니 (275G),6500,6500,0
2018-06-01,1297112338,C013020,티셔츠,베이직 목폴라 여성목폴라긴티 여성긴티 여성폴라티셔,23820,23820,0
2018-06-01,484063040,A016070,귤,S일해/보석건귤 파우치 3박스(9개입-말린귤/제주의맛,37700,37700,0
2018-06-01,1228860317,E041050,냄비,네오플램 일라 IH 인덕션 5종 냄비세트/인덕션냄비,158000,158000,0
2018-06-01,1222039233,L021060,유모차,마리꼬/에코휴대용유모차/초경량/ 쿨시트/파라솔/커버,38000,38000,0
2018-06-01,405479188,A018100,꿀,잡화꿀 (다드림 2K) X8,199200,177290,-21910
2018-06-01,141877691,C011030,남자학생복,꾸제꾸제/EDWIN 집업 니트 가디건/size L/면/스웨터/자켓/세일/브랜드/빈티지/중고/구,17900,17900,0
2018-06-01,783953487,A017300,미역,동원 양반김 참기름/ 들기름/ 올리브유 김 160봉,35900,35900,0
2018-06-01,169246871,C015020,모자,청모자 야구모자 볼캡 군모 골프 여름 여성 남자 모자,10000,10000,0
2018-06-01,1248466529,C012040,여자학생복,앳코너 (ATSW8B520) 아크릴 컬러 배색 V넥 티셔츠,59000,50150,-8850
2018-06-01,1721502740,C014010,아동복,여아원피스/아동치마레깅스/유아스커트/주니어옷/아기,10800,10800,0
2018-06-01,1778707913,L021020,장신구,[바보사랑][액세서리키친] 925실버 별자리목걸이 12자리 A7601N001,34900,34900,0
2018-06-01,1008419188,A013030,조기,[영광굴비] 법성포굴비/영광굴비/국산굴비/명절선물/참조기/조기,85900,85900,0
2018-06-01,1804356844,L021020,장신구,[바보사랑]데일리 귀걸이 6종 세트 13번,6320,6320,0
2018-06-01,395107128,A011040,보리쌀,[가온애]볶은 서리태콩 500g 서리태 검은콩 쥐눈이콩,3900,3900,0
2018-06-01,248934170,C014010,아동복,홀터넥패턴원피스/여름원피스/나시/민소매/유아나시,9900,9900,0
2018-06-01,1208572707,C012040,여자학생복,패턴 7부 장미 가디건 시스루,18100,17560,-540
2018-06-01,451174457,A011020,현미,청산유곡 찹쌀 1kg2개 쌀 찹쌀 청산유곡찹쌀 농산물,17230,15510,-1720
2018-06-01,989999375,A018060,스낵과자,오리온 예감 오리지널 240G,3600,3600,0
2018-06-01,1540630293,C014020,유아복,[백화점SAY][네파]아동 바람막이 셀로 칼라 방수자켓 KCC0681 (기존가:109 000원),21800,19060,-2740
2018-06-01,1314152849,C013030,스웨터,밀란시아 4G 꽈배기 폴라티 mar171-002 남성캐쥬얼 캐,46750,45820,-930
2018-06-01,1804356849,L021020,장신구,[바보사랑]데일리 귀걸이 6종 세트 8번,6320,6320,0
2018-06-01,990158703,L021020,장신구,은팔찌모음2/실버 순은 남자팔찌 원석 커플 가죽팔찌,58800,58800,0
2018-06-01,1597091762,F011130,홍삼,정관장 황진단액(50ML),10000,10000,0
2018-06-01,1084698060,C013020,티셔츠,반팔티/M~4XL/티셔츠/V넥/무지티/빅사이즈/남여공용,9000,8900,-100
2018-06-01,1804356847,L021020,장신구,[바보사랑]데일리 귀걸이 6종 세트 10번,6320,6320,0
2018-06-01,1804356848,L021020,장신구,[바보사랑]데일리 귀걸이 6종 세트 9번,6320,6320,0
2018-06-01,1804356845,L021020,장신구,[바보사랑]데일리 귀걸이 6종 세트 12번,6320,6320,0
2018-06-01,1804356846,L021020,장신구,[바보사랑]데일리 귀걸이 6종 세트 11번,6320,6320,0
2018-06-01,1891244355,E031050,냉장고,LG DIOS 김치톡톡 K337W11 스탠드 김치냉장고 327L,1114580,1070000,-44580
2018-06-01,1804356852,L021020,장신구,[바보사랑]데일리 귀걸이 6종 세트 5번,6320,6320,0
2018-06-01,491908696,I031040,생화,강력LED헤드렌턴/해루질/낚시렌턴/등산/써치라이트,30000,20140,-9860
2018-06-01,1179766583,C012040,여자학생복,[코인코즈]배색라인 큐빅단추 반팔 가디건 (IW8MD609)(영등포점A),68000,60690,-7310
2018-06-01,1804356853,L021020,장신구,[바보사랑]데일리 귀걸이 6종 세트 4번,6320,6320,0
2018-06-01,1804356850,L021020,장신구,[바보사랑]데일리 귀걸이 6종 세트 7번,6320,6320,0
2018-06-01,1804356851,L021020,장신구,[바보사랑]데일리 귀걸이 6종 세트 6번,6320,6320,0
2018-06-01,988434673,A019160,밑반찬,제주의 감칠맛 제주 꽃멸치젓 멜젓  꽃멜젓  제주젓갈,11000,8900,-2100
2018-06-01,89597192,C012040,여자학생복,[MLB]엠엘비 2종택1 남성 실켓쭈리 MLB 후드집업(31TRC6811),79000,67150,-11850
2018-06-01,1120198028,A017200,토마토,[농협] 가지10kg(특/40-50개),42800,42800,0
2018-06-01,2057607210,C013010,점퍼,안감양털 박시 오버사이즈 코트 DM-4043-이쁜코트 오,75000,74250,-750
2018-06-01,1395636301,C013010,점퍼,오리털 롱패딩 S~3XL STLD-6630/롱패딩점퍼 여성롱패,144600,137370,-7230
2018-06-01,1117232266,E031020,가스레인지,RT-1003J 린나이정품 2구 가스레인지 초고효율eco플러,153800,153800,0
2018-06-01,82279380,C013020,티셔츠,[DUCLY] 신상 맨투맨/후드티/후드집업/기모/빅사이즈,19900,19900,0
2018-06-01,908899900,C011030,남자학생복,긴팔/반팔/기본/흰색/와이셔츠/유니폼/일반핏/단체복/,8500,8400,-100
2018-06-01,2125131894,C013040,청바지,렛미 데미지 컷팅 하이웨스트 연청 데님 팬츠/ 일자핏,27900,27900,0
2018-06-01,988179277,E061070,가정용비닐용품,초L 지퍼백(소) 15*10*20매,1300,1300,0
2018-06-01,1423910574,E031090,공기청정기,다이슨 공기청정기 TP04/ 이벤트,820000,820000,0
2018-06-01,121791144,F011130,홍삼,[농협홍삼/한삼인] 순홍삼 50ml*30포 (1500ml) X 5상자,200800,200800,0
2018-06-01,1593037215,L012060,샴푸,2018년형/ 려 화윤/ 화윤생 샴푸액/ 두피모발팩,14030,14030,0
2018-06-01,121791148,F011130,홍삼,[농협홍삼/한삼인] 순홍삼 50ml*30포 (1500ml) X 2상자,80300,80300,0
2018-06-01,121791146,F011130,홍삼,[농협홍삼/한삼인] 순홍삼 50ml*30포 (1500ml) X 4상자,160600,160600,0
2018-06-01,121791147,F011130,홍삼,[농협홍삼/한삼인] 순홍삼 50ml*30포 (1500ml) X 3상자,120500,120500,0
2018-06-01,1544813548,I031070,애완동물관리비,15 바볼랏 테니스라켓 퓨어 드라이브 GT (300g),203000,169710,-33290
2018-06-01,1220916923,C012040,여자학생복,DBN1303 바이도트 뷔스티에 802S 이뷔스티에 빅사이,40790,40790,0
2018-06-01,1210416717,C013040,청바지,[오즈세컨(o2nd)][오즈세컨] [여성] 린넨 혼방 레이스 포인트 팬츠 2WMS2WP03600070,258000,247970,-10030
2018-06-01,1778707948,L021020,장신구,[바보사랑][액세서리키친] 925실버 Simple bar 팔찌,29900,29900,0
2018-06-01,1804356876,L021020,장신구,[바보사랑]데일리 귀걸이 6종 세트 2번,6320,6320,0
2018-06-01,1804356877,L021020,장신구,[바보사랑]데일리 귀걸이 6종 세트 1+1,6320,6320,0
2018-06-01,1577016733,C013040,청바지,상하복세트 반바지레깅스세트,27760,22210,-5550
2018-06-01,1804356875,L021020,장신구,[바보사랑]데일리 귀걸이 6종 세트 3번,6320,6320,0
2018-06-01,1138970960,A017150,버섯,콩나물.찜용.숙주-1kg.2kg.4kg,6500,6500,0
2018-06-01,232566314,C011020,남자상의,후드가디건 린넨정장 여름수트 남성양복 마이 슈트,67500,67500,0
2018-06-01,548624081,C013020,티셔츠,엠블러 남녀공용 신상 반팔티셔츠/단가라티/커플티,10900,9900,-1000
2018-06-01,988179280,E061070,가정용비닐용품,초L) 지퍼백(중) 18*20**20매,1600,1600,0
2018-06-01,456296081,E011050,책상,모노책상 일자책상 컴퓨터책상 사무용책상 2인용책상,34900,34900,0
2018-06-01,1400835514,C012040,여자학생복,[나인스텝]주문폭주(18 S/S) 젤라또 소매프릴 블라우스N18NS8235R[갤러리아],35000,29400,-5600
2018-06-01,2014845302,C013010,점퍼,더 아이잗 야상짚업 사파리 점퍼 IH9M0JP70,59000,48380,-10620
2018-06-01,1352260072,C013020,티셔츠,국산 망고나시/골지나시/K나시/프렌치/흰티/반팔티/단체티/반티/면티/라운드/무지티/나,9900,9900,0
2018-06-01,502896494,L021010,손목시계,유로스타일 듀얼 패션 시계 MV2097029 학생손목시계,75390,75390,0
2018-06-01,1804356878,L021020,장신구,[바보사랑]진주 부케 드롭귀걸이,11120,11120,0
2018-06-01,1804356879,L021020,장신구,[바보사랑]언발란스 십자가 롱드롭 귀걸이,11120,11120,0
2018-06-01,990518314,C012040,여자학생복,[티탁]13900~루즈핏 조끼/네오플렌/패딩/롱,20000,19800,-200
2018-06-01,1826130428,C013040,청바지,여름 남자 반바지/청/5부/7부/면/스판/카고/밴딩/린넨,15700,15700,0
2018-06-01,1828276933,L012010,면도기,페리오 여행용세트/여행용세면도구/칫솔/치약/가그린/,700,700,0
2018-06-01,1570058062,C021040,실내화,클럽 씨 85 리플렉트 [CM9572]/ 리복,59000,51330,-7670
2018-06-01,1686886639,E031070,에어컨,유니맥스/16인지/천정용선풍기/천장용선풍기/업소용,29800,29800,0
2018-06-01,1804356880,L021020,장신구,[바보사랑]데일리 귀걸이 6종 세트 22번,6320,6320,0
2018-06-01,33343254,I031040,생화,케븐 블랙 야전침대 / 캠핑 접이식 간이침대,51500,44620,-6880
2018-06-01,1604409146,A011040,보리쌀,1+1 흰강낭콩 외 콩 모음전 / 완두콩 백태 서리태,4500,4500,0
2018-06-01,170546411,L012030,칫솔,래디어스 토츠 유아칫솔 1개(색상선택가능)/ 래디어스,3200,3140,-60
2018-06-01,311056795,C011030,남자학생복,[예작셔츠]2018 쿨비즈 반소매셔츠 6종기획 YJ8MBR964BL06,30000,23930,-6070
2018-06-01,1541989070,C013010,점퍼,[에고이스트][정상가:838 000] 탈착방울 루즈핏 다운 EH4NC161,419000,326820,-92180
2018-06-01,1042794357,F012020,생리대,쏘피 안심숙면팬티 M 5Px2팩+2P(총12P)/생리대,15900,15900,0
2018-06-01,1184405124,C011050,남자내의,[나쁜남자] P2311 아르고 옆트임 롱슬랙스,29000,29000,0
2018-06-01,475419866,A017250,고사리,특품 생 아스파라거스1kg(30개내외) 냉동아님,29900,29900,0
2018-06-01,250445257,E061030,전구,[무료배송]가장많이쓰는형광등/32W/오스람/번개표/필립스/박스로판매/FHF32SSEX-D/주광,48000,48000,0
2018-06-01,156307707,A011040,보리쌀,2017 햇 서리태 (속청) / 약콩 국산 검정콩 검은콩,22900,22900,0
2018-06-01,984552585,A014010,우유,동원 대니쉬 저지방우유_1.8L,4400,3700,-700
2018-06-01,732115741,E061020,섬유유연제,미국산 다우니 에이프릴후레쉬 섬유유연제 5.03L×2개,34990,34990,0
2018-06-01,1524993718,A012010,국산쇠고기,한우갈비혼합세트 1호 2.6kg 소갈비세트 소불고기세트,327300,327300,0
2018-06-01,155728903,A018090,잼,트라피스트수녀원 유기귤잼 410g 귤잼 과일잼 빵 식,17590,17590,0
2018-06-01,1297136303,C013010,점퍼,MJ-164 옐로우 스티치 데님 자켓- 흑청 점퍼 남성의류,52980,52980,0
2018-06-01,1380315624,A018080,설탕,천연원당 15kg 원당 9kg/사탕수수100%/천연당/비정제,20000,18900,-1100
2018-06-01,1892315431,C013010,점퍼,야상 점퍼 자켓 남자 남성 야상 항공 블루종 바람막이,42000,40900,-1100
2018-06-01,176744962,L021020,장신구,실버반지 098mtcr/ 메트로시티(주얼리),98000,86240,-11760
2018-06-01,961282001,A017300,미역,녹차 돌김자반 50G*2봉,3990,3990,0
2018-06-01,319771832,I053020,스케치북,올페이퍼/크로키북/스케치북/전문가/8절/A4/A5/B4/B5,2100,2100,0
2018-06-01,121791150,F011130,홍삼,[농협홍삼/한삼인] 순홍삼 50ml*30포 (1500ml),40200,40200,0
2018-06-01,1545140148,A012030,돼지고기,[칠레산] 프리미엄 삼겹살 1kg 구이용,9800,9800,0
2018-06-01,1899672889,C013020,티셔츠,[필골드] SLKN504 노르웨이 겨울숲 오버핏폴라니트,39800,39800,0
2018-06-01,109889202,A019090,카레,땅끝마을해남 국내산 귀리500g,13860,13860,0
2018-06-01,416081458,C015040,장갑,리락쿠마 핸드퍼펫 인형장갑 소품장갑 따뜻한장갑 인,18440,18440,0
2018-06-01,374564272,L012090,기초화장품,유알포어 리모델링 마스크EX 코팩+클리어패드10매,12700,12700,0
2018-06-01,1088221637,A013030,조기,[새우몰] 비배열 조기 1박스 50미내외,24350,24350,0
2018-06-01,1774343338,F012020,생리대,[위스퍼] 코스모 메모리폼 생리대 2 3팩 모음전,18900,18900,0
2018-06-01,479745724,C012040,여자학생복,[쉬즈넘버나인]루키 브이넥 반팔 가디건,19800,18810,-990
2018-06-01,2035582021,I031040,생화,버팔로 최신 미니테이블/접이식/휴대용키친테이블,20700,17720,-2980
2018-06-01,961343535,A012050,소시지,CJ 맥스봉치즈 490G,12500,6290,-6210
2018-06-01,1561031801,E041010,식기,일본 도자기 면기 17종 모음전,7500,6900,-600
2018-06-01,2006587088,A013140,북어채,[가온애]먹태 초특가 강원도특품 먹태 10마리/5마리 노가리 짝태 황태 북어 쥐포 술안,17900,17900,0
2018-06-01,1964955432,A016090,참외,지금이 꿀맛 성주 꿀 참외 3kg/5kg-9900원,9900,9900,0
2018-06-01,860536058,I031040,생화,차량LED 써치 라이트 집어등 랜턴 서치 작업등 해루질,11500,10210,-1290
2018-06-01,517186596,C011020,남자상의,잭필드 2018 여름 남성 숨쉬는 바지 3종,59800,56800,-3000
2018-06-01,986214026,F011150,건강기능식품,[풍기][풍기인삼농협][황풍정] 6년근 풍기홍삼진액 950ml*2,50000,50000,0
2018-06-01,1746497828,A015020,식용유,(1+1+1)구도 엑스트라버진 아보카도오일 250ml/500ml,25900,25900,0
2018-06-01,219112748,E041070,밀폐용기,락앤락 모듈러 스테커블 밀폐용기 반찬통,10900,10030,-870
2018-06-01,1321706223,C012060,여자내의,밴드 가죽반바지 SD-5950,8610,7750,-860
2018-06-01,1433278067,C013060,등산복,[케이투(의류)]남여공용 매킨리(Mckinley) (KMW16595),119000,119000,0
2018-06-01,1003169979,L021020,장신구,18K 도금 목걸이 큐빅 팬던트 여성 패션 악세사리 (무,14620,14620,0
2018-06-01,899588714,A018010,초콜릿,[오리온]오리온 닥터유 에너지바 (200G),5400,4590,-810
2018-06-01,1176597755,E011040,소파,서광퍼니처 4인소파 특가 모음전 7종,189000,189000,0
2018-06-01,479745730,C012040,여자학생복,[쉬즈넘버나인]리즈 린넨 브이넥 가디건,19800,18810,-990
2018-06-01,695424859,E031010,전기밥솥,CRP-HQXB0310FP/쿠쿠/IH압력/3인용/음성/GH,185900,171960,-13940
2018-06-01,555451912,L021030,가방,여성가방.신상.숄더백.쌈지정품.가방.핸드백.토드백,30900,27900,-3000
2018-06-01,25087635,A017180,호박,청양고추/오이/풋/꽈리 고추 1kg,4500,4500,0
2018-06-01,582935520,C013020,티셔츠,빅사이즈 남성 나시 나시티 민소매 남자 런닝 티,5900,5900,0
2018-06-01,1138776685,C011030,남자학생복,꾸제꾸제/Teenie Weenie 집업 니트 가디건/size M/울혼방/스웨터/자켓/세일/중고/구제,22900,22900,0
2018-06-01,986192143,F011150,건강기능식품,[풍기][풍기인삼농협][황풍정] 6년근 홍삼액 수(秀) 70ml*60포,118000,118000,0
2018-06-01,768297703,E031140,비데,NK[당일설치]BD-N443 노비타방수비데(리모컨타입),299000,279000,-20000
2018-06-01,986192141,F011150,건강기능식품,[풍기][풍기인삼농협][황풍정] 6년근 황풍정 홍삼액골드 80ml * 60포,165000,165000,0
2018-06-01,297163248,C013050,운동복,(빙고)지지루시 사계절용 쿠션지 겨울용 기모/스키니/일자/두줄/포켓 트레이닝팬츠 츄,7900,7900,0
2018-06-01,463037648,C013040,청바지,남아7부세미배기핏캣브러쉬데님(R1821Q201_36)/ 레노마키즈,43400,39060,-4340
2018-06-01,989853366,A016100,수박,깔라만시자몽청 500G,9900,9900,0
2018-06-01,1168484823,I011030,사진기,소니 A7III 본체 + 28-70mm 정품 명품,3941990,3941990,0
2018-06-01,924607305,C013060,등산복,작업복/봄등산바지/여름등산바지/낚시복/작업복바지/,8900,8900,0
2018-06-01,1326133236,C021040,실내화,[푸마] PACER PLUS MESH SN 페이서 플러스 메쉬 365030 02,69000,34500,-34500
2018-06-01,1248789561,E011060,의자,5월이벤트~캐시밀론no.5600/학생의자.컴퓨터의자,87900,87900,0
2018-06-01,1322880618,C011050,남자내의,(색상:사이즈 : 블랙:M) DON 1846 린넨9부,28220,28220,0
2018-06-01,793491223,I012060,저장장치,로지텍G G903 LIGHTSPEED게이밍마우스/병행수입~당출,178000,173900,-4100
2018-06-01,487053147,C012040,여자학생복,(2XL-5XL)아우룸 나시 블라우스-1605/ 레이디플러스,21900,19710,-2190
2018-06-01,1687042210,A015010,참기름,국내산 깨 사용 하늘뜰 들기름/참기름(가정용) 300ml,17500,17500,0
2018-06-01,460289384,A017200,토마토,토종원 국내산 건가지 500g 순수 자연그대로 나물,10800,10800,0
2018-06-01,1659363433,A016100,수박,수박칼 수박 커터 자르는 칼 슬라이서 커터기 커팅기,10500,10190,-310
2018-06-01,1296303264,C011030,남자학생복,FS-117 투톤 단가라 7부 셔츠-블랙 캐쥬얼셔츠 스트라,18670,18670,0
2018-06-01,2055619500,E031030,전자레인지,[인증점] 삼성 전자레인지 23ℓ 전자렌지 RE-C23TXB,155000,147270,-7730
2018-06-01,327500846,C013010,점퍼,[대구백화점 I관] [멜로디가든]린넨혼방집업점퍼(M8M5R01),40000,36000,-4000
2018-06-01,101767746,C013010,점퍼,봄기획.득템찬스.자켓트렌치야상.55-110..빅사이즈,29900,29900,0
2018-06-01,1435185050,C011020,남자상의,레드 체크 밍크털 코트 털코트 남성용코트 남성털코트,109100,109100,0
2018-06-01,988180232,E061070,가정용비닐용품,초이스L) 롤팩 30*40*500매,7100,7100,0
2018-06-01,1691804599,A017180,호박,고추(통 오포원 삐끼누 1K)/ 식자재 전문,14900,14900,0
2018-06-01,1985657748,A018030,껌,롯데 아이디 ID 자일리톨 화이트 껌 25g x 14개,11400,11400,0
2018-06-01,1091452103,C011030,남자학생복,아우터,14200,14200,0
2018-06-01,524488149,C011050,남자내의,[포에버21]플라워 스트라이프 반바지/FOREVER21/바지/팬츠/반바지,26900,21520,-5380
2018-06-01,1973804541,C014020,유아복,아둘 여아 유아 슬라브 반팔 여름 나그랑 티 12,8000,7900,-100
2018-06-01,885833898,C012060,여자내의,[대구백화점 I관] [VIKI]캐주얼한 와이드 팬츠(TQPAD2216),39000,33540,-5460
2018-06-01,380559866,D031010,주택수선재료,테라코 결로방지퍼티 14kg/결로방지 핸디코트 지하실 베란다 단열성능 친환경 벽지작업,27000,27000,0
2018-06-01,976715818,C013040,청바지,[데]뱅뱅(BANGBANG) 여성용 레귤러핏 핫썸머 데님 팬츠 3종(여),59900,55110,-4790
2018-06-01,1473885612,A013010,갈치,(선물포장)제주 청정해역 선물세트 6호 갈치(400g),154590,154590,0
2018-06-01,651997269,C013050,운동복,[모다아울렛][아디다스키즈][아디다스키즈] 주니어칠부바지 (AA3538),34300,34300,0
2018-06-01,2110478109,C013040,청바지,[레티노] RETNO S~4XL 밴딩/기본/워싱 청바지,10000,9900,-100
2018-06-01,1177715772,E011040,소파,[필우드가구]4인 소파 모음/패브릭/인조가죽/4인쇼파,229000,229000,0
2018-06-01,494719623,C012060,여자내의,내츄럴 워싱 수술 데님 언발 롱 스커트[앞머리],39900,39900,0
2018-06-01,1973804538,C014020,유아복,아둘 여아 유아 슬라브 반팔 여름 나그랑 티 11,8000,7900,-100
2018-06-01,1257856436,E011020,침대,심플라인/일반형침대모음/매트리스포함/서랍추가,120000,74900,-45100
2018-06-01,1062034046,G022020,자동차타이어,넥센타이어 고급형 CP672 225/55R17 정품 무료배송,70000,59080,-10920
2018-06-01,1689259178,A018050,비스킷,로투스 50P 비스코프 비스킷 1P 300개 커피과자312.5g,17900,17900,0
2018-06-01,185135965,C013010,점퍼,푸마 간절기 경량패딩자켓 멀티트레이닝자켓 특가,39800,39800,0
2018-06-01,10001,A017110,감자,[해도지]고향쥬스용 흙당근10kg,17900,17710,-190
2018-06-01,450282461,A013150,어묵,가마보꼬 진전어꼬지 500g2개 꼬지 진전어꼬지 가마보,25820,23240,-2580
2018-06-01,1089512895,E011020,침대,[홈잡스]정품단면매트리스/발통포함(무료반품),65000,59700,-5300
2018-06-01,854234660,E061060,살충제,쌀나방/쌀벌레퇴치 화랑곡나방트랩 페르몬트랩,3900,3900,0
2018-06-01,1409984079,C012040,여자학생복,[모다아울렛][에이비에프지]후드 롱가디건 (AFS3GY09F) 블랙  화이트,39000,36660,-2340
2018-06-01,1524848490,E041050,냄비,락앤락 라면냄비 김치찌개 삼겹살 불판 구이팬,15700,15700,0
2018-06-01,868628538,A013130,오징어채,정화 진미오징어 전기 50gx5.,27420,24410,-3010
2018-06-01,1997315139,E011020,침대,[골든잼]원목 천연생황토 싱글 돌침대(모리아)/흙침대,1537100,1490990,-46110
2018-06-01,1376167224,L012010,면도기,닥터세닥 여행용세트/여행용세트/치약칫솔/칫솔치약,700,700,0
2018-06-01,631142125,L012110,색조화장품,유브이 비타 선 쿠션(UV VITA SUN CUSHION) 특별구성,59900,47920,-11980
2018-06-01,856141643,E041050,냄비,보쌈 수육접시 전골냄비 뚝배기 미니화로 도자기워머,10000,9700,-300
2018-06-01,1220857624,E011020,침대,4단전동베드/KF909/4단베드/2단전동침대/전동베드/,3280000,3280000,0
2018-06-01,450282492,A013150,어묵,그린쉘 다이찌오뎅 400g2개 오뎅 오뎅전골 냉동식품,22120,19910,-2210
2018-06-01,1301119638,E031010,전기밥솥,CRP-P0610FD/쿠쿠/6인용/압력/Full스텐/GH,159600,146740,-12860
2018-06-01,1059216843,A011020,현미,두레생협 찹쌀백미(2kg 유기) 주방용찹쌀백미 가정용,27530,27530,0
2018-06-01,1523604161,E041070,밀폐용기,스텐밧드 푸드커버 세트 바트 보관용기 업소용반찬통,13600,11890,-1710
2018-06-01,1001346806,A013170,생선통조림,유동 번데기캔 (130g) x48,53770,53770,0
2018-06-01,2120329615,A013170,생선통조림,[홈플러스]_유동자연산골뱅이_400G,8900,8460,-440
2018-06-01,187377833,C013020,티셔츠,[특가세일] J.LINDEBERG 반팔 바지 벨트/J린드버그,103000,100940,-2060
2018-06-01,987975763,A022010,주스,[롯데]롯데 파머스 주스바 오렌지 1L,5980,4990,-990
2018-06-01,529706198,C012060,여자내의,허리조절 블랙체크 교복치마 교복 예쁜교복 교복쇼핑,49840,48350,-1490
2018-06-01,1078408880,C012060,여자내의,[화이트폭스] 여름신상 슬랙스/부츠컷/와이드/일자핏,10900,10900,0
2018-06-01,1822835521,I011020,영상음향기기,비비텍 DX931 후속 BX950 출시 밝기5000 빔프로젝터,1050000,941000,-109000
2018-06-01,958425722,A012050,소시지,CJ 한입쏙비엔나 90G,1680,1380,-300
2018-06-01,1173304388,C011050,남자내의,남자배기바지/쿨바지/밀리터리/밴딩바지/작업복/여름,6000,5900,-100
2018-06-01,64148327,E041050,냄비,[에코라믹]데일리세라믹냄비2종/3종세트/양수웍세트,22800,22800,0
2018-06-01,1759669202,A013170,생선통조림,[유동] 유동 번데기 280g,1500,1500,0
2018-06-01,1920267852,L021030,가방,천연가죽서류가방9종/남자/남성/크로스백/노트북가방,44700,44700,0
2018-06-01,1269489258,C011020,남자상의,남자수트 클래식 체크 그레이 수트 2pcs D0117029 정,205530,184980,-20550
2018-06-01,988180202,A019080,고추장,초L 우리쌀 태양초 고추장 500G,4990,4990,0
2018-06-01,988180204,A019060,된장,초L 재래식 집된장 1KG,4500,4500,0
2018-06-01,988179211,A018020,사탕,야미얼스 페퍼민트 파우치팩 59.5G,3400,3400,0
2018-06-01,480592579,C011030,남자학생복,여름신상 남방 셔츠 와이셔츠 반팔 데님 남자 남성 청,11900,11900,0
2018-06-01,898456693,A019170,냉동식품,풀무원 통새우볶음밥 2인(450G),5990,4990,-1000
2018-06-01,988180206,E061080,키친타월,[유한킴벌리]유한킴벌리 크리넥스 키친타올 200매*2,2400,2400,0
2018-06-01,1213225036,C013030,스웨터,ACCMD845 타이틀 3줄 올집업 니트 남자집업니트 남성,61010,61010,0
2018-06-01,1775127078,F011130,홍삼,정관장 홍삼정옥고(10G*30입),75000,75000,0
2018-06-01,713354291,C011030,남자학생복,[디키즈] DSP1UTZU439_레터링 봄 후드집업,48300,43470,-4830
2018-06-01,1125514579,E061060,살충제,피톤치드연무기액 자동차 향균 탈취 살균 소독 악취제거 연막소독기 냄새제거,60000,60000,0
2018-06-01,621089912,A019110,드레싱,[샘표] 폰타나 샐러드 드레싱소스 모음/발사믹/무지방,3500,3500,0
2018-06-01,479745756,C012040,여자학생복,[쉬즈넘버나인]_[세트구성]리즈린넨 가디건+니트탑set,36800,34960,-1840
2018-06-01,289399975,A017180,호박,시골맛 아주매운 김치용 고추가루 2.5kg,46600,45210,-1390
2018-06-01,1463108731,C013010,점퍼,궁극의가벼움 경량패딩/누빔점퍼/컬팅자켓 무료배송,32000,19500,-12500
2018-06-01,1327772459,C012040,여자학생복,[보니알렉스](보니알렉스) 포켓 디테일 절개 블라우스 (BBSZ590C),12200,10740,-1460
2018-06-01,1572579499,C012060,여자내의,[TBJ]유니 콤피 5부 L 인디고 데님-T182DP570P,39900,33120,-6780
2018-06-01,932591877,C013010,점퍼,[온앤온] 뽀글이 양털 오버핏 무스탕 코트 (NW5WH304),460000,440000,-20000
2018-06-01,1065110627,C013010,점퍼,[MS트랜드]아동 경량 패딩점퍼 웰론 패딩특가80927,19800,19800,0
2018-06-01,761339509,E031030,전자레인지,단독 특가 /대우/쿠잉 전자렌지 전자레인지,50100,46060,-4040
2018-06-01,859890944,C013060,등산복,[빈폴아웃도어]네이비 남성 트레블 MA-1 재킷 (BO8239D07R),199000,157210,-41790
2018-06-01,1789668837,F012020,생리대,NEW 템포 슈퍼 20매 x 3박스(총60매)/ 템포,20900,19440,-1460
2018-06-01,571305897,F012010,종이기저귀,군(GOO.N)소프트 팬티 기저귀 점보형(XXL) 20P x 6팩,46900,46900,0
2018-06-01,1789668839,F012020,생리대,NEW 템포 레귤러20매x2박스+슈퍼20매x2박스(총80매)/ 템포,26500,24910,-1590
2018-06-01,952878122,A022020,두유,[삼육]삼육 두유 (190ML*24입),18000,18000,0
2018-06-01,1412196525,E031090,공기청정기,[샤오미] 미에어2S 샤오미 공기청정기 국내AS 우체국 당일발송,219000,219000,0
2018-06-01,242547561,L021010,손목시계,몽콕워치스 고품질 클래식 소가죽 시계줄 무료배송,10500,10500,0
2018-06-01,197576577,L012030,칫솔,[오랄-비]초소형헤드 벨벳 3입x2개+벨벳 블랙티 2입,10900,10900,0
2018-06-01,988926904,L012060,샴푸,[엘지생활건강] 기분좋은 4호 X6 (1BOX),108540,95520,-13020
2018-06-01,988926906,L012060,샴푸,[엘지생활건강] 기분좋은 6호 X5 (1BOX),135900,119600,-16300
2018-06-01,427708107,C012030,여자상의,[셀러브] 데님 벨트 세트 원피스,28800,28800,0
2018-06-01,1789668840,F012020,생리대,NEW 템포 레귤러20매x1박스+슈퍼20매x3박스(총80매)/ 템포,26500,24650,-1850
2018-06-01,988926905,L012060,샴푸,[엘지생활건강] 기분좋은 5호 X6 (1BOX),141260,124320,-16940
2018-06-01,1060634055,E061020,섬유유연제,LG 샤프란 아로마시트-핑크센세이션 (30매) 샤프란,11100,11100,0
2018-06-01,415007725,E041060,수저,스텐/수저/케이스/어린이/아동/통/도시락/숟가락/포크,16000,16000,0
2018-06-01,988926900,L012060,샴푸,[엘지생활건강] 기분좋은 1호 X7 (1BOX),63000,63000,0
2018-06-01,988926902,L012060,샴푸,[엘지생활건강] 한방스페셜 2호 X7 (1BOX),69360,69360,0
2018-06-01,988926901,L012060,샴푸,[엘지생활건강] 기분좋은 2호 X6 (1BOX),75820,75820,0
2018-06-01,741243734,A021010,커피,[커피빈] 커피빈 캡슐커피 premium (에스프레소) 10 캡슐,8900,8900,0
2018-06-01,1347148300,L012090,기초화장품,[구달]청귤 비타C 잡티 세럼 썸머 기획세트,19200,18820,-380
2018-06-01,37360408,C021040,실내화,나이키 여성 테니스 클래식(312498-130),113230,105310,-7920
2018-06-01,347871159,C013020,티셔츠,Doily가오리나시세트티/브이넥티/레이스티셔츠/커버업,9900,9900,0
2018-06-01,1200832578,C011050,남자내의,여름반바지/5부/린넨/면반바지/밴딩/슬랙스/남자/남성,14900,14900,0
2018-06-01,1524562837,E061040,부엌용세제,바이오퐁 주방세제 18kg (트리오 14kg) 대용량 퐁퐁,8900,8900,0
2018-06-01,368849324,L021020,장신구,스텐레스스틸 아웃 체인 롱 목걸이 W 10대 체인 네크,15940,15940,0
2018-06-01,289422849,A017180,호박,가을 다데기 상 고추가루 2.5kg,53200,51610,-1590
2018-06-01,1810349870,A013090,전복,여수 활 바지락(대)1kg 싱싱팩포장,7900,7900,0
2018-06-01,1290073487,C013040,청바지,28~46/빅사이즈청바지/큰청바지/일자/남자,30900,30900,0
2018-06-01,54177396,L012060,샴푸,닥터포헤어 폴리젠플러스 샴푸/탈모방지 두피비듬관리,22900,22900,0
2018-06-01,989912144,E061090,방향제,[애경]애경)크리스탈워터실내용(아시안허브)400ML,6900,6900,0
2018-06-01,260705770,E011070,식탁,[와이엠스토리] LPM 아일랜드홈바/식탁추가,127800,127800,0
2018-06-01,936206766,I031070,애완동물관리비,당구 공 당구큐대 당구용품 3구 4구 포켓볼 장갑 쵸크,12200,11900,-300
2018-06-01,473598764,E021020,커튼,넉넉한 대형 거실커튼(400cm이상) 창 안방 소창 커튼,79800,73420,-6380
2018-06-01,33705573,A012040,닭고기,[아임닭] 부드러운 닭가슴살 소시지 15+1 특가,32500,32500,0
2018-06-01,954817231,A016100,수박,흑수박 (5호/6KG미만),18900,14900,-4000
2018-06-01,203234736,A019180,즉석식품,[비비고]CJ 비비고 사골곰탕 500g×20개,19900,19900,0
2018-06-01,1415245408,A013150,어묵,[사조] 사조오양 부산 오륙도 어묵 (사각) 800g,2400,2400,0
2018-06-01,1151100877,C012030,여자상의,퍼플스완 소프트 카라 셔링 린넨원피스,32900,32900,0
2018-06-01,498876290,D031010,주택수선재료,편백나무천연황토벽지 1kg 풀바른벽지 천연벽지 페인,15900,15900,0
2018-06-01,781497952,E041050,냄비,프랑스루미낙냄비모음 블루밍 내열냄비 강화유리 편수,24500,24500,0
2018-06-01,1122619721,E041010,식기,루미낙 루미락 나뭇잎 앞접시15 6p,31600,30020,-1580
2018-06-01,631947290,A016060,감,달콤샤르르 자연그대로 만든 아이스 홍시 100개(컵)/,139500,122760,-16740
2018-06-01,1270961368,D031010,주택수선재료,쟈스민락 3.8리터/친환경/곰팡이방지/젯소 바니시NO,55000,55000,0
2018-06-01,1742973144,C013020,티셔츠,[빈폴아웃도어]스카이 블루 여성 풀오버형 브이넥 셔츠 (BO8364C03Q),76300,60280,-16020
2018-06-01,556149564,A012050,소시지,부대찌개용 소시지4종 택1/콘킹소시지/카보트 팜랜드,2700,2700,0
2018-06-01,1565621551,C013010,점퍼,유니_ 심플 베이직 바람막이 HUD380/ 헨어스,39000,34320,-4680
2018-06-01,1109755594,C013050,운동복,여성반바지 긴바지 5부 7부 기본 트레이닝 츄리닝,7900,7900,0
2018-06-01,665236213,A019070,양념소스,뉴그린푸드 대용량소스 8종모음 /불닭소스/떡볶이소스,40000,40000,0
2018-06-01,254484690,C012040,여자학생복,베이직 슬랙스 (J11NPT217)/ 매그제이(MAGJAY),39000,35100,-3900
2018-06-01,1666633908,E031030,전자레인지,SK매직 전자레인지 23L MWO-230KG,90900,90900,0
2018-06-01,1771367469,I031040,생화,파세코 캠핑용 쿨러 차량용냉온장고 28L PCC-H028AD,120000,106510,-13490
2018-06-01,1308699275,C013030,스웨터,MJ_1201 베이지 양면 양털 집업 여성집업 집업 집업점,62180,62180,0
2018-06-01,1472067714,I012010,컴퓨터,특가116만 무료퀵 썬더볼트 삼성노트북 NT900X5V-A58A,1310750,1219000,-91750
2018-06-01,1387550989,C013010,점퍼,AG 후드 집업점퍼 BOX 드러그 오픈 CC 집업잠바 후드,52100,52100,0
2018-06-01,1761589704,E021010,침구,2018봄신상 순면 차렵이불세트/토퍼세트,49900,49900,0
2018-06-01,1970021275,C012030,여자상의,레이스원피스/레이어드원피스/뷔스티에원피스/쉬폰,15900,15900,0
2018-06-01,1181310777,L021050,우산,[짱짱한우산]고급 자동장우산 18종모음/골프우산,8000,7400,-600
2018-06-01,445579328,C011020,남자상의,(남성의류도매 킹스맨) 네이비 자켓 D0216001 남자정,111380,111380,0
2018-06-01,1258134538,C013040,청바지,[키스포(kispo)][키스포]트레이닝 팬츠만 모아모아!! 7부팬츠/5부팬츠/4부팬츠,6900,6900,0
2018-06-01,724626595,D031010,주택수선재료,아이생각 내부 무광 4리터 친환경페인트,12000,12000,0
2018-06-01,898395188,A018060,스낵과자,[크라운]크라운 못말리는신짱(120G),1280,1280,0
2018-06-01,371794730,L021020,장신구,실버- 오팔 쉐도우 목걸이 오팔 기념일 10대 겨울 20,27570,27570,0
2018-06-01,680091147,C014010,아동복,[게스키즈]비비드 S/T티셔츠G83KDT051-레드/그린/블루 3가지색상,28000,22400,-5600
2018-06-01,393795843,C013040,청바지,생지느낌 그대로 팬츠 SXL 흑청 DP279 데님스키니 스,24730,24730,0
2018-06-01,1266010896,C013020,티셔츠,피핀 세닝 쇼퍼단가라 티셔츠 #105638/ 피핀,11400,9010,-2390
2018-06-01,1778565712,L021020,장신구,[바보사랑]Silver Bell 목걸이,25900,25900,0
2018-06-01,1778565716,L021010,손목시계,[바보사랑]JA-917 메탈시계,36000,36000,0
2018-06-01,1804919132,L012110,색조화장품,무기자차 순한 베이비 선크림 물리적차단 썬크림,5900,5900,0
2018-06-01,1778565714,L021020,장신구,[바보사랑]925실버 Round Pipe 목걸이,25900,25900,0
2018-06-01,1817026594,A018100,꿀,스페인 (꿀) 벌화분 500g/ 비폴렌/꿀벌/벌꿀화분,16500,16500,0
2018-06-01,1126347530,E021020,커튼,벌집블라인드 베이지 호프발스 140x155 cm/ 롤스크린,71460,63600,-7860
2018-06-01,1778565719,L021010,손목시계,[바보사랑]JA-920 가죽시계,30240,30240,0
2018-06-01,500860317,C012040,여자학생복,[테이트]여성 골지 롱 면가디건(KA8FS-WKS060/431)[갤러리아],19900,15330,-4570
2018-06-01,1778565717,L021010,손목시계,[바보사랑]JA-918 메탈시계,58320,58320,0
2018-06-01,1174750686,A018060,스낵과자,김고소아 고구마스틱 오징어해씨볼 대용량 옛날과자,3300,3300,0
2018-06-01,846363618,A017040,양배추,생 방아잎 1kg /배초향/국내산/ 당일수확후 발송,10000,10000,0
2018-06-01,899432852,E061100,습기제거제,[LG]샤프란 케어 은은한향 (500ML),5990,3000,-2990
2018-06-01,1789668811,F012020,생리대,NEW 템포 레귤러 20매 x 5박스(총100매)/ 템포,32900,30600,-2300
2018-06-01,1898777748,A011080,밀가루,[샘표]바로먹는 간편식 국수/비빔국수/칼국수/쌀소면,1100,1100,0
2018-06-01,1778565721,L021010,손목시계,[바보사랑]JA-921 가죽시계,29880,29880,0
2018-06-01,1836762537,E041010,식기,방짜 유기 놋그릇 밥공기 국그릇 대접 탕기 공기,13000,11370,-1630
2018-06-01,1251986737,C011030,남자학생복,밀란시아 메쉬 라운드 조끼 601-045 남성캐쥬얼 캐쥬,31960,31960,0
2018-06-01,359903626,G011070,자전거,삼천리 자전거 접이식/하로 GS20 GS26/20인치 26인치,115000,103500,-11500
2018-06-01,1430820480,C021020,구두,[소다(SODA)][SODA] 남성 클리퍼 AJM865 2종 택 1,119000,95200,-23800
2018-06-01,1405237522,C012040,여자학생복,여성 무스탕 조끼_베스트 여성조끼 겨울조끼 그레이조,36210,36210,0
2018-06-01,1684953068,E031120,믹서,DWM-3500/대원큰집만능믹서기/대용량/초강력모터,77500,77500,0
2018-06-01,1102559284,C013040,청바지,[엔키스타] 청바지/치마바지/핫팬츠/스키니진,9900,9900,0
2018-06-01,895800329,E051020,건전지,[에너자이져]에너자이저 충전지AAA 2입,11900,7990,-3910
2018-06-01,393830685,C011020,남자상의,MT-216 여름-초가을 바다보카시 싱글수트 (M-2XL) 블,214960,214960,0
2018-06-01,989975446,A019030,생강,[농협청과33번] 양파 2kg - 중,9900,7900,-2000
2018-06-01,989975445,A019030,생강,[농협청과33번] 양파 2kg - 소,7900,6500,-1400
2018-06-01,989975448,A019030,생강,[농협청과33번] 양파 3kg - 중,16900,9900,-7000
2018-06-01,151391542,C012040,여자학생복,[라포프]Raffauf 라포프 로맨틱 텍스쳐 블라우스 3종,79000,79000,0
2018-06-01,434466894,E031110,청소기,[카처]신제품 알러지협회인증 스팀청소기 SC2 Promo,189000,189000,0
2018-06-01,1936143295,C012060,여자내의,[썬비쥬] 랩 점프슈트 /D2C30 아래위붙은 팬츠 프릴 튜브탑 점프수트 탱크탑팬츠 배기,28900,28900,0
2018-06-01,2091152338,C021040,실내화,나이키 에어맥스97 실버 화이트 블랙 아시아 4종,138900,138900,0
2018-06-01,897647530,A012020,수입쇠고기,E-미국산 냉동 우갈비(꽃갈비/LA) 구이용 100g,2990,2488,-502
2018-06-01,895800330,A014010,우유,[남양]남양 맛있는 우유 GT 1L,2680,2480,-200
2018-06-01,1519039833,C013010,점퍼,여름 청자켓 남자 남성 데님 점퍼 워싱 남방 빈티지,29800,29800,0
2018-06-01,632095469,C011030,남자학생복,경량점퍼 빅사이즈 2062 MK 2061 빅사이즈,93310,90520,-2790
2018-06-01,1071078583,E011020,침대,인쏘노 저상형 패밀리침대 스너그온 + 매트리스 포함,300000,268770,-31230
2018-06-01,328607996,A018090,잼,로투스 비스켓크런치 380G 잼,11710,11710,0
2018-06-01,464664874,A013070,굴,러시아대게 수입대게 자숙/생물 스노우크랩 1kg,39900,39900,0
2018-06-01,1141800112,E061020,섬유유연제,바운스 시트유연제 드라이시트320매 외3종 빨래건조기,19800,19800,0
2018-06-01,1832613450,F011130,홍삼,인삼(200G),20900,20900,0
2018-06-01,547201044,C011030,남자학생복,[탑텐]남성 밴드넥 시어서커 7부 셔츠 MSY2WC1911,34900,29670,-5230
2018-06-01,899432874,E061100,습기제거제,[LG]샤프란 케어 상쾌한향 (500ML),5990,3000,-2990
2018-06-01,2088271951,C013060,등산복,여름 등산바지 냉감7부 등산복 작업복 아이스 반바지,16800,15290,-1510
2018-06-01,569554504,C014010,아동복,스탭키즈 )해지뷔스티에블라우스SIBL7S01,19900,9900,-10000
2018-06-01,1243667404,A019180,즉석식품,[올반] 육즙가득 왕교자 455gX3개 + 당면만두(20개),15900,15900,0
2018-06-01,1110685138,E021020,커튼,국산3중직/럭셔리~메탈릭. 클레어 암막커튼/ 커텐,26000,22910,-3090
2018-06-01,2051211887,A016110,딸기,국내산 유기농 달콤한 냉동딸기 2kg,18900,18900,0
2018-06-01,682056531,C012030,여자상의,로로텐 미니/롱/쉬폰/레이스 원피스/빅사이즈,28800,28800,0
2018-06-01,1701179877,A021010,커피,2만원 이상 무배/ 돌체구스토 43종 캡슐 사은품 증정,9880,9880,0
2018-06-01,1970517976,I053010,공책,신학기 과목노트(음악)(10개입)-랜덤 과목노트 학교음,11720,11720,0
2018-06-01,300626512,C012040,여자학생복,[쉬즈미스][쉬즈미스] 울 블렌드 오버핏 브이넥 풀오버_SSKPOI10060_GN,159600,135660,-23940
2018-06-01,1378106338,E021020,커튼,베베데코 인기상품 DTP 암막커튼 모음전,19900,19900,0
2018-06-01,988926998,L012060,샴푸,[엘지생활건강] 스페셜 에디션 T호 X5 (1BOX),124500,109500,-15000
2018-06-01,1397913155,C012040,여자학생복,수지네 일본 구제 블랙체크패턴 베스트 여성 S 18-35,13170,13170,0
2018-06-01,1011185769,F011130,홍삼,[올즙] 올바른 흑홍삼 스틱 30포 x 2박스,99600,49800,-49800
2018-06-01,1619948530,C012020,원피스,피모직 네이비 모던 코트 피코트_CT07_Navy 정장코트 남자정장 남자겨울코트 남자코트,79800,71030,-8770
2018-06-01,988926991,L012060,샴푸,[엘지생활건강] 리엔 3호 X2 (1BOX),74850,69800,-5050
2018-06-01,1559691367,E041070,밀폐용기,글라스락 1+1 핸들 유리병/과실주병/효소병/담금주병,10000,9020,-980
2018-06-01,1145971446,E031070,에어컨,SIF-16HWKR/정품/벽걸이선풍기/리모컨/전자식/40cm,60520,60520,0
2018-06-01,1597208082,F011130,홍삼,정관장 레네세홍삼캔디수(240G),10000,10000,0
2018-06-01,839394827,A018010,초콜릿,땅콩스니커즈 51gx24개 / 트윅스 48.5gx25개 / 아몬드스니커즈 49.9gx24개 /킷캣청키4,20500,20500,0
2018-06-01,1778590701,L021020,장신구,[바보사랑]ROMANTIC HOLIDAY EDITION ROSE UNBALANCE DROP PEARL EARRING,99000,99000,0
2018-06-01,283513480,E041010,식기,소야 아름 민사각찬기 그릇 1호 1P 도자기그릇 찬그릇,7640,6970,-670
2018-06-01,1778590703,L021020,장신구,[바보사랑]ROMANTIC HOLIDAY EDITION ROSE NECKLACE,99000,99000,0
2018-06-01,990000375,F011150,건강기능식품,[대웅] 가르시니아 플러스(900mgx112정) - 5병(40주분),100000,30900,-69100
2018-06-01,1258376847,E061020,섬유유연제,유아용 세탁세제 섬유유연제 아기용 베이비용 가정용,20620,20620,0
2018-06-01,1530589601,C012020,원피스,MELODY F102 모카/코트/여자코트/겨울코디/겨울코트/자켓/점퍼 미국 여성토탈브랜드 멜,39700,39700,0
2018-06-01,895863908,A018080,설탕,[청정원]청정원 유기농 황설탕 454g,3780,3780,0
2018-06-01,1679063722,C013040,청바지,[꼰띠키즈]피터체크블루머,7900,7900,0
2018-06-01,1086544087,A018010,초콜릿,베스킨라빈스31 아이스크림 캔디/리뉴얼 신제품,6300,6300,0
2018-06-01,188786374,A018050,비스킷,삼립 미니 꿀약과 1Kg / 간식 한과 약과 누네띠네,4500,4500,0
2018-06-01,170546320,L012030,칫솔,래디어스 토츠플러스 1개(색상선택가능)/ 래디어스,3310,3250,-60
2018-06-01,1956097565,C012060,여자내의,게스진 면바지(YE0W9063) 트윌 스판 슈퍼스키니,35100,31590,-3510
2018-06-01,1540245693,E021010,침구,시어서커 여름이불/ 다용도이불/요양원/팬션/병원이불,9800,9800,0
2018-06-01,368140135,C013020,티셔츠,(3+1) 비비안 임산부용 30D/80D 팬티스타킹/레깅스 (3개 구매시 1개 더 드려요),8000,7900,-100
2018-06-01,1011185772,F011130,홍삼,[올즙] 올바른 흑홍삼 스틱 30포 x 4박스,199200,97600,-101600
2018-06-01,2115446186,D031010,주택수선재료,수성 우레탄 코킹 퍼티 빠데 실리콘 크랙 금 균열 보수 충진 메꿈 탄성 고무 바닥 방수,19000,19000,0
2018-06-01,1011185771,F011130,홍삼,[올즙] 올바른 흑홍삼 스틱 30포 x 3박스,149400,73700,-75700
2018-06-01,873355817,L012040,치약,크리오 건치미인 치약 190g x 10개/대용량치약,8900,8900,0
2018-06-01,988216724,A016100,수박,리얼허니)고당도수박8호,19900,19900,0
2018-06-01,111437861,A011090,국수,농심큰사발/소컵 육개장/너구리/신라면/짜파범벅,19600,19600,0
2018-06-01,1459573456,C012040,여자학생복,[로로텐]케온줄지남방,39600,38040,-1560
2018-06-01,506477426,I011020,영상음향기기,(가즈아특가) 빔프로젝터 SSB-10DLYN60 미니 스마트빔,519000,519000,0
2018-06-01,1378841522,C011050,남자내의,남성 슬림 스키니 블랙 팬츠 남자청바지 편한청바지,73530,73530,0
2018-06-01,591343862,A016030,복숭아,청정 문경/상주산 야생 개복숭아15kg/10kg 자연산100%,43500,43500,0
2018-06-01,311561266,C012060,여자내의,[토마토팩토리] 돈비샤이 멜빵바지,18900,16680,-2220
2018-06-01,1585577829,I011010,TV,삼성패널 자비오 40인치TV 42인치TV UHDTV LEDTV,209000,209000,0
2018-06-01,900327539,A018060,스낵과자,롯데 칸쵸 216G,3300,1450,-1850
2018-06-01,1011185740,F011130,홍삼,[올즙] 올바른 흑도라지청 30포 x 2박스,99600,47800,-51800
2018-06-01,223705856,C011030,남자학생복,남자남성 반팔긴팔와이셔츠/95~130빅사이즈/체크,15900,14900,-1000
2018-06-01,1232190232,C012040,여자학생복,[꼼빠니아] 이중패턴 블라우스 CA7U5-WRB020_110,33100,33100,0
2018-06-01,1011185743,F011130,홍삼,[올즙] 올바른 흑도라지청 30포 x 4박스,199200,93600,-105600
2018-06-01,1011185742,F011130,홍삼,[올즙] 올바른 흑도라지청 30포 x 3박스,149400,70700,-78700
2018-06-01,817810538,I031040,생화,플라스틱테이블 야외 캠핑 행사 편의점 포장마차 간이,20000,17640,-2360
2018-06-01,988926969,L012060,샴푸,[엘지생활건강] 오가니스트 2호 X6 (1BOX),103050,103050,0
2018-06-01,796637618,C012060,여자내의,[탐나나]NEW미라클 부츠컷슬랙스/부츠컷/슬랙스/팬츠,32500,26330,-6170
2018-06-01,1753594136,E011030,거실장,마켓비 GITAWA 커피테이블 KS1069TB,107700,107700,0
2018-06-01,2010759598,L012060,샴푸,케라시스 데미지케어 샴푸 750mlX3개/대용량샴푸/린스,12900,12900,0
2018-06-01,1301729102,C013010,점퍼,심플 후드집업 BTT0045 남자후드집업 트레이닝복 W /,35100,28790,-6310
2018-06-01,1753594131,E011030,거실장,마켓비 MEND 테이블 망고나무,139100,139100,0
2018-06-01,1753594130,E011030,거실장,마켓비 HANDAL 480 커피테이블 4033B,64600,64600,0
2018-06-01,2084616693,C014010,아동복,게스키즈 G74KDT051 고주파 로고 티셔츠 M 남여공용 기본 라운드 면티 패밀리룩 가족티,22000,18260,-3740
2018-06-01,1753594135,E011030,거실장,마켓비 ENKEL 사이드테이블,45200,45200,0
2018-06-01,1753594134,E011030,거실장,마켓비 GROTES 사이드테이블 KS1043TB,38700,38700,0
2018-06-01,1464924104,I031010,장난감,[앙꼬] 앙꼬 워터토이 물놀이스티커 욕실놀이 장난감,9500,9500,0
2018-06-01,1753594133,E011030,거실장,마켓비 OBGE 사이드테이블 KS1052TB,35500,35500,0
2018-06-01,1753594132,E011030,거실장,마켓비 SEND 테이블 망고나무,139100,139100,0
2018-06-01,860705455,I031040,생화,[마운틴컴퍼니] SOS 긴급 구호세트 캠핑공구 캠핑안전용품 안전용품,24310,22150,-2160
2018-06-01,410556235,A019060,된장,된장(콩 재래식 해찬들 14K),53130,53130,0
2018-06-01,1314619271,E061020,섬유유연제,LG 샤프란 아로마시트-핑크센세이션 (30매) 샤프란,10900,10900,0
2018-06-01,307751899,I053030,복사용지,스마트카피 A4 복사용지(A4용지) 80g 2500매 1BOX,19900,17320,-2580
2018-06-01,900327540,A011100,라면,[이지그로]몬라이스 버미셀리 (250G),2200,2200,0
2018-06-01,1663028901,A011090,국수,내맘대로 15컵/ 컵누들/ 5컵씩 선택/컵라면/라면/국수,14500,14500,0
2018-06-01,392073849,C012040,여자학생복,[로로텐]쇼우슬럽조끼,32700,32700,0
2018-06-01,1011628840,F012020,생리대,에리에르 엘리스 메가미/고쿠수이/초안심 슈퍼롱 모음,15900,15900,0
2018-06-01,1619118192,C013010,점퍼,마크 후드점퍼 바람막이 빅사이즈 MK1051_1053 빅사이즈점퍼 바람막이 후드점퍼 스포츠,85190,75820,-9370
2018-06-01,411510660,A012010,국산쇠고기,설 구정선물세트 삼육재래전장김 20g 10봉,23580,23580,0
2018-06-01,2036765399,D031010,주택수선재료,[무료배송]아이생각수성목재1L/반광/방문용/가구/목재,15500,12500,-3000
2018-06-01,2126792307,C021040,실내화,[아디다스오리지널스]UNISEX ORIGINALS 아디이즈 5종 [C75611][CQ1064][CQ1065][CQ107,41400,34550,-6850
2018-06-01,1753594127,E011030,거실장,마켓비 ROCKWOOD 사이드테이블,117500,117500,0
2018-06-01,1010254340,A011090,국수,풀무원 생면식감 쇼유라멘 112.5G*4,5450,4950,-500
2018-06-01,721827113,C013040,청바지,(SR)MHA535 남자기모빅사이즈스판기모본딩청바지 남자,64580,64580,0
2018-06-01,1225379470,C012030,여자상의,기본루즈핏니트티 EB1711 라운드넥니트 일자핏니트 티,37420,37420,0
2018-06-01,154714463,C013050,운동복,경광봉 light baton 다용도랜턴 차량안전봉 지시봉,4400,4300,-100
2018-06-01,1753594129,E011030,거실장,마켓비 HANDAL 380 커피테이블 4033A,53800,53800,0
2018-06-01,1976507710,L021030,가방,Summers night_가터벨트[EBFC638011]/ 에블린,5000,4100,-900
2018-06-01,714910597,A019130,스프,오뚜기 스프분말 1kg 모음전/크림스프/양송이스프/야채스프/쇠고기스프/옥수수스프/,5400,5400,0
2018-06-01,429989597,L012040,치약,파로돈탁스치약 100gX5개/데일리후로라이드,21800,21800,0
2018-06-01,179443749,A021010,커피,몸이가벼워지는물 60포 초특가기획 설록 워터플러스,33900,33900,0
2018-06-01,1198226865,C013020,티셔츠,여성 여름용 매쉬소매패치 폴리스판 티셔츠 (P0W1226)/ 임페리얼,35100,31590,-3510
2018-06-01,66655986,E011050,책상,[이스마트] 스틸 에이스 플러스 독서실책상,154000,154000,0
2018-06-01,1734813865,C011050,남자내의,(아로미)(908/별대)시원한 기능성의 인견 9부 파자마,10790,9610,-1180
2018-06-01,1597208044,F011130,홍삼,정관장 레네세 홍삼캔디수(秀)(120G),5000,5000,0
2018-06-01,847169247,D031010,주택수선재료,아이생각 반광 친환경페인트 4L,43000,43000,0
2018-06-01,907102329,C012030,여자상의,심플골지이너원피스/섹시원피스/민소매원피스/롱나시,9900,9900,0
2018-06-01,360938031,C015040,장갑,스마트터치 눈꽃 니트 벙어리 여자 장갑 장갑 방한용,23470,23470,0
2018-06-01,536812986,I011030,사진기,소니A5100/16-50mm렌즈포함/32G+소니가방풀패키지/ED,625000,574080,-50920
2018-06-01,1010229394,A013180,젓갈,[더반찬] 키즈멸치볶음(80g),4700,4700,0
2018-06-01,2060623496,C013020,티셔츠,고급 카라티 남자 반팔티 카라티셔츠 반팔카라티 PK티,11900,11900,0
2018-06-01,1401019498,A013070,굴,알이꽉차있는 살아있는 서해안 꽃게 암꽃게 당일조업,29700,29700,0
2018-06-01,1036886533,G022020,자동차타이어,넥센타이어 고급형 CP672 205/65R16 정품 무료배송,74800,63160,-11640
2018-06-01,1743517690,A017150,버섯,친환경인증 100%국내산 산소 콩나물 /믿고드세요,6900,6900,0
2018-06-01,854041450,I012060,저장장치,로지텍코리아 G102 Prodigy pc방 에디션 게이밍마우스,23290,21900,-1390
2018-06-01,451150458,A019010,고춧가루,시골맛 아주매운 김치용 고추가루 2.5kg2개 가루 고추,93490,84150,-9340
2018-06-01,1573927645,C011030,남자학생복,롤프 남성 브이넥 롱가디건 니트가디건 외투 아우터,29500,29500,0
2018-06-01,218810804,C011030,남자학생복,남자긴팔셔츠/정장Y와이셔츠/남성체크남방/솔리드인기,24800,24800,0
2018-06-01,1252935336,C012060,여자내의,빅사이즈/제이스타일 로슬린 도트 펜슬 스커트/ 제이스타일,44900,34580,-10320
2018-06-01,1805981324,I012010,컴퓨터,구매가 102만원+총8GB무상 삼성노트북5 NT500R5N-X54A,1156840,1099000,-57840
2018-06-01,2142490714,C013050,운동복,일농마눌 범퍼보호필름,2900,2800,-100
2018-06-01,1993012545,I012060,저장장치,로지텍코리아 G100s Optical Gaming 게이밍광마우스,21170,19900,-1270
2018-06-01,1796214318,L021020,장신구,특가2점/천연진주팔찌/실버장식/18cm/19cm,50000,50000,0
2018-06-01,451088025,C011020,남자상의,패딩모직코트 모직코트 코트 WS_CT_02 더블브레스트,118070,118070,0
2018-06-01,1753594105,E011030,거실장,마켓비 BASEL 사이드테이블 OCEANIC,64600,64600,0
2018-06-01,901090798,A019080,고추장,청정원 찰고추장 증량 기획(1.5KG+300G),9900,9900,0
2018-06-01,988926936,L012060,샴푸,[엘지생활건강] 리엔 2호 X5 (1BOX),149630,139500,-10130
2018-06-01,1753594104,E011030,거실장,마켓비 KASY 커피테이블 KS1058TB,32300,32300,0
2018-06-01,1753594103,E011030,거실장,마켓비 BEETAL 사이드테이블,96000,96000,0
2018-06-01,504526897,C014010,아동복,화이트 클레식 반팔 셔츠 (BI8365B011)/ 빈폴키즈,58000,51620,-6380
2018-06-01,1079590909,C012060,여자내의,플라워롱플레어스커트_LF3S0922/ 글로리룩,69800,66310,-3490
2018-06-01,1010229361,A013180,젓갈,[더반찬] 마늘쫑무침,4200,4200,0
2018-06-01,988926931,L012060,샴푸,[엘지생활건강] 기분좋은 9호 X2 (1BOX),85270,78980,-6290
2018-06-01,988926930,L012060,샴푸,[엘지생활건강] 기분좋은 8호 X5 (1BOX),181350,159600,-21750
2018-06-01,1753594102,E011030,거실장,마켓비 OPARUN 사이드테이블 KS1016TB,38700,38700,0
2018-06-01,988926933,L012060,샴푸,[엘지생활건강] 명작 미 X2 (1BOX),90720,86180,-4540
2018-06-01,1753594101,E011030,거실장,마켓비 ALBERTA 사이드테이블,74400,74400,0
2018-06-01,1753594100,E011030,거실장,마켓비 BASEL 사이드테이블,64600,64600,0
2018-06-01,988926935,L012060,샴푸,[엘지생활건강] 리엔 1호 X5 (1BOX),112130,109500,-2630
2018-06-01,989013575,F011150,건강기능식품,[네이처드림] 맛있는 유기농 양배추즙 30포,30000,12900,-17100
2018-06-01,1842836525,F011150,건강기능식품,광동 생록천 75ml × 10병(1박스) / 최대 2박스 구매,4300,4300,0
2018-06-01,87389025,C012020,원피스,[닥스레이디스]네이비 경량 하프코트 OUCO7BK02N2,417000,333600,-83400
2018-06-01,1931537644,C012040,여자학생복,드레스제이/신상셔츠/55-88/빅사이즈/롱/루즈,12900,9900,-3000
2018-06-01,237796274,C012040,여자학생복,[모다아울렛][쉬즈미스]쉬즈미스 타이넥 프린트 블라우스(SWWBLI11100-IV),54000,51300,-2700
2018-06-01,1792753636,C011030,남자학생복,봄신상 셔츠/남방/남자남성/봄코디/헨리넥/린넨,8900,8900,0
2018-06-01,561909106,C013050,운동복,미즈노 2018신상트레이닝 반팔티셔츠 반바지 23종무배,31500,31500,0
2018-06-01,654483819,E061010,세탁세제,테크 베이킹소다+구연산 액체세제 리필 2L x 4개 외,14900,14900,0
2018-06-01,1318345088,A017080,무,국내산 청유담 새싹삼 80뿌리 160뿌리,39900,39900,0
2018-06-01,1433401955,A012010,국산쇠고기,[무항생제] 꼬리반골 5kg,101400,101400,0
2018-06-01,123048843,A014030,치즈,무배 미국 메세나 파마산 치즈 분말 파우더 227g 10개,86400,86400,0
2018-06-01,988926929,L012060,샴푸,[엘지생활건강] 기분좋은 7호 X5 (1BOX),158630,158630,0
2018-06-01,2009325098,C012020,원피스,빅사이즈여성정장/면접/여성정장/빅사이즈정장,69800,69800,0
2018-06-01,398940369,C012060,여자내의,SK943-데일리 20대 30대 예쁜스커트 베이직 밴드 플레,12040,12040,0
2018-06-01,323363224,C013020,티셔츠,남성 핑크 미니멀 브이넥 티셔츠 (228342WY9X)/ 에잇세컨즈,35900,31960,-3940
2018-06-01,985444460,A013100,마른멸치,[청산바다] 꼬마전복장 280g_순살,30000,27900,-2100
2018-06-01,449616108,C012060,여자내의,버클 와이드 슬랙스 LRP001 여자슬랙스 바지(YA02004),94480,83150,-11330
2018-06-01,1425924886,C014020,유아복,[대구백화점 I관] [치크]홑겹집업(CKJA82402G),29900,27810,-2090
2018-06-01,539199664,C011020,남자상의,[무료배송]체크 밍크털 코트 남성털코트 남성용털코트,103720,103720,0
2018-06-01,988035341,A019150,김치,[종가집]종가집 투명포기김치 3.5KG,29900,20900,-9000
2018-06-01,2141152662,F012020,생리대,+4P증정/화이트 좋은느낌 유기농 오가닉18+18P 생리대,6800,6800,0
2018-06-01,2140475171,E011020,침대,[잉글랜더]하임 일체형 침대/슈퍼싱글침대/독립매트,133900,133900,0
2018-06-01,1200494012,I011030,사진기,정품 니콘 J5 +10-30mm 사은품 미러리스 카메라 디카,359000,311880,-47120
2018-06-01,486038032,C013020,티셔츠,엄마티셔츠 엄마옷선물 40대미시옷 아줌마옷 50대중년,29800,29800,0
2018-06-01,1976784855,A019110,드레싱,[사천요리 중식 재료 골라담기] 훠궈 마라탕 마라샹궈,2900,2900,0
2018-06-01,474767459,A022010,주스,코카콜라 미닛 홈스타일 청포도 300ml 24개 주스 쥬스,30200,29300,-900
2018-06-01,1244344878,I031010,장난감,뽀로로 샤워컵 4P세트 목욕 물놀이 장난감 완구,22440,19750,-2690
2018-06-01,1533421415,C014020,유아복,[디플랜][디플랜] 구름비티셔츠(그레이 블루),5500,5230,-270
2018-06-01,507791067,I031040,생화,레더맨 멀티툴 WAVE 웨이브 캠핑 낚시 등산 레져 아웃,136000,136000,0
2018-06-01,494599398,C012060,여자내의,(더틸버리) 데님 프린지 언발 스커트 TI4M0SK56/ 더틸버리,59400,53460,-5940
2018-06-01,513517146,C013020,티셔츠,[빈폴아웃도어]네이비 여성 헨리넥 실켓 티셔츠 (BO8342C05R),49000,38710,-10290
2018-06-01,1117498470,L021010,손목시계,CASIO카시오 B650WD-1A 남녀공용메탈시계,46000,46000,0
2018-06-01,701419866,A018060,스낵과자,속초 티각태각 60g 120g모음 맥주안주 주전부리 부각,3500,3500,0
2018-06-01,1778590667,L021020,장신구,[바보사랑]RINGING PEARL RING,47000,47000,0
2018-06-01,1744047080,I031010,장난감,PS4 용과같이 제로 맹세의 장소 한글판 /용과같이제로,59800,58870,-930
2018-06-01,420755701,C012020,원피스,알파카 울 혼방 벨트코디 코트 MRDGWL9840/ 미니멈,359000,315920,-43080
2018-06-01,1778590668,L021020,장신구,[바보사랑]2 LINE PEARL RING,65000,65000,0
2018-06-01,990063797,F011120,인삼,[오늘의식탁]차가버섯 파우더 100g x 2팩,20500,18500,-2000
2018-06-01,1778590669,L021020,장신구,[바보사랑]SPIRAL PEARL RING,99000,99000,0
2018-06-01,1896413189,E031110,청소기,[하우쎈] 업소용청소기 HV-215 건식/습식 진공청소기 공업용,86900,86900,0
2018-06-01,1122933748,C013020,티셔츠,[춘희] 여름신상 면티셔츠 프릴 셔링 데일리룩 러블리,25000,25000,0
2018-06-01,1250548133,C013010,점퍼,반폴라보아털집업 GY1712,60960,54260,-6700
2018-06-01,653684200,C013050,운동복,쌍용자동차 코란도스포츠 사이드스텝 GSC 옆발판,377000,339300,-37700
2018-06-01,532349429,C013010,점퍼,남자라쿤후드무스탕 빅사이즈남성무스탕 남자무스탕코트(국내제작/90~120사이즈별맞춤,1190000,1190000,0
2018-06-01,1602361525,C021040,실내화,정품 아디다스운동화 100종파격가/무료배송/당일출고/,62000,55490,-6510
2018-06-01,2071631790,A017050,미나리,양배추-5kg.7kg,8900,8900,0
2018-06-01,1117498468,L021010,손목시계,CASIO카시오 B650WB-1B 남녀공용메탈시계,83000,83000,0
2018-06-01,2132156135,C013010,점퍼,[베네통][베네통]리얼 양가죽 라이더 자켓(BALED3761BK),362500,344380,-18120
2018-06-01,1117498467,L021010,손목시계,CASIO카시오 B650WC-5A 남녀공용메탈시계,83000,83000,0
2018-06-01,420731740,C012020,원피스,클래식 캐시미어 롱코트 MQDAWL0210/ 미니멈,995000,875600,-119400
2018-06-01,1154283711,A018110,물엿,청정원 요리초 900ml (피클 장아찌 냉국만들때),4450,4450,0
2018-06-01,1384488944,F012020,생리대,순수한면 제로(ZERO) 신규출시 5팩 3팩 구성 릴리안,9900,9900,0
2018-06-01,1969683571,C013040,청바지,빅사이즈 밴딩 패치 워싱 데님 팬츠 청바지,21900,21900,0
2018-06-01,1689130425,F012030,안경,아이린옵틱스 티타늄안경테 남자안경테 여자안경테,55900,55900,0
2018-06-01,522199187,F012010,종이기저귀,하기스/매직팬티5단계/50매x3팩/당일발송,56500,56500,0
2018-06-01,1296330950,C012060,여자내의,톰스 연청 멜빵 청반바지(멜빵탈부착) SD-4085,15270,14510,-760
2018-06-01,1117498494,L021010,손목시계,CASIO카시오 LA-20WH-1C 여성전자시계,29000,29000,0
2018-06-01,1978422147,C011050,남자내의,[폴햄] 남여공용 솔리드 5부 반바지(PHY2PH1012),19900,16120,-3780
2018-06-01,420731711,C012020,원피스,알파카 울코트 MQDAWH0190/ 미니멈,499000,439120,-59880
2018-06-01,1625398045,C011030,남자학생복,[바쏘옴므]춘하 모혼방 베이직 네이비 정장베스트 (WSQ1VED3A),19000,16910,-2090
2018-06-01,1778590670,L021020,장신구,[바보사랑]SPIRAL RING,49000,49000,0
2018-06-01,1778590671,L021020,장신구,[바보사랑]TWIST SPIRAL TASSEL RING,69000,69000,0
2018-06-01,2031161324,C014020,유아복,국산 쉬폰인견 유아복 호피상하세트 6세까지 인견 호,57120,57120,0
2018-06-01,1241075110,A021010,커피,카누아이스블렌드100T+아이스텀블러 또는 아이스머그,19900,19900,0
2018-06-01,1778590674,L021020,장신구,[바보사랑]KNOT PLAIN RING,47000,47000,0
2018-06-01,491597016,C013020,티셔츠,KARRA 포인트자수선인장티셔츠_KBI5TS240A,22710,22710,0
2018-06-01,1778590672,L021020,장신구,[바보사랑]KNOT TWIST RING,42000,42000,0
2018-06-01,1942893197,C012060,여자내의,단추 포인트 청치마/청스커트/미니스커트/미니청치마,14900,14900,0
2018-06-01,425446710,A018030,껌,더블버블껌165입+솜사탕(플루피)증정,12900,12900,0
2018-06-01,177431725,E061040,부엌용세제,자연 EM(활성액) 1병/이엠 발효액 용액 원액 만물상,2250,2250,0
2018-06-01,1781591947,C011030,남자학생복,남자셔츠/기본남방/스트라이프체크남방/청남방/헨리넥,13900,13900,0
2018-06-01,1265837869,L021010,손목시계,로제타 여성 손목시계 FW-16 손목시계 팔찌 팔찌시계,13140,13140,0
2018-06-01,148338549,A014030,치즈,썬리취/ 체다슬라이스치즈100매/무색소 체다슬라이스,12900,12900,0
2018-06-01,1429279848,E031110,청소기,[블랙앤데커]스팀청소기 FSM1620 / FSM1605 / FSM1610,125000,116250,-8750
2018-06-01,536207332,A019110,드레싱,움트리 매운닭발양념1.9kg x 6개 박스판매 제육볶음,45000,45000,0
2018-06-01,276475618,E021010,침구,60수 순면 호텔 침구세트 / 퀸 슈퍼싱글 이불세트,79800,79800,0
2018-06-01,431858724,C014010,아동복,[프렌치캣]PK 캣 MTM Q62DKT401,21000,17850,-3150
2018-06-01,1677457629,F012010,종이기저귀,보솜이 리얼코튼 밴드 대형 36매 (남녀선택),12900,9900,-3000
2018-06-01,1778590676,L021020,장신구,[바보사랑]KNOT SLIM RING,47000,47000,0
2018-06-01,104684452,A019070,양념소스,국내산 녹미원 참 생와사비 100g 니비시기꼬만간장,3500,3500,0
2018-06-01,314357358,C013060,등산복,공용 라운드넥 반팔 티셔츠 BO7342D51/ 빈폴아웃도어,21000,18900,-2100
2018-06-01,536195054,C012040,여자학생복,[쉬즈미스]2018 SSKPOI20050 프릴 슬리브 리브드 풀오버,68040,57840,-10200
2018-06-01,489680083,A019170,냉동식품,사은품증정/아하감자찐만두 1.4kg/만두/간식,6500,6500,0
2018-06-01,632864052,A011170,떡,전북고창 울어매 모시잎 떡모음 3종세트(25개 3팩) /,66000,58080,-7920
2018-06-01,277438266,A017040,양배추,동결건조 유기농 시금치가루 60g 시금치 분말 주스 즙,12000,12000,0
2018-06-01,1081039954,C011030,남자학생복,[루이까또즈 와이셔츠]2018 일반핏/슬림핏 여름 반소매 25종 택1,35000,28000,-7000
2018-06-01,324186751,A017280,김,차조기사쿠라하나(원효 1k)X10 식자재 업소용식자재,51290,49240,-2050
2018-06-01,2051568244,E021020,커튼,/롤러블라인드 베이지 스콕스클뢰베르 100x195 cm/ 블,56280,50090,-6190
2018-06-01,121791020,F011130,홍삼,[농협홍삼/한삼인] 순홍삼 50ml*30포 (1500ml) X 7상자,281100,281100,0
2018-06-01,983598408,A014030,치즈,임실 치즈선물세트 1호 (피자치즈 포션치즈(플레인/양파/아몬드/단호박) 슬라이스치즈),62900,62900,0
2018-06-01,1857126912,A022010,주스,코코팜 포도 봉봉 갈아만든배 238ml x24캔 음료수,11900,11900,0
2018-06-01,1708253654,A021010,커피,자판기 커피믹스 믹스커피 율무차 유자차 핫초코 모카,2600,2600,0
2018-06-01,902773385,C013050,운동복,[AWK 에어워크키즈]공용_AWK라인퍼모먼스7부바지_O172B3531B,19900,18910,-990
2018-06-01,636376979,A018100,꿀,명인 생강청 600g/조청 꿀/조청분야 식품명인 강봉석,15000,15000,0
2018-06-01,1278039141,E061050,청소용세제,Mr.홈스타 바르기만 하면 곰팡이싹 120mlx3개 외,9900,9900,0
2018-06-01,121791019,F011130,홍삼,[농협홍삼/한삼인] 순홍삼 50ml*30포 (1500ml) X 8상자,321200,321200,0
2018-06-01,976715757,C013040,청바지,[데] 뱅뱅(BANGBANG) 남성용 레귤러 썸머 데님 팬츠 3종(남),69900,64310,-5590
2018-06-01,496960092,C012040,여자학생복,MJ_1220 브라운 양털 조끼 캐주얼조끼 털조끼 양털조,30370,30370,0
2018-06-01,1989574389,E021010,침구,올리비아데코 웨딩/혼수/이사 이불 침구,22900,22900,0
2018-06-01,722335204,E041010,식기,업소용 투칼라 멜라민그릇/공기/대접/접시/찬기/11,1000,920,-80
2018-06-01,121791017,F011130,홍삼,[농협홍삼/한삼인] 착한홍삼 50ml*30포 (1500ml),60100,60100,0
2018-06-01,552218610,A017050,미나리,무농약 양배추 5kg,10000,9900,-100
2018-06-01,591615320,F011150,건강기능식품,삼양사 큐원 상쾌환 3 x 10개 숙취해소/컨디션/헛개,16300,16300,0
2018-06-01,526659824,D031010,주택수선재료,숲으로홈앤멀티멜 0.9L 친환경 방문 가구 벽지 페인트,11000,11000,0
2018-06-01,1778590699,L021020,장신구,[바보사랑]D LINE PEARL RING,69000,69000,0
2018-06-01,1320767457,E011040,소파,플로바움 바브린노ll 3/4인용 쇼파,229000,229000,0
2018-06-01,808723821,I031040,생화,[태완]빅토리녹스스티커/포인트스티커/캠핑스티커,3000,2740,-260
2018-06-01,1598078044,E011050,책상,가구뱅크/703탑책상/사무가구/파티션,43000,43000,0
2018-06-01,728569592,C013010,점퍼,배낭점퍼 바람막이점퍼 캐릭터점퍼 귀여운바람막이,18900,17900,-1000
2018-06-01,1210416865,C013040,청바지,[오즈세컨(o2nd)][오즈세컨] [여성] 린넨 혼방 레이스 포인트 팬츠 2WMS2WP03600010,258000,247970,-10030
2018-06-01,819971692,C011050,남자내의,(평화)(여인견8파자마)식물성 천연 섬유 인견 파자마,12020,10700,-1320
2018-06-01,356229604,C012060,여자내의,반바지 숏팬츠 P 2047 밴드여자3부여름면반바지 여름,21050,21050,0
2018-06-01,617757340,A019060,된장,일본 MARUKOME 마루코메 미소 된장국 4종 32입 576g,11290,11290,0
2018-06-01,121791049,F011130,홍삼,[농협홍삼/한삼인] 순홍삼 50ml*30포 (1500ml) X 6상자,240900,240900,0
2018-06-01,410918746,C013010,점퍼,K2 S 무스탕 가죽점퍼 21 라이더점퍼 볶음캐슈넷 간식,149500,149500,0
2018-06-01,1290252039,C014020,유아복,[밀키즈]유아동 여름신상 상하복,8900,8900,0
2018-06-01,992281900,C011030,남자학생복,[탑보이][탑보이] 베이직 라이트 패딩조끼 (JK022),26800,23590,-3210
2018-06-01,240498263,A012040,닭고기,꼬꼬빌 머슬업플러스 30팩 등 닭가슴살 할인모음,49800,49800,0
2018-06-01,748188756,A016110,딸기,DS239/뉴뜨레 냉동딸기S 1kg,15540,15540,0
2018-06-01,285910007,C012040,여자학생복,V넥 사이드 프릴 블라우스 (ENBA82420Z)/ 이앤씨,22000,19800,-2200
2018-06-01,1882322445,C011020,남자상의,국산 정장바지 필우드 중년 청바지 사방스판 골프바지,39000,38610,-390
2018-06-01,698149823,C013050,운동복,[카모드] 차량용소화기 캠핑용 소형소화기 월드프로119 화재대비 휴대용소화기 차량화,9590,8280,-1310
2018-06-01,1758660476,A022030,생수,빅토리아 탄산수 플레인/탄산음료 레몬 350mlx24캔,8900,8900,0
2018-06-01,1880873005,C013010,점퍼,레이스배색경량여름점퍼OH8MJP204/ 올리비아하슬러(여성),128000,115200,-12800
2018-06-01,1267671322,A013060,게,한치 마른화살오징어(S 35미)1kg,112200,112200,0
2018-06-01,386427379,C012020,원피스,컷팅 일자 데님 팬츠 RIN0368RM805 빅사이즈,58930,55400,-3530
2018-06-01,1030678634,A019140,이유식,[20%할인]루솔 프리미엄 이유식 골고루 12팩 + 사은품,28000,28000,0
2018-06-01,2058117258,C013020,티셔츠,[엘르골프](여성)쿨누드라운드티셔츠_6D45304/ 엘르골프,36000,33840,-2160
2018-06-01,2038060982,L021030,가방,(비비안/피에르가르뎅) 학생교복스타킹 5족/80데니아/기모타이즈/학생양말 10족,20800,19800,-1000
2018-06-01,138960991,I053030,복사용지,직배송 삼성 A4 복사용지(A4용지) 75g 2박스/더블에이,39300,33800,-5500
2018-06-01,1692826385,A013030,조기,가거도 참조기 12미 19-22cm,30000,29700,-300
2018-06-01,895621742,A017130,도라지,햇감자 (2KG/박스),7990,7990,0
2018-06-01,2005203401,C011020,남자상의,(무료배송) AG 남성자켓 마이 DB784 785 jk 빅사이즈,208920,183850,-25070
2018-06-01,1746725955,A014020,분유,트루맘 프리미엄 1~4단계 800g,23000,23000,0
2018-06-01,98495065,A011120,두부,독일 하네 뮤즐리 영국 그레인 뮤즐리 그래놀라 8종,7900,7900,0
2018-06-01,1804356782,L021020,장신구,[바보사랑]빅사이즈 골드 십자가 귀걸이,10320,10320,0
2018-06-01,895655160,A016050,밤,생율 (150G/봉),5990,5990,0
2018-06-01,385910801,E011050,책상,[이스마트] 1인실프라임1200/1500독서실책상/혼공책상,72000,64530,-7470
2018-06-01,374192394,C012040,여자학생복,(208) 브이넥단추조끼 기본조끼 단추조끼,23800,23800,0
2018-06-01,992569985,E021020,커튼,국산암막/ 사계절 로맨틱~프리미엄 레이저 컷팅 커튼,40000,35880,-4120
2018-06-01,911766039,I012010,컴퓨터,[E]Z70EV-AR75S1/7세대/i5/8G/128G+1TB/키보드+마우스,899000,854050,-44950
2018-06-01,2006239036,E011050,책상,샤이프 좌식책상 노트북테이블 컴퓨터책상 거실테이블,110000,99000,-11000
2018-06-01,54358459,C012060,여자내의,[로엠][로엠] 페미닌 주름 플라워패턴 A라인 스커트 RMWH549R11_15,4800,4560,-240
2018-06-01,546144588,E061020,섬유유연제,FC 베이비전용 세탁세제 refill 유아용 민감성피부세,21570,21570,0
2018-06-01,379520117,C014020,유아복,화이트 여자아이 아동 주니어 티셔츠 반팔 나비 키즈,10880,10880,0
2018-06-01,918313240,A011140,부침가루,퍼지바 모카 레이지 (42gx12개) 8곽 1박스/빵/케익,25300,25300,0
2018-06-01,1185336414,C012060,여자내의,[빅앤빅]샌드 리넨 큐롯팬츠 3color 빅사이즈 2634까지,40000,38000,-2000
2018-06-01,10089643,C013050,운동복,여성 M~4XL 트레이닝복세트 저지 팬츠 반바지 5부7,10000,9800,-200
2018-06-01,1814484478,L012060,샴푸,댕기머리 뉴골드/명품/해운모 샴푸 500mlx2개+145ml,21900,21900,0
2018-06-01,2107695282,E011050,책상,텐더 각도조절 책상/책장/책꽂이/서랍장/L형/학생,148900,148900,0
2018-06-01,2079309231,F012020,생리대,[화이트] 화이트 입는 오버나이트 중형 8pX4개 팬티형 생리대,32900,32900,0
2018-06-01,460361195,C011020,남자상의,블랙 체크 밍크털 코트 캐쥬얼코트 남자코트 남성용코,107510,104290,-3220
2018-06-01,1990891951,C011020,남자상의,MJSF18003 차콜 코튼 베이직 코트 남성봄코트 면코트,95400,95400,0
2018-06-01,1804356791,L021020,장신구,[바보사랑]러블리 큐빅 드롭귀걸이,8720,8720,0
2018-06-01,1941677208,C013040,청바지,체리데님팬츠/여아청바지/아동복/스커트/면바지/,9900,9900,0
2018-06-01,401599564,E021020,커튼,아라크네 실커튼 땡처리 한정특가 비즈발 타이백,200,190,-10
2018-06-01,739009077,L012030,칫솔,시스테마 콤팩트 칫솔 x 14개 치약 구강,14800,14800,0
2018-06-01,1107647692,C013020,티셔츠,블루빈 남자 긴팔티 7부 기본티 루즈핏 티셔츠 무지티,12900,12900,0
2018-06-01,130159618,A016120,바나나,델몬트 고당도 바나나 2.5kg내외,10900,10900,0
2018-06-01,1264774114,A017160,오이,[남도장터]싱싱한 함평 새송이 버섯 2kg 무료배송,7800,7800,0
2018-06-01,1553047069,I031040,생화,독일명품 도끼 캠핑용 손도끼 장작도끼 벌목도끼 망치,19900,19900,0
2018-06-01,1310304777,C011050,남자내의,[올젠]18 S/S 캐주얼 면스판 팬츠 3종 택1(ZOY1PP1103)(영등포점A),45000,37110,-7890
2018-06-01,956665237,A019110,드레싱,[풀무원]레몬 갈릭 샐러드소스 245G,3580,3580,0
2018-06-01,1273963763,C012040,여자학생복,펄가오리[RSC5KC001]/ 루코루코,34300,32590,-1710
2018-06-01,1854677967,A019030,생강,편강진저빈 (국산 250gX2통) 선물세트,32790,29190,-3600
2018-06-01,959557066,E061060,살충제,홈키파 무향 모기향10매,1300,1300,0
2018-06-01,1476069600,A014040,발효유,헬로엔요 200mlx24팩 프로바이오틱 유산균음료 엔요,10900,10900,0
2018-06-01,9737034,E061040,부엌용세제,참그린 500g 용기 x 6개 주방 세제,8900,8900,0
2018-06-01,290411240,A014020,분유,[베비언스]산양 액상분유1단계 6입(180ml)(니플S1포함),15900,15110,-790
2018-06-01,649585036,A022020,두유,[무배특가]삼육두유 대용량 기획전 검은콩/칼슘/건강,29900,29900,0
2018-06-01,240631341,C021040,실내화,[푸마] (SIZE : 255) 플레어 2(18951703) 신발 러닝,85190,85190,0
2018-06-01,1111577780,C012020,원피스,[올리비아로렌] 솔리드 지퍼포켓 VOPDLRM3321,25600,24070,-1530
2018-06-01,204391088,C011050,남자내의,[여름신상 카고바지]카고/면바지/청바지/작업복/남성,23700,23700,0
2018-06-01,1935938685,C013010,점퍼,여름신상 린넨자켓/마자켓/7부자켓/여름자켓/캐주얼,42800,39800,-3000
2018-06-01,1360640643,A018080,설탕,대한제당하얀설탕3k/갈색설탕3k/갈색설탕5k/CJ설탕,11500,11500,0
2018-06-01,1029604408,C012040,여자학생복,여성 왕꽈배기 8부 고급테잎사 니트 티 긴팔 티셔츠,16670,16670,0
2018-06-01,925367074,C013020,티셔츠,커터앤벅 남성 스판 카라 반팔티셔츠 - 1472-101-65,44900,39900,-5000
2018-06-01,567135850,C013020,티셔츠,빅사이즈민짱/무료배송/예쁘잖아 신상티셔츠모음,16900,16900,0
2018-06-01,978392986,A011020,현미,국산 찹쌀로 만든 푸르맘 찹쌀가루1kg,7400,7400,0
2018-06-01,1518650037,E031030,전자레인지,쿠잉 전자렌지 MM720CJ9 20L/전자레인지/소형/미니,48000,45120,-2880
2018-06-01,631913744,C011030,남자학생복,폴라폴리스 패딩점퍼 MK2081 빅사이즈,78800,76440,-2360
2018-06-01,633518917,E041020,컵,국산 콜라컵 주스컵 PC물컵,350,350,0
2018-06-01,898539301,F012020,생리대,[LG]바디피트 천연코튼 라벤더 팬티라이너 (20P),1000,1000,0
2018-06-01,1252107855,C012060,여자내의,체크롱스커트/ 플레이팝,12900,11490,-1410
2018-06-01,1979750357,C013060,등산복,[빈폴아웃도어]남성 로그 롱 다운 2종 택1 (2종 택1),298800,236060,-62740
2018-06-01,1950443376,C012040,여자학생복,씨드 매끈한 여름 린넨 셔츠 루즈핏남방,24900,24900,0
2018-06-01,959557003,A011130,시리얼,[오뚜기]오뚜기 바삭 고소 튀김가루 1KG,3150,3150,0
2018-06-01,989133491,F011150,건강기능식품,깔라만시분말 140G,12900,12900,0
2018-06-01,1428782064,A011140,부침가루,삼립 소프트 치즈케익 3종 30개 무료배송!!,17900,17900,0
2018-06-01,987287409,A022060,혼합음료,[대웅] 녹용홍삼 (국산 생녹용추출액+6년근홍삼+당귀+천궁 함유  70mlX30포) -1세트,35000,15900,-19100
2018-06-01,795432215,A013140,북어채,용대리 황태풍년(황태포 10미)강원도 특산품 자연건조,29800,29800,0
2018-06-01,1905712541,L012060,샴푸,미쟝센 퍼펙트세럼 샴푸/린스x3개 /프레시팝/댄트롤,8900,8900,0
2018-06-01,126538154,E011010,장롱,10자.18년신상품 장농.옷장.붙박이장.침실세트판매,419000,419000,0
2018-06-01,1811646172,E041010,식기,산토리 밥공기  국그릇 1인 세트 JAPAN/ 니코트,9900,9310,-590
2018-06-01,539476710,A011090,국수,신라면 120g x 40봉 안성탕면/진라면/라면,28190,28190,0
2018-06-01,2088053706,E061060,살충제,투네이처 쥐/고양이/소동물/기피제/퇴치제/쥐퇴치제,15900,15900,0
2018-06-01,451402328,C014010,아동복,[페리미츠]여아레이스셔링원피스 (P1865O559_13),25500,22950,-2550
2018-06-01,812340935,E061040,부엌용세제,[특가]주방세제1.2Lx6팩 퐁퐁 트리오 순샘 베이킹소다,7900,7700,-200
2018-06-01,1258844147,C013010,점퍼,빅사이즈 여성 패딩조끼 WC 여 웰론조끼 VT 060W - 빅,93350,83090,-10260
2018-06-01,444925000,I011010,TV,인켈 TV 40인치TV LEDTV 패널2년보증 직영AS 직배송,314730,299000,-15730
2018-06-01,959498230,F012020,생리대,[유한킴벌리]유한킴벌리 좋은느낌 오가닉코튼커버 중형 날개형(14P),5600,5600,0
2018-06-01,951099921,C011020,남자상의,신화어페럴/봄/여름/정장바지/중년남성/팬츠/슬랙스,19900,19900,0
2018-06-01,813797154,C014010,아동복,[젤리스푼] 데일리 아동바지/레깅스 모음,10900,10900,0
2018-06-01,593561900,A019180,즉석식품,1995년부터 2대째 맛집 남순남순대국 5인분세트,19900,19900,0
2018-06-01,1723541413,D031010,주택수선재료,고리44 방부 방충용 도료(무광) 2.5L-오일스테인,36000,36000,0
2018-06-01,415188626,C013010,점퍼,바람막이 야상 WS-JM31 바람막이 야상 점퍼 남자야상,69700,68310,-1390
2018-06-01,517003472,C011050,남자내의,밀리터리 택티컬팬츠/전술바지 ix7/ix9 카고바지 아웃도어 등산바지,43070,43070,0
2018-06-01,1021901783,I031040,생화,손도끼 도끼 손도끼 도키 농기구 낫 공구 나무절단,13920,12690,-1230
2018-06-01,959618570,A016060,감,유명산지 밀양 얼음골 사과 5kg(19-21개),37700,29000,-8700
2018-06-01,281635680,C013040,청바지,[R.ROBOT]BL)와펜배기데님팬츠(18119-410-07),63200,48670,-14530
2018-06-01,905175450,E031070,에어컨,천장형선풍기s-fan50 써큘레이터 캠핑용 타프팬 60/70,19500,19500,0
2018-06-01,1225581189,A012010,국산쇠고기,[명절선물 Best][프리미엄 한우선물세트 9호 3.2kg]1+,450000,445500,-4500
2018-06-01,762929693,E021010,침구,봄신상 세미마이크로 차렵이불/패드/요토퍼,29900,27510,-2390
2018-06-01,403661910,E031080,선풍기,선풍기 발선풍기 TGE-HA-03 냉온풍겸용 4계절사용,31600,29900,-1700
2018-06-01,2058394530,C014010,아동복,[6~13세] 시그니쳐로고반팔세트_네이비_18EVER_SET04/ 에버라스트,32800,26240,-6560
2018-06-01,667562253,A017220,양파,대파가루 200g,6100,6100,0
2018-06-01,740086839,A019050,간장,[농협] 우리땅우리콩 전통식 재래간장 1.8L 대용량,17800,15900,-1900
2018-06-01,2026160849,F011150,건강기능식품,귀리 렌틸콩 미숫가루X3봉/식이섬유/당일제조/無설탕,12900,11900,-1000
2018-06-01,993099400,E011020,침대,효암 돌침대 싱글 HM2000SS 3종모음/황토 흙침대,640000,590000,-50000
2018-06-01,667562252,A017220,양파,대파분태 100g,3740,3740,0
2018-06-01,202175636,A011070,혼식곡,[CJ직배송] 우리밀 통밀영양가득 밀가루(750g) x 6개,15400,15400,0
2018-06-01,1563212227,C012020,원피스,여성 봄 세미 정장 세트 캐주얼 린넨 투피스 결혼식,74730,71000,-3730
2018-06-01,1440801526,A015020,식용유,[사조해표] 콩기름 식용유 900ml 4병 대두유 카놀라유 포도씨유,9900,9900,0
2018-06-01,880633098,C014010,아동복,OAD-반바지정장팬츠/아동팬츠/아동정장바지/아동정장,21600,21600,0
2018-06-01,1704961574,C012060,여자내의,힙업2부 여름 레이스 속바지 여성 의류 반바지 핫팬츠,990,990,0
2018-06-01,1119594202,I011030,사진기,정품 리코 GR II / +맨프로토 PIXI삼각대 / RICOH GR2,780000,780000,0
2018-06-01,1424802202,I031040,생화,당일발송 코스모스 낚시용 아이스박스 레저용/바퀴형,38700,34640,-4060
2018-06-01,1210426239,E031110,청소기,[악팩+필터5증정] 아이클레보 로봇청소기 YCR-M07-10,569000,569000,0
2018-06-01,532350417,C013010,점퍼,핸드메이드 스타일엔터 남자무스탕자켓 메리노롱헤어무스탕점퍼 5색상 (주문제작상품),1290000,1290000,0
2018-06-01,1057309750,C012040,여자학생복,겨울니트 폴라니트 목폴라티 퍼니트 JD45,26440,26440,0
2018-06-01,898456562,A016130,키위,국산 청포도(200g/팩),5990,5990,0
2018-06-01,2085797876,A016160,과일가공품,[베리필드 미산] A등급 냉동블루베리 1kg 외 냉동과일,6500,6500,0
2018-06-01,1356768872,C013050,운동복,나이키/아디다스/7부/세트/티셔츠/반바지/단체/반팔,24000,22000,-2000
2018-06-01,542431639,C014020,유아복,[뿌야뿌][뿌야뿌] 썸머번아웃점퍼 PC2TGJP23N,17500,7880,-9620
2018-06-01,526442597,C012060,여자내의,[모다아울렛][라인]하이웨스트 스커트(ANWSKHD04),51000,48450,-2550
2018-06-01,398281577,A011090,국수,농심 둥지물냉면16입+비빔냉면16입,26900,26900,0
2018-06-01,197128102,E011040,소파,아로미가구 엘사 2인용 방수패브릭 인조가죽 소파,80000,80000,0
2018-06-01,719828812,C012060,여자내의,여성 베이지 A라인 미니 스커트 (128327B47A)/ 에잇세컨즈,39900,35520,-4380
2018-06-01,1537856593,A012040,닭고기,이번주만!그린푸드 닭가슴살SL 10kg/국내산100%/스킨과지방이제거/1kg단위진공포장,68000,44800,-23200
2018-06-01,2055740127,C021040,실내화,로얄 컴플릿 REEBOK ROYAL COMPLETE2 (CN7426)/ 리복,44000,36080,-7920
2018-06-01,88729610,F011130,홍삼,[풀비타] 활력홍삼 (80mlx21포) .,55000,55000,0
2018-06-01,899588687,A011120,두부,농심 켈로그 스페셜K 480G,7690,7690,0
2018-06-01,615263234,L021020,장신구,14k귀걸이 정품 14k피어싱 핑크골드 큐빅 한쪽 진주,15900,15900,0
2018-06-01,1398736751,C013020,티셔츠,빅사이즈 냉장고 티셔츠 55-99 여성 루즈핏 박스 미시,6000,5900,-100
2018-06-01,1789668714,F012020,생리대,NEW 템포 슈퍼 10매 x 3박스(총30매)/ 템포,11700,11000,-700
2018-06-01,960534339,A016090,참외,알찬사과 2.5KG/봉,9900,7990,-1910
2018-06-01,1867168199,C012060,여자내의,[ab.f.z][17여름][가격인하]캔디 캉캉 롱스커트(AFR3GS55G)[갤러리아],37000,29600,-7400
2018-06-01,88729611,F011130,홍삼,. [풀비타] 귀인 홍삼정 (10gx50포) .,155000,155000,0
2018-06-01,1789668718,F012020,생리대,NEW 템포 슈퍼 10매 x 5박스(총50매)/ 템포,17900,16650,-1250
2018-06-01,155704784,A013100,마른멸치,해말린 건전복 3미(75g),21500,21500,0
2018-06-01,1178825785,A022020,두유,황성주 두유 190mlX16팩-베지밀/삼육/연세/식사대용,9900,9900,0
2018-06-01,1566934117,C012040,여자학생복,리스트 코튼 블렌드 오버핏 블라우스_TWBLF70110_BK/ 리스트,19000,18050,-950
2018-06-01,983094299,C013050,운동복,CAREX 자동차 문콕방지 도어가드 심플블랙 패드 4P,9310,9310,0
2018-06-01,1963750051,C013050,운동복,귀여운 캐릭터 안전벨트 클립 전차종공용 경고음 차단,5000,4850,-150
2018-06-01,719537353,E011040,소파,베스트리빙 피렌체 소파 /3인쇼파/2인쇼파/1인쇼파,139000,139000,0
2018-06-01,1439694607,A012030,돼지고기,[산지직송]산청흑돼지 뒷다리살 400g*2,5900,5900,0
2018-06-01,1182647958,E061030,전구,ㅡ유팡소독기 자외선 살균램프/적외선전구/칫솔걸이,4000,4000,0
2018-06-01,75083042,A022030,생수,로리나(750미리)3종/낱개판매/빠른배송/신제품,3900,3800,-100
2018-06-01,1520459226,E061030,전구,금호전기 LED 사각 일자등30W/등기구/방등/전구/조명,12900,12900,0
2018-06-01,1164636688,A022050,탄산음료,[코카콜라] 몬스터 에너지 시트라 355CAN X24,27700,27700,0
2018-06-01,141116418,A013160,맛살,대림선 스노우크랩킹140gx2,2990,2990,0
2018-06-01,500054250,C013020,티셔츠,[버커루]남성 20수 피케 빈티지 카라 티셔츠 (B182TS280P01)[갤러리아],69000,62100,-6900
2018-06-01,1296391889,G011070,자전거,시애틀모던M 26 하이브리드 하이림적용 삼천리자전거,119000,119000,0
2018-06-01,867244530,C013050,운동복,트레이닝 세트 운동복 상의 하의 빅사이즈 허밍퍼플,20000,19800,-200
2018-06-01,405408688,I031040,생화,한양MSL 접이식 폴딩 캠핑 야외용 사이드 미니테이블,12900,11870,-1030
2018-06-01,38480638,C013010,점퍼,[써스데이아일랜드] 구제가죽자켓/남자가죽점퍼/가죽자켓/남자가죽자켓,39500,39500,0
2018-06-01,1238759342,A019040,소금,0kcal 무칼로리 100% 에리스리톨 1kg,10000,9000,-1000
2018-06-01,1323948229,C013050,운동복,[아스토레] (SIZE : 080) 본딩 히트자켓(ABL) - 우븐+,110640,110640,0
2018-06-01,97652672,F012010,종이기저귀,(해피앙내추럴)기저귀/친환경/MADE IN KOREA/여아남아,26900,26900,0
2018-06-01,2011953405,C013040,청바지,[[크리스크리스티]] (KCXDLTM2419) 에어 도트 프린트 셋업KCXDLTM2419,26700,22170,-4530
2018-06-01,261526882,C013010,점퍼,[바비앤펌킨][바비앤펌킨] 딸기초콜렛 무스탕점퍼,138000,124200,-13800
2018-06-01,222343175,C012040,여자학생복,KD 크리에아숄 Y 원피스,79700,79700,0
2018-06-01,521065154,C014010,아동복,하라 HARA 여름신상입고 아동복/원피스/플라워/롱티,16900,16900,0
2018-06-01,1087434013,C012020,원피스,모직자켓 겨울자켓 자켓 JK08 WS 남자자켓 모직자켓 정장자켓 겨울자켓 자켓,173930,154800,-19130
2018-06-01,620832013,C014010,아동복,[BEANPOLE KIDS] 화이트 피크닉 한줌 바람막이 (BI8339U011),118000,112100,-5900
2018-06-01,2061759914,E021010,침구,겨울왕국 면기모 패드 - 뷰티선샤인 (064187) 패드 까,64090,58380,-5710
2018-06-01,1362003568,F012010,종이기저귀,폴맘오버나이트26px4팩/굿나이트/하기스 기저귀,51900,51900,0
2018-06-01,1252372305,C011030,남자학생복,국산 냉풍조끼/배터리형/쿨링/조끼/바람/여름/작업복,183900,174710,-9190
2018-06-01,1196741462,C021040,실내화,20 할인 벤시몽 18SS_여성용 라셋_6종 택 HTSO8G400EE,25590,25590,0
2018-06-01,398700160,C013020,티셔츠,[밀스튜디오] 583꽃 포켓 티셔츠 (SD517Q220),16000,16000,0
2018-06-01,770752034,C014010,아동복,엘사 루비 소피아 시크릿쥬쥬 번개걸 콩순이/원피스,23900,23900,0
2018-06-01,1003645104,A017220,양파,꼬레촌조미 파(흙대파)최상품 1kg/5단,19400,19400,0
2018-06-01,430604206,E041020,컵,도자기 커피잔세트-머크컵/찻잔/머그잔/선물,22500,21800,-700
2018-06-01,1717944801,C011030,남자학생복,[레노마_셔츠(남성)]18신상 봄맞이 비지니스셔츠 19종택1RISSG0030B,30000,24000,-6000
2018-06-01,1135088214,E041070,밀폐용기,락앤락 트위스트 투웨이 용기 7종 밀폐용기 씨리얼,5900,5430,-470
2018-06-01,1104368550,A013170,생선통조림,유동 번데기캔 130g X 48EA_1BOX 맛있는번데기통조림,63300,62040,-1260
2018-06-01,2007868893,C013020,티셔츠,여름 신상 롱티/원피스 빅사이즈 여성의류 허밍퍼플,9700,9700,0
2018-06-01,1437004325,E061010,세탁세제,CJ라이온 바르는 비트 220ml 3개 얼룩제거 찌든때 부,12760,12760,0
2018-06-01,798841275,E031050,냉장고,정품 사은품증정 딤채스탠드형김치냉장고EDQ57BFRMT,2177080,2090000,-87080
2018-06-01,1753594098,E011030,거실장,마켓비 TEMBO 500 수납테이블 KS1028TB/1,57100,57100,0
2018-06-01,1753594097,E011030,거실장,마켓비 TEMBO 400 수납테이블 KS1028TB/2,49500,49500,0
2018-06-01,249926826,E041010,식기,아키 면기 공기 대접 라면그릇 우동기 식기 그릇세트,1600,1470,-130
2018-06-01,1656326985,C012060,여자내의,난닝구 드펀 밴딩팬츠/ 난닝구,17900,17370,-530
2018-06-01,413056807,E061030,전구,작업등 국내산 야간용 차량용 캠핑용 캠핑용품 조명,6300,6300,0
2018-06-01,818822233,F012050,의료측정기,브라운 체온계 IRT-6520 IRT-6510 IRT-6030 /굿,70000,70000,0
2018-06-01,346763003,C012040,여자학생복,44~99/국산 롱 셔츠 여자남방 체크남방 청남방 사은품,15800,15800,0
2018-06-01,1753594099,E011030,거실장,마켓비 TETOS 소파테이블 550646,37700,37700,0
2018-06-01,506130416,C014010,아동복,밀리밤 자수블라우스MLBW18650,19900,19900,0
2018-06-01,1293891337,C012060,여자내의,시원한 냉장고면 큐롯팬츠 숏팬츠 치마바지 밴딩팬츠,8100,7700,-400
2018-06-01,1298028197,C013030,스웨터,MNT-912 (BIG SALE) 풀오버 스트라이프 하찌 니트 남,18500,18500,0
2018-06-01,362992496,E021010,침구,알러리스 가드닝 리프 이불세트 Q 색상택1/ 한샘,89900,87210,-2690
2018-06-01,1955215438,L021050,우산,먹는게아니에요~ 바나나우산 아이디어우산 디자인우산,6400,5400,-1000
2018-06-01,392962687,C013050,운동복,차량용 와인 미니트렁크콘솔 차량트렁크콘솔 트렁크미,25600,23330,-2270
2018-06-01,1742348806,F012020,생리대,시크릿데이 생리대 러브 일반 팬티라이너20PX12팩,14500,13780,-720
2018-06-01,315249262,C012030,여자상의,에스닉롱원피스/오피스원피스/쉬폰원피스/프릴원피스,9900,9900,0
2018-06-01,1079266713,D031010,주택수선재료,숲으로에이스내부용 - 수성 벽지 친환경 항균 페인트,11900,11900,0
2018-06-01,949238026,A011070,혼식곡,[CJ직배송] 찰밀가루2.5kg x 6개 (총6개),21900,21900,0
2018-06-01,115533451,I031040,생화,현대모비스 크루저 루프백 승용 RV 캠핑백 루프캐리어,209000,190360,-18640
2018-06-01,1917599148,C013010,점퍼,빅사이즈 V배색터틀후드집업 TB1801 큰옷후드집업 큰,69020,61430,-7590
2018-06-01,1714329621,E021010,침구,시원한 여름이불+패드+베개 풀세트/토퍼세트,49900,49900,0
2018-06-01,1749926217,F012020,생리대,생리대/순수 중형18매X4팩/소형/중형/대형/오버나이트,10000,9900,-100
2018-06-01,1153569518,A019090,카레,청정원 카레여왕 7종 골라담기,1150,1150,0
2018-06-01,1446411985,A021010,커피,린저헤즐넛 커피믹스 1kg/믹스커피/커피믹스/자판기,5950,5600,-350
2018-06-01,123372224,I031010,장난감,레고10698 클래식 라지 조립 박스/클래식/빠른배송,60900,54810,-6090
2018-06-01,684850877,F011150,건강기능식품,[파마젠] [파마젠] 울트라원 종합 멀티 비타민/100가지 원료,29900,29900,0
2018-06-01,1242712175,C013020,티셔츠,[무료배송]빅사이즈 DMK00192 포근한 램브 후드티 802,32150,32150,0
2018-06-01,277188873,E061050,청소용세제,레몬허브쏙쏙2.5L 락스 욕실 화장실 청소 락스와세제,3600,3600,0
2018-06-01,2100208648,L021010,손목시계,마크제이콥스시계 MBM3103 MBM3121 MBM3179 남성시계,138000,138000,0
2018-06-01,1155724137,L021060,유모차,***스마트베베 콤보유모차*** 컴팩트형+본사직송,63000,63000,0
2018-06-01,204273946,A012030,돼지고기,에스푸드 불고기탑핑 1kg 10개,220560,213950,-6610
2018-06-01,34127234,F012010,종이기저귀,군(GOO.N) 마시멜로 밴드/팬티형 x 3팩 행사,42900,42900,0
2018-06-01,1753594074,E011030,거실장,마켓비 JUSTIN 사이드테이블,85200,85200,0
2018-06-01,1913622854,C011030,남자학생복,[퍼스트레인] 1st Lane Floria 여성롱가디건/버튼가디건/여성베스트/롱니트/브이넥가디,49800,24900,-24900
2018-06-01,1753594073,E011030,거실장,마켓비 FRITA 커피테이블 650390,160600,160600,0
2018-06-01,14501427,C013010,점퍼,신상 바람막이 점퍼/남자 남성 등산 윈드 아웃도어,30800,29800,-1000
2018-06-01,1126347413,E021020,커튼,벌집블라인드 베이지 호프발스 120x155 cm/ 롤스크린,63870,56850,-7020
2018-06-01,1572435876,A011170,떡,특허받은맛 아리울 떡 공방 굳지않는 모듬 꿀 떡,7800,7800,0
2018-06-01,534354738,C012060,여자내의,[루코루코]EL2 팬츠 2color(RSC4PT006),26000,24700,-1300
2018-06-01,1216707574,A016060,감,달콤샤르르 자연그대로 만든 아이스 홍시 30개(컵)/개,42920,38630,-4290
2018-06-01,242981248,E011050,책상,LFM 스터디책상-독서테이블 키높은책상 수상용책상,65000,64350,-650
2018-06-01,300541012,C012040,여자학생복,[모다아울렛][막스카라]쉬폰브라우스M82QWB343MEG1,89000,80100,-8900
2018-06-01,404795948,A021020,차,휘핑 프리마 (액상 동서 1Ll) X6,43870,39050,-4820
2018-06-01,1574303276,C013040,청바지,킨록 18년 S/S 슬림 핏 신축성 슬렉스 6종 EVP777(md2951),49000,40670,-8330
2018-06-01,919266032,I031010,장난감,굿베이비 전동오토바이(21352)-엘로우,237650,232900,-4750
2018-06-01,500078213,C012020,원피스,[시에로][18S/S]레이스 피그먼트워싱 점퍼(SE3JPF095)[갤러리아],299000,230230,-68770
2018-06-01,2036822219,L012010,면도기,도루코 페이스 6중날 휴대용 면도기 10개입,11700,11700,0
2018-06-01,784544408,A019060,된장,청정원 조개 멸치 된장(450G),5750,5750,0
2018-06-01,1679891226,A011100,라면,맛있는납작당면14kg/자른당면 당면 넙죽이당면 찜닭용,32000,32000,0
2018-06-01,1889050465,A018030,껌,자일리톨껌 알파 파워민트 낱개150개/츄잉껌/졸음껌,10900,10900,0
2018-06-01,1517591632,F011150,건강기능식품,락토핏 생유산균 베베/키즈/60포/2달분/아기유산균,21800,21800,0
2018-06-01,1816423558,C015020,모자,블럭 스냅백 패션 브릭모자 볼캡 피규어 힙합모자,7900,7900,0
2018-06-01,1753594069,E011030,거실장,마켓비 NETUD 원목수납테이블 50x50 아카시아,60300,60300,0
2018-06-01,1465265607,I012060,저장장치,YK 커세어 K70 RAPIDFIRE 회축 기계식 키보드,188050,175000,-13050
2018-06-01,546085777,I031010,장난감,스텝2 사파리웨곤 new 대형완구 유아동붕붕카 아기자,597080,597080,0
2018-06-01,1768266238,C013040,청바지,빅사이즈민짱/예쁜핏 청바지모음/신상/구제진,28900,28900,0
2018-06-01,898395096,A016060,감,참외(3~6입/봉),9900,5990,-3910
2018-06-01,1240809561,E011020,침대,[삼익가구]카렌 가죽헤드 트윈 모션베드(메모리폼 매트리스-킹),2022800,1820520,-202280
2018-06-01,514818418,E061050,청소용세제,[힐링세일!!]글루팡 곰팡이제거제+붓증정/벽지곰팡이,13800,11730,-2070
2018-06-01,657894788,F012010,종이기저귀,[리베로]리베로기저귀 팬티형6단계 40매 4팩,73900,70210,-3690
2018-06-01,1667669540,A022050,탄산음료,[산펠레그리노] 산펠레그리노 아란시아타 오렌지 200mlx24병,29490,29490,0
2018-06-01,2055740150,C021040,실내화,로얄 컴플릿 REEBOK ROYAL COMPLETE2 (CN7429)/ 리복,44000,36080,-7920
2018-06-01,1753594072,E011030,거실장,마켓비 CARINO 500 사이드테이블,33400,33400,0
2018-06-01,1753594071,E011030,거실장,마켓비 DUGED 사이드테이블 KS1032TB,21500,21500,0
2018-06-01,657894785,F012010,종이기저귀,[리베로]리베로기저귀 밴드형6단계 52매 4팩,73900,70210,-3690
2018-06-01,1753594070,E011030,거실장,마켓비 FLENCE 460 사이드테이블,17200,17200,0
2018-06-01,1142417525,C013020,티셔츠,데일리앤 여름 기본티 무지티 슬라브티 레터링티,9800,9800,0
2018-06-01,2030038325,A011010,쌀,국내산 유기농 현미 100% 미강/쌀눈/쌀겨가루 500g,4000,4000,0
2018-06-01,2047665811,A018080,설탕,유기농 비정제설탕/유기농 마스코바도설탕 3kg,15000,15000,0
2018-06-01,753167738,L012090,기초화장품,오늘발송 2018년 신상 설화수 자음 2종 세트 윤조탄력,79900,79900,0
2018-06-01,1818834804,L021020,장신구,1부6리 다이아반지/0.16ct/14K골드/diamond ring,240000,240000,0
2018-06-01,1724888109,L021020,장신구,14k남성반지/곡선라인/예물로도굳/4731,189000,189000,0
2018-06-01,622219076,L012030,칫솔,페리오 이지클리닉 AD 칫솔 10입 x 2개 (택일),9900,9900,0
2018-06-01,2018788102,E061050,청소용세제,아스토니쉬 곰팡이제거 클리너 / 욕실곰팡이 제거,12800,12800,0
2018-06-01,906008848,C013010,점퍼,[JR주니어] 골지후드집업(핑크_네이비_레드_블랙),13900,9730,-4170
2018-06-01,1857942484,A012040,닭고기,하림 IFF 닭가슴살 1kg 5봉,35900,35900,0
2018-06-01,484173470,A016020,배,신안 명품(名品) 압해 배 7.5kg(8~9과),55000,48400,-6600
2018-06-01,2091093684,C013010,점퍼,[더데이걸]소매슬릿 후드 롱티,19900,19900,0
2018-06-01,2005504336,A018060,스낵과자,노래방 새우깡 400g x 6봉 과자/스낵,18900,18900,0
2018-06-01,1152291414,A018050,비스킷,과자/스낵/비스켓/캔디/껌/젤리/사탕/초콜릿/간식나라,2100,2100,0
2018-06-01,28787454,C013020,티셔츠,[크루클린] TRS-211 레이어드 후드반팔 티셔츠,24800,21080,-3720
2018-06-01,1778565620,L021010,손목시계,[바보사랑]JA-869 가죽시계,30240,30240,0
2018-06-01,113268552,A017140,콩나물,도라지가루 200g 길경 길경가루 도라지즙 도라지효능,15560,15100,-460
2018-06-01,1778565624,L021010,손목시계,[바보사랑]JA-881 메탈시계,41760,41760,0
2018-06-01,1778565622,L021010,손목시계,[바보사랑]JA-879 메탈시계,36000,36000,0
2018-06-01,2039802221,C012030,여자상의,나시원피스/아이스쿨원피스/비치원피스/스모크원피스,6900,6900,0
2018-06-01,1778565627,L021010,손목시계,[바보사랑]JA-883 메탈시계,41400,41400,0
2018-06-01,451150301,A015010,참기름,해정원 참진한 기름1.8L2개 기름 참진한기름 해정원참,45810,41230,-4580
2018-06-01,1939184923,E061020,섬유유연제,F C 베이비전용 세탁세제 refill 유아세탁세제 유아세,22480,22480,0
2018-06-01,1778565626,L021010,손목시계,[바보사랑]JA-882 가죽시계,26640,26640,0
2018-06-01,188049084,A017110,감자,[초특가/무배] 깨끗하고 싱싱한 세척당근 / 5kg 10kg,11000,9800,-1200
2018-06-01,1395612148,C013010,점퍼,레이딘 후리스 집업점퍼 S~3XL STLD-6628/후드집업점,46200,43890,-2310
2018-06-01,1104381591,A019090,카레,카리야 2종 포크카레/치킨카레/하우스카레/보노스프,1690,1690,0
2018-06-01,532350393,C013010,점퍼,핸드메이드 스타일엔터 B3 메리노베이비 무스탕자켓 남자무스탕점퍼(주문제작),960000,960000,0
2018-06-01,1089272878,I031070,애완동물관리비,당구장갑/당구공/당구용품/모리팁/당구큐대/개인큐대,9800,8680,-1120
2018-06-01,1158547793,L021050,우산,[뉴엔] 튼튼한 접이식 3단 자동우산 예쁜 양산 장우산 우양산,14900,14900,0
2018-06-01,988121805,A022030,생수,초L)지리산수 1L,450,400,-50
2018-06-01,2002656159,A011130,시리얼,프리믹스 웨이브파우더(태원 5K)X4 파우다 분말믹스,66930,66930,0
2018-06-01,270277051,I031010,장난감,플레이그로 목욕놀이 회전튜브(182247) 베이비목욕완,18930,18930,0
2018-06-01,1717080853,A011160,빵,미니찐빵/호빵/2.4kg 100개입 (개당 99원),9900,9900,0
2018-06-01,562057450,C013050,운동복,스마트 성에제거기_1537 휴대용성에제거기 차량성에제,7770,7090,-680
2018-06-01,1753594038,E011030,거실장,마켓비 PEMBA 좌식 테이블 6046H,64600,64600,0
2018-06-01,1753594037,E011030,거실장,마켓비 NAPLES 커피테이블 980320,87500,87500,0
2018-06-01,1373143634,E041020,컵,심플화이트 커피잔세트 모음 에스프레소잔 라떼잔,1500,1430,-70
2018-06-01,927176418,C013020,티셔츠,아디다스 나이키 반바지 반팔티 반티 축구유니폼 라운,15000,14700,-300
2018-06-01,1444308177,A017280,김,일가집 김밥용 치자 단무지 240g X 20EA_1BOX 김밥만,62460,62460,0
2018-06-01,1240799718,C013020,티셔츠,아스토레 골프 반집업티셔츠 ORG LSTM10031 여성골프,78370,78370,0
2018-06-01,1688201540,A013040,고등어,공식 이동삼 간고등어 국산 고등어 330g 500g 700g,21000,20000,-1000
2018-06-01,1957580956,C013040,청바지,난닝구 래디스 컷팅팬츠/ 난닝구,17900,17370,-530
2018-06-01,2107720690,E031130,보온매트,new2018년형 일월매트 카페트매트/전기장판/전기매트,114000,109000,-5000
2018-06-01,1753594036,E011030,거실장,마켓비 PAPAGENO 커피테이블 600,78600,78600,0
2018-06-01,1482048964,L012060,샴푸,올뉴 TS 샴푸 1000g/올뉴 TS 트리트먼트,37800,37800,0
2018-06-01,364774378,L012110,색조화장품,포피네 데일리 선스틱 18g 1개,6490,6490,0
2018-06-01,896780611,A019010,고춧가루,[하선정]하선정 까나리 액젓 (2.5KG),11690,11690,0
2018-06-01,896780612,A019010,고춧가루,[CJ]CJ 하선정 멸치액젓 (2.5kg),11790,11790,0
2018-06-01,410473520,C012040,여자학생복,보트넥 스트라이프 오버핏니트 ATTS8B603/ 앳코너,39200,33320,-5880
2018-06-01,106527739,I011010,TV,인켈 TV 65인치TV UHD LEDTV 삼성패널 돌비24W 설치,830520,789000,-41520
2018-06-01,1114256715,C014010,아동복,[펠릭스키즈]다르앤가 프릴 티셔츠 FXRA65N3,3800,3800,0
2018-06-01,204682632,C014010,아동복,토미힐피거 남아동 70-75 여성 90 적당 라운드/D03,19000,18810,-190
2018-06-01,2054032724,I031040,생화,(다양한~종류/사이즈)홍진/듀플렉스~버그킬러/벌레~모기~해충퇴치기/포충기/HJ-4W/HJ-,25400,22900,-2500
2018-06-01,895800237,L012090,기초화장품,[존슨&존슨]존슨앤존슨 베이비 울트라케어 로션 500ML,14900,14900,0
2018-06-01,895800236,L012090,기초화장품,[존슨&존슨]존슨앤존슨 베이비 레귤러 오일 300ML,8900,8900,0
2018-06-01,1199924780,C013010,점퍼,남자 바람막이 점퍼 블루종 잠바 바람부는날 입기 좋,34700,34700,0
2018-06-01,1076142122,C013010,점퍼,~2XL 인기 남자여름자켓/린넨자켓/마자켓/체크자켓,33800,32800,-1000
2018-06-01,288948180,A017280,김,사천 짜사이 1kg /짜차이/짜샤이/무장아찌/무절임/,1800,1800,0
2018-06-01,640833140,E061010,세탁세제,[애경]울샴푸아웃도어 1000ml리필 x3개(리큐300ml증정),13800,13800,0
2018-06-01,2003599581,C021040,실내화,[리복]벌사펌프 퓨리 SYN CS CN0013,44250,38500,-5750
2018-06-01,1298004148,C013030,스웨터,MNT-047 배색컬러 유니크 패턴 라운드 니트 니트티 남,49700,49700,0
2018-06-01,2030256484,A017200,토마토,가지 특 3개 / 국내산,6450,6450,0
2018-06-01,1853937121,C013010,점퍼,여름신상 여성자켓 린넨자켓 체크자켓 롱자켓 청자켓,31800,31800,0
2018-06-01,1778590605,L021020,장신구,[바보사랑]GOLD BAR NEC,27000,27000,0
2018-06-01,1778590606,L021020,장신구,[바보사랑]H&NOPE NEC,23000,23000,0
2018-06-01,1778565653,L021010,손목시계,[바보사랑]JA-885 가죽시계,28440,28440,0
2018-06-01,1778565650,L021010,손목시계,[바보사랑]JA-884 가죽시계,29520,29520,0
2018-06-01,1154881268,C012060,여자내의,[만원이상무료]신상추가 슬랙스/트레이닝바지/42C1,6900,6900,0
2018-06-01,1778565656,L021010,손목시계,[바보사랑]JA-908 가죽시계,27720,27720,0
2018-06-01,300626421,C012040,여자학생복,[쉬즈미스][쉬즈미스] 세트인 포켓 사이드 슬릿 가디건_SSKCDI11010_BK,69000,58650,-10350
2018-06-01,1033160084,I053030,복사용지,HP A4 복사용지(A4용지) 80g 2500매 2BOX/더블에이,38950,33500,-5450
2018-06-01,1778565654,L021010,손목시계,[바보사랑]JA-904 메탈시계,39780,39780,0
2018-06-01,505600949,F012020,생리대,{비교불가특가}바디피트 귀애랑/중형 18PX10팩/생리대,28500,28500,0
2018-06-01,1931537585,I031010,장난감,(중모)스카이콩콩 킥보드 트라이더 붕붕카 오토바이,27900,27900,0
2018-06-01,1778565658,L021010,손목시계,[바보사랑]JA-910 가죽시계,29160,29160,0
2018-06-01,563779442,C013010,점퍼,봄 여름용 고급 바람막이 블루종 항공점퍼 스트라이프,42800,42800,0
2018-06-01,1778565659,L021010,손목시계,[바보사랑]JA-911 가죽시계,22140,22140,0
2018-06-01,1158897640,I012060,저장장치,(이벤트) COX CK600 기계식 키보드 (갈축) 청축 적축,37760,35500,-2260
2018-06-01,535278166,L021020,장신구,가죽 팔찌 161-0362-B/ 에디포스,98000,93100,-4900
2018-06-01,1765278627,C013020,티셔츠,가로절개반팔티/박스티/빈티지/루즈핏티/펀칭티/커팅.,9900,9900,0
2018-06-01,471932605,C011030,남자학생복,탈부착후드집업 SM1711 면집업후드 후드 집업후디 컬,59080,59080,0
2018-06-01,283537320,C013050,운동복,키스포/무배/초등학생바지/주니어트레이닝복/단체복,6900,6900,0
2018-06-01,1686269169,F011150,건강기능식품,[큐원] 상쾌환 3gx10포/숙취해소제/최신제조상품/우체국택배,14900,14900,0
2018-06-01,1290577881,C013040,청바지,(SR)MHA700 남자기모빅사이즈스판기모본딩청바지 남자,47980,47980,0
2018-06-01,1749052855,C013050,운동복,(1+1 EVENT) 16ss 첨이첨이 블루힐링나시세트 슬럽사 유아동의류 아동의류 공용 상하,30000,30000,0
2018-06-01,1597208176,F011130,홍삼,정관장 레네세무설탕캔디수(180G),12000,12000,0
2018-06-01,894501514,C013010,점퍼,[인터페이스]보온성까지 갖춘 봄자켓 항공점퍼/바람막,23700,23700,0
2018-06-01,2006480391,C013010,점퍼,[고스트리퍼블릭]고스트리퍼블릭 GHZ-435 후리스 후드집업,36900,35060,-1840
2018-06-01,1672563192,E061080,키친타월,el 고급형 요술행주 10개 1박스 일회용행주 압축행주,3470,3470,0
2018-06-01,1789668750,F012020,생리대,NEW 템포 레귤러 10매x3박스+슈퍼10매x2박스(총50매)/ 템포,17900,16830,-1070
2018-06-01,86845040,A022010,주스,내사랑 드링크(포도 185mlX24팩),8900,8900,0
2018-06-01,675085297,L021030,가방,고급형 노트북 파우치 가방 11인치/13인치/15인치,7900,7900,0
2018-06-01,1130096271,C013010,점퍼,MJ-1059 (겨울신상) 원 컬러 카키 심플 패딩 (95-110),104100,92650,-11450
2018-06-01,1986525784,E061010,세탁세제,신제품 액츠 파워젤 14L/세제/섬유유연제/액체세제/리큐/드럼겸용/펌프별도구매,23900,23900,0
2018-06-01,379184355,C012040,여자학생복,플라워 비즈장식 가디건 MRBAKC5260/ 미니멈,149000,131120,-17880
2018-06-01,340817337,E061020,섬유유연제,(NEW)다우니 퍼퓸 아로마쥬얼 480g 데오도라이저 480g,9900,9900,0
2018-06-01,464894889,C011020,남자상의,MT-220 여름-초가을 패피 싱글수트 (M-2XL) 블루 투버,200640,200640,0
2018-06-01,18682197,A011030,찹쌀,보리 엿기름 가루 엿질금 식혜 고추장재료 메주가루,3500,3400,-100
2018-06-01,2110987953,A011050,콩,[가온애]알땅콩 1kg 볶음땅콩 땅콩분태 분태땅콩 땅콩,6900,6900,0
2018-06-01,1074561033,E021010,침구,사계절 디자인침구 이불커버 단품/매트커버/누빔패드,24900,24900,0
2018-06-01,1657420517,E011010,장롱,[에인하우스] 다양한 컬러구성의 장롱 모음,79900,79900,0
2018-06-01,989999597,A012060,햄및베이컨,CJ 스팸마일드 200G*3,11950,11950,0
2018-06-01,1241820397,A019180,즉석식품,올반 육즙가득새우왕교자 455gX3개 + 당면만두(20개),18900,18900,0
2018-06-01,1786050185,F012010,종이기저귀,국내/빠른배송) 미국산 팸퍼스 스와들러 6단계 기저귀,75900,75900,0
2018-06-01,561853845,C012040,여자학생복,[모다아울렛][크로커다일레이디스]린넨혼방소재 기본 가디건(CL8MSW102),59500,56530,-2970
2018-06-01,983096832,E011020,침대,앨리스 싱글침대/데이베드/소파베드/철재/아동/아기/,117000,109000,-8000
2018-06-01,895863847,A019070,양념소스,[청정원]청정원 소갈비 양념장 280g,2300,2300,0
2018-06-01,2131516304,A013130,오징어채,신선한국내가공 일미/진미채 300g 쥐포채 오징어채,5000,5000,0
2018-06-01,2093467951,C012060,여자내의,[반에이크]린넨 랩 스커트J(V75SKM402Z),35800,32220,-3580
2018-06-01,451149343,A019010,고춧가루,가을 특 한식 고추가루 2.5kg2개 가루 고추가루 한식,106520,95870,-10650
2018-06-01,685730673,A022050,탄산음료,캔음료 레쓰비 콜라 사이다 제주감귤 음료수 캔커피,5800,5800,0
2018-06-01,300626446,C012040,여자학생복,[쉬즈미스][쉬즈미스] 세트인 포켓 사이드 슬릿 가디건_SSKCDI11010_GN,69000,58650,-10350
2018-06-01,73878916,E061030,전구,금호전기 고효율 LED형광등/LED램프/LED조명/안전기,20900,20900,0
2018-06-01,1143961942,E061030,전구,필립스 LED전구 램프 PAR30 볼전구 촛대 MR 볼구 파,1260,1140,-120
2018-06-01,1810528523,L021060,유모차,분리 결합형 세쌍둥이 유모차 휴대용 티크듀오 유모차,220000,220000,0
2018-06-01,2141524219,F012050,의료측정기,오므론 블루투스 혈압계 HEM-7280T+수첩 혈압측정기,141000,128800,-12200
2018-06-01,300626449,C012040,여자학생복,[쉬즈미스][쉬즈미스] 세트인 포켓 사이드 슬릿 가디건_SSKCDI11010_BE,69000,58650,-10350
2018-06-01,1515867547,A011120,두부,코리원/이든타운 유기농 오트밀 퀵롤드 오츠 1kg/귀리,6000,5900,-100
2018-06-01,1500064289,A018050,비스킷,로투스 50Px6개 1p300개 싱글팩비스킷 커피과자312.5g,15900,15900,0
2018-06-01,1778565682,L021010,손목시계,[바보사랑]JA-912 가죽시계,31680,31680,0
2018-06-01,1778565686,L021020,장신구,[바보사랑]Silver Bell 반지,25900,25900,0
2018-06-01,1501159484,C011050,남자내의,(평화)(여파자마9부)면100% 다양한무늬 여성9부파자마,8740,7780,-960
2018-06-01,1982210247,A013010,갈치,제주어멍 제주은갈치 150gX7마리 /(참고) 갈치 은갈치,75800,66710,-9090
2018-06-01,38717000,G011070,자전거,샤샤 미니벨로 접이식 자전거 20형 7단,147000,135240,-11760
2018-06-01,1778565684,L021010,손목시계,[바보사랑]JA-913 메탈시계,67680,67680,0
2018-06-01,344868037,A011040,보리쌀,검정강낭콩 2kg/흰강낭콩/검은콩/검정강낭콩,8200,8200,0
2018-06-01,1778565689,L021020,장신구,[바보사랑]925실버 & 천연 터키석 반지,19900,19900,0
2018-06-01,765018934,C013010,점퍼,인기신상 사파리 야상 린넨자켓 여름가디건 특가모음,22900,22400,-500
2018-06-01,1181574158,I031040,생화,버팔로 더블 뉴 와이드 캠핑체어(2P)/접이식 캠핑의자,40400,34540,-5860
2018-06-01,895863822,A019070,양념소스,[청정원]청정원 소불고기 양념장 280g,2300,2300,0
2018-06-01,386491857,E021020,커튼,압축커튼봉 22mm 130x240,19200,19200,0
2018-06-01,1259484095,A011040,보리쌀,흰강낭콩 500g+500g/ 렌틸콩 병아리콩 1+1모음,4500,4500,0
2018-06-01,1778590645,L021020,장신구,[바보사랑]RING TASSEL EARRING,49000,49000,0
2018-06-01,1778590643,L021020,장신구,[바보사랑]CHAIN PEARL RING,45000,45000,0
2018-06-01,1778590644,L021020,장신구,[바보사랑]CHAIN PEARL CHOKER,67000,67000,0
2018-06-01,868423572,C011030,남자학생복,[앤듀O172SH160P 남성)린넨 배색절개SH,19000,16720,-2280
2018-06-01,98770193,E011020,침대,현대돌침대/1022S(싱글)/통원목/돌/흙침대파격세일,649000,649000,0
2018-06-01,1136510702,C013050,운동복,카본 범퍼윙 가드 대 중 소 중 택1 차량용범퍼가드 가,20010,18230,-1780
2018-06-01,1084857710,A019080,고추장,[사조해표]해표 순창궁 태양초고추장 6.5kg x2,20900,20900,0
2018-06-01,86845039,A022010,주스,웅진 자연은 140일 포도주스 1.5L X 4페트/쥬스/음료,10900,10900,0
2018-06-01,1779193521,E031070,에어컨,[하이마트] 후지마루 박스팬 FJ-105SP [3엽 / 25cm],36300,36300,0
2018-06-01,1049221791,E031110,청소기,SK매직 싸이클론 진공청소기 VCL-A300,67900,67900,0
2018-06-01,507298591,C012020,원피스,[나인(NAIN)]빅 카라 핸드메이드 코트(CT-919)(대구신세계),221400,204030,-17370
2018-06-01,1625616702,E041070,밀폐용기,베이직 핸디 스텐밀폐용기 스텐김치통 스텐통 밀폐,15000,13800,-1200
2018-06-01,1053057795,G011070,자전거,2018년 접이식자전거 하이브리드 자전거,129000,118680,-10320
2018-06-01,1851795581,F012010,종이기저귀,군기저귀 밴드형 L 대형 54매 1팩,14000,14000,0
2018-06-01,1804356818,L021020,장신구,[바보사랑]데일리 귀걸이 6종 세트 20번,6320,6320,0
2018-06-01,1804356819,L021020,장신구,[바보사랑]데일리 귀걸이 6종 세트 17번,6320,6320,0
2018-06-01,1804356816,L021020,장신구,[바보사랑]데일리 귀걸이 6종 세트 18번,6320,6320,0
2018-06-01,1942437298,A018070,파이,[무료배송]롯데 초코파이 오예스 마가렛트 파이모음전,15900,15900,0
2018-06-01,1804356817,L021020,장신구,[바보사랑]데일리 귀걸이 6종 세트 19번,6320,6320,0
2018-06-01,1804356814,L021020,장신구,[바보사랑]골드 레이스 드롭귀걸이,9520,9520,0
2018-06-01,1695686137,C011030,남자학생복,남자 오버핏 가디건 루즈핏 롱가디건 니트 겨울,29800,26800,-3000
2018-06-01,2117030989,C013050,운동복,3M 광택 스폰지 패드 3725 1SET 2EA/3m광택/3m패드/,41460,37770,-3690
2018-06-01,1804356815,L021020,장신구,[바보사랑]핸드메이드 드롭 크리스탈 귀걸이,11920,11920,0
2018-06-01,1804356813,L021020,장신구,[바보사랑]찰랑 롱드롭 은침귀걸이,9520,9520,0
2018-06-01,511869949,E061060,살충제,바퀴헌터 끈끈이 100개입 보행해충 끈끈이 왕바퀴벌레,40520,40520,0
2018-06-01,441154347,A011170,떡,(냉장)평화 쌀떡1.4kgx3개,17590,17590,0
2018-06-01,1778590543,L021020,장신구,[바보사랑]NON NONE LOVE NEC (ORANGE),25000,25000,0
2018-06-01,1010232239,A013160,맛살,동원 실속맛살 500G,1990,1990,0
2018-06-01,1653439121,C013050,운동복,유럽형 스프레이 강화액소화기 /대용량 차량용 가정용,20000,18000,-2000
2018-06-01,451176410,A015010,참기름,신비로 진성맛기름1.8L2개 맛기름 진성맛기름 신비로,30260,27240,-3020
2018-06-01,1155521047,C013010,점퍼,[에어워크]바람막이/윈드자켓/아웃도어자켓/골프웨어,40800,32800,-8000
2018-06-01,2061322383,C012020,원피스,[미니멈][MINIMUM]천연모피퍼 모혼방 밸티드 롱코트 MRDGWL0990-BK,479000,455050,-23950
2018-06-01,2037899476,A016100,수박,당도선별 완주 정품 하우스수박 7kg/8kg 우체국배송,15900,15900,0
2018-06-01,451979735,C013010,점퍼,심플 항공점퍼,43930,43930,0
2018-06-01,1187400878,I011020,영상음향기기,비비텍 BX565   BW566 밝기4000 빔프로젝터 프로젝터,670000,535900,-134100
2018-06-01,911969031,A013170,생선통조림,동원참치 살코기 150g/반찬통 증정/사조/롯데/양반죽,1780,1780,0
2018-06-01,2108467276,C013010,점퍼,DBG1160 포베 하프 점퍼 802S 아웃도어코트 모직코트,108260,108260,0
2018-06-01,1385320817,C014010,아동복,[BEANPOLE KIDS] 블루 고래 친구 티셔츠 (BI8542B03P),58000,55100,-2900
2018-06-01,1778590546,L021020,장신구,[바보사랑]NON NONE SMILE NEC (BLUE),25000,25000,0
2018-06-01,1778590547,L021020,장신구,[바보사랑]DOLLAR NEC (SKY),25000,25000,0
2018-06-01,1778590544,L021020,장신구,[바보사랑]NON NONE LOVE NEC (ODD EYE),25000,25000,0
2018-06-01,1778590545,L021020,장신구,[바보사랑]NON NONE SMILE NEC (EMERALD),25000,25000,0
2018-06-01,1778565590,L021010,손목시계,[바보사랑]JA-860 가죽시계,30240,30240,0
2018-06-01,303038930,A015020,식용유,카놀라유500ml(5입)/식용유 카놀라유 올리브유 참기름,10900,10900,0
2018-06-01,1778590548,L021020,장신구,[바보사랑]DOLLAR NEC (RED),25000,25000,0
2018-06-01,1778590549,L021020,장신구,[바보사랑][액세서리키친] 925실버 리본타이 가죽쵸커,21900,21900,0
2018-06-01,1017594095,I031010,장난감,(여름물놀이용) 비치발리볼 캐치볼 네오프랜라켓세트,6900,6900,0
2018-06-01,409038093,C012040,여자학생복,[리안뉴욕]W 리안뉴욕 플리츠5부블라우스 MEWBL930IVF,39000,36270,-2730
2018-06-01,1436077631,C013020,티셔츠,[피그먼트] 봉쥬 레터링 반팔티셔츠,18000,15660,-2340
2018-06-01,1778565594,L021010,손목시계,[바보사랑]JA-875 가죽시계,27000,27000,0
2018-06-01,2065760942,A011160,빵,[삼립]무료배송/아침미소식빵5봉/토스트앤샌드위치,11500,11500,0
2018-06-01,1778565592,L021010,손목시계,[바보사랑]JA-864 가죽시계,29160,29160,0
2018-06-01,2029312185,C012060,여자내의,난닝구 인스텐 와이드밴딩팬츠/ 난닝구,15000,14550,-450
2018-06-01,1778565597,L021010,손목시계,[바보사랑]JA-878 메탈시계,46440,46440,0
2018-06-01,788390091,C013020,티셔츠,[갖고파]후드티/롱티셔츠/루즈핏/봄신상/무지티/여성,10000,7900,-2100
2018-06-01,238414516,C013020,티셔츠,[키키제제]여아 티셔츠/반팔티/가디건/남방/블라우스,10900,10900,0
2018-06-01,1778565596,L021010,손목시계,[바보사랑]JA-877 가죽시계,28440,28440,0
2018-06-01,1226448215,F012010,종이기저귀,[군] 군(GOO.N)슬림앤드라이 밴드 기저귀 대형(L) 32Px3팩,28900,28900,0
2018-06-01,732536174,A015010,참기름,오뚜기 옛날 참기름 500ml / 백설 진한 참기름 500ml,4100,4100,0
2018-06-01,123746850,C013050,운동복,LED휴대용비상조명등F1인정품,11500,11500,0
2018-06-01,698801970,A019110,드레싱,청정원 오리엔탈 드레싱(325G),3000,3000,0
2018-06-01,925359991,A022050,탄산음료,탑씨 1.5L/콜라/오렌지/포도/파인/슬러시/음료수,11160,10500,-660
2018-06-01,50210587,C013050,운동복,VIP/컵홀더/사이드포켓/차량용컵홀더/자동차컵홀더,18000,15460,-2540
2018-06-01,1120078806,I053020,스케치북,퀄리아 작화지 9필드 500매/포 애니메이션용 켈리그라,12600,12600,0
2018-06-01,2000414297,A018020,사탕,[특가]멜랜드 2.3kg 대용량 사탕 /디저트캔디/업소용,9700,9700,0
2018-06-01,126986009,I031010,장난감,Step2 멜로디 지붕차 유아장난감 승용완구 타고다니는,227600,227600,0
2018-06-01,1855362063,E031020,가스레인지,[린나이][신세계강남]2구 인덕션 독일 SHOOT상판 EGO사IH/ 부스터 기능/ 슬라이드 터치,850000,766790,-83210
2018-06-01,2103129945,L021050,우산,일러스트 3단자동 5단 장우산 자외선차단 겸용 우산,11700,11700,0
2018-06-01,1745999969,E011070,식탁,루쏘퍼니쳐 인기 식탁세트/대리석/원목/2인용/4인용,94410,94410,0
2018-06-01,368239951,L021020,장신구,크림진주 귀걸이 2종선택 리본 큐빅 진주귀걸이 도금 악세사리 주얼리 쥬얼리 진주,15600,12600,-3000
2018-06-01,323867401,C013010,점퍼,FS 몬스터 RYU 야구점퍼 FS-131JKA1 티셔츠 후드티 몬,82370,82370,0
2018-06-01,1338586453,A019180,즉석식품,김말이 1Kg/튀김/간식/안주/간편,4500,4500,0
2018-06-01,1221509712,A022010,주스,필리핀 수입 프로푸드 열대과일 쥬스 250ml 5종中선택,1500,1480,-20
2018-06-01,811748363,C015020,모자,팀킨정품 볼캡 군모 야구모자 남자 여성 캡 남성 모자,6900,6900,0
2018-06-01,185265333,E051020,건전지,SONY 소니 급속 건전지충전기 4구 AA/AAA겸용 건전지,9900,9800,-100
2018-06-01,2145500387,I012010,컴퓨터,삼성 LG i5 i7 외 슬림 중고컴퓨터 윈도7 SSD옵션,199000,199000,0
2018-06-01,473226612,A018040,아이스크림,조안나5L 2통/3통/4통/라벨리딜리셔스5L아이스크림,29000,29000,0
2018-06-01,1778590550,L021020,장신구,[바보사랑][액세서리키친] 925실버 리본타이목걸이,19900,19900,0
2018-06-01,1626449295,E031010,전기밥솥,쿠쿠 전기 압력밥솥용 고무패킹 CCP-6/CCP-8/CCP-10,7500,7400,-100
2018-06-01,1686328195,F012010,종이기저귀,킨도 독일 프리미엄 기저귀 팬티형 5단계 (38매x4팩),61600,61600,0
2018-06-01,1778590551,L021020,장신구,[바보사랑][925실버] 미니큐빅나비 목걸이,29900,29900,0
2018-06-01,1778590552,L021020,장신구,[바보사랑][액세서리키친] 925실버 행운만가득 팔찌/목걸이 택1,19900,19900,0
2018-06-01,688311980,C011050,남자내의,(남자옷도매) DP-250 린넨마 ST팬츠 (S-XL) 진소라 일,31830,31830,0
2018-06-01,555977414,A012050,소시지,[클라식소세지]영국식 정통 고급 수제 소세지 17종류,2900,2900,0
2018-06-01,698801998,A019110,드레싱,청정원 참깨드레싱(300G),3000,3000,0
2018-06-01,765112850,A022050,탄산음료,코카콜라 300ml(PET) x24개,19900,19900,0
2018-06-01,650466534,E041020,컵,1+1 머그컵 & 티인퓨저 모음 /티타임/커피/차/거름망,4900,4900,0
2018-06-01,559970134,C012040,여자학생복,[쉬즈미스] 2018 SSKCDI20060 린넨 오픈 롱가디건,173600,138880,-34720
2018-06-01,279996925,A018080,설탕,참다움 에리스리톨 위드 스테비아 200g 1+1 총2병,18500,18500,0
2018-06-01,988953998,A011100,라면,초L 자른당면 300G,2990,2990,0
2018-06-01,1238400652,C011030,남자학생복,4XL 빅사이즈 반팔 셔츠 남방 헨리넥 린넨 체크 여름,9900,9900,0
2018-06-01,1172064069,C012060,여자내의,COMPAGNA 꼼빠니아 쿨 레이온 슬림 스트레이트 팬츠 4종,59900,52360,-7540
2018-06-01,2139932382,A013130,오징어채,[가온애] 땅콩 버터오징어 허니버터구이 진미채 버터,6700,6700,0
2018-06-01,1235363689,E031130,보온매트,(DO한일생명 183X270 거실매트13T 분리난방 한일생명,217020,217020,0
2018-06-01,1317140512,C011050,남자내의,JMM611-617 옆밴드링클프리남자슬렉스팬츠 남자하의,24750,24750,0
2018-06-01,1778590582,L021020,장신구,[바보사랑]EPOXY 5+,27000,27000,0
2018-06-01,1778590583,L021020,장신구,[바보사랑]SILVER BAR NEC,27000,27000,0
2018-06-01,1490642955,C013020,티셔츠,남자 반팔티 카라티셔츠/남성 반팔티 쿨 여름 폴로 PK,17800,16800,-1000
2018-06-01,1778590580,L021020,장신구,[바보사랑]EPOXY 2+,25000,25000,0
2018-06-01,1089233631,A013130,오징어채,진미 오징어채1kg 진미 식자재 오징어채 식품 식료품,51780,51780,0
2018-06-01,230723827,C013010,점퍼,써스데이아일랜드 (T182MJK138) 앞 요크 꽃자수 데님 슬림 자켓,239000,191200,-47800
2018-06-01,1778590581,L021020,장신구,[바보사랑]EPOXY 4+,27000,27000,0
2018-06-01,988096601,A019110,드레싱,요리하다 소갈비양념 135G,1480,1480,0
2018-06-01,988096602,A019110,드레싱,요리하다 골뱅이&비빔국수 양념 140G,1480,1480,0
2018-06-01,581250656,C013050,운동복,[LED 안전삼각대]야간주행 안전운전 구난용품 야간시인성 경광등 비상등 경고삼각대 안,13500,11960,-1540
2018-06-01,492720709,C013010,점퍼,[모니카룸] 썸머점퍼/ 모니카룸,56800,43170,-13630
2018-06-01,1354306221,C013020,티셔츠,심플 후드집업 LLTT0044 후드집업 트레이닝복,24820,24330,-490
2018-06-01,2079782327,E031130,보온매트,슈퍼싱글 COTTON 전기요(180 105) /(참고)전기매트 방,121700,103450,-18250
2018-06-01,1300950604,C013030,스웨터,[동대문] (색상 : 블랙 | 사이즈 : 2XL(110)) BIGWM,56200,56200,0
2018-06-01,876668651,F011150,건강기능식품,뉴트리라이트 암웨이 더블엑스 종합비타민,75000,75000,0
2018-06-01,567894947,A019180,즉석식품,[시중동일상품][파격특가] 비비고 사골곰탕500g 16봉,20400,20400,0
2018-06-01,532330901,C011030,남자학생복,트랜디 컬러 무지 포켓 반팔 셔츠 남자셔츠 남자반팔,24340,23610,-730
2018-06-01,381903146,C013010,점퍼,[SOUP]와펜탈부착 집업점퍼 SU5UJ33A[갤러리아],99000,79200,-19800
2018-06-01,631139118,C011030,남자학생복,패딩조끼 빅사이즈 LM302 305 빅사이즈,71880,69730,-2150
2018-06-01,925906315,E011050,책상,케이데스크 각도 높이조절 초등학생 어린이 책상,399000,359100,-39900
2018-06-01,385562424,C012030,여자상의,물결배색 원피스 MN2232M805 빅사이즈,41000,38540,-2460
2018-06-01,992474570,C012040,여자학생복,[해인즈]트임슬라브가디건여름가디건데일리룩,27800,26410,-1390
2018-06-01,100425123,C011050,남자내의,빅사이즈 여름신상 면바지/정장바지/청바지/스판바지,29800,29800,0
2018-06-01,236265140,A014040,발효유,프로스티보이 요원요거트파우더 요파이브요거트파우더,13500,13300,-200
2018-06-01,428808387,E011050,책상,써클 H형 책상 책장 재고정리 초특급 파격세일,48000,48000,0
2018-06-01,1252937350,F012020,생리대,시크릿데이 생리대 NEW 러브코튼 중형 16PX6팩/ 시크릿데이,17600,16550,-1050
2018-06-01,1778590575,L021020,장신구,[바보사랑][액세서리키친] 925실버 행운만가득 끈팔찌,15900,15900,0
2018-06-01,1778590576,L021020,장신구,[바보사랑]NOPE RNG,25000,25000,0
2018-06-01,1778590574,L021020,장신구,[바보사랑][액세서리키친] 925실버 플라워 팔찌/목걸이 택1,19900,19900,0
2018-06-01,1610439315,A014020,분유,[아이배냇]순산양유아식 3단계 400g,16900,16900,0
2018-06-01,1749520050,E021020,커튼,6230 갈대발/자동 문발/파리문발/대나무발/비즈발,11900,11900,0
2018-06-01,19179924,E011020,침대,[잉글랜더]데니스 3단 수납 침대/매트리스포함/SS,124900,124900,0
2018-06-01,987324138,A019050,간장,샘표 맑은 조선 간장 930ML,8450,7990,-460
2018-06-01,2105311944,A019180,즉석식품,[코스트코 냉장냉동] 하림 용가리 치킨너켓 1.5kg,13230,12710,-520
2018-06-01,1226068594,C011020,남자상의,MJSF18002 베이지 코튼 베이직 코트 베이직코트 면코,91960,91960,0
2018-06-01,529887186,E061040,부엌용세제,무궁화 오곡 안심설거지(주방세제)_1.2리필 x 3개,6900,6900,0
2018-06-01,872416796,E061020,섬유유연제,FC 베이비전용 세탁세제 (refill) (#10046),18380,16360,-2020
2018-06-01,708711591,A013050,오징어,오뚜기 고등어 280g X 24EA 재료 고등어 캔 가공식품,66830,66830,0
2018-06-01,1778590579,L021020,장신구,[바보사랑]PLUMP+ RNG,25000,25000,0
2018-06-01,1147733306,A014050,달걀,백봉오골계 방사형농장 계란 종란(부화용) 10 20 30알,30000,30000,0
2018-06-01,1778590577,L021020,장신구,[바보사랑]NOPE 2 RNG,25000,25000,0
2018-06-01,1778590578,L021020,장신구,[바보사랑]CIRCLE+ RNG,25000,25000,0
2018-06-01,642487275,C013050,운동복,리치테크 RCP-A1.C24A 12V 차량용 타이어 공기압 자동주입 YF쏘나타.NF쏘나타.EF쏘나,41000,41000,0
2018-06-01,90491944,A021010,커피,아이수 페루산 카카오닙스500g 카카오닙스 카카오 페,17110,17110,0
2018-06-01,1753596923,E011030,거실장,[채움가구] 네추럴 1200 서랍 거실장,57900,57900,0
2018-06-01,307055698,C014010,아동복,[이유까까] 여름신상~상하복세트/아동복/티셔츠/나시,7900,7900,0
2018-06-01,1816751841,A011170,떡,DS379/딤섬 지마구 700g,16000,15840,-160
2018-06-01,819716224,F012020,생리대,[위스퍼]생리대 보송보송 중형 36Px2팩,16900,16900,0
2018-06-01,498590891,A017280,김,이엔알밥용단무지 1kgX10개반찬 식자재 식품 단무지,80100,70490,-9610
2018-06-01,1753596921,E011030,거실장,[채움가구] 네추럴 600 협탁,27900,27900,0
2018-06-01,1544139955,C013020,티셔츠,PH)COQUIN와펜티셔츠(36113-334-02)/ 밍크뮤,18000,17100,-900
2018-06-01,1753596922,E011030,거실장,[채움가구] 네추럴 1200 비디오 거실장,57900,57900,0
2018-06-01,49223346,C014010,아동복,[젤리스푼] 아동 데일리상하복 특가모음,10900,10900,0
2018-06-01,2003972848,C012040,여자학생복,매그제이 네추럴리본블라우스 J11OBL025,31200,31200,0
2018-06-01,1087318605,A016160,과일가공품,블루베리(건조 한끼 350g)X6,110760,110760,0
2018-06-01,1881023704,C012060,여자내의,[ab.f.z][18S/S]린넨반팬츠(AFS3GP54F)[갤러리아],39000,33150,-5850
2018-06-01,720636867,E061010,세탁세제,친환경 마크 인증 세탁세제/액체세제 1.8L + 1.6L x 3,14900,14900,0
2018-06-01,701816154,F012030,안경,남자안경테 뿔테 동그란안경 국산/수입산 안경테,14900,14900,0
2018-06-01,1465013347,E031020,가스레인지,린나이 2018년 최신형 2구/3구가스렌지 RTR-W2000,189000,189000,0
2018-06-01,1784312245,L021010,손목시계,[CASIO]카시오 LRW-200H-2E2 여성시계 우레탄밴드 디지털 패션시계,39800,39800,0
2018-06-01,450328596,E041050,냄비,네오플램 에콜론코팅 밀크팬/이유식냄비/냄비,15900,14900,-1000
2018-06-01,773950736,C013050,운동복,흠집방지 도어가드/문콕방지/차량용/실리콘/자동차/8P,1400,1290,-110
2018-06-01,985442568,A016090,참외,성주꿀참외 2kg 8-16과,26000,18400,-7600
2018-06-01,1256148815,L021020,장신구,[골드리아:실버묵주반지 모음] 국내생산/은반지,28900,28900,0
2018-06-01,74237541,A017250,고사리,무료배송 브로콜리 2kg 컬리플라워 2kg 특품/푸른나라,16900,16900,0
2018-06-01,895680239,A013050,오징어,갈치 (200G내외)중/마리_냉동,3790,2660,-1130
2018-06-01,2121018254,C013010,점퍼,AGC여성 체크코트 후드코트 KK 셀린체크 후드CT 캐쥬,94600,94600,0
2018-06-01,760193411,A013160,맛살,올리브녹차 돌자반 70gx20개 입안에서 살살녹는 고,57540,57540,0
2018-06-01,1855689835,A013130,오징어채,정화 버터진미 오징어 ( 채 ) 30g x 5.,22080,19660,-2420
2018-06-01,1226245547,A022010,주스,Tipco 팁코 오렌지쥬스 500ml 12개 감귤주스 오렌지쥬,47780,47780,0
2018-06-01,233493383,E021020,커튼,레이스 캐노피 모기장(화이트) 가정용캐노피 레이스캐,16080,16080,0
2018-06-01,1114256574,L012060,샴푸,엘라스틴 실크리페어 샴푸 린스 / 광채 손상 집중케어,13900,13900,0
2018-06-01,606593173,C012040,여자학생복,병정자수NB 루즈핏 스트라이프 셔츠 남방 빅사이즈,26900,26900,0
2018-06-01,550912051,A013150,어묵,CJ 삼호 정통어묵탕 368g X 2 어묵 탕 간식 정통어묵,11300,11300,0
2018-06-01,263764293,F012010,종이기저귀,2팩/크린베베/아기기저귀/일자형기저귀/크린베베소형,21500,21500,0
2018-06-01,1388932045,C013010,점퍼,청자켓/데님자켓/남자청자켓/데님점퍼/청점퍼/블루종,25900,25900,0
2018-06-01,368129444,C021020,구두,남성구두 M1196 키높이 7cm 천연가죽 신사화 구두 남,60190,60190,0
2018-06-01,1201952065,C021020,구두,[금강제화] 리갈 201 DRESS 남성 U팁 정장구두 MMX5100FG11(본점),250200,218430,-31770
2018-06-01,406839212,C012040,여자학생복,트로피칼야자수로브(7217210011)/ 지컷,139000,118150,-20850
2018-06-01,1453015605,E041010,식기,[르크루제][백화점상품] 찬기(중) 4개 세트 - 색상선택(본점),79000,75050,-3950
2018-06-01,547646246,C011030,남자학생복,[홈런]셔츠/남방/린넨/체크/데님/7부/반팔/남성/남자,10000,9800,-200
2018-06-01,982549976,E011030,거실장,[채우리] 피에타 3인용 소파 + 스툴,490000,490000,0
2018-06-01,1774571255,A012030,돼지고기,(고기천국)쫄깃고소한 목삼겹500g/삼겹살/목살/구이용,3900,3900,0
2018-06-01,1217469142,E011040,소파,[동서가구]편안한 패브릭 3인소파 스툴 901121-0,213000,189000,-24000
2018-06-01,663344264,L012060,샴푸,EM샴푸린스 헤어두피비듬/탈모방지 천연건강 비누치약,13100,12950,-150
2018-06-01,955738732,A022020,두유,[정식품]정식품 베지밀A (190ML*10입/병),11000,11000,0
2018-06-01,955738733,A022020,두유,[정식품]정식품 베지밀B (190ML*10입(병)),11000,11000,0
2018-06-01,882050488,A019080,고추장,장 먹을 일이 많은 추석!,4200,4200,0
2018-06-01,989877584,L012030,칫솔,메디안 미니언즈칫솔3단계_2입 (남아)*4,12600,11500,-1100
2018-06-01,1867398472,C015040,장갑,무지암워머/짜임암워머/니트암워머/손토시/워머,3900,3900,0
2018-06-01,50148047,C011030,남자학생복,인터페이스제작 가디건 주머니자크포켓 후드집업자,29700,29700,0
2018-06-01,771500624,C014010,아동복,MLB 또봇 다이노코어 터닝메카드 스파이더맨 카봇/티,16900,16900,0
2018-06-01,2070212778,C012060,여자내의,빅사이즈/이중/리본/랩/스커트 / 참고 이중리본랩스커,57700,49050,-8650
2018-06-01,28930903,C014010,아동복,초등학생여아원피스 주니어BEST모음 여아롱티,12900,12900,0
2018-06-01,1304732442,I031010,장난감,(Step2)이인용밴 (2016.4.1 소비자가인상) 붕붕카 승,242370,242370,0
2018-06-01,443817838,C013010,점퍼,GM 지퍼패딩 럭셔리 2줄지퍼패딩 패딩점퍼 후드점퍼,168740,168740,0
2018-06-01,418768767,A022050,탄산음료,건영제과 아이스파워 10개입 x 5봉 얼려먹는 쭈쭈바,11900,11900,0
2018-06-01,531687875,L021030,가방,2016 섹시 가터벨트 5종 콜렉션/가터벨트+섹시팬티+스타킹 세트,19800,19800,0
2018-06-01,470621519,C013050,운동복,[스타일리쉬위즈] (색상선택 : 실버) 3M 자동차 문콕 방지,11810,10770,-1040
2018-06-01,1736935811,C013010,점퍼,세로영문라인항공점퍼/여아봄점퍼/샤링바람막이점퍼,22900,17900,-5000
2018-06-01,2143791151,A022010,주스,웅진)자연은 제주감귤 180ml12개입 감귤쥬스 과일쥬스,15610,15610,0
2018-06-01,954041704,A019040,소금,오천년 신비 천일염 구운소금 180G,2180,2180,0
2018-06-01,989877580,L012030,칫솔,메디안 코코몽칫솔2단계_2입*4,12600,11500,-1100
2018-06-01,422458719,C015030,넥타이,(색상 : 네이비) BTIE_121 스틸 니트 보타이,15140,15140,0
2018-06-01,1524381300,E061050,청소용세제,유한락스 3L x 2개 + 유한락스 x3개 (증정) 살균 소독,15000,13800,-1200
2018-06-01,989877577,L012040,치약,메디안 자일리톨치약 75G*2입(사과맛)*4,12200,10900,-1300
2018-06-01,949373335,L021030,가방,러브캣 (베이직45)숄더백(LIS2S609),214800,171840,-42960
2018-06-01,989877579,L012030,칫솔,메디안 코코몽칫솔1단계_2입*4,12600,11500,-1100
2018-06-01,989877578,L012040,치약,메디안 칼슘치약 75G*2입(딸기맛)*4,12200,10900,-1300
2018-06-01,2111409539,E031110,청소기,2018출시 말하는로봇청소기 휴머/물걸레청소/자동청소,225000,225000,0
2018-06-01,668216867,A019040,소금,지리산 대전스님 원조 뽕소금 500g/900g 뽕나무 소금 천일염 불가에서 먹던 소금 보림,17000,16500,-500
2018-06-01,2114267359,C012040,여자학생복,민소매블라우스MSBCWB4920_/ 미니멈,99000,87120,-11880
2018-06-01,2133903131,C013010,점퍼,셔링 패치 롱 패딩 점퍼 야상 노옵션 29800원 균일가,29800,19800,-10000
2018-06-01,1827482824,C021040,실내화,TJM/조던/나이키/아디다스/뉴발란스/아동화/키즈/농구,69900,69900,0
2018-06-01,68417831,A013070,굴,청우 수월한 돼지껍데기두루치기 400g,3800,3800,0
2018-06-01,1397514124,A013080,조개,두레생협 대구전부침용(400g/러시아산) 대구전부침용,23610,23140,-470
2018-06-01,1615143562,F012010,종이기저귀,특가 !! 하기스 굿나이트 어린이용 안심팬티 2팩 폴맘,28900,28900,0
2018-06-01,557367952,E061010,세탁세제,대용량 세탁세제(12Kg~10Kg)가루세제/가루비누/표백제,9900,9400,-500
2018-06-01,983537738,L012060,샴푸,[아모레퍼시픽]미쟝센 안티에이징 샴푸(400ML),3490,3490,0
2018-06-01,1171402980,E041030,솥,풍년/주물압력밥솥/20인/25인/30인/39인/50인용 세원,134000,134000,0
2018-06-01,818128626,L012060,샴푸,(파우치10매증정)댕기머리 뉴골드 프리미엄/명품샴푸 500ml~1500ml구성/린스/한방샴푸,18900,15800,-3100
2018-06-01,854425610,E031080,선풍기,[흥신] 전기라디에타 타이머형 ERT-15BST(9핀 3~4평형),172700,172700,0
2018-06-01,854425612,E031080,선풍기,[흥신] 전기라디에타 타이머형 ERT-25BST(13핀 5~7평형),204000,204000,0
2018-06-01,473189969,C013040,청바지,ACCHT7207 밑단 데미지 데님 5부팬츠 데님반바지 남성,30580,30580,0
2018-06-01,1328843357,C013010,점퍼,린넨자켓 마자켓 7부자켓 여름자켓,36800,36800,0
2018-06-01,409856950,A018010,초콜릿,스위스 초콜릿 토블론 100gx1개 초콜렛/밀크/화이트,1850,1850,0
2018-06-01,682536235,F012010,종이기저귀,최신 기저귀 샘플 / 기저귀 견본 / 하기스 마미포코,1200,1200,0
2018-06-01,538246958,C013020,티셔츠,남 반팔 피케 폴로 018501/ 지오다노,15000,12300,-2700
2018-06-01,1610041569,L012060,샴푸,헤드앤숄더샴푸/린스 가려운/쿨멘솔/지성모발 비듬,9000,8900,-100
2018-06-01,249060813,C012040,여자학생복,[대구백화점 I관] [후라밍고]린넨집업가디건(FMK82049),79000,71100,-7900
2018-06-01,1435506166,C011030,남자학생복,[예작셔츠]남성 반소매 일반핏 셔츠 25종 택1,30000,23700,-6300
2018-06-01,165376587,E041010,식기,[예가]한국도자기/킴스아트-공기/대접/찬기/구프/볼/주름찬기/원형찬기/앞접시/홈세트,4000,3680,-320
2018-06-01,1048992686,C012030,여자상의,여성 목폴라 원피스 니트 조끼 KK 니트조끼P 여성 목,64740,63450,-1290
2018-06-01,1832833825,F012030,안경,국산 무테 안경테 30종 티타늄외 메탈 남자 여자 안경,32800,32800,0
2018-06-01,281702062,A017220,양파,무농약 대파 200g 국산/간편사용/손질채소/깐대파,2300,2300,0
2018-06-01,367754320,C013040,청바지,[패션플러스][CUBICA][쿠비카]스컬 프린팅 양포켓 밴딩 배기팬츠 (Size 5566) CAP-CHP,27800,22240,-5560
2018-06-01,502918532,L021010,손목시계,BELCARINO 로만썬레이 실버 심플한 손목시계 MV202011,68500,68500,0
2018-06-01,651275692,A017150,버섯,[엉클팜]싱싱한 삼색 혼합 파프리카 5kg / 무료배송,38900,36960,-1940
2018-06-01,1241604048,C013020,티셔츠,베이직셔링티(DG_16B) 셔링티셔츠 캐주얼티셔츠 빅사,15000,15000,0
2018-06-01,1617836046,C014020,유아복,[디플랜][디플랜] 셔링티셔츠,5900,5610,-290
2018-06-01,1306707121,A011130,시리얼,오뚜기 부침가루 500g X 20EA 볶음쌀가루 튀김분말 요,36440,36440,0
2018-06-01,854425604,E031080,선풍기,[흥신] 전기라디에타 ERT-12BS(7핀 2~3평형) 1.2KW,126500,126500,0
2018-06-01,854425605,E031080,선풍기,[흥신] 전기라디에타 ERT-15BS(9핀 3~4평형) 1.5KW,144100,144100,0
2018-06-01,866146145,E021010,침구,사계절 요차렵 4종 침구세트/이불+요커버+요솜+베개,34800,34800,0
2018-06-01,854425607,E031080,선풍기,[흥신] 전기라디에타 ERT-25BS(13핀 5~7평형) 2.5KW,175400,175400,0
2018-06-01,854425608,E031080,선풍기,[흥신] 전기라디에타 ERT-30BS(15핀 6~8평형) 3.0KW,191700,191700,0
2018-06-01,854425609,E031080,선풍기,[흥신] 전기라디에타 타이머형 ERT-12BST(7핀 2~3평형) 1.2KW,157700,157700,0
2018-06-01,1204219870,A021020,차,코코넛크림파우더 (코만 160g) X24,116310,103520,-12790
2018-06-01,536197749,C012040,여자학생복,[쉬즈미스]2018 SSKVTI21010 티셔츠형니트베스트,86940,73900,-13040
2018-06-01,833772249,C013040,청바지,리바이스/리바이스청바지/청바지/남자청바지/지갑벨트,45000,45000,0
2018-06-01,1273869965,I031040,생화,썬파인정품 해먹스탠드/해먹스텐드/해먹거치대/팩증정,138000,123430,-14570
2018-06-01,1085463768,I031010,장난감,67종 레고놀이판 듀플로 블럭판 클래식 호환 레고판,1000,1000,0
2018-06-01,636592311,I011010,TV,삼성패널 이노스 49인치 UHDTV E4900UC,309000,299000,-10000
2018-06-01,895655247,F011120,인삼,표고버섯(팩),2990,2990,0
2018-06-01,1096708502,C011030,남자학생복,린넨셔츠 여름 7부 남방 셔츠 남자 남성 빅사이즈 3XL,19800,19800,0
2018-06-01,957533080,L012060,샴푸,LG 엘라스틴퓨어브리즈퍼퓸샴푸 600ML,13000,4990,-8010
2018-06-01,54777371,A017200,토마토,[토종원] 토종원/국산 건가지 70gx5팩/향이 좋은 웰빙먹거리,18400,18400,0
2018-06-01,722303709,A017050,미나리,무농약 양배추 3.5kg,7900,7900,0
2018-06-01,1377880639,A012050,소시지,롯데 키스틱 소세지 500gX2개(40입)/포켓몬카드,9900,9900,0
2018-06-01,1051993346,L021050,우산,[주토피아] 예쁜 3단자동우산 6종,15900,15900,0
2018-06-01,1097633136,C013020,티셔츠,[마르조] [5종]여성에스닉블라우스,49800,41340,-8460
2018-06-01,1536580967,C011030,남자학생복,남자 남성 일자핏/약간슬림핏 반팔 와이셔츠 95~120,10900,9900,-1000
2018-06-01,382051079,L021020,장신구,[티르리르] 다즐링(자수정) 팔찌TBSSVW10636M-14,59000,50150,-8850
2018-06-01,200956779,E031110,청소기,아토케어 무선청소기 에브리원 EP-9UP 진공침구핸디형,209000,209000,0
2018-06-01,1256087315,C012040,여자학생복,[나인스텝](18 S/S) V라인레이스러플블라우스 N18NS8243R[갤러리아],35000,30100,-4900
2018-06-01,291991474,C013020,티셔츠,아인스골프 여성용 멀티프린팅 냉감 이너웨어 ES8S302/ 럭스골프,25000,22250,-2750
2018-06-01,886904337,E061020,섬유유연제,다우니 퍼퓸 1Lx4개/고농축섬유유연제/미스티크/블룸,19800,19800,0
2018-06-01,417837143,C013010,점퍼,여름에 입는 점퍼 TUMAE2150/ 비키,149400,134460,-14940
2018-06-01,807779419,C013040,청바지,[세르퐁텐느]세르퐁텐느 커스텀핏 워싱 데님 팬츠_W03819,32000,30400,-1600
2018-06-01,19743704,A013170,생선통조림,(유동공식몰)유동자연산골뱅이300gx2+팔도비빔면2개,14900,14900,0
2018-06-01,809647280,I031040,생화,[태완]JEEP스티커/지프스티커/텐트스티커/캠핑용품,3000,2740,-260
2018-06-01,742816250,A022040,기능성음료,파워에이드 마운틴 블라스트 355ml x24개입,15000,15000,0
2018-06-01,895716785,A011110,당면,풀무원 순두부 350G,1990,1990,0
2018-06-01,429578213,E041070,밀폐용기,10%쿠폰! [락앤락] 투웨이용기 샐러드용기 1+1,9400,9400,0
2018-06-01,673038498,A011170,떡,쫀득쫀득 맛있는 국내산 방울기정떡 3kg(30gX100개),19900,17980,-1920
2018-06-01,376662628,A016110,딸기,[올프레쉬][아침배송] 과일소믈리에 미국산 체리 500g팩,14500,14500,0
2018-06-01,622006893,D031010,주택수선재료,UV오일스테인(3.5리터)+붓1증정/동우켐/목재용페인트,38000,38000,0
2018-06-01,511446344,A013170,생선통조림,(사조/참치/17종)x10캔/참치캔/마일드/고추/연어/동원,12900,12900,0
2018-06-01,608585260,A019140,이유식,[일동후디스]아기밀 홈쿡 10종/죽/카레,4600,3800,-800
2018-06-01,895716789,A017150,버섯,풀무원 유기농콩나물 270G,2000,2000,0
2018-06-01,1305048705,A013030,조기,[e수산물][반건조민어조기35cm대]/ 제수용 민어조기 / 마른생선 /제수생선 마산어시장,11900,11900,0
2018-06-01,954041736,A015020,식용유,해표 해바라기유 500ML,3950,3950,0
2018-06-01,900506442,A018070,파이,임페리얼 데니쉬 쿠키 (500G),7060,7060,0
2018-06-01,328931725,A013130,오징어채,오징어채 1+1 (400g+400g) 진미채 가문어 쥐포구이채,22900,22900,0
2018-06-01,439635220,A013170,생선통조림,(무)유동 번데기캔130gX48개술안주 번데기 번데기캔,76500,65030,-11470
2018-06-01,471790250,C013020,티셔츠,보통샵 기본티/스트라이프티/롱티/빅사이즈/반팔티,8000,7900,-100
2018-06-01,1010315078,A019150,김치,요리하다 롯데호텔 열무김치 1KG,9000,9000,0
2018-06-01,751383691,A011100,라면,백설 자른 햇당면 500g / 국산100%당면 400g,2350,2350,0
2018-06-01,598849838,E061030,전구,[코닥] LED 전구 15W 2년 무상 A/S,2790,2790,0
2018-06-01,1010256297,A018070,파이,롯데 치즈초코파이 384G,3840,3840,0
2018-06-01,19310664,E061020,섬유유연제,바운스 드라이시트 시트유연제 빨래건조기 160매,9900,9900,0
2018-06-01,1306952214,C012060,여자내의,[탐탐탐][오가게/탐탐탐]8부 와이드팬츠(3color),22000,22000,0
2018-06-01,1010315074,A019180,즉석식품,CJ 비비고찜닭 350G,7390,5290,-2100
2018-06-01,765219662,A019110,드레싱,CJ 유자 샐러드소스(250G),3980,3980,0
2018-06-01,58640869,C013060,등산복,쿨미러 남성 등산티셔츠 남자 등산복 작업복 등산티,15800,15800,0
2018-06-01,1973887092,C014020,유아복,아둘 가족티 엄마랑 커플룩 도날트덕 롱 티셔츠 11,14300,14300,0
2018-06-01,1905521176,I031010,장난감,꼬마버스 타요 버스 5종 세트 장난감 미니카 자동차,24900,24160,-740
2018-06-01,676151976,A019180,즉석식품,빅마마 이혜정 비법요리 갈비찜 소갈비 황태구이,23500,23500,0
2018-06-01,590318879,E031110,청소기,(공식)한경희강력살균 핸디스팀청소기HS-101Y/HS-101S,45000,32500,-12500
2018-06-01,1619855744,C013020,티셔츠,[로즈마리]여름특가!! 여름신상 린넨/티셔츠/원피스,14900,14900,0
2018-06-01,1251266943,C012020,원피스,[플라스틱아일랜드][정상가:199 000]투버튼 라글란 코트(PH4EC083),79000,67150,-11850
2018-06-01,1488842142,A012010,국산쇠고기,[무항생제] 사골 5kg 1등급,101400,101400,0
2018-06-01,451524566,C011020,남자상의,MJSF18002 베이지 코튼 베이직 코트 남자베이직코트,91580,91580,0
2018-06-01,1222182154,C013020,티셔츠,[에스티아]66-120/원피스형 롱티셔츠~!!/롱후드/박스,12900,12900,0
2018-06-01,1172517189,A013170,생선통조림,동원 자연산 골뱅이 400g/유동 골뱅이400g/골뱅이230g,5540,5540,0
2018-06-01,1321446693,A022020,두유,삼육 달콤 옥수수 두유 195ml 60팩/섬유질충전/웰빙,19900,19900,0
2018-06-01,984456457,A017300,미역,초이스L_얼굴이 보이는)서천재래전장김 20G*3/봉,3990,2990,-1000
2018-06-01,238257225,C013060,등산복,[노스페이스] NT7UJ13 JT 남성 리커버리 2 그래픽 반팔 라운드 티셔츠,28000,28000,0
2018-06-01,267579986,A011080,밀가루,베트남쌀국수/쌀국수육수/월남쌈/월남쌈소스/칠리소스/스리라차/피쉬소스/해선장/팟타,3400,3400,0
2018-06-01,984456458,A017300,미역,[1+1]초L)얼굴이보이는서천재래도시락김 16봉,7990,7990,0
2018-06-01,1138363050,C012060,여자내의,[엔엔에프]NnF 여성 쿨컬러 썸머팬츠 세트 3종,39000,37050,-1950
2018-06-01,1890484017,I031010,장난감,(둥근 지붕차) 햇빛차단 자동차 선물 유아 안전 승용,183250,183250,0
2018-06-01,328331026,C013010,점퍼,[대구백화점 II관] [탑걸]꽃자수 면점퍼(TIZ4JP714F),29000,24940,-4060
2018-06-01,821005175,C013010,점퍼,아둘 가족티 쥬니어 상하세트 시그니처 조던 34,25500,25500,0
2018-06-01,1882407517,C012030,여자상의,빅사이즈여성의류/원피스티셔츠블라우스/니트/반팔티,20200,14900,-5300
2018-06-01,984226100,A014010,우유,(가정배달) 서울우유 앙팡베이비우유 1000ml,42100,42100,0
2018-06-01,646764697,A019100,식초,코리원/오뚜기 일회용 케찹 9kg(9gX1000개입)/대용량,24900,24900,0
2018-06-01,533364911,C013050,운동복,여름 추천/겨울 앞유리 자동차커버 i40 i30 투싼ix,12000,10860,-1140
2018-06-01,289400846,A017180,호박,가을 특 한식 고추가루 2.5kg,53100,51510,-1590
2018-06-01,676692806,F011150,건강기능식품,대용량! 멀티프로 멀티비타민 골라담기,8900,8900,0
2018-06-01,1269048847,E011070,식탁,원목이동식식탁 미니테이블 웨건주방수납장 렌지다이,89000,87220,-1780
2018-06-01,480636573,C012020,원피스,글랜체크 롱재킷 RLJWLJ8A0/ 리안뉴욕,74000,66600,-7400
2018-06-01,903545613,C012060,여자내의,[앤썸][앤섬]톤온톤 배색 패턴 슬림핏 팬츠 MVBDLQS1421_53,8900,8460,-440
2018-06-01,610079457,F011150,건강기능식품,[BYO] CJ(냉장) BYO 피부유산균 2.5g X 100포(100일분),54500,54500,0
2018-06-01,545827946,C013020,티셔츠,디젤 구제매니아 여성 85 라운드 긴팔 티 봄 가을 굿,38020,38020,0
2018-06-01,589132108,C013050,운동복,폴로 남아 아동 주니어 16 세 치노 긴 바지 새상품,29110,29110,0
2018-06-01,906226866,E031120,믹서,딤채 믹서기 25 500RPM 고속믹서기 뉴트리불렛 NB1000,129000,129000,0
2018-06-01,194070212,E061080,키친타월,한예지 천연펄프 키친타올 150매 8롤/각티슈 화장지,7800,7800,0
2018-06-01,95458579,E031140,비데,{사은품 증정} 노비타 방수 비데 BD-N431 ipx5,229000,229000,0
2018-06-01,629407861,C013050,운동복,순수에탄올 워셔액1.8L x 6개 불스원 (영하25도 사용),11900,10800,-1100
2018-06-01,2003850432,C012060,여자내의,3버튼 기모 가죽 바지 레깅스 팬츠 스키니 여성 여자,24740,24740,0
2018-06-01,1130098379,C021010,아동화,블랙 징 유아신발(127-170mm)900022 아기신발 돌신발,27130,27130,0
2018-06-01,989973436,A016090,참외,RF)작아도 당찬참외 (11~18입/2.0KG/박스),15900,12900,-3000
2018-06-01,1007745642,L021020,장신구,11mm천연진주메달반지/화이트골드/pearl/LE308,999550,999550,0
2018-06-01,335192787,L021010,손목시계,로제타 여성 손목시계 FW-16 패션시계 디지털시계 팔,13560,13560,0
2018-06-01,1307437741,I031070,애완동물관리비,태권도송판/격파용송판/유아용/아동용/4mm~9mm,570,510,-60
2018-06-01,1942349034,C012040,여자학생복,[드레스투미]봄여름셔츠/블라우스/원피스,9900,9900,0
2018-06-01,990929757,C013060,등산복,봄여름 등산셔츠/빅사이즈/반팔 긴팔 등산티/등산복,16800,14800,-2000
2018-06-01,1996484777,I031040,생화,초강력 5W 10W 충전 랜턴 써치라이트 후레쉬 손전등,43500,43500,0
2018-06-01,408976929,E061010,세탁세제,향기품은 가루세제 10kg 2개 슈퍼워시 세탁세제,9800,9800,0
2018-06-01,1814313718,F012050,의료측정기,[아이센스] 케어센스 N 혈당측정기 혈당계 혈당시험지,8000,6800,-1200
2018-06-01,454754283,E061010,세탁세제,맑은em원액 1리터 2EA 가정용 1리터 다목적 다용도 주,22520,21620,-900
2018-06-01,820681536,A019110,드레싱,코리원/CJ 맛있는 요구르트 드레싱_2kg/샐러드/소스,10000,9900,-100
2018-06-01,335202679,L021050,우산,19종 투명우산 비닐우산 파스텔우산 벚꽃 자동 우산,1500,1500,0
2018-06-01,345667102,A017200,토마토,가지 50개,80450,80450,0
2018-06-01,957533079,L012060,샴푸,LG 엘라스틴러브미퍼퓸샴푸 600ML,13000,4990,-8010
2018-06-01,2124623693,A016040,포도,동원)황도 슬라이스 400g x 12개 사시사철 맛있는 복,34500,33470,-1030
2018-06-01,346582467,C013050,운동복,이지 휴대용 비상 소화기 산소캔 119 차량 캠핑,14000,12790,-1210
2018-06-01,1038477660,L021030,가방,삼성 맥북 노트북 가방 파우치 13.3 15 15.6 인치,22000,22000,0
2018-06-01,1597269644,F011130,홍삼,정관장 고울려세트(SET),49900,49900,0
2018-06-01,1686223898,A018090,잼,국내산 딸기로 만든 초록원 딸기잼 1kg x 2병 딸기쨈,10500,10500,0
2018-06-01,897466857,A022010,주스,[서울]서울 아침에 주스 오렌지 (210ML),1000,1000,0
2018-06-01,854425580,E031080,선풍기,[흥신] 전기라디에타 ERT-12ABN(10핀 2~3평형) 1.2KW,136000,136000,0
2018-06-01,983403360,F012010,종이기저귀,팸퍼스 베이비드라이 밴드형 점보팩 기저귀,44800,42800,-2000
2018-06-01,854425581,E031080,선풍기,[흥신] 전기라디에타 ERT-15ABN(13핀 3~4평형) 1.5KW,155000,155000,0
2018-06-01,1544739703,L021020,장신구,MBC 결혼계약 협찬- 쥬이시 롱 목걸이 저렴한 주얼리.,33380,33380,0
2018-06-01,1212152490,C013020,티셔츠,레이어드 여름티 반팔티 레이스티 나시티 롱티 흰티,7900,7900,0
2018-06-01,1789668620,F012020,생리대,NEW 템포 10매 (레귤러/슈퍼 선택)/ 템포,3080,2900,-180
2018-06-01,899348403,A013020,명태,[1+1 하나 더!] 안동간고등어 온라인최초! 14마리+14마리+사은품 2마리 더(손당 330g),44900,41900,-3000
2018-06-01,899348406,A013050,오징어,이동삼 안동간고등어 3손/6마리-손당 330g,13900,10900,-3000
2018-06-01,987255846,A019180,즉석식품,다향 오리훈제 슬라이스 400G*2,18900,18900,0
2018-06-01,268638680,A019110,드레싱,코리원/오뚜기 삼겹살 양파절임 소스 2.1kg/파채/소스,6600,6500,-100
2018-06-01,1737921103,C013020,티셔츠,[민트코크]봄여름신상 티셔츠/반팔/팬츠/데일리룩,5900,5900,0
2018-06-01,19718680,A013030,조기,조기 손질조기 10미/15미(140-170g),29900,29900,0
2018-06-01,523971998,A011050,콩,[가온애]스낵류 총모음 땅콩 초코볼 고구마스틱 하모니콘 깨돌이 강정 꽈베기 커피땅콩,3900,3900,0
2018-06-01,389358993,A018100,꿀,뉴질랜드/로얄제리/젤리/비타민E/부모님선물/6개월분/,49900,49900,0
2018-06-01,1016368223,E031110,청소기,LG 로보킹 터보 청소기 R46RIM 상단카메라,487200,455000,-32200
2018-06-01,989169045,L012030,칫솔,[애경]애경) 2080쏙쏙터치 칫솔(미세모) 3+3,9900,9900,0
2018-06-01,1597269672,F011130,홍삼,정관장 마음설세트(SET),49000,49000,0
2018-06-01,1888172591,C011050,남자내의,버커루 남성 UP2 L톤 데님 청바지 B162DP138M,30530,30530,0
2018-06-01,1988828584,E021010,침구,국내산 순면 호텔식 이불커버/이불패드/차렵이불/이불,26000,15800,-10200
2018-06-01,1409339905,I031040,생화,파세코 모스클린 플러스 UV LED 모기퇴치기,79000,69000,-10000
2018-06-01,1196041302,D031010,주택수선재료,아이생각/수성내부프로/4L(무광)/친환경페인트/벽지용,12000,12000,0
2018-06-01,1144782830,E031070,에어컨,16형 벽걸이 선풍기/업소용 IA-W160,21800,21800,0
2018-06-01,12731977,I031040,생화,차량용 루프백 루프박스 자동차 캐리어백 가방 캠핑,79000,72680,-6320
2018-06-01,1032426355,E011050,책상,[벨라홈] 이지심플 L형 책상 (B)(CN7209),53900,38900,-15000
2018-06-01,1152339168,C012060,여자내의,[디어제인][디어제인]플리츠와이드팬츠M4402,5900,5610,-290
2018-06-01,719635801,A019060,된장,청정원 순창조개멸치찌개된장 2개+증정 쌈장200g,10530,10530,0
2018-06-01,306626148,E051020,건전지,CSLED 18650 리튬이온 충전배터리 - 파나소닉셀,13900,13900,0
2018-06-01,488082923,E041010,식기,놋쇠/향로/풍수지리/인테리어/소품/집들이/개업선물,82300,80660,-1640
2018-06-01,1530083751,E031120,믹서,NK한샘 초고속 진공블렌더 오젠 HAF-HB300/350/500,379000,379000,0
2018-06-01,1742574279,E041030,솥,(풍년/압력밥솥)파워클래드 IH 압력솥/4인용/밥통,77900,77900,0
2018-06-01,366967567,I031010,장난감,특가완구3개골라9800원/무료배송,9800,9800,0
2018-06-01,1010317799,A018060,스낵과자,Onlyprice 감자칩 양파맛 140G,1000,1000,0
2018-06-01,505480424,E021010,침구,[아망떼] 스윗드림 순면 이불커버/매트커버/패드,18900,18900,0
2018-06-01,1755330252,C012040,여자학생복,[디데무]펀칭소매프릴블라우스(LW1606402),22000,19580,-2420
2018-06-01,30178980,A018020,사탕,멜랜드3kg2.5kg대용량디저트벌크사탕카라멜젤리업소용,8200,8200,0
2018-06-01,1238928496,C013050,운동복,BMW5시리즈 G30 콘솔 박스 수납정리 트레이,26590,24230,-2360
2018-06-01,5231623,E031030,전자레인지,쿠잉 전자렌지 MC-20MW 20L/전자레인지/소형/미니,51000,44840,-6160
2018-06-01,751033565,A017230,마늘,감자 왕특 10kg 25000원 보성감자,23000,23000,0
2018-06-01,395724460,A019170,냉동식품,해태 불낙교자/깐풍교자/치즈갈비교자만두315gx4(4봉),15900,15900,0
2018-06-01,1799432889,I011030,사진기,소니 미러리스 A6000 (16-50+55-210렌즈)/공식대리점,909000,836280,-72720
2018-06-01,1970385505,E031010,전기밥솥,(공식)쿠첸 명품철정 IH압력밥솥 6인용 CJH-BT0602IC,213900,201070,-12830
2018-06-01,549856622,A013170,생선통조림,동원 화끈한 골뱅이 400g*5캔,33150,33150,0
2018-06-01,1324938032,C013050,운동복,[오토컴] 스마트브라운_접이식콘솔박스 2개 자동차수납함 콘솔,48550,44230,-4320
2018-06-01,986336237,A018070,파이,[크라운]크라운 쿠크다스 화이트 288G,4240,4240,0
2018-06-01,1079347828,C012030,여자상의,(원모어) 여성 라운드 반팔 프릴 면 원피스,12900,12900,0
2018-06-01,1716187097,C013050,운동복,자동차 사이드갭 가죽 컵홀더 포켓 수납정리 차량용품,12800,11270,-1530
2018-06-01,1915504528,A015020,식용유,청정원 카놀라유 900ml X 12EA(Hanworld),114300,97160,-17140
2018-06-01,1085400181,C012030,여자상의,엄마옷 조이마담 ON1025 핀턱소매 린넨 원피스 미시옷,55800,55800,0
2018-06-01,1833062805,C012060,여자내의,트렌디한 이중 도트 쉬폰스커트(GH5A0SK66)[예약상품 2018.06.01 부터 발송]/ 제이제이,39000,31200,-7800
2018-06-01,1433342535,A012010,국산쇠고기,[무항생제] 꼬리반골 1kg,20700,20700,0
2018-06-01,230552644,A017050,미나리,양배추 2통(5kg내외),14900,14900,0
2018-06-01,186400274,F012010,종이기저귀,수영장기저귀 마미포코 물놀이팬티 남아/여아,9800,9800,0
2018-06-01,415042708,C013040,청바지,EX 88 4 청반바지 청반바지 청5부 청 반바지 남자청반,54190,53110,-1080
2018-06-01,546333197,A017080,무,2018년 첫 출하 국내산 마늘쫑/마늘종 2kg / 산지직송,9900,9900,0
2018-06-01,612674879,C011050,남자내의,[폴햄] 남성 슬림핏 데님 팬츠(PHY1DP1012),19900,16520,-3380
2018-06-01,1001899860,C012040,여자학생복,[보니알렉스](보니알렉스) 기본 Y형 숏 가디건 (BBWX592C),6000,5700,-300
2018-06-01,318974900,A021010,커피,[맥스웰하우스] 맥스웰하우스 커피믹스 마일드 900g/자판기커피,3970,3970,0
2018-06-01,768439277,C011030,남자학생복,써스데이아일랜드 (T184MCD233) 자카드 조직단 로브형 가디건,239000,191200,-47800
2018-06-01,1663112027,C013050,운동복,빅사이즈민짱/트레이닝팬츠모음/세트/츄리닝/밴딩바지,15900,15900,0
2018-06-01,962396835,E061060,살충제,FLUGUN 플루건 살균기 비타포레4L 에코하이진 비타포레4L 비타오레4L 아쿠아비타노스,68000,68000,0
2018-06-01,1721778587,I031010,장난감,[파파야나인] VW Micro Bus 유아용 아기 어린이 푸시카,249000,249000,0
2018-06-01,2071887896,C012040,여자학생복,슬린 가디건 LBR0632 여성의류 여성가디건 / 참고 여,97500,82880,-14620
2018-06-01,2134484809,C013010,점퍼,AGC남자 바람막이 야상 JM09 WS바람막이점퍼야상남자,87820,86070,-1750
2018-06-01,638950244,A014020,분유,일동-모유보감 2g x 60포 (120g) - 물티슈 20매 증정,44900,44900,0
2018-06-01,534079925,C012040,여자학생복,보풀방지 네이비화이트라인 롱 교복조끼 공용 교복 예,25720,24950,-770
2018-06-01,1391825669,C013010,점퍼,[모다아울렛][ENC]파스텔롱야구점퍼(ENJJ81221OLPI),111500,104810,-6690
2018-06-01,1061107888,F011130,홍삼,[농협홍삼/한삼인] 블루베리 홍삼골드(50ml*30포),59300,59300,0
2018-06-01,2116841048,D031010,주택수선재료,[던에드워드]친환경 페인트 모음- 문/가구/벽지,18200,18200,0
2018-06-01,761352320,A016020,배,찬바람N(앤) 도라지배즙 (100mg25포),52670,52670,0
2018-06-01,371770582,L021020,장신구,아울 - 태슬 롱 목걸이 기념일 악세사리 예쁜 여성 여,14790,14790,0
2018-06-01,231373862,C012020,원피스,체크대형숄 겨울체크 목도리 남여성목도리 겨울목도,30580,30580,0
2018-06-01,318600008,A013090,전복,오독오독 싱싱한오만둥이2kg,7000,7000,0
2018-06-01,586323309,C011020,남자상의,웰론점퍼 패딩 점퍼 MK 3021 3023,112170,112170,0
2018-06-01,1169569936,C013010,점퍼,[페이퍼돌] 페이퍼돌 내츄럴핏 앞포켓 집업 노카라 자켓,29900,29900,0
2018-06-01,954817416,A016050,밤,[밤톨이약단밤] 영양간식 약단밤3kg 무료배송,35900,27500,-8400
2018-06-01,988216971,A019010,고춧가루,초L 청양 고춧가루 110G,7800,7800,0
2018-06-01,988216970,A019010,고춧가루,초L 고춧가루 110G,7200,7200,0
2018-06-01,1297109453,C013030,스웨터,MTS-117 심플후드집업티셔츠 집업 남성의류 후드 후드,23840,23840,0
2018-06-01,2069980405,C012060,여자내의,빅사이즈/로즈/레이스/스커트 / 참고 로즈레이스스커,57000,50160,-6840
2018-06-01,1213960817,C012060,여자내의,[대구백화점 II관] [테이트]여성 데님 언발런스 스커트(KA8U4WQS010),39920,34340,-5580
2018-06-01,246324773,C012060,여자내의,옆줄라인 레깅스 JE-2723 반바지레깅스 면레깅스 치마레깅스 레깅스 기본레깅스,7520,6700,-820
2018-06-01,884647050,E011020,침대,[안전한!베디스]SB150원목침대 컬러 선택형(커버증정),238000,238000,0
2018-06-01,1457671605,C014010,아동복,홀리데이 티셔츠 17419-332-01/ 알로봇,19000,19000,0
2018-06-01,1859102190,E011020,침대,엉클베드 실속형 침대프레임 매트리스 베스트 초특가,70000,66000,-4000
2018-06-01,2120053653,C014010,아동복,아둘 가족티 쥬니어 샌프란시스코 74 반팔 티셔츠 28,11100,11100,0
2018-06-01,988216968,E061010,세탁세제,초L프라임) 프리미엄 울 세제 1300ML,2990,2990,0
2018-06-01,985381032,A016100,수박,프L_얼)여름 감귤 카라향 1KG,8990,8990,0
2018-06-01,266492717,L021020,장신구,[폭스타일] 에스포 반지,8000,7280,-720
2018-06-01,60384081,E041010,식기,행남자기방짜유기2인세트/반상기/놋그릇/놋수저/예단,398000,366070,-31930
2018-06-01,2145668299,A011010,쌀,[참쌀닷컴] 임금님표 이천쌀 추청 10kg,33800,33800,0
2018-06-01,409014197,C012030,여자상의,[22XX]로맨틱 데일리룩/원피스/블라우스/티셔츠,13900,13900,0
2018-06-01,1969516720,C014010,아동복,[에어워크주니어]에어워크 주니어 PNC02 트레이닝 세트 w182b5223b19,59900,57510,-2390
2018-06-01,126178175,A016020,배,2017 추석 미래로 VIP 배 선물세트 추석선물 감사선,111350,111350,0
2018-06-01,1925735001,C012060,여자내의,[르샵](르샵) 밴딩 끈 포인트 팬츠(LH7PT856),19900,17720,-2180
2018-06-01,1971155848,C012040,여자학생복,[마르조[MARZO]][마르조] 이사벨블라우스5종,29800,24440,-5360
2018-06-01,1910328028,C015040,장갑,어린이 장갑 DS0056데이지덕리본 장갑 겨울장갑 아동,23230,23230,0
2018-06-01,1963681314,C014020,유아복,베이직 포그니 퍼레깅스 겨울아동복 아동겨울옷 유아,6200,6020,-180
2018-06-01,1492394857,A019130,스프,보노스프 혼합 18봉(6가지맛)+머그컵 증정 죽 간식,17900,17900,0
2018-06-01,2096083915,E011020,침대,마블3단접이식매트리스(대형)/ 블루밍홈,69900,69900,0
2018-06-01,394817692,I031040,생화,접이식 캠핑테이블 야외 바베큐 화로대 간이보조 매대,15500,13800,-1700
2018-06-01,1112411642,E061020,섬유유연제,F C 베이비전용 섬유유연제 bottle 유아세탁섬유유연,21040,21040,0
2018-06-01,1795853799,C013010,점퍼,아디다스 아디제로 트랙자켓 ( S99687 ),150570,138530,-12040
2018-06-01,492719808,C013020,티셔츠,난닝구 리스펙트 언발나염티/ 난닝구,15000,14550,-450
2018-06-01,1681426637,C012060,여자내의,[포에버21]부분 버튼 다운 스커트/FOREVER21/스커트/치마/미니스커트,21900,10950,-10950
2018-06-01,961400083,A018050,비스킷,[롯데]롯데 크런치 웨이퍼 바닐라맛 (100G),1440,1000,-440
2018-06-01,1373476284,A016060,감,상주전통곶감 꽁꽁얼린홍시2kg이상13-20과 개별포장,34700,34700,0
2018-06-01,322015361,I031010,장난감,물놀이 오리보트 파스텔 행동발달장난감 오리보트 장,7230,7230,0
2018-06-01,1434628697,A012030,돼지고기,국내산목살 수입산삼겹살오겹살목살 구이용수육용,6600,6600,0
2018-06-01,352911940,E061010,세탁세제,애경 스파크 가루세제 5.5kg(리필),9900,9900,0
2018-06-01,316878554,C013010,점퍼,[에이글] 에이글 KC16A-F648_NC아울렛,259000,51800,-207200
2018-06-01,1130098321,A011160,빵,안흥찐빵마을 국산팥 수제 안흥찐빵 1.2kg 25개 단팥,25370,25370,0
2018-06-01,1301756908,C014010,아동복,한국 블랙줄무늬 3종세트(3개월-24개월) 800018 / 참,74100,62990,-11110
2018-06-01,969227890,C011050,남자내의,아디다스 반바지 스포츠팬츠 스포츠반바지 축구바지,15800,15800,0
2018-06-01,657267020,D031010,주택수선재료,국산 접착식(스티커 방식)데코타일,11900,11550,-350
2018-06-01,630813598,C013050,운동복,불스원/레인OK/rainok/유리코팅/발수코팅/유리세정제/레인오케이/김서림방지/빗물발수,5400,5400,0
2018-06-01,341234766,I031010,장난감,프리스쿨토이즈 리틀타익스 트렁크라이드온(2종택1) /littletikes/리틀타익스붕붕카,34800,33060,-1740
2018-06-01,395185745,C013060,등산복,[블랙야크]B라이트다운자켓]역시즌 한정판매 남여 경량 구스다운자켓(대구신세계),60000,48450,-11550
2018-06-01,1530587622,C012020,원피스,MELODY F101 모카/코트/여자코트/겨울코디/겨울코트/자켓/점퍼 미국 여성토탈브랜드 멜,64700,64700,0
2018-06-01,1010232303,A012010,국산쇠고기,한우 명품 1호 (1++등급),420000,400000,-20000
2018-06-01,624459083,L021020,장신구,베이맥스 은침925 포스트 귀걸이/실버귀걸이,3950,3950,0
2018-06-01,1010232306,A012010,국산쇠고기,한우 명품 2호 (1++등급),380000,350000,-30000
2018-06-01,1010232308,A012010,국산쇠고기,한우 명품 3호 (1++등급),330000,320000,-10000
2018-06-01,649130145,L021060,유모차,[엔픽스]마블 기내반입 유모차 / 사은품3종,263000,221500,-41500
2018-06-01,191929329,C013040,청바지,[게스][18SS] MI1D9022 BBK 남 원워시 슬림일자,47900,46950,-950
2018-06-01,410615685,A012010,국산쇠고기,동원 캔63호,36550,36550,0
2018-06-01,1714966796,A022050,탄산음료,환타 웰치스 코카콜라 칠성사이다 마운틴듀 뚱캔모음,12900,12900,0
2018-06-01,1341195527,L021020,장신구,도리스 진주 초커 목걸이 초커네크리스 짧은목걸이 진,11290,11290,0
2018-06-01,493886526,E011060,의자,시스카 회의용의자 모음 다용도 사무용 야외 인테리어,25000,25000,0
2018-06-01,92660111,C011030,남자학생복,조끼 가디건 점퍼 모음전 바람막이잠바니트 모두의 스,24700,24700,0
2018-06-01,1178191781,C013040,청바지,[올젠]편안한착용감의 스판 데님팬츠 ZRY2DP1301/1302,45000,36000,-9000
2018-06-01,1001899800,C012040,여자학생복,[보니알렉스](보니알렉스) 섬머 시스루 가디건 (BBWZ637A),12200,11590,-610
2018-06-01,1778565560,L021010,손목시계,[바보사랑]JA-544 가죽시계,21600,21600,0
2018-06-01,764317571,L012010,면도기,도루코 일회용 면도기 PACE4/4중날 PACE6/6중날 FRESH,9000,8300,-700
2018-06-01,1483671094,E061020,섬유유연제,Biocera 세탁볼 원천특허정품 세제대용 친환경 워싱볼,80000,80000,0
2018-06-01,1116230442,A022050,탄산음료,동]나랑드 사이다 500mlx 20 초특가 행사중,11000,11000,0
2018-06-01,684835336,L021030,가방,투카노 STROZZO 스트로조 백팩 여행용/슬림/백팩/가방,49000,49000,0
2018-06-01,1778590520,L021020,장신구,[바보사랑]NON NON LOVE (GOLD),23000,23000,0
2018-06-01,1778590521,L021020,장신구,[바보사랑]NON NONE LOVE NEC (RED),25000,25000,0
2018-06-01,1778565565,L021010,손목시계,[바보사랑]JA-857 가죽시계,27000,27000,0
2018-06-01,1218349997,C014010,아동복,한국생산 프릴 도트 아기정장 3종(3-24개월)800010 유,64100,62180,-1920
2018-06-01,2087799368,D031010,주택수선재료,겔코트/frp수지/물탱크보수/모형제료/4kg,30800,30800,0
2018-06-01,1789668657,F012020,생리대,NEW 템포 레귤러 10매 x 3박스(총30매)/ 템포,11700,11000,-700
2018-06-01,1778565563,L021010,손목시계,[바보사랑]JA-855 가죽시계,23400,23400,0
2018-06-01,1871760745,C014010,아동복,주니어 아동 기모 맨투맨/후드티/후드집업/단체티,9400,9400,0
2018-06-01,959462647,E061020,섬유유연제,다우니 퍼퓸 블랙 기획 (1L+1L),11000,11000,0
2018-06-01,639881802,C013050,운동복,클릭앤미 내몸에 찰떡! 여름신상 트레이닝세트/롱티,5900,5900,0
2018-06-01,1156354908,E021010,침구,국내산 사계절 차렵이불+패드+베개세트/침구3종세트,33900,28500,-5400
2018-06-01,1710193188,I031040,생화,휴대용 LED후레쉬 NO.1 비상랜턴 손전등 미니펜라이트,3500,3220,-280
2018-06-01,794241322,C021040,실내화,나이키 에어맥스 95 올백 609048-109,118000,118000,0
2018-06-01,1398109394,A011010,쌀,2017년 참새방아쌀5kg 현미/찹쌀/잡곡 밥선생,14900,14900,0
2018-06-01,1430638075,I012010,컴퓨터,2018 삼성노트북9 NT900X3Y-A58WA 초경량799g 재고有,1156850,1099000,-57850
2018-06-01,462471291,A011030,찹쌀,[오색향미] 국내산 검정통보리 1Kg 흑보리/성현물산,10600,10600,0
2018-06-01,1252940946,F012020,생리대,시크릿데이 생리대 NEW 러브코튼 대형 14PX6팩/ 시크릿데이,18800,17680,-1120
2018-06-01,1215839670,C012020,원피스,빅사이즈/아이스/포켓/가디건,40230,36210,-4020
2018-06-01,1369463031,C013010,점퍼,여름 남성바람막이 경량 아웃도어점퍼 남여w026,14800,14800,0
2018-06-01,852543103,G011070,자전거,에이모션 TOURS GTS 소라 18단 로드자전거,199000,199000,0
2018-06-01,1168638311,C014020,유아복,배냇베이비 허리라인이 들어간 순면 아동 티셔츠,10780,10780,0
2018-06-01,989914935,A013130,오징어채,손질한참먹태130G/봉,7990,5990,-2000
2018-06-01,1320074708,L021020,장신구,Crystal Ver 캔디 문 스타 목걸이 큐빅귀걸이 별목걸,19430,19430,0
2018-06-01,505697787,E041010,식기,체크하트 식기세트/공기대접/접시/면기/찬기/홈세트,7500,6840,-660
2018-06-01,1843706591,E011060,의자,특가)학생의자SD300/책상의자/컴퓨터의자/사무용의자,62900,53010,-9890
2018-06-01,322796747,C013050,운동복,AS 드릴 탑(698916011) 긴팔트레이닝복 트레이닝복 스,102770,102770,0
2018-06-01,1778590519,L021020,장신구,[바보사랑]NON NON LOVE (SILVER),23000,23000,0
2018-06-01,1860178764,C013020,티셔츠,남녀공용 브이넥 반팔 티셔츠 T165TS160P/ 티비제이,5000,4500,-500
2018-06-01,1476873003,G022020,자동차타이어,[타이어플러스]피렐리 피제로 올시즌 275/40R19,380000,323000,-57000
2018-06-01,445817549,I011010,TV,인켈 TV 32인치TV TV모니터 A+급패널 돌비20W 직영AS,198940,189000,-9940
2018-06-01,1778590513,L021020,장신구,[바보사랑]NON NON SMILE (RED),23000,23000,0
2018-06-01,1396225194,C012040,여자학생복,8B-CA016 시크시스루가디건/ 데드라,61900,46430,-15470
2018-06-01,1778590514,L021020,장신구,[바보사랑]DOLLAR RNG (SKY),21000,21000,0
2018-06-01,1778590512,L021020,장신구,[바보사랑]NON NON SMILE (DEEP BLUE),23000,23000,0
2018-06-01,266492751,L021020,장신구,[폭스타일] 베르드레 큐빅 반지,14000,12740,-1260
2018-06-01,341976595,L021060,유모차,지비 (GB) 큐빗 기내반입 휴대용 유모차,360000,306000,-54000
2018-06-01,1778590517,L021020,장신구,[바보사랑]ODD EYE LOVE (SILVER),23000,23000,0
2018-06-01,1778590518,L021020,장신구,[바보사랑]ODD EYE LOVE (GOLD),23000,23000,0
2018-06-01,1778590515,L021020,장신구,[바보사랑]DOLLAR RNG (RED),21000,21000,0
2018-06-01,1778590516,L021020,장신구,[바보사랑]DOLLAR RNG (WHITE),21000,21000,0
2018-06-01,535293022,E011040,소파,[에보니아] 디바 2인소파/탈부착커버/패브릭천쇼파,195000,195000,0
2018-06-01,1778590422,L021010,손목시계,[바보사랑]JA-1031 가죽시계,28600,28600,0
2018-06-01,107059635,I011030,사진기,(컴온탑)니콘 D850 BODY (18년4월/가이드북/캐시백),3750000,3596900,-153100
2018-06-01,146108120,A019140,이유식,[엘빈즈]클래식 아기국 반찬 볶음밥 골고루(랜덤) 8팩,26900,26900,0
2018-06-01,989853429,A016100,수박,파인애플오렌지청 500G,9900,9900,0
2018-06-01,2138378054,C012040,여자학생복,비키 플레어핏 밸트라인 반팔블라우스TQBAE2468,23200,23200,0
2018-06-01,439985479,E041050,냄비,키친아트 스텐냄비/블랙경질냄비/러브쿡경질냄비 모음,10900,10900,0
2018-06-01,1180800581,C013050,운동복,45_고구마베이비 아기옷-무형광 라이언 자카드 민소매,10910,10590,-320
2018-06-01,2074623894,A011140,부침가루,하루노유키 피레네 플레인 바움쿠헨 답례품 디저트 간,29440,29440,0
2018-06-01,496382333,A012010,국산쇠고기,(롯데햄 4호 선물세트) 로스팜 200g x 16캔 국내산 돼,76600,68180,-8420
2018-06-01,774235091,A017250,고사리,(맛나)#깻잎(밀양.25속),26600,23940,-2660
2018-06-01,1778590423,L021010,손목시계,[바보사랑]JA-1030 메탈시계,39600,39600,0
2018-06-01,104202249,A022030,생수,박스포)다이아몬드생수/아이시스/삼다수 300ml/2L/500,8480,8480,0
2018-06-01,1591519569,L012090,기초화장품,마몽드 대용량 스킨 320ml : 로션 320ml 선택,6100,6100,0
2018-06-01,231361936,C013010,점퍼,남자아우터 데님배색 사파리 야상 자켓 봄자켓 봄점퍼,60450,60450,0
2018-06-01,1632524612,C013010,점퍼,푸조 사파리점퍼 스판바지 상하별도판매 기능,18800,18430,-370
2018-06-01,988241897,A021010,커피,누보커피필터(3~4인용) 100매,3700,3700,0
2018-06-01,1305795158,E021010,침구,국산 간절기 차렵이불 패드 베개 /이불패드세트 3종,29800,29800,0
2018-06-01,1984907894,C013010,점퍼,봄기획.득템찬스.자켓트렌치야상.55-110..빅사이즈,29900,29900,0
2018-06-01,989853430,A016100,수박,파인애플을품은오렌지청 500G,9900,9900,0
2018-06-01,175475461,E031130,보온매트,한일의료기 패밀리 슬림매트 4인용방석,39000,39000,0
2018-06-01,175475462,E031130,보온매트,한일의료기 패밀리 샤링 전기매트 더블,156000,156000,0
2018-06-01,397783498,A013090,전복,국내산 완도 깐 바지락살 1kg/탱탱한살/바지락/조개,21000,21000,0
2018-06-01,1922855376,C013050,운동복,(1+1 EVENT) 16ss 첨이첨이 힐링멜로우나시세트 레이온 유아동의류 아동의류 공용 상,30000,30000,0
2018-06-01,846432476,L012030,칫솔,지앤마 유아 아기/어린이 전동칫솔 본체/리필 6p,11900,11900,0
2018-06-01,1441120968,A019060,된장,신송된장3kg 고추장 간장 쌈장 재래식,9850,9850,0
2018-06-01,1463371395,L012090,기초화장품,참존nc1 퓨플 하이드로 모이스춰 로션/대용량 310ml,20900,20900,0
2018-06-01,451916282,C013010,점퍼,빅사이즈 패딩 점퍼 MC 1300,98640,98640,0
2018-06-01,1030363283,C013050,운동복,나이키 아디다스 트레이닝복 세트 단체 츄리닝 기모,69800,69800,0
2018-06-01,1122678345,E041010,식기,루미낙 루미락 나뭇잎 접시28대6p,43400,41230,-2170
2018-06-01,376926705,C013010,점퍼,봄야상점퍼 남자바람막이 블루종 아웃도어 등산작업복,49800,39800,-10000
2018-06-01,278620427,A011090,국수,오뚜기 진라면 40개/신라면/비빔면/짜파게티,19300,19300,0
2018-06-01,1034178896,A019060,된장,[권기옥명인] 메주 된장 500g,13900,13900,0
2018-06-01,653867356,A011130,시리얼,백설 부침가루 1kgx10개,31150,31150,0
2018-06-01,1034178897,A019060,된장,[권기옥명인] 메주 된장 930g,22900,22900,0
2018-06-01,1034178898,A019060,된장,[권기옥명인] 메주 된장 2kg,44900,44900,0
2018-06-01,333584042,C012030,여자상의,지홍 여름신상 원피스66~빅사이즈 루즈핏 롱 쉬폰린넨,34900,34900,0
2018-06-01,989076940,E061020,섬유유연제,진짜그대로 베이킹소다 3.0L 1개,17500,7900,-9600
2018-06-01,1593975490,C012060,여자내의,#NAME?,29400,28520,-880
2018-06-01,958954080,E041010,식기,[폴란드그릇1탄] 자크라디 블루버블 전품목 60 SALE 택1,7200,7200,0
2018-06-01,1407710826,A017160,오이,착한송이송향버섯 최고급1kg,60000,51000,-9000
2018-06-01,1314859571,C012060,여자내의,SK1556-마론 플레어 롱스커트 FREE(44~66) A라인치마,44000,43560,-440
2018-06-01,402311944,C012060,여자내의,슬랙스 밴딩배기 와이드팬츠 Free~4XL 빅사이즈여성,26800,25800,-1000
2018-06-01,1982462415,C012020,원피스,코트 WS CT 01 윈드브레이커 싱글 코트 반코트 봄코트 바바리 롱코트,90870,80880,-9990
2018-06-01,1804356975,L021020,장신구,[바보사랑]핑크 작은 꽃 은침귀걸이 데일리 이어링,5520,5520,0
2018-06-01,443830977,C013040,청바지,MHASM-WN 505-506 빅사이즈남성7부청바지 빅사이즈청,39410,39410,0
2018-06-01,466833287,C013020,티셔츠,아스토레 골프 반집업티셔츠 ORG LSTM10031 여성골프,82290,82290,0
2018-06-01,1804356976,L021020,장신구,[바보사랑]프린세스 진주 드롭귀걸이,9520,9520,0
2018-06-01,1804356973,L021020,장신구,[바보사랑]로망스 블루 드롭귀걸이,8720,8720,0
2018-06-01,1804356974,L021020,장신구,[바보사랑]물방울 드롭 은침귀걸이,8720,8720,0
2018-06-01,1804356972,L021020,장신구,[바보사랑]큐빅 하트 롱드롭 귀걸이,10320,10320,0
2018-06-01,1206234379,A011090,국수,오뚜기 컵누들 12입/15입 무료배송,12900,12900,0
2018-06-01,440291831,A018090,잼,오뚜기 포도잼300gX15개(1박스)블루베리잼 포도잼 딸,80500,70840,-9660
2018-06-01,530482834,C012060,여자내의,백합주름치마 블랙체크 전체 주름 교복치마 교복 예쁜,55060,53410,-1650
2018-06-01,640843117,A017150,버섯,콩나물 키우기 1인용 만들기 세트 집에서 키우는 방법,10000,9700,-300
2018-06-01,175475484,E031130,보온매트,한일의료기 패밀리 샤링 전기매트 싱글,134000,134000,0
2018-06-01,370792786,C013050,운동복,코리아 울트라파워9인치광택기 12V전용/차량용 광택기,54300,53220,-1080
2018-06-01,341016616,C011030,남자학생복,[예작셔츠]남성 반소매 일반핏 미디엄체크 YJ8MBA994,30000,25500,-4500
2018-06-01,1449327541,E011010,장롱,[봄맞이10%할인] 이느낌 옷장/이불장/투서랍/장롱,59000,53100,-5900
2018-06-01,1804356977,L021020,장신구,[바보사랑]작은 크리스탈 은침 귀걸이,9520,9520,0
2018-06-01,621580385,E051030,디지털도어록,사은품증정/게이트맨 디지털 도어락 WV-43/카드키4개,79000,79000,0
2018-06-01,2014833427,A022050,탄산음료,탑씨1.5L x 12펫 음료수 탄산음료 오란씨 쥬스,11300,11300,0
2018-06-01,1695772359,C012040,여자학생복,[시슬리]시스루 슬림 니트가디건(SAKC40631아이보리),101400,86190,-15210
2018-06-01,559083978,A016090,참외,첫출하/달콤아삭 꿀참외 4kg,9900,9900,0
2018-06-01,1282319297,F012050,의료측정기,한독약품 바로잰 혈당측정기+시험지50+솜50+채혈침50,20000,18140,-1860
2018-06-01,384978145,C013050,운동복,차량용 5단 멀티 컵홀더 다용도 수납 홀더 컵케이스,17700,17700,0
2018-06-01,895680325,A017300,미역,풀무원 두번 구운 김밥김 (10매),2450,2450,0
2018-06-01,1788174107,F011120,인삼,강원도 토종 새싹삼 100/200뿌리 산삼 장뇌삼 산양삼,39900,39900,0
2018-06-01,472383539,C013040,청바지,DDP-022 연청 포인트스크레치 반바지 청반바지 반바지,25190,25190,0
2018-06-01,1539220746,C012030,여자상의,여성 AMOUR 탑 레이어드 프릴 원피스,13900,13900,0
2018-06-01,592857697,C013020,티셔츠,여름신상/반팔티/반팔카라티/7부티/티셔츠/카라티,15800,14800,-1000
2018-06-01,1875703421,E031010,전기밥솥,쿠첸 10인용 IH 전기압력밥솥 CJH-PA1001IC,322000,299000,-23000
2018-06-01,1898440899,C011050,남자내의,반바지/BB면반바지/쿨반바지XLㅡ4XL/37종신상빅사이즈,15900,15900,0
2018-06-01,1617765273,C013050,운동복,여성트레이닝 반바지/남녀빅사이즈/여름추리닝/츄리닝,14900,14900,0
2018-06-01,1358720996,E031120,믹서,[바이타믹스] 바이타믹스 콰이어트원 업소용 믹서기 블렌더 대용량D,2030000,1910000,-120000
2018-06-01,1241582842,I053010,공책,근영사)아이디얼 양장노트(무지_엘로우)박스(24개입),125470,125470,0
2018-06-01,67690205,C011050,남자내의,S-5XL 스판밴딩 카모 조거팬츠 남자조거바지/밴딩팬츠,25800,22800,-3000
2018-06-01,1831527511,A019140,이유식,[아이배냇] 베베 햅쌀 아기 이유식(7종택1),2240,2240,0
2018-06-01,1778590450,L021020,장신구,[바보사랑]UNISEX CHAIN NECKLACE,12000,12000,0
2018-06-01,989076939,E061020,섬유유연제,쉬슬러 3배 진한 고농축 액체세제 3.05L 1개,17500,8900,-8600
2018-06-01,1778590451,L021020,장신구,[바보사랑]UNISEX ROUND NECKLACE,12000,12000,0
2018-06-01,1269705728,C013010,점퍼,소매 다운 집업점퍼 S-3XL SD-6629 다운집업 여자점퍼,64730,64730,0
2018-06-01,923414005,E031080,선풍기,[바보사랑]빈크루즈 미니 PTC 온풍기/BCPH-1700R/전기/미니/히터,37800,37800,0
2018-06-01,1778590454,L021020,장신구,[바보사랑]CROSS CHAIN NECKLACE,12000,12000,0
2018-06-01,1778590455,L021020,장신구,[바보사랑]PLUMP RING (GOLD),25000,25000,0
2018-06-01,1778590452,L021020,장신구,[바보사랑]HEART NECKLACE,12000,12000,0
2018-06-01,1778590453,L021020,장신구,[바보사랑]PLUMP RING,25000,25000,0
2018-06-01,1884997824,G022020,자동차타이어,넥센타이어 고급형 CP672 205/60R16 정품 무료배송,74900,63240,-11660
2018-06-01,1200171283,C013020,티셔츠,[JEIKEI]줄무늬 얼룩 강아지 티셔츠 [JH6TS002Z][갤러리아],10000,8700,-1300
2018-06-01,2071887861,C012040,여자학생복,라엘 가디건 LBR0672 여성가디건 가디건 / 참고 여성,97500,82880,-14620
2018-06-01,479745014,C012040,여자학생복,[쉬즈넘버나인]리즈 브이넥 민소매 니트,17900,17010,-890
2018-06-01,1300925523,C013030,스웨터,[동대문] (색상 : 네이비 | 사이즈 : XL(105)) BIGW,56200,56200,0
2018-06-01,1461049906,I012060,저장장치,로지텍코리아 B100 USB 유선마우스,7500,6900,-600
2018-06-01,2053003286,A021010,커피,그린커피빈 분말 가루 녹색 커피 콩 생두 그린빈커피,30900,30900,0
2018-06-01,441166242,G011070,자전거,알톤 여성용자전거 밀라노 클래식 24인치/26인치 7단,126500,113850,-12650
2018-06-01,988987449,A016060,감,청정원 츄앤리얼 감츄 38g×10봉,25900,22900,-3000
2018-06-01,173032544,D031010,주택수선재료,노루페인트 순앤수 항균 수성페인트 1L 방문가구용,12100,11600,-500
2018-06-01,1778590458,L021020,장신구,[바보사랑]CIRCLE DROP EARRING,12000,12000,0
2018-06-01,242511868,I053010,공책,트와이스 노트 2종 세트 사각사각 한땀한땀 줄노트 라,13290,13030,-260
2018-06-01,1323292689,E061080,키친타월,유한킴벌리 빨아쓰는 위생행주 독일 부직포 수세미,8850,8850,0
2018-06-01,1778590459,L021020,장신구,[바보사랑]UNBALANCE PEARL EARRING,12000,12000,0
2018-06-01,1778590456,L021020,장신구,[바보사랑]HEART EARRING,12000,12000,0
2018-06-01,1778590457,L021020,장신구,[바보사랑]SIMPLE CHAIN EARRING,12000,12000,0
2018-06-01,56334510,E031030,전자레인지,대우전자 20L 전자레인지/전자렌지 KR-L200DMP,106740,106740,0
2018-06-01,760168334,A015020,식용유,만토바 트러플오일 스프레이 250ml /송로버섯향,13000,13000,0
2018-06-01,1501941095,I011020,영상음향기기,5종사은품증정!소니 MP-CL1A 모바일프로젝터,519790,499000,-20790
2018-06-01,1778590483,L021020,장신구,[바보사랑]UNBALANCE CHAIN EARRING,12000,12000,0
2018-06-01,1778590484,L021020,장신구,[바보사랑]GOLD DROP EARRING,12000,12000,0
2018-06-01,1778590481,L021020,장신구,[바보사랑]BOLD CHAIN EARRING,8900,8900,0
2018-06-01,1778590482,L021020,장신구,[바보사랑]CROSS CHAIN EARRING,12000,12000,0
2018-06-01,1778590487,L021020,장신구,[바보사랑]NONENON TAPE RING (SILVER),29000,29000,0
2018-06-01,651275750,A017150,버섯,[엉클팜]싱싱한 삼색 혼합 파프리카 3kg / 무료배송,24500,23280,-1220
2018-06-01,1778590488,L021020,장신구,[바보사랑]NONENON TAPE RING (GOLD),29000,29000,0
2018-06-01,451176310,A015010,참기름,해정원 고소한 참기름 1.8L2개 기름 참기름 고소한참,78240,70420,-7820
2018-06-01,1778590485,L021020,장신구,[바보사랑]PLUMP RING 2 (GOLD),27000,27000,0
2018-06-01,1778590486,L021020,장신구,[바보사랑]CIRCLE RING (GOLD),24000,24000,0
2018-06-01,1198079691,C021020,구두,로렌 4.0cm 남성 블로퍼 / 참고 남성구두 블로퍼 정장,66500,56530,-9970
2018-06-01,73817712,C013010,점퍼,[그랜피니]집업/양털/후드/긴바지/데일리/무료배송,39900,39900,0
2018-06-01,1455113833,A015020,식용유,[CJ직배송] 백설 포도씨유 900mlX3개,15900,15900,0
2018-06-01,2097516370,C013010,점퍼,[캐주얼 후드점퍼]탈부착 가능/멋스러운 연출/민트 아이보리 색상,125000,119000,-6000
2018-06-01,88534493,C013020,티셔츠,[SI][18 여름]어깨트임 레터링 티셔츠(SUI9851)(SUIBE9851)[갤러리아],39000,31200,-7800
2018-06-01,1495223567,C013020,티셔츠,빅사이즈 DWW083 단가라 트임 티셔츠 801 여성빅사이,51960,51960,0
2018-06-01,1961255298,A014010,우유,파스퇴르 무항생제유산균우유(홈밀크) 200ml 14개,17830,17830,0
2018-06-01,2517085,L012090,기초화장품,라네즈 기초 스킨/로션/크림/에센스/카밍/워터뱅크,17700,17700,0
2018-06-01,1362698544,C011050,남자내의,빈폴 바지/헤지스/라코스테/면바지/청바지 사랑채,47000,47000,0
2018-06-01,1419869287,I031040,생화,[HH03-ZK] 500m 서치라이트 사냥써치 탐조등 유해조수,105000,94670,-10330
2018-06-01,1992675473,C013020,티셔츠,타이틀리스트 TITLEIST 버튼 다운 폴로 셔츠 TSMC1732,79900,79900,0
2018-06-01,87379062,I053010,공책,옥스포드 리갈패드 A5/ 옥스포드노트 리갈패드 옥스포,3500,2400,-1100
2018-06-01,1352010694,C012020,원피스,[스테파넬]럭셔리 루즈핏 벨트원피스(SF8MOP723)(센텀시티점),142800,115720,-27080
2018-06-01,511870886,E061060,살충제,바퀴파크 초강력 끈끈이 100개입 해충 왕바퀴벌레 끈,37190,37190,0
2018-06-01,1301756844,C013020,티셔츠,베이직 후드티 BTT0032 남성티셔츠 무지후드티 (YA020,35100,29840,-5260
2018-06-01,1778590489,L021020,장신구,[바보사랑]NON NON SMILE (EMERALD),23000,23000,0
2018-06-01,1747231955,A019160,밑반찬,델리우드/ 골라먹는 수제반찬 100종 /밑반찬/반찬/집,3700,3700,0
2018-06-01,774129832,L021030,가방,브랜드백팩 학생가방 노트북가방 여행백팩 남자백팩,41700,41700,0
2018-06-01,1955230454,G011070,자전거,하이브리드22인치 나이트로7/셔플카프리스헤르츠큐티,95840,88180,-7660
2018-06-01,1448940,E051030,디지털도어록,에버넷EN750/목문용도어락/방문번호키/나무문용,81000,74520,-6480
2018-06-01,1841920690,A013030,조기,제수용 부세조기 1박스(12마리) 황금물고기 조기 굴비,30500,30500,0
2018-06-01,1129056062,A018010,초콜릿,자유시간/초콜릿/초코바/트윅스/크런키/가나초코바,5000,5000,0
2018-06-01,381699057,C013020,티셔츠,지오다노 01018501 반팔 피케 폴로(솔리드) 018501 [2018년 S/S],15800,13120,-2680
2018-06-01,1487437812,C013010,점퍼,[미스티에이치][미스티에이치] 스냅 버튼 7부 소매 점퍼,16100,13210,-2890
2018-06-01,2066870296,C011050,남자내의,지오다노 남 라이트웨이트 슬림 테이퍼드 치노 118524,22950,22950,0
2018-06-01,440229862,C012020,원피스,[블루종]린넨 롤업 더블 자켓_[B1806JK028B],99000,78310,-20690
2018-06-01,1789333911,I031040,생화,파라곤/12000 루멘/L2/10발/국내 최강랜턴/풀셋/,149000,129000,-20000
2018-06-01,1628151490,F012020,생리대,예지미인 진한면 중형 16p/ 예지미인,2750,2750,0
2018-06-01,2023263548,C013050,운동복,자동차 LED 경광봉 다기능 LED경광봉 지시봉 비상등 안전용품 안전봉 경광봉 교통신호,9500,9400,-100
2018-06-01,1970540071,C012040,여자학생복,빅사이즈 DMS1133 레이스 옆리본 조끼 801S 조끼 패션,42750,42750,0
2018-06-01,565537067,C013050,운동복,캐릭터 벨트레 안전벨트 경고음 차단 클립 국산차&수,5000,4850,-150
2018-06-01,2111399744,E031040,전기레인지,크로바온장고보온고비누제작50인70인100인CL-50 CL-70,145000,145000,0
2018-06-01,184412581,C013010,점퍼,푸마 간절기 경량패딩자켓 멀티트레이닝자켓 특가,39800,39800,0
2018-06-01,473189878,C013040,청바지,ACCHT8037 밑단 데미지트월 데님 5부팬츠 남성팬츠 5,36010,36010,0
2018-06-01,1087434199,C012020,원피스,빅사이즈 울 코트 DB 97번 울코트 트랜치코트 빅사이즈코트 모직코트 패딩코트 코트,147380,131170,-16210
2018-06-01,1745410983,A011170,떡,HACCP 떡국떡1.4kg/쌀떡/순쌀떡,1990,1990,0
2018-06-01,827616934,C014010,아동복,신상)아동목폴라 주니어목폴라 아동티셔츠 주니어티,8900,8900,0
2018-06-01,188269945,C021020,구두,[로드워크][신문광고정품]에어크로스오버신사화/,141000,141000,0
2018-06-01,897562710,A019080,고추장,해찬들 새콤달콤초고추장 500G,4250,4250,0
2018-06-01,71634395,A013170,생선통조림,유동 번데기탕 캔 구수한맛 280g X 24EA_1BOX 번데기,50490,50490,0
2018-06-01,482435941,C012060,여자내의,밴딩스커트팬츠/슬랙스/치마바지/와이드팬츠/통바지,9900,9900,0
2018-06-01,948608226,C013050,운동복,아트로마 페루찌 키홀더/키고리/열쇠고리,7900,5640,-2260
2018-06-01,897562711,A019080,고추장,[해찬들]해찬들 새콤달콤 초고추장 (300g),3690,3690,0
2018-06-01,1831461879,C012060,여자내의,[파프리카]린넨 치마 반바지_N82SL403(센텀시티점),20000,16220,-3780
2018-06-01,986983375,C012060,여자내의,청스커트 신상 청 데님 치마 스커트 빅사이즈허밍퍼플,20000,19800,-200
2018-06-01,632901526,A012010,국산쇠고기,(목우촌 선물세트)맛있는 스페셜 S호 x 4개 고급 쇼핑,201700,177500,-24200
2018-06-01,1312627120,E061060,살충제,기어다니는 벌레 다잡는 마툴키플러스 300ml 킬라 벼,20590,20590,0
2018-06-01,306195331,C013020,티셔츠,[앨빈클로]교복위에 필수템! 따뜻한 양털 후드집업,32900,24900,-8000
2018-06-01,635374928,C012020,원피스,슬림모직베이직코트,64700,64700,0
2018-06-01,718792158,C013020,티셔츠,티코리아나 대구공장 단체티 면티 라운드티 흰티 반티,2400,2400,0
2018-06-01,537562954,A014020,분유,[베비언스] 뉴트리밀크 오곡 180ml 24입,37900,37900,0
2018-06-01,1429383091,C013010,점퍼,[플라스틱아일랜드]배색 자수 점퍼(PJ2WZ462)(광주신세계),65400,53060,-12340
2018-06-01,706485534,E011050,책상,라운딩 고급형 집중력 책상/독서실 책상/랩/책상/책장,28900,26900,-2000
2018-06-01,50173126,C011030,남자학생복,인터페이스제작 특양면가디건 For Me 포인트후드집,29700,29700,0
2018-06-01,2068164917,I031010,장난감,(신상출시) 베베포레 물놀이 스티커/장난감/퍼즐,9200,9200,0
2018-06-01,747353870,C011050,남자내의,[오리지널핏] 다니엘크레뮤 18SS 쿨맥스 라이크라 슬랙스 3종,78000,78000,0
2018-06-01,92698580,A019160,밑반찬,[농협] 우리땅우리콩 전통식 재래된장/간장/고추장,11000,9900,-1100
2018-06-01,1778590490,L021020,장신구,[바보사랑]NON NON SMILE (GREEN),23000,23000,0
2018-06-01,1090549701,A016090,참외,성주 참외 4kg이내/ 싱싱한 제철과일,8900,8900,0
2018-06-01,1296187764,C012060,여자내의,[밸리걸] 플라워프린트 랩 점프수트 973130,29900,25420,-4480
2018-06-01,604509241,L021030,가방,ssamzie 플로럴패턴 보스톤외 백팩 11종 크로스백,14700,14700,0
2018-06-01,366683796,C015040,장갑,실버D 국내제조 성인용 손싸게 2개 1세트 노인용품 지,88710,86940,-1770
2018-06-01,1709458159,C013010,점퍼,[트루젠][트루젠S+] 엠보싱 집업점퍼 SS5U5MGJ020410,42000,38640,-3360
2018-06-01,1092118904,E061040,부엌용세제,애경 항균 트리오 14kg/주방세제x10개 퐁퐁,16300,16300,0
2018-06-01,245885238,C012040,여자학생복,빅사이즈 브이오픈니트조끼 RM1704 빅사이즈 여성의류,36200,35480,-720
2018-06-01,661486796,A017110,감자,[아임제주] 제주 구좌 100% 착즙 당근 주스,36000,36000,0
2018-06-01,1564045373,F012020,생리대,500원할인)귀애랑 생리대 대형180P/중형200P 바디피트,25900,25400,-500
2018-06-01,562948395,E011050,책상,코너높이조절책상R 블랙브라운 화이트 베칸트 160x110,1168670,1040120,-128550
2018-06-01,1132027530,A022010,주스,[코카콜라] 미닛메이드 알로에 350ml(페트) x24개,20670,19900,-770
2018-06-01,1998258618,C011030,남자학생복,당일발송 반팔/긴팔 솔리드 캐주얼 체크 와이셔츠,14800,14800,0
2018-06-01,242631686,I031070,애완동물관리비,프로케넥스 Q+ 30 119(260g)16x19 테니스라켓,255000,225680,-29320
2018-06-01,1903805376,E031110,청소기,퀸즈메이트 스팀싹싹 핸디형 스팀청소기 비제이몰,69000,69000,0
2018-06-01,1630201552,C012030,여자상의,스토어10%할인 [위드이픈]여름원피스/블라우스/린넨,6900,6900,0
2018-06-01,614001815,A013170,생선통조림,CJ 알래스카연어캔 100gX6개입/통조림,10900,10900,0
2018-06-01,1754684957,E051020,건전지,파나소닉 소니 CR2032(5알)CR2025(5알)코인배터리,1500,1400,-100
2018-06-01,897706921,E041080,부엌용용구,[루미아]루미아 갈비 가위,3990,3990,0
2018-06-01,479290913,C013010,점퍼,[게스키즈](2018년여름신상품)패커블바람막이점퍼G83KSJ030P1[갤러리아],77000,59290,-17710
2018-06-01,1154942989,L021010,손목시계,SKMEI 50M방수 만보기 다기능 손목시계,11900,11900,0
2018-06-01,398824952,C012040,여자학생복,여성 무스탕 조끼_베스트 여성털조끼 방한조끼 털조끼,35050,35050,0
2018-06-01,1094031375,E031110,청소기,샤오미로봇청소기 2세대 한글지원 미지아2 물걸레청소,590000,590000,0
2018-06-01,1123188679,A013090,전복,부경 냉동반가리비 2.1kg(210gx10개),62590,62590,0
2018-06-01,1072223757,L012090,기초화장품,단독 로즈 워터 토너 500ml/ 마몽드,25000,12500,-12500
2018-06-01,1347173135,A014020,분유,프리미엄 산양분유 1~4단계 3캔X800g,118800,118800,0
2018-06-01,1336897499,C013060,등산복,슬레진저아웃도어/여름긴팔반팔/등산티냉감등산복셔츠,5800,5200,-600
2018-06-01,1183290490,E061030,전구,필립스 FPL 36W 형광등 삼파장 PL 55W 오스람 전구 등,1480,1340,-140
2018-06-01,1713687262,E011040,소파,1인쇼파 좌식소파 패브릭소파 커버탈착세탁가능,45000,37000,-8000
2018-06-01,2118637048,C013020,티셔츠,갠소 신상 핏예술! 반팔티/무지/롱티/티셔츠/빅사이즈,16900,16900,0
2018-06-01,470621619,C013050,운동복,[스타일리쉬위즈] (색상선택 : 블랙) 3M 자동차 문콕 방지,11810,10770,-1040
2018-06-01,1722215459,A019170,냉동식품,사은품증정/아하감자찐만두/만두/간식,6500,6500,0
2018-06-01,349545044,E011040,소파,인텍스 에어쇼파/소파/의자/캠핑/빈백/에어매트/침대,22480,22480,0
2018-06-01,969734339,E011020,침대,패드 거치형 폴딩 테이블,33470,33470,0
2018-06-01,1066988577,E021020,커튼,[홈앤창]방한 방풍 3중암막커튼/거실커튼/안방커튼,18900,17390,-1510
2018-06-01,988096564,E061010,세탁세제,초L) 베이킹소다 세탁세제 2KG,3990,3990,0
2018-06-01,988241869,E041040,프라이팬,초L) 셰프양면팬 24cm,29900,29900,0
2018-06-01,988241868,E041040,프라이팬,초L) 셰프그릴팬 24CM,17900,17900,0
2018-06-01,2117133076,A019130,스프,오뚜기/오뚜기스프1kg/스프/쇠고기/양송이/크림/옥수수/야채스프/대용량/식자재/오뚜기,4900,4900,0
2018-06-01,1221125506,F011150,건강기능식품,국산 블랙 미숫가루 식사대용 선식 검은콩가루 팥가루,11000,11000,0
2018-06-01,349643432,A018080,설탕,CJ 백설설탕/갈색설탕 5kg/유자청/레몬청,6950,6950,0
2018-06-01,141121994,C013020,티셔츠,유라비 여름신상 오픈 민소매 반팔 핫팬츠 반바지,2900,2900,0
2018-06-01,1126142886,A013090,전복,부경 냉동반가리비 2.1kg(210gx10개),65500,65500,0
2018-06-01,2139728790,C013010,점퍼,아디다스 유소년 콘디보16 스타디움자켓 (AN9871 ),139570,124220,-15350
2018-06-01,2103308521,E031010,전기밥솥,쿠쿠압력밥솥고무패킹 분리형커버 이중모션6/8/10인용,4900,4700,-200
2018-06-01,989973524,A011140,부침가루,[풀무원] 토이쿠키 만들기 (300g)x5개,44900,44900,0
2018-06-01,1617212437,C013010,점퍼,겨울패딩 패딩점퍼 JK543W 남자패딩 패딩점퍼 패딩 점퍼 빅사이즈패딩 패딩점퍼,93880,83560,-10320
2018-06-01,1283549370,C013020,티셔츠,T748-세련된 여성 데일리 티셔츠 프린지t 레이스티셔,29880,28390,-1490
2018-06-01,155728159,A018090,잼,트라피스트수녀원 유기무화과잼 410g 무화과잼 과일,17590,17590,0
2018-06-01,1062071382,C013050,운동복,재규어 동전통 다용도함 재떨이함 XJ XE XF JAGUAR,25000,22310,-2690
2018-06-01,1299381890,A018020,사탕,대용량 사탕 업소용사탕 막대사탕 봉지사탕 디저트,8500,6700,-1800
2018-06-01,823240584,A011010,쌀,경기미 아끼바리쌀 20kg /쌀20kg,52900,52900,0
2018-06-01,1153073136,C021040,실내화,[나이키]우먼스 에어맥스 테아 NIKE 599409-020,59880,59880,0
2018-06-01,370851877,A021010,커피,카카오닙스/폴리페놀/카테킨/카카오닙/카카오빈/미국,19400,19400,0
2018-06-01,1841319959,C021010,아동화,SNS소문난 아동화 BEST 크록스 외 슬립온 젤리슈즈,24800,24800,0
2018-06-01,1365497774,L021050,우산,11//woman raincoat 여성레인코트 성인여성비옷 등산,20000,19500,-500
2018-06-01,1798442405,A016160,과일가공품,블루베리(건조 한끼 350g),20130,20130,0
2018-06-01,988241862,E041040,프라이팬,초L)셰프프라이팬26CM,16900,16900,0
2018-06-01,571342419,F012010,종이기저귀,군기저귀 슬림앤드라이밴드형/소프트팬티형 3팩 모음,28900,28900,0
2018-06-01,2068534405,L021030,가방,천연소가죽 여성백팩 가죽백팩 천연가죽백팩,34800,34800,0
2018-06-01,959555087,A014040,발효유,동원 비피더스 명장 베리믹스(150ML*8입),4090,2600,-1490
2018-06-01,1469786588,C011050,남자내의,여니트9부 다양한 캐릭터 부드러운 숙녀면 니트파자마,9460,8420,-1040
2018-06-01,502860724,C012060,여자내의,데니 플레어 청 미디스커트청치마 SD-5036 롱청치마,19860,19860,0
2018-06-01,777876376,A013030,조기,가거도 참조기 12미 19-22cm 청정지역 조기 조기구이,30000,29700,-300
2018-06-01,1339121721,C015040,장갑,큐브 포인트 피혁장갑(남성) 남성용장갑 장갑 가죽장,12700,12700,0
2018-06-01,2047012251,C021040,실내화,남여공용 커플 시원한 통풍 키높이 여름 슬립온 단화,31500,29800,-1700
2018-06-01,408362562,A013160,맛살,올리브녹차 돌자반 70gx20개 입안에서 살살녹는 고,57600,57600,0
2018-06-01,447677151,E011050,책상,스틸 인더밴 책상 시리즈 입식 컴퓨터책상 철제테이블,109000,105730,-3270
2018-06-01,410831201,C013010,점퍼,빅사이즈 데일리웰론후드패딩 WWC1711 데일리웰론후드,63820,57440,-6380
2018-06-01,168268071,L021020,장신구,럭셔리 한글/영문판 주기도문 고급 실버반지 (20921sr) 커플링 인기 실버반지 골드조아,28000,28000,0
2018-06-01,448435478,A018110,물엿,해표포도씨유900mlx12개(box),94000,94000,0
2018-06-01,508146959,E021020,커튼,20% 쿠폰할인! 승승장구 1+1 암막커튼 초특가,10900,10900,0
2018-06-01,645052075,C013050,운동복,안전 경광봉/마트판매용 자동차용품판매용 세차장납품,8100,7460,-640
2018-06-01,562924394,E061050,청소용세제,[유한락스]레귤러 1Lx3개/2L/펑크린/욕실/곰팡이/도마,7900,7900,0
2018-06-01,989877490,L012040,치약,메디안 미니언즈 치약 초코민트 75G*2*3,9900,8900,-1000
2018-06-01,948224116,C013020,티셔츠,듀클라이 신상 반팔티 빅사이즈 티셔츠 남여공용,9900,9900,0
2018-06-01,988241896,A021010,커피,누보커피필터(1~2인용) 100매,3200,3200,0
2018-06-01,989877491,L012040,치약,메디안 미니언즈 치약 체리쥬빌레 75G*2*3,9900,8900,-1000
2018-06-01,988096597,A011170,떡,CJ 밀당의고수 국물떡볶이 421.5G,4980,3990,-990
2018-06-01,643955786,E041010,식기,leah 도자기 냉면기/볼(선택) 그릇 냉면그릇 그릇세트,10000,9900,-100
2018-06-01,2088447424,F012010,종이기저귀,18년형 에어핏팬티 기저귀 8팩 (대형/특대형),87000,87000,0
2018-06-01,989877489,L012030,칫솔,메디안 미니언즈칫솔3단계_2입 (여아)*3,9900,8900,-1000
2018-06-01,989877488,L012030,칫솔,메디안 미니언즈칫솔3단계_2입 (남아)*3,9900,8900,-1000
2018-06-01,1115364306,L021030,가방,노트북 캐쥬얼 여행 남자 여자 여행용 서류 백팩 가방,49800,49800,0
2018-06-01,1276517441,E011060,의자,식탁의자/원목/식당/등받이/인조가죽/음식점/카페/매,22900,22900,0
2018-06-01,1977471458,A018060,스낵과자,생각과자/간식/안주과자/벌크과자/대용량과자,5000,5000,0
2018-06-01,575220194,E061040,부엌용세제,자연퐁 주방세제 3.1kg용기/솔잎/오렌지/1개~4개/퐁퐁,8900,8900,0
2018-06-01,251423634,L021020,장신구,투톤반지/무광스지/프로포즈/예물/JC,278000,278000,0
2018-06-01,345670720,A017220,양파,국내산 믿을수 있는 우리 농산물 흙쪽파 1단(대)×3개,6440,6440,0
2018-06-01,1318837703,C015040,장갑,뱅키드 장갑 터치장갑 기본장갑 요술장갑 군대장갑 동,18430,18430,0
2018-06-01,1349714837,C013010,점퍼,[업타운홀릭]놓치면 후회! 베스트 여름신상,19800,19800,0
2018-06-01,1970517693,I053010,공책,신학기 과목노트(음악)(10개입)-랜덤 과목노트 학교음,11720,11720,0
2018-06-01,1112411594,A015020,식용유,코코라이프 유기농 코코넛오일 쿠킹오일 500ml × 3개,35000,17500,-17500
2018-06-01,420755024,C012020,원피스,알파카 모혼방 하프코트 MRDGWH9820/ 미니멈,329000,289520,-39480
2018-06-01,504561912,C012060,여자내의,[스타일빅걸]미니 브이 점프수트 MSM1523,45770,43940,-1830
2018-06-01,1198910334,F012010,종이기저귀,하기스 네이처메이드 팬티형 4~6단계36/30/25x3팩,42900,42900,0
2018-06-01,1305940344,C013010,점퍼,남자 바람막이 야상 JM11 WS바람막이점퍼야상남자 바,96580,96580,0
2018-06-01,2006888635,A017100,당근,열무1kg(1단),5490,5490,0
2018-06-01,1811648032,E041010,식기,노바 밥공기  국그릇 4인 세트 JAPAN/ 니코트,36900,35800,-1100
2018-06-01,180910389,C013020,티셔츠,프린트티셔츠/루즈핏/스팽글/유니크/박시/큐빅/오버핏,26800,26800,0
2018-06-01,2029461523,C021010,아동화,아디다스 VS 어드밴티지 크린 CMF C (CG5682)/ 아디다스키즈,29800,29800,0
2018-06-01,1812195398,L021060,유모차,컴팩트 스마트 기내반입 휴대용 세스토라이트T 유모차,210000,210000,0
2018-06-01,1339049939,C012060,여자내의,[PL_홈쇼핑][페리젠슨]스트레치 슬림와이드 팬츠 블랙.NPD16214,8000,7600,-400
2018-06-01,383244164,C013020,티셔츠,로로텐 롱/루즈핏/라운드/티셔츠 빅사이즈 여성의류,19800,19800,0
2018-06-01,989169110,A019030,생강,큐브형 다진생강 155G,7990,4490,-3500
2018-06-01,488844044,E061060,살충제,유기농 피톤치드 원액 편백수 4L 새집증후군 냄새제거,34000,34000,0
2018-06-01,335192659,L021010,손목시계,로제타 메탈 손목시계 FW-13 손목시계 아날로그시계,16730,16730,0
2018-06-01,56633355,C021040,실내화,[나이키] 프리모코트/코트로얄/슬립캔버스/탄준,59900,59900,0
2018-06-01,80003530,C014010,아동복,뉴욕꼬맹이 B급패밀리정품/아동복/티셔츠/반팔/맨투맨,6900,6900,0
2018-06-01,970049111,C011050,남자내의,남자마바지 남성린넨팬츠 여름슬랙스 끈밴드마반바지,17800,17800,0
2018-06-01,357110189,C012040,여자학생복,[매그제이(MAGJAY)]레이스슬립니트 (J11PNT211),29900,28110,-1790
2018-06-01,1696554637,C013050,운동복,미즈노 2018 트레이닝복 자켓 팬츠 세트 7종 모음,89700,89700,0
2018-06-01,321989513,C012020,원피스,노카라 포켓 바바리 (LI5BY603)/ 르샵,79000,67150,-11850
2018-06-01,1151901545,F012050,의료측정기,에스디 글루코링크0.3 혈당계+시험지 200매+정품침200,75000,70000,-5000
2018-06-01,420961157,A016070,귤,화남-밀감(850gX12캔) 감귤,56000,54320,-1680
2018-06-01,52961882,A019110,드레싱,● ♣ 오뚜기 허니머스타드(265G),1980,1980,0
2018-06-01,156041299,E061080,키친타월,깨끗한나라 촉앤감 3겹 키친타올 130매x2롤/130매x6롤,19800,19800,0
2018-06-01,1178056358,A011010,쌀,흑미증정! 백미 5kg/현미/찹쌀/현미찹쌀/찰흑미,12600,12600,0
2018-06-01,701033474,A018010,초콜릿,[롯데제과] 크런키 더블크런치바 36g 60개입 박스,38000,38000,0
2018-06-01,345670661,A017220,양파,국내산 믿을수 있는 우리 농산물 흙쪽파 1단(소),2470,2470,0
2018-06-01,631203596,A016060,감,경북청도 껍질없는 아이스 왕 홍시 20개(컵)/개당100,78400,66640,-11760
2018-06-01,1597908542,C012060,여자내의,푸조 워테레깅스(S26-3),28540,26260,-2280
2018-06-01,1761024382,A021010,커피,맥심 모카골드 커피믹스 100T 믹스커피 아이스커피,11170,10500,-670
2018-06-01,489572196,C012040,여자학생복,빅사이즈/제이스타일 케니든 레이스카라 블라우스/ 제이스타일,57300,44130,-13170
2018-06-01,1578728949,A019110,드레싱,아워홈 오리엔탈드레싱2k(데미그라스/순두부찌게양념),6900,6900,0
2018-06-01,64187589,A011020,현미,2017년 밥맛좋은 착한쌀 20kg,55900,55900,0
2018-06-01,989169108,A019030,생강,큐브형 다진마늘 155G,7990,4490,-3500
2018-06-01,1010315041,A022050,탄산음료,롯데 칠성사이다 280ML,1980,1980,0
2018-06-01,1832654946,D031010,주택수선재료,KCC타일용페인트[0.9L]2액형/만능우레탄/욕실타일/세면대/양변기/욕조/욕실리폼/유리/,29800,29800,0
2018-06-01,1403191423,A017050,미나리,양배추분말(국산) 300g/양배추/분말/가루/파우더/생식/선식/천연/조미료/찌개/국/양념,8900,8900,0
2018-06-01,586758004,C012060,여자내의,Y-JIN018 워싱청치마3부스커트 여성의류 여성청치마,18710,17780,-930
2018-06-01,989973584,E061020,섬유유연제,[LG]LG)AURA섬유유연제(홀리데이판타지)1L,4990,3990,-1000
2018-06-01,989973585,E061020,섬유유연제,[LG]LG)AURA섬유유연제(플라워바이플로라)1L,4990,3990,-1000
2018-06-01,2003850529,C012060,여자내의,밴딩 기모 가죽 바지 레깅스 팬츠 스키니 여성 여자,16460,16460,0
2018-06-01,391925917,A019040,소금,조개다시다(백설 1k)X10 조개다시다 식당용조개다시다,192660,173400,-19260
2018-06-01,989973586,E061020,섬유유연제,[LG]LG)AURA섬유유연제(스모키머스크)1L,4990,3990,-1000
2018-06-01,989973587,E061020,섬유유연제,[LG]LG)AURA섬유유연제(로열웨딩데이)1L,4990,3990,-1000
2018-06-01,161394136,C015020,모자,[이니셜 DIY스냅백] 패션모자 아크릴 힙합스냅백,1000,1000,0
2018-06-01,411510380,A012010,국산쇠고기,설 구정선물세트 삼육광천 식탁김 15g 15봉,23370,23370,0
2018-06-01,551228272,E031020,가스레인지,'동양매직 빌트인 가스오븐렌지/레인지 GOR-B5T01V,654000,654000,0
2018-06-01,420757655,C012020,원피스,모던 라인 패미닌 롱 울코트 MRDGHL9980/ 미니멈,359000,315920,-43080
2018-06-01,709259820,L021020,장신구,[하얀보석]14K피어싱 핫한 피어싱 지금 바로 사야돼,9900,9900,0
2018-06-01,1611258711,A013070,굴,남해안 자연산 살이꽉찬 황게 대사이즈 1kg 4마리,16900,16900,0
2018-06-01,1125825797,E041070,밀폐용기,스텐 밀폐용기/95종/97무배,9800,9800,0
2018-06-01,1986131694,A017250,고사리,해물총각 혼합야채믹스4종2종 냉동브로콜리 그린빈1kg,3700,3700,0
2018-06-01,2068304356,C012040,여자학생복,빅사이즈/톡톡/스카프/블라우스 / 참고 톡톡스카프블,75100,63840,-11260
2018-06-01,1218504860,F012030,안경,[테하우스]국내제작 뿔테 보안경 선글라스 안경테,7000,6900,-100
2018-06-01,1951254891,I012010,컴퓨터,bs [애플정품] 맥프로 [ME253KH/A] 쿼드코어/ apple Mac Pro/ 12GB/ 256GB-Flash/ 추가,4200000,4200000,0
2018-06-01,1268599377,C013040,청바지,[루미씨] 미디움 컷팅 보이 데님,29000,26430,-2570
2018-06-01,91309143,C012040,여자학생복,옆트임 라운드 넥 긴팔 니트 티 티셔츠 여성 캐주얼,18100,18100,0
2018-06-01,2122696982,A014010,우유,파스퇴르 롯데푸드 딸기 멸균 우유 190mlx24팩,13400,12800,-600
2018-06-01,1233346581,E061080,키친타월,스카트 빨아쓰는타올 45매6롤 /키친타올/화장지,12500,12500,0
2018-06-01,1163771857,C013020,티셔츠,[톰보이]렛츠고 레터링 프린트 티셔츠 9108222990,39000,30420,-8580
2018-06-01,18867910,C013020,티셔츠,기본나시/끈나시/여성나시/나시티/롱나시/민소매/반팔,2800,2800,0
2018-06-01,1440967230,A022040,기능성음료,포카리스웨트 1.5L x 12펫 게토레이 파워에이드 음료,21900,21900,0
2018-06-01,988155469,E061070,가정용비닐용품,초L 쿠킹호일 18U*25CM*30M,5900,5900,0
2018-06-01,1270478250,L021020,장신구,14K 트리플 라인 귀걸이,120330,120330,0
2018-06-01,321989568,C012040,여자학생복,셔링 태슬 블라우스 (LI5BL205)/ 르샵,39000,33150,-5850
2018-06-01,358496421,C013050,운동복,작업등 M730 T6 LED랜턴 후레쉬 손전등 자전거전조등,22850,20570,-2280
2018-06-01,1296303083,C013010,점퍼,남자청자켓 심플 워싱 청자켓 W0216002 남자셔츠 남성,50530,50530,0
2018-06-01,675447807,A021010,커피,카카오닙스/카카오닙/열매/원두/100%/카카오/200g//,16900,16900,0
2018-06-01,345670698,A017220,양파,국내산 믿을수 있는 우리 농산물 흙쪽파 1단(대)×10개,24810,24810,0
2018-06-01,345670692,A017220,양파,국내산 믿을수 있는 우리 농산물 깐쪽파 1단(소),15920,15920,0
2018-06-01,441925234,E061030,전구,재실감지기/오토리모/재실감지센서/DM2215BL/재실감지,75000,75000,0
2018-06-01,345670695,A017220,양파,국내산 믿을수 있는 우리 농산물 흙쪽파 1단(대),2950,2950,0
2018-06-01,259966551,C012020,원피스,[플라스틱아일랜드]레이스 핏앤 에이 원피스(PJ2WO364)(강남점),159000,141900,-17100
2018-06-01,796973601,A013070,굴,(속초홍게) 홍게(일반형) 7kg 당일조업/산지직송,38900,38900,0
2018-06-01,2122234425,E041010,식기,어린이/청동/방짜/유기/선물/외국인/식기/추천/가격/파는곳/VIP/VVIP/예단혼수/참방짜,147000,147000,0
2018-06-01,271027599,C013010,점퍼,바람막이/점퍼/후드점퍼/야상/남자점퍼/남성/블루종,59800,39800,-20000
2018-06-01,1010315015,A013130,오징어채,구운건한치 50G*2/봉,11900,11900,0
2018-06-01,868602772,A013120,낙지,정화 해오징어 버터구이 30gx5.,22060,19640,-2420
2018-06-01,1317306228,C014020,유아복,아동바지 주니어 베이직 데님 팬츠 KIDBOK-61 바지 남,11720,11720,0
2018-06-01,391683313,C012060,여자내의,[레코브][18여름]고방 써커 언발 스커트(LU3186SK552X)[갤러리아],31800,27030,-4770
2018-06-01,1457083894,C013030,스웨터,[공구우먼] 로맨스 골지 니트 29521 빅사이즈 여성의류 반팔티,29000,29000,0
2018-06-01,959557777,A019100,식초,[오뚜기]오뚜기 하프 케찹 475G,2690,2690,0
2018-06-01,289424957,A017180,호박,가을 왕 고추가루 2.5kg,51800,50250,-1550
2018-06-01,934192147,L021030,가방,LITMUS패션백팩/무지백팩/해골 스컬백팩,18900,16900,-2000
2018-06-01,2000862963,C012040,여자학생복,[플라스틱아일랜드]골지 숏 가디건(PJ2KG561)(하남점),35100,27920,-7180
2018-06-01,961367535,A016160,과일가공품,스위트커팅파인애플 (450G/팩),4990,4990,0
2018-06-01,543864511,A011140,부침가루,삼립 냉동 조각케익7종 택1 티라미스/치즈케익 무배,14900,14900,0
2018-06-01,2118892057,C011030,남자학생복,[이니프]일자 누비 패딩조끼,38900,36960,-1940
2018-06-01,1520939354,E021010,침구,[아망떼] 신상 순면 피그먼트 차렵이불/패드,21900,18900,-3000
2018-06-01,36482689,E031120,믹서,대용량믹서기 HMF-3260S 믹서분쇄커터다지기칼날3종,77320,77320,0
2018-06-01,1156822702,C013010,점퍼,[스타일빅걸]라인배색 바람막이 AIB71,86020,82580,-3440
2018-06-01,548803565,C011050,남자내의,(남자옷도매) DP-249 린넨마 ST팬츠 (S-XL) 연소라 남,32430,31460,-970
2018-06-01,1424660844,E011020,침대,펠리스침대 초극세사벨로아 6회전스프링 단면매트리스,119000,84000,-35000
2018-06-01,1920759161,L012090,기초화장품,1+1/무료/일리윤 토탈에이지 클렌징 오일/폼 택1,12800,12800,0
2018-06-01,397689959,E011060,의자,의자[델타체어][난초체어]의자/사무용의자/사무실의자/학생의자/컴퓨터의자/아동의자/,59900,59900,0
2018-06-01,386584687,A018080,설탕,비정제설탕 10kg 청매실/황매실/매실통/사탕수수,15900,15900,0
2018-06-01,912577024,C012030,여자상의,언발란스 오프숄더 그물 망사 커버업 시스루 NT,19800,19800,0
2018-06-01,959557786,A018070,파이,[동서]동서 오레오 화이트 크림(100G),1290,990,-300
2018-06-01,1905195391,C013050,운동복,여성트레이닝복세트/빅사이즈/봄신상/운동복/츄추리닝,32900,32900,0
2018-06-01,916988274,C013050,운동복,100%국내생산/반팔+반바지 세트/2장구매시무료배송,19700,19700,0
2018-06-01,1973887119,C014020,유아복,아둘 가족티 엄마랑 커플룩 도날트덕 롱 티셔츠 12,14300,14300,0
2018-06-01,872377359,E041030,솥,풍년 통5중 하이파이브압력밥솥 6인용/8인용/세원통상,92000,92000,0
2018-06-01,378625296,L021010,손목시계,로제타 여성 손목시계 FW-22 팔찌형시계 디지털시계,15570,15570,0
2018-06-01,624315456,E061060,살충제,레인보우에어 휘산기 액체 - 레인보우 솔루션 180ml (,56600,48110,-8490
2018-06-01,509893967,C012040,여자학생복,[에고]에고 비잔틴볼륨소매 AW폴라니트 EMCKP105R,29000,27550,-1450
2018-06-01,1162791827,E061040,부엌용세제,닥터큐 우유분해 세정제 우유분해세정제 닥터큐우유분,42810,42810,0
2018-06-01,637119351,I012010,컴퓨터,[E]Z70EV-AR73S1/7세대/i3/8G/SSD128G+500G/윈10/슬림,768000,729600,-38400
2018-06-01,271880989,E021020,커튼,베드텐트 터쿼이즈 쿠라/ 베드텐트 디자인용품 인테리,33510,29830,-3680
2018-06-01,476493490,C011020,남자상의,MJ-061 패딩 싱글 하프코트 - 네이비 남성코트 캐쥬얼,165440,165440,0
2018-06-01,895800454,A019180,즉석식품,[CJ]CJ 밥이랑 해물 24G,2690,2690,0
2018-06-01,895800453,A019180,즉석식품,[CJ]CJ 밥이랑 야채랑 27g,2690,2690,0
2018-06-01,895800451,L012090,기초화장품,[존슨&존슨]존슨앤존슨 베이비 핑크 로션 500ML,14400,14400,0
2018-06-01,2009878460,A022010,주스,남양 과수원190mlX24팩/델몬트/음료수/주스/피크닉,6900,6900,0
2018-06-01,1538748208,C012020,원피스,[크로커다일레이디] 하이넥 집업 코트 CL7MCT901 NC아울렛,198000,99000,-99000
2018-06-01,52961816,A019110,드레싱,● ♣ 오뚜기 아일랜드 드레싱(500G),2520,2520,0
2018-06-01,411042405,C012060,여자내의,[레코브] LECCOVE 벨티드 프릴 점프 수트 LU2178JS801B,25000,22500,-2500
2018-06-01,607380221,C013020,티셔츠,앨빈클로 반팔티 무지 티셔츠 브이 오버핏 커플 남자,9900,9900,0
2018-06-01,412837864,A011010,쌀,TV방영/참쌀홍쌀 홍국쌀(1kg)홍국균사체배양미,22800,22800,0
2018-06-01,990000494,A016160,과일가공품,미국산 체리(400G/팩),8990,8990,0
2018-06-01,1520219962,A018070,파이,참붕어빵232gx4곽(총32마리) 몽쉘 초코파이 과자 간식,17800,17800,0
2018-06-01,1125166041,A018030,껌,캐나다 과일향껌 1375g(약250개입) 간식 자판기 벌크,18900,18900,0
2018-06-01,1010702732,C012040,여자학생복,[이앤씨]플라워 자수 단추 니트 가디건 (ENCK81205Z),47000,37600,-9400
2018-06-01,439865619,F012020,생리대,템포 (레귤라/슈퍼)10Px5개 / 혼합주문가능 / 생리대,17800,17800,0
2018-06-01,1481374659,E011030,거실장,RX-101 다용도선반/TV다이/TV장식장/수납장/렌지대,18900,17900,-1000
2018-06-01,8629129,A013130,오징어채,밥도둑 명엽채 1Kg 쥐치손채 이중채 진미채 오징어채,9000,8900,-100
2018-06-01,1436621916,A012040,닭고기,특허받은 훈제닭가슴살3kg 헬스 무색소 무방부제,35000,32000,-3000
2018-06-01,2092044891,C013010,점퍼,[헤지스레이디스]HSJU8B301G3 쿨터치 집업점퍼,359000,308740,-50260
2018-06-01,1642328646,A011110,당면,국내생산 포두부 250g /4팩/밀가루 대체식품 포두부,2180,2180,0
2018-06-01,280659939,E061080,키친타월,(특가+증정)기름쏙~100%천연펄프 키친타올 120매x12롤,9900,9900,0
2018-06-01,64364736,A014040,발효유,헬로엔요 180mlx18팩/유산균 음료/오렌지쥬스,8900,8900,0
2018-06-01,1337214282,C013050,운동복,까도스 안전 삼각대/야간/반사광/휴대용/사고/고장/야,9000,8190,-810
2018-06-01,456394829,C013050,운동복,R로고 자동차 도어가드/문콕방지가드 차량용도어가드,8450,8200,-250
2018-06-01,1788544412,A011010,쌀,[국산귀리]귀리가루/귀리미숫가루/귀리선식/오트밀,8900,8900,0
2018-06-01,2126550537,C015040,장갑,파스텔 곰돌이 벙어리 장갑 팬시장갑 장갑 겨울용장갑,10610,10610,0
2018-06-01,1181672302,C013050,운동복,137_고구마베이비 아기옷-무형광 기차동물 자카드 민,10910,10590,-320
2018-06-01,1877117979,E061020,섬유유연제,샤프란 아로마시트 코튼블로섬 30매 x 12,56410,56410,0
2018-06-01,1544113377,E061060,살충제,[국산개발 신상품]바퀴벌레약 피프로겔 250g/맥스포스,25300,16960,-8340
2018-06-01,1741141253,A015020,식용유,[사조해표] 포도씨유 900mlx2병,12700,12700,0
2018-06-01,1351054612,C021010,아동화,[베베마루]라이팅 충전LED 발광 아동화 샌들 운동화,29900,17900,-12000
2018-06-01,619650381,L021020,장신구,스와로브스키 귀걸이 이어링 귀고리 은침 실버 비즈 크리스탈 여성악세사리선물 패션쥬,7200,6990,-210
2018-06-01,794302865,E021010,침구,프리미엄 순면 워싱 간절기 세트(이불+패드+베개),89800,89800,0
2018-06-01,256415948,F012050,의료측정기,카스(CAS) 디지털 혈압계(혈압측정기) KD-595 팔뚝형,48000,44160,-3840
2018-06-01,1047088331,A014050,달걀,간이 배어 있는 촉촉한 감동란 30개입/반숙계란/ 롯데식품관,19900,18910,-990
2018-06-01,113675207,C012040,여자학생복,옆트임 라운드 넥 니트 티 티셔츠 스웨터 여성 여자,19940,19940,0
2018-06-01,1858212659,C012040,여자학생복,린넨블라우스 린넨셔츠 반팔 남방 레이스 오프숄더,26000,24000,-2000
2018-06-01,677097015,C012060,여자내의,BYC여성 융 유발 타이즈(T1110) 타이즈 레깅스 스타킹 BYC 팬티스타킹,16410,14610,-1800
2018-06-01,301173994,E041020,컵,el 도자기 패턴 머그컵 3p세트 머그잔 커피잔 컵 찻잔,14700,14700,0
2018-06-01,1424060336,L021060,유모차,베리타스유모차/휴대용유모차/기내반입/등받이조절,39800,39800,0
2018-06-01,261587668,C012060,여자내의,[바비앤펌킨][바비앤펌킨] 볼륨핏 니트롱스커트,49200,44280,-4920
2018-06-01,330655218,I031040,생화,은성사 원투대모음/원투낚시대/바다낚시대/릴낚시대,24900,24900,0
2018-06-01,1530563567,C012020,원피스,MELODY F3 그레이/코트/여자코트/겨울코디/겨울코트/자켓/점퍼 미국 여성토탈브랜드 멜,54700,54700,0
2018-06-01,480636601,C012020,원피스,모직 하프 코트 RLLWHC8A0/ 리안뉴욕,109000,98100,-10900
2018-06-01,637856502,A019080,고추장,청정원 순창 찰고추장(2KG),12780,12780,0
2018-06-01,182429018,C013050,운동복,에탄올 워셔액/불스원/모비스/발수코팅/유리세정,4900,4320,-580
2018-06-01,584705133,C013020,티셔츠,빅사이즈민짱/잇템 잘나가는 인기티셔츠/라운드/무지,10900,10900,0
2018-06-01,911428351,A021010,커피,아이수 페루산 카카오닙스200g,13400,11930,-1470
2018-06-01,251531314,C012040,여자학생복,[공구우먼] 메리즈 썸머 린넨 남방 29546 빅사이즈여성의류,32000,32000,0
2018-06-01,1535579005,A018050,비스킷,로아커 웨하스 콰드라티니 110g 125g 7종/수입 과자,1750,1750,0
2018-06-01,1673970258,E041010,식기,칠기 밥그릇 장국공기 데마끼 우동기 락교통 멜라민,850,750,-100
2018-06-01,1112722250,C013010,점퍼,국내제조 여름용 정장자켓 콤비자켓 마이자켓 110까지,49800,49800,0
2018-06-01,123756102,L012040,치약,2080 뉴샤이닝 화이트 치약 120g x 9개/미백치약/칫솔,9900,9900,0
2018-06-01,440291796,A018090,잼,오뚜기 포도잼500gX12개(1박스)잼 딸기잼 후루츠잼 포,95100,83690,-11410
2018-06-01,1805539980,A011070,혼식곡,큐원 밀가루 (다목적용)(1KG),1380,1380,0
2018-06-01,440291795,A013170,생선통조림,유동번데기 130gX48개식자재 유동번데기 식품 번데기,76600,65110,-11490
2018-06-01,2065522950,E061050,청소용세제,홈스타/락스와세제/변기청소/욕실청소/막힌곳을펑펑,8900,8900,0
2018-06-01,417191504,F012020,생리대,숲속이야기텐셀 롱라이너 20p x10팩 (200p)+샘플4p/ 예지미인,15600,15600,0
2018-06-01,417191502,F012020,생리대,숲속이야기 텐셀 일반라이너 20p x 10팩 /팬티라이너/ 예지미인,14500,14500,0
2018-06-01,288660433,C013040,청바지,빅사이즈스키니 일자청바지 밴딩팬츠 부츠컷 여자여성,19900,19900,0
2018-06-01,1530587528,C012020,원피스,MELODY F101 그레이/코트/여자코트/겨울코디/겨울코트/자켓/점퍼 미국 여성토탈브랜드,64700,64700,0
2018-06-01,959557750,A017280,김,일미 쫄깃 치자 단무지(200G),2590,2590,0
2018-06-01,1436621908,A012040,닭고기,특허받은 훈제닭가슴살5kg 헬스 다이어트,52000,52000,0
2018-06-01,1346785646,C013040,청바지,[지오지아] ABX2PP1105 NV 네이비 스판소재 캐주얼 팬츠,40000,33200,-6800
2018-06-01,809096456,L021010,손목시계,젤리 아쿠아 방수시계 시계 방수손목시계 고무밴드시,12770,12770,0
2018-06-01,692062173,C013050,운동복,멀티형 물기 제거기 버전2 자동차용품 실리콘물기 세,7830,7830,0
2018-06-01,959557747,A012060,햄및베이컨,[동원]동원 리챔 200G,3680,3680,0
2018-06-01,1823860312,I011010,TV,인증점 삼성 55형 커브드 스마트 TV UN55M6200AFXKR,920000,809000,-111000
2018-06-01,1449376478,I011030,사진기,소니A6000/16-50mm렌즈포함/32G+소니가방풀패키지/ED,715000,657800,-57200
2018-06-01,1922831326,C013050,운동복,(1+1 EVENT) 16ss 첨이첨이 패치플라워3부세트 레이온 유아동의류 아동의류 공용 상하,30000,30000,0
2018-06-01,1514495612,A022050,탄산음료,천연사이다 190mlx30캔/콜라,4900,4900,0
2018-06-01,987108664,E061090,방향제,훠링)모두다 급속 충전기_3.4A,12900,12900,0
2018-06-01,796086492,A015020,식용유,백설 튀김 전용유 1.8L x 4병 /코스트코 튀김유,22690,22690,0
2018-06-01,1837392710,C011030,남자학생복,[어스앤뎀]남성 여름스판 슬림핏 팬츠 TCPA208(인천점),19000,16590,-2410
2018-06-01,1319732271,C011050,남자내의,스판 진그레이 교복바지 여자 교복 학생복쇼핑몰 교복,51140,51140,0
2018-06-01,1348738447,L021050,우산,브랜드우산/3단우산/장우산/자동우산/도매특가/답례품,3700,3600,-100
2018-06-01,1267744585,A022040,기능성음료,토레타 240mlx30개입 500ml 이온음료 포카리 게토레이,12900,12900,0
2018-06-01,608487498,F012020,생리대,바디피트 볼록맞춤 중형 22Px3팩+중형6P(총72P)생리대,12300,12300,0
2018-06-01,1058336662,A015010,참기름,더 고소해진 삼마(울타리)표 참맛기름1.8L 외 6종,6000,6000,0
2018-06-01,693145783,A014030,치즈,코리원/코다노 모짜렐라치즈 E 2.5kg/치즈/피자치즈,18900,18900,0
2018-06-01,1297109386,C011030,남자학생복,FS078 카모 패턴 데님 셔츠 남자셔츠 남자와이셔츠 긴,18670,18670,0
2018-06-01,670349478,A012010,국산쇠고기,축협1등급 한우등심 2.4kg 한우선물세트 등심선물세트,260000,257400,-2600
2018-06-01,1720984188,G011070,자전거,[스마트자전거]HG21/21단 700C자전거 /하이브리드/ G7/엑스2.1/스피너/셔플,109000,98100,-10900
2018-06-01,2045638885,L021060,유모차,예약판매 세스토 라이트 BE 휴대용유모차 기내반입,369000,369000,0
2018-06-01,1089186678,A013050,오징어,CJ 계절어보 3종택1 x 5개(간장꽁치/매운꽁치/큰꼬막),14000,14000,0
2018-06-01,1664496203,A013030,조기,영광굴비/법성포/조기/오가/마른/굴비/추석/선물세트/,144900,144900,0
2018-06-01,443278380,F012010,종이기저귀,[[[아이커머스몰][일본 정품 내수용] 군기저귀 2팩 밴드형 팬티형 리뉴얼 최신상품 입,34700,34700,0
2018-06-01,1318034275,C021020,구두,VA-111 남성신발 로퍼 구두 정장화 캐주얼화 남자신발,52960,52960,0
2018-06-01,1345122479,A013160,맛살,건맛살 (차오름 1K) X10,216780,192940,-23840
2018-06-01,513615228,C011030,남자학생복,[TOP 10]여성 샴브레이 러플 블라우스MSY2WC2045(영등포점A),29900,27560,-2340
2018-06-01,1597005815,E061020,섬유유연제,프리미엄 섬유유연제20L 향기랑/피죤/샤프란/쉐리,10000,9900,-100
2018-06-01,975174281,L021010,손목시계,40%off 보이런던/정품/손목시계/패션시계/커플시계,39900,39900,0
2018-06-01,208670802,C013020,티셔츠,[빈폴아웃도어]네이비 여성 오픈넥 스트라이프 포인트 티셔츠 (BO8442C02R),55300,43690,-11610
2018-06-01,1240775573,C013020,티셔츠,넥포인트 오프숄더 티셔츠/ 쇄골라인 유니크한 디자인,23500,23500,0
2018-06-01,417658408,C012060,여자내의,빅사이즈/제이스타일 디벨트 스트링 8부 점프수트/ 제이스타일,44900,34580,-10320
2018-06-01,885894452,A019080,고추장,고추장  쌈장 소형제품 모음,1950,1950,0
2018-06-01,984938845,C011050,남자내의,[필골드] YS3081n3083 기모 트레이닝팬츠 4종중택일,22800,22800,0
2018-06-01,589146817,I012010,컴퓨터,특가164만/삼성노트북 Pen NT950QAA-X58A MS오피스,1841050,1749000,-92050
2018-06-01,1241606803,C013030,스웨터,백지퍼단가라니트(RMD_1602) 빅사이즈 큰옷티셔츠 여,16500,16500,0
2018-06-01,453629420,A011030,찹쌀,쌀보리 (농협 1K) X10,65800,58570,-7230
2018-06-01,9235213,C013020,티셔츠,남자무지나시티/레이어드나시/박스나시/오버핏롱나시,8500,8500,0
2018-06-01,685661861,C014010,아동복,아둘 쥬니어 여름 면바지 썸머 린넨 팬츠 15,14300,14300,0
2018-06-01,1267671174,A013060,게,한치 마른화살오징어(2s 50미)1kg,91790,91790,0
2018-06-01,1650261825,C013060,등산복,여름 신상품 高 기능성 스판 등산복 티셔츠 작업복,15800,15800,0
2018-06-01,435141491,E031130,보온매트,일월 일품 프리미엄 카페트 온수매트 싱글 100x183,130000,111910,-18090
2018-06-01,616951283,E041010,식기,스텐 이중 냉면그릇 냉면기 면기 탕기 그릇 업소용 식,3600,3320,-280
2018-06-01,1237948373,A018040,아이스크림,[40개]매그넘 34[클래식+아몬드+화이트+더블초코+미니]+쿠키6,45900,45900,0
2018-06-01,472751229,A018080,설탕,백설 하얀설탕 3kg/갈색설탕/큐원/스틱설탕/롱슈거,4600,4600,0
2018-06-01,1864068259,F012020,생리대,쏘피 안심숙면팬티10P+2P/생리대/오버나이트/바디피트,15900,15900,0
2018-06-01,1466086851,A018030,껌,도매킹/롯데5000자일리톨(통)-오리지날87g/리필/껌,3780,3780,0
2018-06-01,1387616434,C013010,점퍼,AG 가죽자켓 라이더자켓 가죽점퍼 P171 남성용라이더,99360,99360,0
2018-06-01,1286348952,E061020,섬유유연제,다우니 초고농축 퍼퓸 섬유유연제 1L X 2개,8400,8400,0
2018-06-01,650880841,A011080,밀가루,(손맛칼국수5kg)수타식 생면칼국수15인분 냉동보관,16500,16500,0
2018-06-01,763110540,C013010,점퍼,[헤지스키즈]WT블루종 점퍼(HOS72JB40G-WT),138600,138600,0
2018-06-01,523366259,F012010,종이기저귀,360핏 마미포코 팬티기저귀 대형/특대형,34900,34900,0
2018-06-01,739007118,L012030,칫솔,키즈세이프 칫솔 20개 유아 칫솔치약,15900,15900,0
2018-06-01,844802461,C021040,실내화,티안나게 6cm 업 스니커즈 큐핏아로하 키높이운동화,26900,26900,0
2018-06-01,522055528,F012020,생리대,동아제약 템포 레귤러/슈퍼 4팩,21900,21900,0
2018-06-01,1220733111,F012010,종이기저귀,[군] 군(GOO.N) 마시멜로 밴드 대형(L) 38P x 3팩,47500,47500,0
2018-06-01,692870509,C012030,여자상의,로로텐 롱/미니/쉬폰/레이스 원피스/빅사이즈,26900,26900,0
2018-06-01,1363029985,C013050,운동복,자동차 선바이져 선글라스클립 /안경클립/메모꽂이,3400,3130,-270
2018-06-01,1266510072,C012030,여자상의,롱원피스 민소매 면 미니 여름 나시원피스 박시 맥시,19500,19300,-200
2018-06-01,640843154,C012060,여자내의,청 롱스커트 청치마 롱청치마 데님 긴청치마 롱치마,21900,21250,-650
2018-06-01,1942559835,C013050,운동복,AXEMEN 소프트 접이식 루프백 - 스포츠 레저 낚시 여,102980,84330,-18650
2018-06-01,2069294963,C013010,점퍼,빅사이즈/테일러드/카라/자켓 / 참고 빅사이즈 큰옷,95300,81010,-14290
2018-06-01,23335040,D031010,주택수선재료,노루페인트 색감좋은 친환경 프리미엄 팬톤페인트,13530,13530,0
2018-06-01,1290386195,C011050,남자내의,남성워싱 면스판바지/카고바지/건빵바지/빅사이즈바지,29800,29800,0
2018-06-01,1010317923,F012020,생리대,[유한킴벌리]유한킴벌리)좋은느낌오가닉코튼오버나이트10P,5600,5600,0
2018-06-01,1917195472,A015020,식용유,청정원 포도씨유 500ml X 15EA 기름 청정원기름 청정,136890,136890,0
2018-06-01,1427814019,C013020,티셔츠,여름신상/반팔티/헨리넥/라운드/커플티/티셔츠/남자,10800,9800,-1000
2018-06-01,1119954119,C012020,원피스,[보니알렉스](보니알렉스)트위드 오버코트(BAHZ100A),46600,41010,-5590
2018-06-01,296285878,I053010,공책,GT 모닝 초등 3-6 영어노트 남 초등영어노트 어린이과,5230,5230,0
2018-06-01,1119954114,C012020,원피스,[보니알렉스](보니알렉스)랍빠 배색 코트(BAJZ101A),37700,33180,-4520
2018-06-01,1323304823,C012060,여자내의,시크 무광 코팅 스키니진- 코팅스키니진 무광택코팅스키니진 슬림핏데님 데일리스키니,37410,33300,-4110
2018-06-01,2063047206,C011050,남자내의,필골드 편안한 밴딩반바지 밴딩슬랙스 15종 무료배송,20000,14900,-5100
2018-06-01,1171798678,C011020,남자상의,[제스]XESS 봄 여름 정장 2종 X7BSU1272 X7BSU4268,99000,85140,-13860
2018-06-01,798708275,E061050,청소용세제,Mr.홈스타 짜서쓰는 락스 120mlx4개 외,10900,10900,0
2018-06-01,1119954117,C012020,원피스,[보니알렉스](보니알렉스)보니알렉스 더블밀링지롱코트 (BAHZ101A),53300,46910,-6390
2018-06-01,982464211,L012040,치약,[메디안]코코몽 어린이치약 75g X 3입(딸기맛),4100,3900,-200
2018-06-01,151236824,A011170,떡,[떡보의 하루]곶감호박떡 (5개/팩),4200,4200,0
2018-06-01,1974108760,E061100,습기제거제,올굿 물먹는제습제 24개/습기제거제/제습기/염화칼슘,17900,17900,0
2018-06-01,368788627,C021020,구두,남성구두 M386 세무 4cm 심플디자인 신사화 정장화 남,50890,50890,0
2018-06-01,1972851045,E031080,선풍기,뉴초절전원적외선 데스크히터 - 뉴초절전원적외선 데,125670,111850,-13820
2018-06-01,1011183627,A013070,굴,랍스터맛 엄청 큰 징거미새우 특(4~6미) 총 1kg,50000,40000,-10000
2018-06-01,1215778010,A016090,참외,[오늘만 이가격!]달콤한 성주 꿀참외7kg,8500,8500,0
2018-06-01,608164823,A012060,햄및베이컨,런천미트200g x6/스팸200g x5/리챔340g x5/클래식,9900,9900,0
2018-06-01,1182875090,C013020,티셔츠,[엠씨]부엉이 티셔츠 ( C62T205 ),39000,35100,-3900
2018-06-01,714981882,C021020,구두,[레페토] 레페토 마에스트로 유광 로퍼슈즈 V1792VLUX_410,368000,290720,-77280
2018-06-01,1241579120,I053010,공책,근영사)아이디얼 양장노트(그리드_블루)박스(24개입),125470,125470,0
2018-06-01,60038979,L021060,유모차,엘레니어 세스토라이트 T 기내반입 실속 휴대용유모차,210000,210000,0
2018-06-01,930422599,C013020,티셔츠,[그랜피니] 후드/집업/맨투맨/티셔츠/무료배송/데일리,32900,32900,0
2018-06-01,1034455984,E031020,가스레인지,SK매직 안심센서 클래식 가스오븐레인지 GORS2200,616000,585200,-30800
2018-06-01,701855992,F011130,홍삼,정관장 천녹톤(70ML*30),260000,260000,0
2018-06-01,1074609167,C012060,여자내의,훌니트스커트 MN1712 심플니트스커트 심플스커트 베이,41600,41600,0
2018-06-01,386488828,E021020,커튼,프리미엄커튼봉 3단 25mm 길이조절300cm,31720,31720,0
2018-06-01,1741794662,E031050,냉장고,LG(주)삼정 K332S11 스탠드형 김치냉장고,1150000,1098000,-52000
2018-06-01,1794069376,E011050,책상,HADY 독서실 책상 8060 KS1031TB,55900,55900,0
2018-06-01,1478716898,I012010,컴퓨터,삼성노트북5 NT500R5W-LD5S/i5/8GB/256G SSD/윈7 가능,872630,829000,-43630
2018-06-01,408805351,C012040,여자학생복,T185CD5Z002(레이스자수로브)/ 토모톰스,26000,24700,-1300
2018-06-01,988096813,A012060,햄및베이컨,요리하다 샌드위치햄 90G,1980,1980,0
2018-06-01,896669012,A012020,수입쇠고기,E-미국산 냉장 돈삼겹살 구이용 100G,1390,1000,-390
2018-06-01,345535591,A011140,부침가루,베이킹 아크릴 스텐실도안 어린이날 케이크용스텐실,10930,10930,0
2018-06-01,693855126,C011030,남자학생복,여름신상 프린트 셔츠 남방 7부 반팔셔츠 솔리드 체크,14700,14700,0
2018-06-01,817171008,I053020,스케치북,)아트 크로키하드커버 A5(105g-80매) 드로잉 드로잉북,7440,6700,-740
2018-06-01,1506752214,E011040,소파,[조은가구]티파니 인조가죽 3인용쇼파/스툴포함,215000,188100,-26900
2018-06-01,648563543,A018060,스낵과자,[농심]인기과자 50종 세트구성 /새우깡/양파링/포스틱,17900,17900,0
2018-06-01,1552481736,F012020,생리대,예지미인 숲속이야기 텐셀 생리대 4팩+1팩 +사은품,11900,11900,0
2018-06-01,770839552,E031110,청소기,일렉트로룩스 진공청소기ZUF4306DEL미세먼지완벽차단,361900,361900,0
2018-06-01,1716932821,A018080,설탕,무료배송 에리스리톨 스테비아1kg/설탕초/O쇼핑동,29500,29500,0
2018-06-01,1011183630,A013070,굴,랍스터맛 엄청 큰 징거미새우 왕특(2~4미) 총 1kg,54000,44000,-10000
2018-06-01,1373812145,A022010,주스,Dole 120ml 파인애플 주스 32팩,13900,13900,0
2018-06-01,765560821,A019060,된장,. 애간장 소스180ml(무침조림용) .,4900,4900,0
2018-06-01,765560822,A019060,된장,. 애간장 소스180ml(비빔용) .,4900,4900,0
2018-06-01,856513707,A022040,기능성음료,포카리스웨트 245mlx30캔 게토레이/파워에이드/음료수,12900,12900,0
2018-06-01,2082579923,C013040,청바지,[토모톰스]DE142 일자 청바지(AT185DM5Z001),36000,34920,-1080
2018-06-01,765560820,A019060,된장,. 애간장 소스180ml(국물용) .,4900,4900,0
2018-06-01,1236432383,C013020,티셔츠,반팔티 티셔츠 롱티 박스티 여자 여성 7부 여름 박시,9900,9900,0
2018-06-01,1895919916,A019110,드레싱,폰타나 오리엔탈 드레싱(270G),2580,2580,0
2018-06-01,1869051796,C012060,여자내의,[대구백화점 II관] [레코브]자라 망사 스커트(LF317XSK576X),17900,17010,-890
2018-06-01,362955944,C013020,티셔츠,[잠뱅이]UNI) AI7WTS42 ( CP Slub 반팔 후드 티셔츠 )(마산점),39000,34050,-4950
2018-06-01,896669007,A012020,수입쇠고기,E-미국산 냉장우 갈비찜용 100G,2490,1694,-796
2018-06-01,1107429280,A017160,오이,특가 꽃송이버섯 균사체 분말 200g/가루/베타글루칸,69800,69800,0
2018-06-01,1920654652,C014020,유아복,[클랜씨][클랜씨] 레인보우 니트망또 C665C005-MU,21330,19200,-2130
2018-06-01,964318439,C012030,여자상의,66~110 시크&러블리핏원피스 여름빅사이즈여성블랙탑,59800,59800,0
2018-06-01,580852114,C011030,남자학생복,남자 긴팔 셔츠 남방 헨리넥 체크 데님 오버핏,28000,23800,-4200
2018-06-01,1488724777,A012010,국산쇠고기,[무항생제] 사골 2kg 1+등급,42000,42000,0
2018-06-01,1419206029,C013050,운동복,PRO팔콘광택기폴리셔 동급최고출력1550W 무단변속+10M전원선+전문프로시공업소용-툴마,145800,134140,-11660
2018-06-01,1267249402,A021010,커피,[빠른배송] 까페리얼 대용량 1.5L X 6PET,14900,14900,0
2018-06-01,1098290070,D031010,주택수선재료,[노루] 친환경 멀티플러스 수성바니쉬 - 1L 투명,8900,8900,0
2018-06-01,349550901,C013020,티셔츠,[무료배송]DWW018A 굵은 끈 심플 후디 802 여성면후드,40610,40610,0
2018-06-01,685502576,C012060,여자내의,[보니알렉스](보니알렉스)린넨 리본 스커트(BCKX200A),14400,12680,-1720
2018-06-01,685502577,C012060,여자내의,[보니알렉스](보니알렉스)린넨 라운딩 밴딩 스커트(BCKX202A),11100,9770,-1330
2018-06-01,1340599059,C011050,남자내의,[써스데이아일랜드][Thursday Island]여성 셔링 숏 팬츠(T164MPT238W),39900,31920,-7980
2018-06-01,765560825,A019060,된장,. 유기농 양조 간장 800ml .,13500,13500,0
2018-06-01,546215787,I031040,생화,지진용품/지진가방/생존용품/생존배낭/재난/EDC,3400,3400,0
2018-06-01,907263959,A016070,귤,보석건귤 선물세트 16호 x 2박스]말린귤,52570,52570,0
2018-06-01,323749159,C013050,운동복,고휘도 LED 인솔지시봉 경광봉 ST-900R 공구 산업자재,15750,14360,-1390
2018-06-01,1851264092,C021040,실내화,아디다스 남녀공용 이큅먼트16 런닝화 ( AF4969 ),110190,99180,-11010
2018-06-01,1432881552,L021010,손목시계,세일특가 알마니시계 남성용 31종 이월특가,99000,98000,-1000
2018-06-01,1879341279,L012010,면도기,도루코 일회용면도기/100개/2중날/업소용/휴대용/모텔,5000,4900,-100
2018-06-01,767018655,E031010,전기밥솥,CRP-JHT0610FS 쿠쿠 6인용 IH압력밥솥/무기압ens,514000,457380,-56620
2018-06-01,1876409035,E031110,청소기,샤오미 로봇청소기 2세대 미지아 한글지원 물걸레청소,590000,590000,0
2018-06-01,1326379902,E021010,침구,무독성 PE놀이방매트 퍼니스터디 200×150 모서리보호대/ 어린이집놀이방매트 놀이방매,47600,42780,-4820
2018-06-01,200271796,E061030,전구,LED방수등 방진등 방습등 IP66 21W 32W,60000,60000,0
2018-06-01,314414126,C011050,남자내의,젊은디자인 남자 면 바지/슬랙스 남성 밴딩 여름 마,21800,19800,-2000
2018-06-01,1673766575,A011010,쌀,[오뚜기] 오뚜기 씻어나온 쌀 10kg/명품/박스포장/최근도정,26900,26900,0
2018-06-01,1310426676,C011050,남자내의,[캘빈클라인진] 남성용 프린팅 반팔 티셔츠(4AOKQ93),39000,33150,-5850
2018-06-01,1514253806,C013020,티셔츠,코펜하겐럭스 여성 린넨혼방 티셔츠 6종,49900,49900,0
2018-06-01,1269404693,A013100,마른멸치,청정완도전복 란이 1호(특특대) 5ㅡ6미 600g(마리당,79220,79220,0
2018-06-01,1996183803,C013050,운동복,헬스장 찜질방납품전문/쿨론티/운동복/단체복,6000,5900,-100
2018-06-01,1011207715,A016150,아몬드,사차인치 250G,8490,8490,0
2018-06-01,473189786,C013040,청바지,ACCHT8037n8053 밑단 데미지 데님 5부팬츠 3종중택일,36010,36010,0
2018-06-01,2146421909,E011070,식탁,모닝2인식탁세트/테이블1개+의자2개,125000,114900,-10100
2018-06-01,1859946595,C013040,청바지,MHA528 남자빅사이즈스판청바지 남자빅사이즈데님바지,61080,61080,0
2018-06-01,1871757402,E041030,솥,풍년 압력솥 비엔나 블랙펄 손주물 드레스쿡 업소용,69500,69500,0
2018-06-01,83938251,C012060,여자내의,허리끈 양털 반바지 겨울 핫팬츠 숏팬츠 여성 캐주얼,8820,8720,-100
2018-06-01,408626610,C012040,여자학생복,[컨택유][컨택유] 체크 퍼프소매 블라우스 44127,41700,39620,-2080
2018-06-01,524877535,C012040,여자학생복,[비키]별무늬 썸머 롱 가디건 TQCCE2912,38000,32300,-5700
2018-06-01,352022283,A011160,빵,코리원/피자 도우 생지 9인치/12인치/곡물도우/또띠아,9100,9000,-100
2018-06-01,461015724,C013040,청바지,마리끌레르 슬림라인 밴드 데님팬츠 3종,69900,62910,-6990
2018-06-01,1309506379,C011030,남자학생복,[디즈니] 어벤져스 남아 파워 후드집업 Q71TM55746,9800,9800,0
2018-06-01,16598633,C011050,남자내의,밍크/여밑단 포근하고 따뜻한 밍크 시보리 파자마,13500,12020,-1480
2018-06-01,982672746,A019140,이유식,[남양]남양 임페리얼드림XO 3단계800G,27500,27500,0
2018-06-01,698571336,A019080,고추장,청정원 순창비빔면고추장(300G),5750,5750,0
2018-06-01,1370702189,F012010,종이기저귀,앵콜특가 쿠잉 팬티/밴드 기저귀/2팩/,14900,14900,0
2018-06-01,982672747,A019140,이유식,[남양]남양 임페리얼드림XO 4단계800G,27800,27800,0
2018-06-01,498590651,A017280,김,청해이엔단무지통 1kgX10개단무지통 식품 식자재 반찬,82000,72160,-9840
2018-06-01,420875018,C013010,점퍼,[화이트폭스][화이트폭스]패딩누빔 시크 라이더 자켓,59000,53690,-5310
2018-06-01,1297205001,A011140,부침가루,두레생협 꽃빵(220g)2개,17000,16490,-510
2018-06-01,617015665,A011090,국수,컵라면 50종류 / 신라면/진짬뽕/사발면/진라면/미니컵,15300,15300,0
2018-06-01,2109648207,A019070,양념소스,움트리 매운탕찌개장1950Gx6개 실장님회간장1950Gx6개,45000,45000,0
2018-06-01,1212575860,C013030,스웨터,[앙투] 여름신상 니트44~110빅사이즈 루즈핏 그물 롱,24800,24800,0
2018-06-01,1921277440,C013020,티셔츠,골프 이너웨어 스판 반폴라 티셔츠 A232/등산/레저용,19000,18810,-190
2018-06-01,2004482383,C013050,운동복,멀티 제설 성에제거기 스크래퍼 빗자루 세트 자동차물,7760,7760,0
2018-06-01,402791244,C013020,티셔츠,민트딜 캣츠미 레이온스판 라운드 반팔티 JE-2480 티,4800,4800,0
2018-06-01,988008252,A019180,즉석식품,훈제오리&장작삼겹 500G+400G,19800,19800,0
2018-06-01,209116463,A022010,주스,[롯데칠성 델몬트 망고 1.5리터 x 12페트] 과즙음료/망고주스/과일주스/1박스포장/온가,60800,58980,-1820
2018-06-01,982464236,L012040,치약,[메디안]코코몽 어린이치약 75g X 3입(사과맛),4100,3800,-300
2018-06-01,1600611309,I031040,생화,K4CAMP 쿠션겸용 사계절 트윈 연결 침낭 방수강화,30900,18220,-12680
2018-06-01,1291528112,A019090,카레,청정원 정통 인도식 병커리소스(360g) 5종 골라담기,4600,4600,0
2018-06-01,885040730,L021020,장신구,원석sale/자수정/31캐럿/큼직/amethyst,96000,96000,0
2018-06-01,1890110029,C011020,남자상의,블랙 체크 밍크털 코트 남성용털코트 남성코트 퍼코트,109100,109100,0
2018-06-01,1453399319,E031140,비데,이누스 방수비데 IS-H28 (정품필터30개월분증정),259000,239000,-20000
2018-06-01,1295712835,F012010,종이기저귀,LG 핑크퐁 에어슬림 밴드기저귀 3팩(초슬림)+사은품,35900,35900,0
2018-06-01,1782601564,C013020,티셔츠,하얀비3000원쿠폰/오피스룩/쉬폰블라우스/하객룩/나시,13800,10800,-3000
2018-06-01,20531993,C013050,운동복,소프트99 글라코 G-47 유막제거제/발수코팅제,12700,11690,-1010
2018-06-01,1374564190,C013010,점퍼,PROMORE/S/S신상품 초경량 바람막이/등산/골프/트레킹,19900,19900,0
2018-06-01,1316742495,C011020,남자상의,잭필드 2018 여름 남성 숨쉬는 바지 3종,59800,56800,-3000
2018-06-01,450160443,C013010,점퍼,K2 S 무스탕2 가죽점퍼 라이더점퍼,112010,112010,0
2018-06-01,1610680251,A015020,식용유,[사조해표]해표 콩기름(식용유) 1.5Lx4병,14900,14900,0
2018-06-01,450448605,I031040,생화,파세코 아이스박스/24-44리터/쿨러/냉온장고/캠핑용,109000,88610,-20390
2018-06-01,899493417,A013070,굴,흰다리 새우 (사우디/마리) (20마리),499,499,0
2018-06-01,985238678,A011130,시리얼,백설 자연재료 부침가루1KG,2880,2880,0
2018-06-01,493585697,C013010,점퍼,(더아이잗컬렉션) 루즈핏 빅 포켓 점퍼 CH5A0JP33/ 아이잗컬렉션,249000,236550,-12450
2018-06-01,1459884013,C011030,남자학생복,여성 [니티] 화이트 배색 브이넥 반소매 풀오버 (328451SY31)/ 에잇세컨즈,29900,26620,-3280
2018-06-01,886869687,E041010,식기,한국도자기 단반상기모음 유기수저,77000,77000,0
2018-06-01,1812959039,I031040,생화,LED 랜턴 캠핑 텐트조명 전구 캠핑랜턴 트리전구,5000,4800,-200
2018-06-01,970568476,C013050,운동복,카렌스2용 엑스트렉-미르웨이 후사경/4WD/RV용품/사각지대/후진주차/현대/기아/대우/쌍,27000,24600,-2400
2018-06-01,324206369,A013170,생선통조림,유동 번데기 130g (10캔) 무료배송,11800,11800,0
2018-06-01,151138312,E031120,믹서,메디하임 세척간편 다용도 믹서기/미니믹서기/분쇄기,21900,21900,0
2018-06-01,1779514006,L021020,장신구,[바보사랑]925실버 bold 데일리 반지 택1 A5168041,29900,29900,0
2018-06-01,1779514007,L021020,장신구,[바보사랑]925실버 thin 데일리 반지 택1 A5164551,29900,29900,0
2018-06-01,16511443,E061080,키친타월,세제없이 빨아쓰는 위생행주 웰크리너,5900,5900,0
2018-06-01,1779514005,L021020,장신구,[바보사랑]925실버 빈티지 마블스톤 반지 A5168672,45900,45900,0
2018-06-01,884324788,L012010,면도기,도루코 일회용 면도기 프레쉬 PACE4/4중날 PACE6,17000,16300,-700
2018-06-01,453367853,C012040,여자학생복,베하터 청롱 NB 여성 청남방 KD 남방 청남방 여성남방,90960,90960,0
2018-06-01,1779514008,L021020,장신구,[바보사랑]925실버 Z line 반지 A5166411,35900,35900,0
2018-06-01,16560050,E011050,책상,스마일 H형 2인용 책상+책장세트 공간활용 컴퓨터책상,150000,144900,-5100
2018-06-01,1779514009,L021020,장신구,[바보사랑]925실버 우정링/레이어드링 7종택1 A7117R01,15900,15900,0
2018-06-01,467664738,C013050,운동복,AS 드릴 탑(698916011) 트레이닝복상의 운동복 긴팔트,102350,102350,0
2018-06-01,11501616,I031040,생화,제드 젠투1000침낭/ZCASL0101/슬리핑백/하계형,27000,24840,-2160
2018-06-01,1017621960,C021020,구두,[루플랫] 1309845 (해외) 18SS 생로랑파리 윌리엄 레이스업 레더 앵클 부츠,1448400,1248800,-199600
2018-06-01,909358083,A018070,파이,초코파이/몽쉘/카스타드/오뜨/오예스/찰떡파이/파이,2450,2450,0
2018-06-01,989050066,A019100,식초,오뚜기 유기농 케찹 425G,5400,5400,0
2018-06-01,1809708827,I031010,장난감,레고10864 듀플로 놀이터 브릭 박스,66400,66400,0
2018-06-01,1017621963,C021020,구두,[루플랫] 1309997 (해외) 18SS 구찌 조르다 깅엄 로퍼,883100,761430,-121670
2018-06-01,504009422,E031010,전기밥솥,쿠쿠고무패킹 CRP-HXB107FS/CRP-HXXB1010FB,8500,8400,-100
2018-06-01,585278557,I031040,생화,BR425 BR435 PS 리튬전지 전자찌 배터리 덤핑가,1000,920,-80
2018-06-01,285133498,A014030,치즈,[냉동마트]매일 상하 아기치즈 총80매/전단계/첫치즈/어린이치즈,19800,19800,0
2018-06-01,487787349,E041030,솥,풍년 메가펄 압력밥솥 2인용~10인용 세원통상,53000,53000,0
2018-06-01,1779514010,L021020,장신구,[바보사랑]925실버반지 4종택1 A6017R001,24900,24900,0
2018-06-01,493969272,E011050,책상,(HIT)퍼스트 L형코너책상/L형책상/책상/컴퓨터 책상,96000,96000,0
2018-06-01,1961182042,E011060,의자,RM 제네시스게이밍 컴퓨터 PC방 사무 책상 학생 의자,149000,139000,-10000
2018-06-01,1181432415,E011040,소파,[보니애가구]타미 패브릭 3인용 소파,179000,171560,-7440
2018-06-01,1093251783,C012060,여자내의,시크폭스 웨이리쿨 플리츠밴딩팬츠/ 시크폭스,12500,9750,-2750
2018-06-01,1774341144,I012010,컴퓨터,[특] DM500S7Z-AD2A-SD-WIN10+키보드+마우스,674040,674040,0
2018-06-01,76120365,C013010,점퍼,폴햄 모직 야구 점퍼/size L/자켓/코치/중고/구제,35000,35000,0
2018-06-01,847334191,A018080,설탕,유기농 설탕 고이아사 비정제 설탕 원당 매실,65000,65000,0
2018-06-01,504620494,E031070,에어컨,JJH신일산업 천정용 선풍기 SIF-16CSH 여름선풍기 계,122520,122520,0
2018-06-01,235409047,C013020,티셔츠,[블루독](BL)애니멀그래픽티셔츠(27415-332-03),26000,20020,-5980
2018-06-01,603627312,C015040,장갑,DOT코팅 면장갑-10켤레♥흰면장갑 반코팅면장갑 골프 헬스 등산 낚시 목장갑 반코팅목,7420,7420,0
2018-06-01,577153662,L021030,가방,늘푸른백화점 하림 SJAH9159 업무용 비즈니스서류가방,11290,11290,0
2018-06-01,782869732,F011150,건강기능식품,[동화약품] 동화약품 부채표 까스활 75ml(20병)소화제/까스활명수,13400,13400,0
2018-06-01,381452432,C013020,티셔츠,루즈핏기모폴라티 WW1801 스판폴라티 폴라티 데일리폴,39730,39730,0
2018-06-01,340930899,L021020,장신구,실버 체인 은팔찌 각인 커플 남자 여자 컷팅 7/10D,84000,84000,0
2018-06-01,1357766130,D031010,주택수선재료,조립식 마루 바닥재 54P/베란다 /욕실원목매트/발코니,28600,27900,-700
2018-06-01,517326078,D031010,주택수선재료,[슁글박사]안새내/옥상방수/지붕방수/슁글방수재/슁글,120000,120000,0
2018-06-01,154214924,A013120,낙지,장수왕 1등급오징어다리 장족 오징어발 문어발,10800,10800,0
2018-06-01,1510670705,A018080,설탕,인차 에리스리톨 위드 스테비아 600g 사은품 증정,25500,25500,0
2018-06-01,1577626306,A013170,생선통조림,오뚜기 참치빅캔 살코기 1880g 1캔 참치캔 업소용 P,15890,15890,0
2018-06-01,788931285,C014020,유아복,해피젬 유아동 베이비 모시의류,19500,19500,0
2018-06-01,83869963,L021020,장신구,[1부현대감정]14K/18K 천연다이아몬드 다프네 귀걸이,447000,447000,0
2018-06-01,736793645,C021020,구두,[금강제화] 6CM의 자신감 리갈 남성 키높이 정장구두 MMX7831KR16(본점),174400,152260,-22140
2018-06-01,1396734699,C012060,여자내의,[보니알렉스](보니알렉스) 베이직 니트 스커트(BAWZ121A),12200,10740,-1460
2018-06-01,1781869818,I031040,생화,아오맥스 프리미엄 낚시대 풀세트/TV쇼핑 원투 쭈꾸미,124000,117800,-6200
2018-06-01,1779514011,L021020,장신구,[바보사랑]925실버반지 Line 3종택1 A6020R001,19900,19900,0
2018-06-01,741035114,C014010,아동복,아동 긴팔티/ 긴팔 골지티셔츠/ 12가지 색상/ 국내산 고급면티/ 아동 기본티셔츠/ 아동,8900,8800,-100
2018-06-01,342689286,E021010,침구,겨울왕국 면기모 패드 - 뷰티선샤인 (064187) 패드 까,62020,56490,-5530
2018-06-01,119329573,A015010,참기름,살림터 미드미 참기름 / 들기름 1.8L 업소용,26400,26400,0
2018-06-01,1160274607,I011030,사진기,캐논 정품 EOS 80D + 18-55mm + 가이드북 증정 명품,1275000,1172910,-102090
2018-06-01,1569312074,I031040,생화,은성 갯바위낚시대/찌낚시대/방파제낚시대/바다낚시대,69800,69800,0
2018-06-01,181772409,I011030,사진기,명품 니콘 COOLPIX W300s 정품 + NK41 파우치 증정,472800,452790,-20010
2018-06-01,1238985379,A012060,햄및베이컨,콩으로 만든 식물성 쏘시지 구프랑 500g 12입,115660,115660,0
2018-06-01,1354306406,C013020,티셔츠,심플 후드집업 LLTT0043 후드집업 트레이닝복,24820,24330,-490
2018-06-01,512540495,C012060,여자내의,도호 DOHO 여성 허리 밴딩 주름 롱 스커트 DR640820,88000,88000,0
2018-06-01,390191374,C012020,원피스,[쉬즈미스][쉬즈미스] 탈착 스트랩 솔리드 셔츠_SWWSTI10010_PU,138600,117810,-20790
2018-06-01,1747231868,A018090,잼,[오뚜기] 오뚜기 딸기쨈 (디스펜팩) 12g 72개 일회용 휴대용 잼,6840,6840,0
2018-06-01,1774969206,A011010,쌀,렌틸콩증정! 칼로리 낮은 홍신애 곤약미 180g5봉 외,21900,21900,0
2018-06-01,476429029,C013010,점퍼,수퍼노바 스톰 자켓 화이트 스포츠자켓 트랙자켓 운동,145450,145450,0
2018-06-01,234493320,E031130,보온매트,글루바인TC 전기요GW-823 [더블 세탁가능 4중안전시스템 스마트타이머],139000,139000,0
2018-06-01,551772199,I011030,사진기,(캐논총판) 캐논 EOS 200D 18-55mm Kit+활용책,662000,662000,0
2018-06-01,234493321,E031130,보온매트,글루바인극세사 전기요 GW-813[더블 세탁가능 3중안전시스템 8시간타이머],89000,89000,0
2018-06-01,1223833521,C011030,남자학생복,[모다아울렛][베이직하우스]남자여름베스트베스트면베스트 MOVT3101,9900,9410,-490
2018-06-01,896576822,A012050,소시지,CJ 더건강한 치즈그릴비엔나 330G,9380,4590,-4790
2018-06-01,942716588,C013010,점퍼,봄 여름 남성 여성 등산 골프 바람막이 점퍼 자켓,16800,16800,0
2018-06-01,1961184679,A018040,아이스크림,라벨리팥빙수6개/아카라카24개/설in면초코10개,9900,9900,0
2018-06-01,1302651541,C011030,남자학생복,(컬러:사이즈 : 블랙:2XL) TAL2003 남자빅,54050,54050,0
2018-06-01,234493322,E031130,보온매트,극세사 전기요 GW-812 [슈퍼싱글 / 세탁가능 / 3중안전시스템 / 8시간타이머],84000,84000,0
2018-06-01,234493323,E031130,보온매트,TP 전기요 GW-802 [슈퍼싱글 / 세탁가능 / 3중안전시스템],53000,53000,0
2018-06-01,1373354050,C013020,티셔츠,[필골드] SL3001 엔리코 와펜 폴라 티셔츠,19800,19800,0
2018-06-01,390191347,C012020,원피스,[쉬즈미스][쉬즈미스] 깅엄체크 버튼다운 코튼 셔츠_SWWSTI10020_BK,59000,50150,-8850
2018-06-01,1674117212,E021020,커튼,침대캐노피50종 사각모기장 러브리캐노피 빅사이즈인,24800,24800,0
2018-06-01,845936869,C013050,운동복,국산 차량용 소화기 250ml 1개 휴대용 간이소화기,22870,22870,0
2018-06-01,1966815633,E041070,밀폐용기,메탈락 스텐 밀폐용기 직사각 원형 반찬통 김치통,4900,4510,-390
2018-06-01,234493319,E031130,보온매트,글루바인 TC 전기요 GW-822 [슈퍼싱글 / 세탁가능 / 4중안전시스템 / 스마트타이머],129000,129000,0
2018-06-01,1525212989,I031040,생화,카드형 멀티툴 맥가이버칼 캠핑툴 다용도툴 만능툴 등,2100,1840,-260
2018-06-01,88017737,D031010,주택수선재료,페인트마트 노루페인트 유성페인트 슈퍼에나멜 100ml 미니 샘플 소분판매 유성 에나멜,2200,2200,0
2018-06-01,664511407,E011070,식탁,[동서가구]토트 4인 대리석식탁세트,710000,661010,-48990
2018-06-01,238727524,C011030,남자학생복,[리즈코] MCD-904 컬러배색 하이니 브이넥 가디건 그린,16000,16000,0
2018-06-01,1154053106,C012040,여자학생복,뒷반전니트/니트/ 립합(LIPHOP),15000,14250,-750
2018-06-01,390191349,C012020,원피스,[쉬즈미스][쉬즈미스] 플라이 프런트 스트라이프 셔츠_SWWSTI11020_BK,58000,49300,-8700
2018-06-01,183926769,E011010,장롱,동서가구 가성비 Good! 북유럽풍 옷장&장롱,62910,62910,0
2018-06-01,2095152109,C013050,운동복,다이아코트 프리미엄 트렁크정리함_콘솔박스 (대형),27210,27210,0
2018-06-01,439635440,A015020,식용유,(무)해표 식용유(콩기름)18LX1개콩기름 해표 식용유,67700,57550,-10150
2018-06-01,1032159143,A022030,생수,딥스 해양심층수 (경도150) 2L 12개,24000,24000,0
2018-06-01,1185299209,C012040,여자학생복,[블루종][블루종]카사리 골지 7부 가디건_[B1806CD031B],19800,18810,-990
2018-06-01,1439792597,E011060,의자,시팅포인트 레이싱 게이밍 PC방의자,72900,65610,-7290
2018-06-01,1648982218,I031010,장난감,해피플레이 매직워터벌룬 물풍선제조기1+1+1특가333개,9900,9900,0
2018-06-01,1411571863,E031010,전기밥솥,CRP-HPF0660SR/쿠쿠/6인용/IH압력/GH,197400,183400,-14000
2018-06-01,2014005093,C013010,점퍼,[애드혹]애드호크(HTBDO90) 오리털 롱 패딩,59000,47200,-11800
2018-06-01,234493318,E031130,보온매트,글루바인 TP 전기요 GW-803 [더블 / 세탁가능 / 3중안전시스템],58000,58000,0
2018-06-01,353431156,A012010,국산쇠고기,대관령한우 럭셔리3호,304750,304750,0
2018-06-01,1467999536,A012040,닭고기,[아임닭] 맛있고 간편하게 먹는 닭가슴살 큐브 15+1팩,30500,30500,0
2018-06-01,795515426,A011180,파스타면,오뚜기 스파게티면500gx24개/오뚜기마카로니500gx24개,21400,21400,0
2018-06-01,2108908234,A017120,고구마,포근포근 고소한 2018년 햇감자 5Kg/10kg 13600/양파,7900,7600,-300
2018-06-01,1222691528,E031070,에어컨,[[더위야 가라~!!]]신일/동일 4엽 20-24-30인치대형선풍기/SIF-20FOG SIF-24FQG SIF-3,119800,119800,0
2018-06-01,1007111511,F011150,건강기능식품,[본사공식몰]드시모네 4500(20포),110000,110000,0
2018-06-01,1179115245,C013010,점퍼,PK 번아웃 JP(Q83DKJ051)/ 프랜치캣,40500,34430,-6070
2018-06-01,1828453053,C014010,아동복,[블루독] 슬림7부팬츠 (27375-411-01),46000,37720,-8280
2018-06-01,62173600,L012040,치약,덴티스테 치약 6개 370g/미백 화이트닝/구취/입냄새,18300,18300,0
2018-06-01,666263760,C011030,남자학생복,할인쿠폰! 시원한 린넨 긴팔 반팔셔츠 체크 남방,15800,15800,0
2018-06-01,1762156132,A013070,굴,캐나다 직수입 랍스터 테일 4-5oz 1kg(7~8마리),66000,66000,0
2018-06-01,231889549,C012060,여자내의,밴딩잔주름롱스커트/M4246/ 디어제인,6700,6240,-460
2018-06-01,503754605,C013040,청바지,워싱 데미지 7부 청반바지 남성청반바지 패션청반바지,15730,15730,0
2018-06-01,281344452,A012030,돼지고기,구이용 왕목살 오겹살 항정살 삼겹살 돼지고기,3200,3200,0
2018-06-01,416020082,C011030,남자학생복,슬림 카라포인트 비취패턴 블루 셔츠 남자남방 남방,20390,20390,0
2018-06-01,1005133639,A011090,국수,농심 신라면 안성탕면 오짬 너구리 진라면 1박스,22800,22800,0
2018-06-01,1825357705,A017110,감자,장흥표고_흑화고세트200g건강식품 명절선물세트 특산품 추석선물세트 효도선물 표고세,42170,42170,0
2018-06-01,103787002,C013050,운동복,[M~2XL] 3부 핫팬츠 5부 반바지 오버핏 반팔티 슬랙스,7900,7900,0
2018-06-01,954852016,A013170,생선통조림,동원 꽁치고등어 기획(400G*2),5490,4490,-1000
2018-06-01,1966815663,C012040,여자학생복,리프 스트라이프 롱 셔츠,13900,13900,0
2018-06-01,1688453629,E021010,침구,국내산 순면 차렵이불 패드세트 카페트 침구세트,38900,38900,0
2018-06-01,624041957,I031070,애완동물관리비,윌슨 헤드 가와사키 바볼랏 테니스라켓 모음,64700,64700,0
2018-06-01,1503729939,E021020,커튼,[리앤룸]호텔식1+1어반커튼/별레이져 커튼set,19600,19600,0
2018-06-01,823048900,E031070,에어컨,정품빠름ㅁ 사파이어 천정형리모컨선풍기 HJ-R16T,44000,44000,0
2018-06-01,1014315012,E021010,침구,{베게솜무료증정}여름이불+패드세트/여름이불세트,34900,34900,0
2018-06-01,618786600,L021020,장신구,스와로브스키 은침귀걸이 이어링 귀고리 유색 크리스탈 여성악세사리선물 패션쥬얼리,17600,17080,-520
2018-06-01,1103425589,C013010,점퍼,아디다스 유소년 콘디보16 스타디움자켓 (AN9871 ),139590,124240,-15350
2018-06-01,1302421655,I031040,생화,버팔로 토르 해머 캠핑망치 캠핑해머 AC2466/피아누라,13000,9260,-3740
2018-06-01,1888691920,F011150,건강기능식품,대웅 간건강 가네굿 700mg x 90캡슐,25990,25990,0
2018-06-01,892736150,C011030,남자학생복,[인터페이스] 가볍게 걸치는 니트/가디건/후리스 모든,17700,17700,0
2018-06-01,386393936,C012020,원피스,쫀득 베이직 스키니 RIN0357RM805 빅사이즈,56430,53050,-3380
2018-06-01,1906339718,L012060,샴푸,프레시팝 모히또 두피샴푸 500mlX3 외 BEST,17900,17900,0
2018-06-01,1095143175,A016020,배,[해울림] 추석 명절선물 프리미엄 나주배 2호,79000,78000,-1000
2018-06-01,1025746866,C013020,티셔츠,T1627-피치기모 반폴라 레이스 티(레이스/기모레이스/,35840,34050,-1790
2018-06-01,1117844856,A017010,배추,[미가푸드]배추우거지 1k*3봉/무청시래기/김치/마늘,6900,6900,0
2018-06-01,1060575655,E061020,섬유유연제,LG 샤프란 아로마시트-후레쉬드림 (30매) 섬유유연,11100,11100,0
2018-06-01,439635465,A013170,생선통조림,동원자연산골뱅이 140gX48개골뱅이 식품 골뱅이캔 식,270600,221900,-48700
2018-06-01,1244618794,E031010,전기밥솥,쿠쿠 보온밥솥 CR-1713R 밥솥 대용량밥솥 전기밥솥 14,99770,99770,0
2018-06-01,1095228586,A016020,배,[해울림] 추석 명절선물 프리미엄 나주배 1호,55000,54000,-1000
2018-06-01,1119954144,C012020,원피스,[보니알렉스](보니알렉스)수술장식 오버사이즈 기모코트(BAHZ102A),41100,36170,-4930
2018-06-01,1119954146,C012020,원피스,[보니알렉스](보니알렉스)클래식 무드 베이직 코트(BAHZ181C),29900,26320,-3580
2018-06-01,1999266253,I031010,장난감,최신상 특가세일 뉴턴블럭/블록/교육완구/학습교구,42000,36900,-5100
2018-06-01,1048037163,I012060,저장장치,한성 GTune GK550 XRGB 축교환LP PBT 청축/갈축/적축,47760,44900,-2860
2018-06-01,2005103030,C013050,운동복,상하세트 유아상하세트 핑크상하세트 상하복세트 맨투,34730,33690,-1040
2018-06-01,1953528966,C013010,점퍼,쥬크 재입고 라쿤털오리털롱패딩점퍼 Z174PSG801,153230,153230,0
2018-06-01,540125027,C013010,점퍼,[모다아울렛][반에이크][반에이크]기본 무스탕_(행담도 모다)_V7YJPM502Z,139000,130660,-8340
2018-06-01,1382435122,E031120,믹서,일본 가전 레꼴뜨 솔로 블렌더 솔렌 보틀 2개 세트,49000,49000,0
2018-06-01,1320170799,I031010,장난감,퀵쿠페 붕붕카 / 유아 자동차 카 장난감 안전 어린이,23700,23700,0
2018-06-01,1695961670,A022020,두유,연세두유 발효 퀴노아 렌틸콩/검은콩 두유 96팩,36900,36900,0
2018-06-01,372598023,C013020,티셔츠,(정품)Levis 리바이스 로고 반팔티셔츠9종/미국직수입정품/신혼여행/커플티/빅사이즈티,20900,20900,0
2018-06-01,596624928,C012020,원피스,김발(속대 에브리홈)X2,2480,2480,0
2018-06-01,1326630570,C021040,실내화,[푸마] (SIZE : 280) 플레어 2(18951701) 신발 러닝,85190,85190,0
2018-06-01,895775339,A018080,설탕,CJ 갈색설탕 15KG,27900,25900,-2000
2018-06-01,958452850,F012020,생리대,[유한킴벌리]유한킴벌리 화이트 탐폰 슈퍼16P,7350,5990,-1360
2018-06-01,1807131345,L021020,장신구,[바보사랑][실버] 대니 펄 귀걸이,16500,16500,0
2018-06-01,1226353655,C014020,유아복,기본 유아 아기 봄여름반팔티셔츠 워싱 싱글 목시보리,8900,8900,0
2018-06-01,268396398,C012040,여자학생복,[ab.plus][ab.plus] 스포티한 빅버튼 가디건 (LSQ2GW15A)_F1J2,19000,16150,-2850
2018-06-01,1295805041,C012040,여자학생복,[조이너스(JoinuS)]큐빅장식 셔링 라운드넥 슬리브리스 블라우스_JA7U4-WRB720,48300,48300,0
2018-06-01,1807131344,L021020,장신구,[바보사랑][실버] 레타 진주 귀걸이,31000,31000,0
2018-06-01,1792574622,A022030,생수,[동원] 디톡스파클링500ml*20+쿨피스톡캔350ml*24,11520,11520,0
2018-06-01,412630380,E011060,의자,원목 식탁의자 30여종 커피숍의자 카페의자,25900,22410,-3490
2018-06-01,256797932,C012020,원피스,헤링본체크자켓(N181MSF003)/ 나이스클랍,199500,179550,-19950
2018-06-01,1656818971,E061040,부엌용세제,멜라루카 전제품 리뉴/코알라/주방/세제/치약/오일,19800,19800,0
2018-06-01,1567238291,L012040,치약,(CMIT/MIT 無) 덴티스테 마일드 치약 4~8개 set,27000,20900,-6100
2018-06-01,958452846,A019080,고추장,해찬들 우리쌀로만든태양초골드고추장 (1.6kg+300g),20900,20900,0
2018-06-01,861191381,C011020,남자상의,패딩 코트 레이어드 PD05 WS패딩코트코트남자코트트랜,160310,160310,0
2018-06-01,1502882906,C015020,모자,빅사이즈모자 큰모자 대두볼캡 스냅백 군모 XL모자,9900,9900,0
2018-06-01,874705377,E061010,세탁세제,리큐 진한겔2Lx4개/테크 액체 유한젠 세탁세제,13800,13800,0
2018-06-01,1183452043,E041050,냄비,[에코라믹] 데일리 세라믹 냄비 2종세트 (핑크),22800,22800,0
2018-06-01,293126895,C013020,티셔츠,DSHN0115R 베이직 심플 맨투맨 803 티셔츠 여자라운드,30830,30830,0
2018-06-01,958452849,F012020,생리대,[유한킴벌리]유한킴벌리 화이트 탐폰 레귤러 16P,7350,5990,-1360
2018-06-01,410759354,I011010,TV,아남TV 32/40/43/49/55/65 HD  FHD  UHD TV 컬렉션,206960,189000,-17960
2018-06-01,492849103,F012020,생리대,늘 산뜻한 롱 라이너 40p/ 예지미인,2400,2400,0
2018-06-01,440945129,C012040,여자학생복,베이직 쿨비침 가디건 7color/ 빅사이즈 55~100까지,25500,24000,-1500
2018-06-01,2046421804,C011050,남자내의,아디다스 여성 에센셜 리니어 타이츠 (AY4824 ),52960,47140,-5820
2018-06-01,1122859826,L021010,손목시계,[바보사랑]슈어 가죽 시계,29500,29500,0
2018-06-01,708711710,A013050,오징어,오뚜기 꽁치 280g X 24EA 재료 통조림 가공통조림 캔,79390,79390,0
2018-06-01,1453302418,E061030,전구,오스람 EL 20W 삼파장 전구 11W 15W 형광등 램프 장미,1380,1250,-130
2018-06-01,2044349453,E031120,믹서,[하이벨] 하이벨 커피 그라인더 원두 전동 분쇄기 MFM-002H,16500,16300,-200
2018-06-01,2069654336,A012010,국산쇠고기,특선 1등급 암소한우 400g 구이세트 특가판매,29800,29800,0
2018-06-01,1624915173,G011070,자전거,무료배송 하이브리드 135cm부터사용 21단 시애틀모던F,128000,115200,-12800
2018-06-01,708625296,A022040,기능성음료,토레타 240ml X 30CAN,14700,14700,0
2018-06-01,445602576,C013010,점퍼,인조이 롱 점퍼 (블랙) 가볍게 걸쳐입기 좋은 시보리,24490,24490,0
2018-06-01,440972753,C013010,점퍼,케빈 트렌디 점퍼 (블랙 카키) 커플 항공 롱 점퍼 롱,28980,28980,0
2018-06-01,1495369897,A021010,커피,1kg갓볶은 원두커피/10+1행사/3kg 무배(특가제품제외),8000,8000,0
2018-06-01,1881596007,E021020,커튼,트렌디하고 하늘하늘한 20수 면 사계절 커튼 창 거실,22800,20980,-1820
2018-06-01,1145838082,A013150,어묵,(참소당 오뎅소스1.8L)오뎅쯔유 어묵육수 오뎅탕 국물,12900,12900,0
2018-06-01,1092238540,I031040,생화,국산 에코젠 친환경 마이보틀500ml/티보틀/스포츠물통,1700,1530,-170
2018-06-01,612721415,C013020,티셔츠,프랑 레이온 슬림Tee/ 핑크시슬리,9100,7280,-1820
2018-06-01,53838898,A012060,햄및베이컨,초특가 스팸 200g x 6개 / 클래식 마일드 340g x 5개,16800,16800,0
2018-06-01,461432757,E061060,살충제,기어다니는 벌레 다잡는 마툴키플러스 300ml 바퀴벌레,20590,20590,0
2018-06-01,983415597,A022050,탄산음료,코카 환타오렌지 355ML(캔),750,600,-150
2018-06-01,1027291596,E011070,식탁,멀바우 아일랜드식탁 수납형아일랜드테이블 빠테이블,219000,219000,0
2018-06-01,885147566,E061020,섬유유연제,다우니 리필 700mlx5개/퍼퓸/고농축섬유유연제/보타닉,15900,15900,0
2018-06-01,989074094,A013150,어묵,동원 바른어묵 얇은사각 200G*2,3890,2490,-1400
2018-06-01,1603843704,C011030,남자학생복,거즈면 오픈 롱가디건 JE-2467 가디건 브이넥가디건 롱가디건 후드가디건 루즈핏가디건,5620,5010,-610
2018-06-01,1638201417,A011120,두부,켈로그 씨리얼 대용량7종 첵스초코 아몬드푸레이크,9900,9900,0
2018-06-01,507768944,E031120,믹서,파벡스 믹서기 멀티 블렌더,70500,63450,-7050
2018-06-01,820095467,C011050,남자내의,아로미 905/고무호피 발목 고무밴딩 스프사 9부파자마,11700,10420,-1280
2018-06-01,296939033,C012040,여자학생복,도트패턴 프릴 탑 (551720)/ 밸리걸,9900,8910,-990
2018-06-01,296939034,C012040,여자학생복,숏기장 프릴레이스 가디건 (551520)/ 밸리걸,9900,8910,-990
2018-06-01,511226090,D031010,주택수선재료,[에버그린]로하스인증/친환경페인트/벽지용/벽면용,10900,8900,-2000
2018-06-01,922019819,C013020,티셔츠,남자 반팔티셔츠 남성골프웨어 남성카라티 단체티CLST,11900,11900,0
2018-06-01,1244511972,E011050,책상,해머 원목책상 원목의자 책상세트 어린이 학생 1인용,99000,89100,-9900
2018-06-01,835162586,C013010,점퍼,[로엠걸즈(아동)]캉캉바람막이점퍼 RGJA82306C,29900,29900,0
2018-06-01,862056162,C013010,점퍼,[인터페이스] 네오프렌 블루종/항공점퍼/스타디움 고,29700,29700,0
2018-06-01,949385033,E011030,거실장,보노쇼파베드,73900,73900,0
2018-06-01,1845623143,C012020,원피스,[다바걸][다바걸] 올리브롱롱울코트,73500,69830,-3670
2018-06-01,949385031,E011030,거실장,보노쇼파베드2,64900,64900,0
2018-06-01,895775343,E061060,살충제,[한국존슨]에프킬라오프에어졸150ML,6900,6900,0
2018-06-01,415872057,C012030,여자상의,겹침 V넥 튜닉 원피스 KD 원피스 청원피스 니트원피스,36350,35630,-720
2018-06-01,423348664,A019090,카레,카레(중간매운맛 SB 240g)X60,423460,423460,0
2018-06-01,949385032,E011030,거실장,보노쇼파베드S,68900,68900,0
2018-06-01,1432325591,A022010,주스,[무료배송]웅진)(6입)자연은 포도100-1.5L 주스 과일,29020,29020,0
2018-06-01,1742368111,A019170,냉동식품,[냉동] CJ 비비고 왕교자 1.05kg×2봉/ 씨제이제일제당,15900,15900,0
2018-06-01,70646100,F011150,건강기능식품,쌀눈검은콩 미숫가루X2봉/100%국내산/無설탕,12900,11900,-1000
2018-06-01,2135256492,C013050,운동복,형광가정용소화기 소방차450,40170,36160,-4010
2018-06-01,1257087768,C013020,티셔츠,[닥스키즈] 한정수량 어린이날 세일,28000,28000,0
2018-06-01,955885960,A018040,아이스크림,빠삐코 초코 (10개),7000,5600,-1400
2018-06-01,291932855,C013010,점퍼,라보니 아동 리얼폭스퍼 다운점퍼 -카키 /(참고) 아동,120200,105780,-14420
2018-06-01,909202260,C013010,점퍼,남아 쿠션지 웜업 집업 점퍼_EAJB7142BL0/ 오션스카이,7000,6160,-840
2018-06-01,1572785253,A017140,콩나물,발송중)자연산 참 두릅 참 옻순 참 가죽나물 1KG 500G,19800,19800,0
2018-06-01,296939060,C012040,여자학생복,플라워 패턴의 가디건형 우븐 탑 (973600)/ 밸리걸,9900,8910,-990
2018-06-01,778486981,A013090,전복,금진 생생이 세척홍합 5kg내외 홍합요리,17600,17600,0
2018-06-01,680918538,A012050,소시지,한성 매콤불고기맛후랑크 80gx50개 1박스/핫바/햄,24600,24600,0
2018-06-01,1270011887,C012020,원피스,남자정장 보카시 차콜 수트 BC0117002 더블수트 남성의류 정장조끼 면접의상 남자자켓,138410,123190,-15220
2018-06-01,780270898,C021010,아동화,아동 운동화 아동화 유아 신발 키즈 남아 여아 실내화,24900,24900,0
2018-06-01,1358291525,E011060,의자,의자[버치체어]인테리어의자/보조의자/간이의자/사무용의자/회의용의자/회의실의자/책,32900,32900,0
2018-06-01,1964668937,E061020,섬유유연제,샤프란 아로마시트 섬유유연제 50매x4개,17900,17900,0
2018-06-01,1205305044,C013020,티셔츠,포켓맘 포켓수유티,27130,27130,0
2018-06-01,93853911,C012060,여자내의,여름신상 슬랙스 와이드팬츠 린넨슬랙스 부츠컷,14800,14800,0
2018-06-01,1049678964,C012040,여자학생복,[탑걸] (TIZ4GD703F) 프린트 로브 가디건,31200,25590,-5610
2018-06-01,88500813,I011030,사진기,후지필름 파인픽스 XP130 방수카메라,253000,253000,0
2018-06-01,1646483030,E031110,청소기,[트윈버드] [본사정품]쎈스톰 핸디용 싸이클론 진공청소기 센스톰,79900,79900,0
2018-06-01,1383447371,C012020,원피스,모던하고시크한루즈핏자켓(NW6WH447)/ 온앤온,99000,79200,-19800
2018-06-01,2093620416,A011090,국수,오뚜기 컵라면 24종 총집합 / 미니컵 진라면 열라면,9300,9300,0
2018-06-01,890995700,E011030,거실장,모던 화이트 2단 거실장,69900,69900,0
2018-06-01,1453522920,L021060,유모차,씽크킹 마이티 더블 유모차걸이 (핑크)유모차용품,38760,38760,0
2018-06-01,1773957095,I031040,생화,[키모니] 국산 고품질 무릎보호대 무릎아대 무료배송,9900,9110,-790
2018-06-01,459609707,C013010,점퍼,#NAME?,70390,70390,0
2018-06-01,1453760016,A017040,양배추,생 방아잎 500g /배초향/국내산/ 당일수확후 발송,6000,6000,0
2018-06-01,825876471,C013010,점퍼,[대구백화점 II관] [레코브](기존가:99 800원)레고 자수야상(LU2177JK801X),44900,42660,-2240
2018-06-01,1851012744,C013050,운동복,와인 데코라인 도어가드/ 자동차도어가드 문콕방지패,8900,7800,-1100
2018-06-01,1124475330,A013010,갈치,제주 옥돔 프리미엄 2kg(마리당450g내외 선물포장) 탐,168400,163350,-5050
2018-06-01,1963101561,C013050,운동복,실리콘 캐릭터벨트클립 귀여운 안전벨트 클립 경고음,5000,4850,-150
2018-06-01,1700917063,C011030,남자학생복,남성 와이셔츠 슬림남방 긴팔/롤업/스판/면/체크,14000,12800,-1200
2018-06-01,811504005,E061060,살충제,페스트캅 권연벌레 페로몬 끈끈이 트랩 해충퇴치 박멸,9900,8400,-1500
2018-06-01,1205067470,A022020,두유,[정식품] 건강담은 야채가득 V19 야채주스 야채즙 145m 72팩,32900,32900,0
2018-06-01,363609925,C013010,점퍼,MJ-1048 블랙 스카 심플 패딩 남성캐주얼패딩 패딩점,82450,82450,0
2018-06-01,291907863,E061010,세탁세제,[독일기술 페리엘] 유니버셜젤 3Lx2/컬러젤/액체세제,22900,22900,0
2018-06-01,754190053,I011010,TV,공식파트너 삼성 125cm UHD TV UN50MU6300FXKR,982000,799000,-183000
2018-06-01,2097921321,C021010,아동화,소피루비 아카 운동화 핑크 캐릭터아동화 여아용 신발,43280,43280,0
2018-06-01,2034486279,C013020,티셔츠,[슈퍼스타아이]불스 보카시꽈배기 폴라니트[TSH127228],19100,15280,-3820
2018-06-01,266548314,I012060,저장장치,조위기어 BenQ CAMADE 마우스번지..,32810,30000,-2810
2018-06-01,352715178,A012010,국산쇠고기,대관령한우 럭셔리4호,271730,271730,0
2018-06-01,1400009822,I012060,저장장치,앱코 HACKER K640 게이밍 기계식키보드 블랙 갈축,38900,38900,0
2018-06-01,61773908,L021030,가방,국산 인기 여성가방 데일리백/크로스/핸드백/숄더,10000,9900,-100
2018-06-01,1807559400,L012030,칫솔,유아칫솔 부드러운모 12개입 어린이집준비물 유아치약,21000,18000,-3000
2018-06-01,895775317,A015020,식용유,[CJ]CJ 옥배유 (900ml),4990,4990,0
2018-06-01,1011063790,A014020,분유,[베베쿡] 사르르쿵 딸기 1봉,3900,2900,-1000
2018-06-01,895775316,A012060,햄및베이컨,CJ 스팸 340G*3입,17600,17600,0
2018-06-01,210156251,A012060,햄및베이컨,롯데햄 런천미트 340g x 1캔/햄/스팸/롯데런천미트,1890,1890,0
2018-06-01,2031366980,C013050,운동복,[무스트]시원한 쿨론정품 에어컨 프린팅 반팔세트,15900,15900,0
2018-06-01,2028074142,A016150,아몬드,브라질너트 1Kg 사차인치 카카오닙스 헤이즐넛 피칸,25900,25900,0
2018-06-01,1100327525,L021020,장신구,실버바 스틱 체인 은팔찌 각인 커플 남자 여자 10돈15,148900,148900,0
2018-06-01,1435261712,A018080,설탕,유기농 비정제 설탕 5kg/황설탕/매실/과일청/수제청,14900,14900,0
2018-06-01,290401647,A018080,설탕,코리원/자일리톨 크리스탈 1kg/자일리톨가루/설탕,11900,11900,0
2018-06-01,115885499,C011030,남자학생복,오마샤리프 블랙 스트라이프셔츠 드레스셔츠/30332BK,18800,18800,0
2018-06-01,430077668,L012090,기초화장품,엘리자베스아덴 그린티 데오도란트 43g/아로마틱 효과,12990,12990,0
2018-06-01,562890706,I031010,장난감,점보 지프와 피규어 남아장난감 자동차장난감 야외용,60950,60950,0
2018-06-01,2121307198,E041070,밀폐용기,특판 글라스락 선물세트 유리밀폐용기 얌얌 선물포장,19800,18220,-1580
2018-06-01,852952010,A011070,혼식곡,백설 우리밀 밀가루(750G),2930,2930,0
2018-06-01,1318933707,A019050,간장,테라오카 계란에 뿌려먹는 간장 300ml (3207) 일본쯔,13520,13520,0
2018-06-01,1812197875,C011020,남자상의,쉐도우 롱 패딩 코트 스포츠패딩 남성롱패딩 남롱패딩,277430,277430,0
2018-06-01,1001899639,C012020,원피스,[보니알렉스](보니알렉스) 오버사이즈형 코트 (BBHX600A),21100,20050,-1050
2018-06-01,1170721502,F011150,건강기능식품,[안국건강] [안국건강]New안심캡슐 눈에 좋은 안국 루테인 60캡슐 1통,18900,17960,-940
2018-06-01,1492764345,C012040,여자학생복,안지크 린넨 셔츠형 블라우스 AB2BL5220,42630,42630,0
2018-06-01,568772908,C011020,남자상의,[킨록] S/S 춘하 신축성 남성 슬림정장 4종 택1 IVS8598,129000,103200,-25800
2018-06-01,793704248,C012040,여자학생복,여름신상~ 시원한셔츠 체크/롱/박시핏/무지/오버핏,14900,14900,0
2018-06-01,1270478129,L021020,장신구,14K 두줄 박스체인 귀걸이,195040,195040,0
2018-06-01,1224091590,E061060,살충제,바퀴킬러훈연탄150G (10개 묶음)_0081 /(참고)생필품,62600,55090,-7510
2018-06-01,386317488,C015030,넥타이,(색상 : 퍼플) BTIE_107 미로 패턴 보타이,13420,13420,0
2018-06-01,2110910083,A022030,생수,이동크리스탈 2L*27병,13800,13800,0
2018-06-01,1860703873,E061020,섬유유연제,스너글 드라이시트 275매 빨래 의류 건조기,19600,19600,0
2018-06-01,400536703,I012010,컴퓨터,프리미엄 렌탈중고 컴퓨터본체 윈도우7/10 정품,150000,139000,-11000
2018-06-01,656169733,A016120,바나나,[Dole본사직영]Dole 스위티오/유기농/미니 바나나,2900,2900,0
2018-06-01,1088066815,C013050,운동복,트레이닝복 긴바지 기모 트레이닝바지 운동복 츄리닝,10900,10900,0
2018-06-01,372214512,C013010,점퍼,항공점퍼 블루종 남자아웃도어 봄야상잠바 등산작업복,49800,39800,-10000
2018-06-01,622435738,L012090,기초화장품,강블리 제주 유채꿀/녹차 기초 화장품/샴푸/바디워시,1900,1900,0
2018-06-01,997797224,L021030,가방,삼성9 LG그램 13인치 14인치 15인치 노트북파우치가방,25900,25900,0
2018-06-01,1805635689,A022040,기능성음료,포카리스웨트/이온음료/포카리캔/1.5/500/뚱캔/스포츠,14900,14900,0
2018-06-01,546927817,C012060,여자내의,[에잇컨셉]여름날의 반부츠컷(C8E1FPT007),29000,28130,-870
2018-06-01,1325299059,C012060,여자내의,페이크삭스 10족 양말 스타킹 발목스타킹 기모레깅스 기모레깅스 레깅스 스타킹 겨울스,11730,10440,-1290
2018-06-01,420757721,C012020,원피스,라글란 빅버튼 8부 울코트 MRDGHH9970/ 미니멈,329000,289520,-39480
2018-06-01,317720618,C013050,운동복,테라칸후사경 주차미러 뉴카렌스후방거울 빽미러,19000,17390,-1610
2018-06-01,1387616523,C011020,남자상의,AG 빅사이즈 야상 피쉬 오버코트 BW 코트 남성오버코,122350,122350,0
2018-06-01,174392369,E061050,청소용세제,홈스타 바르면 곰팡이싹 120mlx4 락스 세정제 곰팍이,10000,9900,-100
2018-06-01,537942903,E031120,믹서,쿠잉 미니 믹서기/국내산 고성능모터/소형/쥬서기,21500,21170,-330
2018-06-01,1395494220,C013010,점퍼,글램 에스라인 모직코트 STLD-6118/여성하프코트 모직,35400,33630,-1770
2018-06-01,321098539,C012020,원피스,세련된 케이프 느낌의 모직코트@벨트(C164MSG035)/ 씨씨콜렉트,109800,93330,-16470
2018-06-01,1629586987,C013010,점퍼,사파리 야상점퍼 집업외투모음 Free~3XL 빅사이즈여성,58800,57800,-1000
2018-06-01,899493356,E061080,키친타월,[유한킴벌리]유한킴벌리)크리넥스안심키친타올150매*4+4,8490,7490,-1000
2018-06-01,742052359,A017120,고구마,2018 햇감자 10kg/20kg 대용량 특가 /무료배송,16900,16900,0
2018-06-01,605583386,A016120,바나나,[무배] 정품 돌(Dole) 바나나/ 6kg내 4송이 대용량,20900,20500,-400
2018-06-01,365400379,E021020,커튼,[뷰하우스]루나 린넨 호텔식 암막커튼/100%맞춤제작,25900,21070,-4830
2018-06-01,871656321,A012030,돼지고기,(출시특가)이베리코 갈비살500g/목심(목살)500g,11900,11900,0
2018-06-01,562985690,C021020,구두,로하 샌들 LKR2723 여자샌들 여성샌들 YA02004,54850,54850,0
2018-06-01,1790057621,A013070,굴,◈TV홈쇼핑정품!!◈조선대가 전통 양념 꽃게장 2.4Kg 양념게장/젓갈/게뚜껑/전통방식/,74000,73260,-740
2018-06-01,466497670,E041070,밀폐용기,코멕스 스텐밀폐 28종모음- 스텐킵스 반찬통 정리용기,7890,7260,-630
2018-06-01,321098541,C012020,원피스,귀여운 오버핏 모직코트@브로치(C164MSG054)/ 씨씨콜렉트,75800,64430,-11370
2018-06-01,321098542,C012020,원피스,카라 배색 포인트 더블코트@퍼(C164MSG047)/ 씨씨콜렉트,119800,101830,-17970
2018-06-01,774211159,A017170,풋고추,(맛나)#단호박(뉴질랜드)1통,4600,4140,-460
2018-06-01,1185277911,C012040,여자학생복,[블루종][블루종]쓰리 단추 포켓 롱가디건_[B1806CD035B],29700,28220,-1480
2018-06-01,1484651427,A011010,쌀,2017년 햅쌀 지리산메뚜기쌀 플러스 / 수라간쌀20kg,48900,48900,0
2018-06-01,1010317992,F011120,인삼,[청년]친환경 양송이버섯(150g/팩),3490,3490,0
2018-06-01,1185277916,C012040,여자학생복,[블루종][블루종]다이아 짜임 포켓 가디건_[B1806CD034B],27800,26410,-1390
2018-06-01,1339121399,I053040,기타문구,롤접착포스트잇/접착메모지/롤 포스트잇,1050,1050,0
2018-06-01,1462096362,A012010,국산쇠고기,[무항생제] 불고기 300g 1등급,16100,16100,0
2018-06-01,190461,L021010,손목시계,Paop-u 스포츠시계 (색상선택) 패션시계 시계 스포츠,8220,8060,-160
2018-06-01,895799397,A018080,설탕,[CJ]CJ 흑설탕 1KG,2490,2490,0
2018-06-01,370657668,F011150,건강기능식품,미숫가루20곡 1kg 3개(3kg 무료배송) 미싯가루20곡,10900,10900,0
2018-06-01,1880741051,E051020,건전지,18650 USB 충전기 리튬이온 고속충전기 충전지 배터리,2290,2290,0
2018-06-01,898598792,A011180,파스타면,[대상]대상 스파게티면 (500G),2550,2550,0
2018-06-01,126048827,C013050,운동복,[마운틴리서치] 아동 아이스 무지 반팔티/냉감티셔츠/아동 주니어 트레이닝복,7900,7900,0
2018-06-01,299932858,A019030,생강,다진마늘 2kg 다진생강 혼합야채 고추슬라이스,5900,5900,0
2018-06-01,1933253481,A022020,두유,검은콩 칼슘 96팩/검은참깨/A/B/호두와아몬드/두유,49900,49900,0
2018-06-01,1547101094,E031070,에어컨,[에이핀] 16형 벽걸이 선풍기/업소용 AF-1602WF,19800,19800,0
2018-06-01,320605831,E051020,건전지,국산 18650 실리콘 방수 배터리팩 7.4V 6800mAh 대용,27000,27000,0
2018-06-01,1180993128,A017280,김,무맛나치킨무4kg/민속,6600,6600,0
2018-06-01,2044325426,C012040,여자학생복,[탑온탑]마일롱체크셔츠(TP1814173),24800,23560,-1240
2018-06-01,431702480,I011030,사진기,[LEICA][정품] D-LUX (TYP 109) Explorer Kit + LCD 보호필름 + 64GB메모리,1570000,1501740,-68260
2018-06-01,1462072362,C013040,청바지,[젤리스푼]스타일예쁜레이스숏데님팬츠,21900,19710,-2190
2018-06-01,895799365,A011130,시리얼,CJ 부침가루 1KG,2850,2390,-460
2018-06-01,386462134,C012030,여자상의,포인트 리본 원피스 MO2189M805 빅사이즈,66570,62580,-3990
2018-06-01,94625146,C013020,티셔츠,남자 나시티/남성 쿨티셔츠 박스 루즈 민소매 롱 농구,14800,12800,-2000
2018-06-01,1587000196,A011010,쌀,[거시기장터]2017년 햅쌀 지리산 달팽이쌀 10kg,24300,24300,0
2018-06-01,867460415,C012030,여자상의,[픽톡]-5키로 감량 원피스 44~88 빅사이즈/하객원피스,26900,26900,0
2018-06-01,1598859660,C013010,점퍼,에고이스트 브로치러플야상점퍼EJ2EZ300,105460,105460,0
2018-06-01,685502600,C012020,원피스,[보니알렉스](보니알렉스)쓰리버튼 베이직 코트(BCHZ101A),37700,33180,-4520
2018-06-01,410977520,C012060,여자내의,빅사이즈 뒷밴딩사선러플스커트 LT1710 빅사이즈 여성,52710,47440,-5270
2018-06-01,685502604,C012020,원피스,[보니알렉스](보니알렉스)모던 야상 트렌치코트(BCFX180C),27700,24380,-3320
2018-06-01,1326629512,C021040,실내화,[푸마] (SIZE : 285) 플레어 2(18951701) 신발 러닝,85190,85190,0
2018-06-01,1497906156,C012060,여자내의,빅사이즈/이중/리본/랩/스커트 이중리본랩스커트 빅사,42990,42990,0
2018-06-01,401431354,F012020,생리대,화이트 울트라 날개 중형 57매 외 구성 견본증정!,10900,10900,0
2018-06-01,1888605897,A013040,고등어,고급형 청정 노르웨이 간고등어 순살손질가시제거생선,22900,19900,-3000
2018-06-01,1681272668,C012040,여자학생복,[하루메이비] 1133 심플한 하프버튼의 노카라 셔츠,31800,31800,0
2018-06-01,1761754274,C013050,운동복,자동차 유니온잭 컵홀더/송풍구거치대 자동차악세사리,7100,6390,-710
2018-06-01,761903866,C014010,아동복,(숲자람) 기능성 키즈 바람막이 유아바람막이 어린이,72900,72900,0
2018-06-01,8979368,C012030,여자상의,대박난박양 빅사이즈 원피스 투피스 오피스룩 하객룩,18900,18900,0
2018-06-01,1462542478,F012020,생리대,[위스퍼]순면감촉 피부애 슈퍼슬림 대형 32Px2팩,17600,17600,0
2018-06-01,972554729,E061100,습기제거제,[슬기로운 제습생활] 제습제 습기제거제 24개,18900,18900,0
2018-06-01,1463782596,A011090,국수,팔도 일품해물라면40개/해물라면/라면/봉지라면,23900,23900,0
2018-06-01,1457019450,C011030,남자학생복,밀란시아 빅사이즈 웰론 조끼 unc10-no.191 빅사이즈,67220,65880,-1340
2018-06-01,2102627226,E011060,의자,식당의자/카페의자/철재의자/업소용의자/인테리어의자,17800,17800,0
2018-06-01,426904840,C011050,남자내의,[TI포맨]18 S/S 투톤 워싱 데님 통팬츠 M182MPT216MS,98000,80360,-17640
2018-06-01,728810059,F011150,건강기능식품,단호박미숫가루 자색고구마미숫가루 쑥미숫가루 선식,4900,4900,0
2018-06-01,820239869,C011050,남자내의,밍크/여 밍크처럼 도톰한 밍크 숙녀파자마,13110,11670,-1440
2018-06-01,694914266,C012020,원피스,김발 겉대x2,3290,3290,0
2018-06-01,175872203,E021020,커튼,쉬즈홈 마이크로 커튼/쉬폰/레이스/거실/창문/커텐/봉,25900,25900,0
2018-06-01,955861958,A022050,탄산음료,[롯데]롯데 트레비 라임(PET) (500ML),1450,720,-730
2018-06-01,666478516,A014040,발효유,CJ메티에 요거트 파우더 1kg 라떼 빙수 베이커리,12000,12000,0
2018-06-01,78986580,C011050,남자내의,[뱅뱅]남여공용 밴드 반바지 YPD500,9900,7920,-1980
2018-06-01,955861959,A022050,탄산음료,[롯데]롯데 트레비 레몬(PET) (500ML),1450,720,-730
2018-06-01,1268730266,A012050,소시지,CJ 맥스봉 치즈(560gX2묶음)/빅소세지/간식/술안주,10300,10300,0
2018-06-01,903567218,C011030,남자학생복,여름 가디건 남자 남성 집업 니트 브이넥 기본 롱,19800,19800,0
2018-06-01,451394575,C013010,점퍼,[꼬망스]남아베이직바람막이점퍼(C1825J501),29500,26550,-2950
2018-06-01,1435393459,C013050,운동복,차량용바스켓/바스켓케리어/짐받이캐리어/차량용거치,165000,151800,-13200
2018-06-01,516860431,C013040,청바지,로로텐 청바지/슬림핏/스키니/밴딩/팬츠 빅사이즈,26900,26900,0
2018-06-01,1134904323,C013020,티셔츠,수아 여름 신상 여성 롱 티셔츠/프린팅 티셔츠/반팔티,4900,4900,0
2018-06-01,895775373,A019150,김치,[종가집]종가집 열무 김치 (500G),7600,7600,0
2018-06-01,1916083876,L012060,샴푸,DHT-X샴푸/LED진동두피마사지/탈모 증상 완화에 도움,29900,29900,0
2018-06-01,1147688885,C021040,실내화,명품모티브 자수 운동화 여성 스니커즈 키높이,33800,33800,0
2018-06-01,895775372,A019150,김치,종가집 맛김치 (500G),6450,4990,-1460
2018-06-01,138678363,L012010,면도기,도루코 면도기 페이스파워 페이스7 페이스6 여성면도,13500,13500,0
2018-06-01,955861960,A022050,탄산음료,롯데 트레비 플레인(PET) (500ML),1450,720,-730
2018-06-01,1889894950,F012050,의료측정기,마이크로라이프 전자체온계 MT200 구강/MT-200,7690,7160,-530
2018-06-01,1366296915,C014010,아동복,[고잉키즈X디즈니] 아동 여름의류 특가 / 봄시즌오프!,2900,2900,0
2018-06-01,476853270,C021020,구두,토리버치 에스파듀/플랫슈즈/슬립온 45974 모음전,177000,155960,-21040
2018-06-01,1294820015,A014020,분유,[베비언스] 액상분유 3단계 240ml 25입,33900,33900,0
2018-06-01,1097456853,D031010,주택수선재료,노루 다용도용 친환경 수성페인트 멀티플러스 3.8L,35700,32800,-2900
2018-06-01,1614680023,A018060,스낵과자,누네띠네 12gx100개 / 19. 5. 06.까지 약과 미니약과,8500,8500,0
2018-06-01,1291494324,C013020,티셔츠,[하프클럽/라코스테]라코스테 클래식핏 PK티셔츠,59800,59800,0
2018-06-01,904141938,C013010,점퍼,[레더프로스트][레더프로스트] SLF412BB 크로스 짚업 트리플 스트랩 천연양가죽 무스탕,2145000,2037750,-107250
2018-06-01,1219972150,C021040,실내화,7cm 키높이 통굽 운동화 스니커즈 슬립온 스탠딩신발,24500,24500,0
2018-06-01,1812201318,L021060,유모차,세스토라이트T 기내반입 휴대용 스마트한 유모차,210000,210000,0
2018-06-01,1932128783,D031010,주택수선재료,예쁜 디자인 초인종 문 현관 도어 벨 종 딸랑이 장식,9840,9840,0
2018-06-01,1526366510,A017090,열무,홍천사람들 양구 펀치볼 시래기 1kg,17500,17500,0
2018-06-01,1829982167,A019130,스프,아침엔 본죽 쇠고기죽 300g X 6개/즉석식품/죽/스프,12580,12580,0
2018-06-01,837032589,F011150,건강기능식품,동화약품 까스 활 액 75ml 20병/소화제/활명수 마트,17100,17100,0
2018-06-01,1049941223,C013040,청바지,[퍼스트제이][오가게/퍼스트제이]레츠고팬츠 (2color),39900,39900,0
2018-06-01,2051931830,C011050,남자내의,어스앤뎀 공용 린넨 허리밴드 팬츠 V11US TBPB704,38530,38530,0
2018-06-01,2079723895,E031130,보온매트,더블 COTTON 전기요(180 135cm) /(참고)전기매트 방한,131400,115640,-15760
2018-06-01,851303402,I012060,저장장치,[레이저(RAZER)] Razer DeathAdder Elite 웨이코스 게이밍 마우스,75160,69900,-5260
2018-06-01,1316526685,C011030,남자학생복,2018신상 가디건/베스트/롱/아우터/봄/남자/남성,19900,19900,0
2018-06-01,1570589517,I031040,생화,순수국산 2단 팔각 파라솔 테이블 의자 비치파라솔,20980,20980,0
2018-06-01,1008869552,I011010,TV,한정특가 삼성패널 40인치TV 42인치TV 43인치 UHD TV,215460,209000,-6460
2018-06-01,1807131321,L021020,장신구,[바보사랑][실버] 엘리사 스틱 귀걸이,21000,21000,0
2018-06-01,1807131320,L021020,장신구,[바보사랑][실버] 홀리 롱 귀걸이,35000,35000,0
2018-06-01,1807131322,L021020,장신구,[바보사랑][실버] 발레리 투 하트 귀걸이,19000,19000,0
2018-06-01,372312938,E031130,보온매트,名品 2018년형 한솔 워셔블 절전형매트/한솔전기장판,80000,79000,-1000
2018-06-01,201775545,C012030,여자상의,[패션24시30%쿠폰]스위티! 원피스/블라우스 SET 특가!,8900,8900,0
2018-06-01,1058409938,C013020,티셔츠,[게스]GUESS 남여공용 오리지날 PVC 반팔 티셔츠(MI2K9416),22000,18040,-3960
2018-06-01,1387616554,C013010,점퍼,AG 빅사이즈 야상 딜러자켓 BW 패션용야상 남성용야상,113190,113190,0
2018-06-01,1807131318,L021020,장신구,[바보사랑]로맨틱 퍼플 드롭귀걸이,14900,14900,0
2018-06-01,1267671047,A013060,게,한치 마른화살오징어(M 25미)1kg,117740,117740,0
2018-06-01,1807131319,L021020,장신구,[바보사랑][실버] 앰버 귀걸이,16000,16000,0
2018-06-01,743377492,C013010,점퍼,깔깔이 군복 패딩점퍼 조끼 바지 한개사면 한개더,6900,6900,0
2018-06-01,439226702,A011010,쌀,쌀눈 미강 동결건조 스틱포장 산마을 국내산,6600,6600,0
2018-06-01,1407526065,C013040,청바지,올젠 (ZPY1PP1503) 구김없는 대나무소재의 팬츠3종 택1SSOZ,49000,39200,-9800
2018-06-01,1965093490,C013020,티셔츠,폭탄할인+추가할인! 바닐라비 반팔티外6900~,9500,9500,0
2018-06-01,321747399,A015020,식용유,백설 튀김전용기름 1.8L 튀김유 콩식용유 콩기름 오일,13900,13900,0
2018-06-01,835847386,C013040,청바지,쿨링원단 시원 쫄깃 짤막 일자진 / 스키니 슬랙스,17000,16800,-200
2018-06-01,675278745,C013010,점퍼,K2 S 무스탕 5 라이더점퍼 남자무스탕 무스탕 가죽점퍼 라이더점퍼 가죽자켓,120650,107380,-13270
2018-06-01,820701175,L021030,가방,[메트로시티(metrocity)]클러치 M63MQ270Z(본점),338000,278690,-59310
2018-06-01,951730054,C013040,청바지,남아 HS 해지 데님 PT(P1761Q202_36)/ 페리미츠,24000,21600,-2400
2018-06-01,1024626722,A017120,고구마,{햇감자 한정 초특가} 포근포근 햇감자 3kg/5kg,6500,6500,0
2018-06-01,423289919,A011180,파스타면,스파게티(라폰데500g)X20,37880,37880,0
2018-06-01,1010317801,A015020,식용유,Onlyprice 식용유 1L,3000,3000,0
2018-06-01,2056548609,C012030,여자상의,(AGC여성 빈스 단가라 니트 KK단가라 니트니트여자 니,62240,62240,0
2018-06-01,889182036,E031080,선풍기,듀프렉스 원적외선 탁상용 세라믹히터 DP-525CH [2단온도조절 / 전도안전장치],18000,18000,0
2018-06-01,1010317800,A018060,스낵과자,Onlyprice 감자칩 오리지날 140G,1000,1000,0
2018-06-01,1380590006,I011020,영상음향기기,프로젝터 만능 브라켓/마운트/빔프로젝터/빔프로젝트/고정대/설치/거치대/홈씨어터/홈,15000,13500,-1500
2018-06-01,293820882,E011020,침대,KS인증기업 일체형 침대 매트리스/슈퍼싱글/더블/퀸,55800,50220,-5580
2018-06-01,1136752451,C012040,여자학생복,[화이트폭스][화이트폭스]데일리감각무드반팔가디건,21000,19110,-1890
2018-06-01,1719704960,C013030,스웨터,봄 여성 루즈핏 롱니트/망사/보트넥/빅사이즈/브이넥,24800,24800,0
2018-06-01,26604522,A022050,탄산음료,코카콜라 콜라 355ml x 24캔,19040,17900,-1140
2018-06-01,607223367,A016070,귤,제주감귤 레드향 9kg 특품 선물용(3kgX3 합포장)/제주,163930,155740,-8190
2018-06-01,751816894,A021010,커피,2018NEW 까페리얼 1.5L X 6개/칸타타/신상입고,12900,12900,0
2018-06-01,1813459446,C013040,청바지,JMM8034 롤업슬랍워싱진청남자스판청바지-빅사이즈까,35540,35540,0
2018-06-01,1010232362,A012010,국산쇠고기,한우 실속 1호,200000,180000,-20000
2018-06-01,1010232363,A012010,국산쇠고기,한우 실속 2호,190000,175000,-15000
2018-06-01,1456400246,E011010,장롱,[데코라인]카렌 갤러리 옷장세트/장롱풀세트/9자/10자,269000,269000,0
2018-06-01,1010232364,A012010,국산쇠고기,한우 실속 3호,180000,160000,-20000
2018-06-01,1010232365,A012010,국산쇠고기,한우 실속 4호,140000,122000,-18000
2018-06-01,1366003148,A022050,탄산음료,롯데 칠성사이다 245ml x 24캔/코카콜라/펩시콜라,12900,12900,0
2018-06-01,1388535116,C013020,티셔츠,[TOMBOY]톰보이WOULD 레터링 티셔츠 9108222448(의정부점),41400,33590,-7810
2018-06-01,1192038029,C013010,점퍼,아디다스 여성 헬리오닉 패딩자켓 (BQ1938 ),187460,166840,-20620
2018-06-01,2097610841,E061030,전구,필립스 오스람 두영 장수 삼파장램프 전구 EL PL 램프,800,720,-80
2018-06-01,350188114,C013020,티셔츠,T2062-루네타 어깨포인트 티셔츠 소매퍼프티셔츠 라운,12400,12400,0
2018-06-01,34286911,C013010,점퍼,남자 여자 특양면 후드티 후드 집업 자켓 점퍼 빅세일,12900,12900,0
2018-06-01,1426877293,A017230,마늘,국내산 햇 양파~대용량10kg(7900원)~,7900,7900,0
2018-06-01,467542390,L021030,가방,신학기 책가방 학생가방 키홀더증정 메신저백,15900,15900,0
2018-06-01,444120174,I053040,기타문구,3M 포스트잇 이젤패드 모음 월패드 559/563/566,29320,29320,0
2018-06-01,807241013,C013050,운동복,44~120/여성트레이닝바지/운동복/마바지/츄리닝반바지,11900,9800,-2100
2018-06-01,988900092,F011150,건강기능식품,일동제약 락토피아 프로바이오틱스 100포,20000,17900,-2100
2018-06-01,1385268054,F012010,종이기저귀,팸퍼스프리미엄케어 기저귀 모음,58900,56900,-2000
2018-06-01,1247368788,E021010,침구,순면 워싱이불커버/패드/매트커버외,18900,18900,0
2018-06-01,1093251813,C013010,점퍼,시크폭스 제리콤 바람막이점퍼/ 시크폭스,17900,13970,-3930
2018-06-01,895834061,L012010,면도기,[P&G]P&G 질레트 퓨전 매뉴얼 면도기,14500,14500,0
2018-06-01,895834060,L012010,면도기,[P&G]P&G 질레트 퓨전파워 면도기,17900,17900,0
2018-06-01,989049108,A013170,생선통조림,샘표 바로바로요리하는바지락 140G,3990,3990,0
2018-06-01,1453847990,C012040,여자학생복,[대구백화점 I관] [NBA]기획 BASIC 집업(N181TJ951P),69000,59340,-9660
2018-06-01,1010232336,A012010,국산쇠고기,한우 특선 2호,330000,300000,-30000
2018-06-01,1010232337,A012010,국산쇠고기,한우 특선 3호,300000,283000,-17000
2018-06-01,1010232338,A012010,국산쇠고기,한우 특선 4호,230000,210000,-20000
2018-06-01,1010232339,A012010,국산쇠고기,한우 갈비 세트,360000,330000,-30000
2018-06-01,1177005809,A013120,낙지,[바다원]울릉도 오징어 3미/5미,15150,15150,0
2018-06-01,1272059159,E021020,커튼,캐노피 침대 가리개 커튼 침대커튼 침대용커튼 침대캐,41080,41080,0
2018-06-01,15248510,C011050,남자내의,면바지/슬림/스키니/슬랙스/테이퍼/오버핏/밴딩//남자,20900,19800,-1100
2018-06-01,589278422,E031070,에어컨,축사 양계장 농장 비닐하우스 공장 대형천장용선풍기,89000,89000,0
2018-06-01,180877814,A016110,딸기,[우리가스토리]유기농 하와이안 노니 분말 가루 250g1통,16900,16900,0
2018-06-01,100873696,C021010,아동화,[아식스키즈] 아식스 키즈 KIDS 디베토 DIVETO (111614110-1109),32000,32000,0
2018-06-01,1636656206,A011010,쌀,반공기는 없었던일로/곤약쌀/곤약미/곤약/강황/울금,36000,36000,0
2018-06-01,1608619971,A013140,북어채,황태채 1kg 300/100g 북어채 명태 북어국 황태채가루,24000,24000,0
2018-06-01,1354370959,C012040,여자학생복,[스타일빅걸][스타일빅걸]썸머 트임가디건 MSR163,34270,32900,-1370
2018-06-01,444107181,E011060,의자,컴퓨터의자/DIY/사무용/pc방/책상의자/21세기트랜드,51500,51500,0
2018-06-01,824181997,C013050,운동복,루시아 여자 트레이닝복세트 총집합  신규오픈 최저가,23000,21850,-1150
2018-06-01,1312333587,C012040,여자학생복,kk34 헨리넥st 하프버튼 데님셔츠_블루청 여성셔츠 데,16000,16000,0
2018-06-01,1200690351,A022030,생수,제주스파클링 탄산수 한라봉 350ml X 20페트,10900,10900,0
2018-06-01,2084435213,E061020,섬유유연제,샤프란 꽃담초 섬유유연제 리필 1.3L x 8개,25900,25900,0
2018-06-01,895834087,A018030,껌,[롯데]롯데 1500 후라보노(14g*3입),1000,1000,0
2018-06-01,1017621897,C021020,구두,[루플랫] 1308572 (해외) 18SS 생로랑파리 안야 포인트 토 스웨이드 펌프스,976700,842080,-134620
2018-06-01,1010232330,A012010,국산쇠고기,한우 명품 4호 (1++등급),260000,250000,-10000
2018-06-01,1010232332,A012010,국산쇠고기,한우 특선 1호,370000,350000,-20000
2018-06-01,1630020242,A019070,양념소스,청정원 쉐프원 부대찌개양념2kg,8900,8900,0
2018-06-01,440291643,A018090,잼,(무)일회용 딸기잼 디스팬팩12g(480개입)블루베리잼,74700,65740,-8960
2018-06-01,321098575,C012020,원피스,컬러가 예쁜 오버핏핸드메이드코트@브로치(C164XSG502)/ 씨씨콜렉트,99800,84830,-14970
2018-06-01,839414685,C014010,아동복,아동 반팔남방/ 아동 반팔셔츠/ 아동 체크남방/ 아동 체크셔츠/ 반팔 체크남방/고급스,19800,19800,0
2018-06-01,1161813553,F012030,안경,국산 안경테/82% 할인/안경/안경테/남녀공용/9900원,9900,9900,0
2018-06-01,1841560629,A018050,비스킷,로아커 웨하스 클래식 37.5g 45g 7종 4개/9개 모음,2750,2750,0
2018-06-01,804320664,C015030,넥타이,[COLOMBOS] 콜롬보스 프리미엄 클래식 넥타이 컬렉션,18000,18000,0
2018-06-01,972373596,C013040,청바지,유아 아기 아동 남아 여아 어린이 키즈 청바지 반바지,16000,16000,0
2018-06-01,1434183307,I053010,공책,줄없는 종합장NO. 14501 76836 연습장노트 연습장 무,6770,6770,0
2018-06-01,641711542,C013050,운동복,남녀공용 쿨 냉장고바지/냉장고긴바지/빅사이즈/여름,9900,9900,0
2018-06-01,895858087,L012090,기초화장품,[존슨&존슨]존슨앤존슨 베드타임 로션 500ML,15900,15900,0
2018-06-01,1649752702,A011110,당면,웅부도토리 묵말랭이 250g-국내산 도토리,35840,35840,0
2018-06-01,216950413,C011050,남자내의,여름신상/세상편한/드라이아이스팬츠/남녀공용/커플,5900,5900,0
2018-06-01,953817091,C013010,점퍼,[아메리칸웨스트] Twist Windbreaker 바람막이점퍼/캐주얼자켓/윈드브레이커/남성자켓,13900,12510,-1390
2018-06-01,1436258410,C013010,점퍼,초경량 여성 패딩 점퍼 오리솜털 90%이상 빅사이즈,32000,29800,-2200
2018-06-01,1266174499,E031070,에어컨,[세신 정품]DWF-5015 타워팬선풍기/선풍기/날개없는선풍기/리모콘선풍기/DWF5015/삼성,78600,78600,0
2018-06-01,1214022512,C012060,여자내의,[대구백화점 I관] [나이스클랍]플리츠롱스커트(N182MSD016),159000,135150,-23850
2018-06-01,353494872,E011020,침대,라자가구 고급PU가죽 슈퍼싱글 퀸 침대 독립 매트리스,229000,161100,-67900
2018-06-01,1191102684,A017080,무,강화약쑥 강화도쑥 500g 쑥차 약쑥스킨 입욕제 발효쑥,12000,11800,-200
2018-06-01,1747615500,I031070,애완동물관리비,[15%쿠폰]윌슨 헤드 바볼랏 가와사키 테니스라켓,33700,33700,0
2018-06-01,1835941030,E021020,커튼,쉬운설치/찍찍이 암막커튼/북유럽 면커튼/가리개커튼,28000,23830,-4170
2018-06-01,1839847799,E061040,부엌용세제,애경 비움 주방세제 용기300ml + 리필 300ml/7무첨가,8900,8900,0
2018-06-01,1402778648,C012020,원피스,트랜디한체크롱자켓(N181MSF007)/ 나이스클랍,139000,125100,-13900
2018-06-01,854340049,E031080,선풍기,세티즈 원적외선 바이오 세라믹히터(코일형) SPH-105,40200,40200,0
2018-06-01,854340048,E031080,선풍기,세티즈 원적외선 바이오 세라믹히터(할로겐형) SPH-102,42000,42000,0
2018-06-01,1119954204,C012020,원피스,[보니알렉스](보니알렉스)빅카라 오버사이즈 코트 (BAHZ182C),26600,23410,-3190
2018-06-01,851736194,A018080,설탕,핀란드 자일리톨 크리스탈 500g 분말 가루 설탕,10500,10500,0
2018-06-01,1914230766,F011120,인삼,(장생농산장수산삼 7년근 7주(7뿌리) 스승의날 10년근,282930,274450,-8480
2018-06-01,1059275372,A013080,조개,두레생협 냉동굴(400g) 굴 국용냉동굴 해물파전용냉동,21570,21570,0
2018-06-01,1896212838,L021020,장신구,시크 롱 목걸이 (RG) 시크 이니셜 네크라인 펜던트 20,18270,18270,0
2018-06-01,2059272155,E011060,의자,에펠의자 카페의자 식탁의자 인테리어의자 디자인의자,19900,19900,0
2018-06-01,1010232392,A012010,국산쇠고기,한우 혼합 1호,180000,160000,-20000
2018-06-01,755309717,A019050,간장,[사조해표] 옹가네 진간장S1.8L X2,7900,7900,0
2018-06-01,1010232393,A012010,국산쇠고기,한우 혼합 2호,150000,128000,-22000
2018-06-01,1010232395,A012010,국산쇠고기,한우 보신 1호,130000,113000,-17000
2018-06-01,958631502,A013170,생선통조림,[동원]동원 살코기+매운고추참치 100G*4+2입기획,8500,8500,0
2018-06-01,471126800,E041010,식기,예담은/방짜유기/어린이식기/세트/유아식기/돌선물/돌잔치/백일선물/방짜수저/방짜/유,185000,183000,-2000
2018-06-01,1208569610,E011020,침대,비트 소나무원목 침대깔판 Q,182280,182280,0
2018-06-01,1282346616,C013020,티셔츠,30% 추가할인!핵이득 베스트핏 반팔티셔츠/PK/반바지,9900,9900,0
2018-06-01,1340817562,C012060,여자내의,jj42 꽈배기니트 미디스커트_라이트그레이 치마 여성,14280,14280,0
2018-06-01,545600009,E041070,밀폐용기,스텐바트 스텐밧드 바트 밧드 스텐통 소스통 양념통,2450,2220,-230
2018-06-01,89117657,A021010,커피,[레스트빈]10+1증정/1kg 원두커피 3kg무배(특가제외),8000,8000,0
2018-06-01,2000921420,A016160,과일가공품,블루베리안주 (소울 350g) X6,130520,116170,-14350
2018-06-01,1175701514,C012060,여자내의,SK1577-야자수 밑단프릴 스커트 FREE(44~66) A라인치,39080,37130,-1950
2018-06-01,440291618,A018090,잼,오뚜기 블루베리잼300gX15개(1박스)잼 딸기잼 후루츠,109000,95920,-13080
2018-06-01,1284148013,C013020,티셔츠,매니몰 남여 프리미엄 캠핑 반팔티셔츠,9900,9900,0
2018-06-01,871284476,A022050,탄산음료,펩시콜라 업소용 500ml 펩시 1.25L 사이다 스프라이트,11500,11500,0
2018-06-01,345572411,L012090,기초화장품,참존 디에이지 레드와인 에스 아이크림 기획세트 1개,50880,50880,0
2018-06-01,1010232366,A012010,국산쇠고기,한우 구이 1호,350000,320000,-30000
2018-06-01,1319732426,C013040,청바지,JMM9980 기획기본연청남자스판청바지-빅사이즈까지 남,26400,26400,0
2018-06-01,1010232368,A012010,국산쇠고기,한우 구이 2호,230000,218000,-12000
2018-06-01,492720834,C012040,여자학생복,[모니카룸] 그물가디건/ 모니카룸,31300,23790,-7510
2018-06-01,1929029376,I031040,생화,SOS 긴급 구호세트 캠핑편의용품 안전용품 캠핑안전용,23090,21040,-2050
2018-06-01,956846989,A022030,생수,롯데 아이시스8.0 (2L*6개입),5040,4080,-960
2018-06-01,2057528639,A022010,주스,PT 음료수 1.5L/콜라 사이다 이온음료 주스 음료 탑씨,1400,1400,0
2018-06-01,1133951907,C013020,티셔츠,남.여공용 유니레터링 후드 반팔 티셔츠 AI7WTS46-PK,39000,31200,-7800
2018-06-01,985442441,A013110,마른오징어,통영멸치(볶음조림용) 200G/봉,8990,8990,0
2018-06-01,436501342,C013050,운동복,쿨론 칠부팬츠/C108/트레이닝 반바지/런닝/헬스/요가,19710,19710,0
2018-06-01,985442440,A013110,마른오징어,통영멸치(국물용) 200G/봉,5990,5990,0
2018-06-01,2012668817,C012030,여자상의,럭셔리 빅사이즈 원피스/세일상품/행사복/66-110,34800,34800,0
2018-06-01,386462100,E021020,커튼,브라켓커튼봉 3단 25mm 길이조절300cm,25040,25040,0
2018-06-01,1094395983,C012060,여자내의,[하프클럽/SI]씨 클래식 플레어 치마 팬츠 (SMPAF2267),19900,19900,0
2018-06-01,672264667,A022010,주스,서울우유 리이브과즙음료 190ml x 48팩,11900,11900,0
2018-06-01,1064567266,C014020,유아복,꽃패턴민소매팬츠set/반바지/나시/유아상하복/외출복,9900,9900,0
2018-06-01,601769413,C012060,여자내의,핀 스트라이프 제천벨트 팬츠(AJ2WP560)/ 랩,59000,50150,-8850
2018-06-01,445518879,E011050,책상,누마보아보이책상/컴퓨터책상/2인용책상,72000,71280,-720
2018-06-01,248387893,L021020,장신구,비주트리 남자 여자 커플 은팔찌 게르마늄팔찌 특가전,23500,23500,0
2018-06-01,1456218122,C011030,남자학생복,FS-053 포켓 디테일 스티치 청남방 남성남방 남자남방,35910,35910,0
2018-06-01,1268211197,A022050,탄산음료,비락 식혜 238ml (x12캔) 레쓰비 150ml 음료수 캔음료,5100,4800,-300
2018-06-01,1779514127,L021020,장신구,[바보사랑]925실버 Karena Side-pull 팔찌 JAKRN004,21900,21900,0
2018-06-01,459489485,L021020,장신구,슈가 별 목걸이 WG 레이어드 주얼리 10대 기념일 20대,15370,15370,0
2018-06-01,771127988,F011130,홍삼,[풍기인삼] 5년근 수삼 1채 750g (3~4뿌리),169000,169000,0
2018-06-01,1010195007,A018100,꿀,산삼배양근 담은꿀 2호,115000,110000,-5000
2018-06-01,1779514129,L021020,장신구,[바보사랑][액세서리키친] 925실버 진주팔찌 Sopia Pearl-Cross JASPA000,25900,25900,0
2018-06-01,2115963037,C011030,남자학생복,압구정클럽 남녀공용 프리사이즈 하찌후드니트숄가디,84060,81540,-2520
2018-06-01,1010195009,A018100,꿀,산삼배양근 담은꿀 3호,185000,180000,-5000
2018-06-01,1289660008,E031020,가스레인지,RT-1020 린나이정품 2구가스레인지/자동불꽃센서,156300,156300,0
2018-06-01,1500037132,A018050,비스킷,로투스 50Px6개 1Box 1p 300개 싱글팩비스킷 커피과자,17900,17900,0
2018-06-01,771127987,F011130,홍삼,[풍기인삼] 5년근 수삼 1채 750g (4~5뿌리),159000,159000,0
2018-06-01,1736164679,C013010,점퍼,[체이스컬트]17 SS 여성용 사파리형 후드 점퍼-GARG4106AX0,49900,47410,-2490
2018-06-01,1227152356,C013020,티셔츠,빅사이즈 여성나시 롱/끈나시 레이어드나시 여성의류,9800,9800,0
2018-06-01,1232983851,C012060,여자내의,[난닝구]피니어스 플라워밴딩스커트,15000,13800,-1200
2018-06-01,316022623,L012090,기초화장품,(캘빈클라인) 이터너티 포맨 애프터 쉐이브 밤 150ml,51480,51480,0
2018-06-01,1206824316,A017020,상추,믿을 수 있는 우리 농산물 양상추 반박스(6~8입),33860,33860,0
2018-06-01,657111099,E061060,살충제,전문가용 개미약 페스트세븐앤트겔 맥스포스퀀텀,10000,2800,-7200
2018-06-01,604029571,E061040,부엌용세제,돈(DAWN)울트라 핸드리뉴얼 고농축 주방세제/퐁퐁,5800,5800,0
2018-06-01,1779514131,L021020,장신구,[바보사랑]925실버 소원팔찌-Rose JAWPT01030,19900,19900,0
2018-06-01,1322660214,E061020,섬유유연제,[피죤미친특가!]*섬유 유연제 3100mlx4개/4210mlx4개,11900,11900,0
2018-06-01,492005098,C012040,여자학생복,라운드단추조끼 ZYD_1711 하프조끼 여성베스트 하프베,22300,22300,0
2018-06-01,1010197675,A013020,명태,[속초반건조생선]명절 선물세트2호,69000,58000,-11000
2018-06-01,1010195010,A018100,꿀,산삼배양근 담은꿀 4호,95000,90000,-5000
2018-06-01,1010195012,A018100,꿀,산삼배양근 담은꿀 5호,65000,60000,-5000
2018-06-01,1010197678,A013020,명태,보리굴비 특선 2호,82000,78000,-4000
2018-06-01,386381849,C015020,모자,(컬러:사이즈 : 블랙:FREE) ACC-CAP106 찡군,26080,26080,0
2018-06-01,1265007992,E041070,밀폐용기,ITALY 보르미올리 유리병 밀폐용기 더치병 담금주 잼,1280,1280,0
2018-06-01,773911053,C021040,실내화,[나이키] 다이나모 프리 (PS) 343738_013,39800,38210,-1590
2018-06-01,1241580084,I053010,공책,근영사)아이디얼 양장노트(라인_엘로우)박스(24개입),125470,125470,0
2018-06-01,679246432,A017040,양배추,박하건초 300g - 국산 말린박하 건박하,6440,6440,0
2018-06-01,571342205,F012010,종이기저귀,군(GOO.N)슬림앤드라이 밴드 기저귀 특대(XL) 30Px8팩,57500,57500,0
2018-06-01,378627623,L021020,장신구,(유색보석 롱 드롭 귀걸이) 데일리 쥬얼리 연예인,10900,9810,-1090
2018-06-01,1216705469,A016060,감,달콤샤르르 자연그대로 만든 아이스 왕 홍시 50개(컵),75250,67730,-7520
2018-06-01,1051209940,C011030,남자학생복,꾸제꾸제/BENETTON 니트 가디건 /size L/스웨터/세일/브랜드/빈티지/중고/구제/베네통,19900,19900,0
2018-06-01,940220722,C014020,유아복,프로리 배색 팬츠_UR73SL589 면 유라비 가을 배색 남,12140,12140,0
2018-06-01,1490546941,E041050,냄비,[네오플램] 네오플램 에콜론 밀크팬 이유식냄비 냄비,15900,14900,-1000
2018-06-01,529731458,C012060,여자내의,라인이 예뻐보이는 핑크체크주름치마 주름 교복치마,49840,48350,-1490
2018-06-01,1010197681,A013020,명태,영광 법성포 황토굴비 실속 1호,120000,110000,-10000
2018-06-01,1270576331,A022050,탄산음료,과즙음료 폼펠모 리모나타 아란시아타 로싸 만다리노,28500,28500,0
2018-06-01,1010197680,A013020,명태,보리굴비 특선 3호,68000,65000,-3000
2018-06-01,594510311,E031080,선풍기,다이슨 핫앤쿨 AM-09 / 이벤트,550000,517000,-33000
2018-06-01,435545323,E021020,커튼,국내최대사이즈 순수국산 친환경모기장 1~10인 블루 화이트 사각 모기장 텐트 방문형,7000,6900,-100
2018-06-01,1997320875,E011020,침대,[골든잼]소나무 원목 더블 돌침대(고재)/흙침대,4001700,3881650,-120050
2018-06-01,300600222,E011060,의자,울리불리 체어 의자 학생 책상 식탁 카페 인테리어,23900,23900,0
2018-06-01,1802942652,E061010,세탁세제,퍼실 듀오 컬러캡스 32개/파워젤/세탁세제/액체세제,13500,13500,0
2018-06-01,1209405834,C013040,청바지,[Blouson]쿨링 와이드 뒷밴딩 슬랙스_[B1806PT057B],41000,36450,-4550
2018-06-01,648573070,A022010,주스,롯데칠성몰 주스 델몬트 망고/망고코코 240mlx30캔,18500,18500,0
2018-06-01,194155873,E031020,가스레인지,동양매직 가스 오븐 레인지/GOR-B5T01V ;,653500,653500,0
2018-06-01,942765650,C012060,여자내의,헤이즈 기모 가죽바지 SD-5049,12730,12730,0
2018-06-01,489942778,C012040,여자학생복,[로즈맘]시원한풍기인견블라우스(큰꽃)/ 로즈맘,16770,14760,-2010
2018-06-01,501451729,L021030,가방,노트북백팩 메신저백 모음,25900,25900,0
2018-06-01,269197813,C011020,남자상의,(추동용신상)빅사이즈 st 댄디 자켓 sun1710-001 빅사,105450,105450,0
2018-06-01,692001325,L021030,가방,할인+할인/인기 여름가방 데일리백/숄더/크로스/여행,9900,9900,0
2018-06-01,972686357,E031040,전기레인지,주말특가/아이엠냉장고KD-175F냉장고/소형냉장고/175L,219000,219000,0
2018-06-01,483209862,A021010,커피,돌체구스토 정품 캡슐 4박스 + 무료배송 + 텀블러증정,39520,39520,0
2018-06-01,1779514134,L021020,장신구,[바보사랑]925실버 Round PT 소원팔찌 JA001B010,19900,19900,0
2018-06-01,2088954293,A022050,탄산음료,환타 오렌지/파인애플/포도 250mlX30캔/탄산음료/음료,20500,20500,0
2018-06-01,1779514135,L021020,장신구,[바보사랑][액세서리키친] 925실버 Lidia Yarn 팔찌 A010615,19900,19900,0
2018-06-01,1779514132,L021020,장신구,[바보사랑]925실버Allie color tie 팔찌 Clover_JA002B060,19900,19900,0
2018-06-01,1779514133,L021020,장신구,[바보사랑]925실버Allie color tie 팔찌 Heart_JA002B012,19900,19900,0
2018-06-01,615843396,A022050,탄산음료,맥콜 160ml x 30캔 사이다 콜라 탄산음료수 캔커피,9600,9600,0
2018-06-01,1530622095,C012020,원피스,MELODY F131 모카/코트/여자코트/겨울코디/겨울코트/자켓/점퍼 미국 여성토탈브랜드 멜,68700,68700,0
2018-06-01,1284560272,C013020,티셔츠,T2234-여성 데일리 세틴 프릴 카라 맨투맨티셔츠 빅카,21040,19990,-1050
2018-06-01,890995698,E011030,거실장,모던 화이트 3단 거실장,101000,101000,0
2018-06-01,1516804788,E031140,비데,18년형 필터가필요없는 대림도비도스 방수비데,178000,178000,0
2018-06-01,934880255,E011060,의자,제도용팔무의자/병원/약국 연구실/작업용/진찰용/높은,78900,78900,0
2018-06-01,1218927819,E011020,침대,3단전동베드/KF902//피부관리실베드/3단전동침대/,890000,890000,0
2018-06-01,890995696,E011030,거실장,모던 화이트 2단 장식장,60900,60900,0
2018-06-01,380570773,C013020,티셔츠,레이스 배꼽티셔츠 SD-6463 마담옷 러블리티 배꼽티,15620,15620,0
2018-06-01,890995694,E011030,거실장,모던 화이트 3단 장식장,70900,70900,0
2018-06-01,258929322,A016100,수박,지금부터 꿀맛 하우스 꿀수박 4kg~/안전배송,11900,11900,0
2018-06-01,665312823,E011050,책상,상일리베가구 국내산 베이직 컴퓨터 철제 책상 택배,44330,39900,-4430
2018-06-01,1997344838,E011020,침대,[골든잼]잣나무 천연 생황토 평상/돌평상 돌침대 쇼파,1543300,1497010,-46290
2018-06-01,1220615881,C013040,청바지,[게스]여성 슬림 부츠컷진 데님 팬츠(YI2D9072),62400,51170,-11230
2018-06-01,1268599530,C013040,청바지,[루미씨] 라이트 블루 부츠컷 데님,32000,29160,-2840
2018-06-01,1866982061,C013020,티셔츠,앨빈클로 정품 반팔티 남자 무지 브이넥 헨리넥 후드,16900,9900,-7000
2018-06-01,394842459,C011020,남자상의,HMJ-003 체크스타일 하프코트 (M-XL) 그레이 체크코트,132850,132850,0
2018-06-01,345657960,C012060,여자내의,기모 타이즈 레깅스 기모안감 여성타이즈,15250,15250,0
2018-06-01,1235786910,C012060,여자내의,[나무그림][MD추천]신축성좋아(밴딩프리)_쿠아바지/C18MIT4B012P4,39000,31980,-7020
2018-06-01,2061430136,C012020,원피스,데시데 테이핑 포인트 슬림슬랙스 (DHS212),149000,119200,-29800
2018-06-01,1927980150,A013050,오징어,오뚜기 꽁치 280g X 24EA 꽁치 가공음식 캔 고등어통,79390,79390,0
2018-06-01,1407707073,C012020,원피스,김발(속대 에브리홈)X20,16130,16130,0
2018-06-01,415933465,C015020,모자,볼캡 스냅백 야구모자 디스볼캡 모자 모자 패션모자,16440,16120,-320
2018-06-01,890995664,E011030,거실장,모던 화이트 5단 서랍장,91900,91900,0
2018-06-01,807841820,A018100,꿀,[오리진] 스페인산화분/비폴렌/벌꿀화분/꽃가루/플라보노이드//,28900,28900,0
2018-06-01,1671913462,F012010,종이기저귀,베베룩스 슈퍼그레잇 슬림 팬티형 기저귀 4팩 출시,23800,21900,-1900
2018-06-01,533423740,C011050,남자내의,여름신상/반바지/슬랙스/린넨/청/카고/밴딩/남자/남성,17800,17800,0
2018-06-01,1652322110,D031010,주택수선재료,삼화페인트 아이생각 목재용 반광 4L 친환경 멀티내부,35000,35000,0
2018-06-01,1317428886,C013010,점퍼,사계절용동물잠옷/캐릭터잠옷/커플룩/공룡잠옷/이벤트,27000,27000,0
2018-06-01,59961122,A012010,국산쇠고기,현미와 보리 누룽지 선물세트 (5세트)선물세트 추석선,84300,84300,0
2018-06-01,890995668,E011030,거실장,모던 화이트 3단 서랍장,71900,71900,0
2018-06-01,1092464998,A016120,바나나,[Dole] 정품 돌바나나 4kg 2~3수 안동애가족 수입과일,17900,17010,-890
2018-06-01,868181327,C012040,여자학생복,30%쿠폰! 조이너스/꼼빠니아 인기상품 단독추가할인!,9700,9700,0
2018-06-01,579161027,F012020,생리대,위스퍼 보송보송 슈퍼롱 오버나이트10pX3(총30매)-나,12200,12200,0
2018-06-01,883926356,A019080,고추장,장류 모음,4230,4230,0
2018-06-01,1445455480,L021020,장신구,레트로핑거 신상 925 실버 은반지 은팔찌 발찌 목걸이,10600,10600,0
2018-06-01,1450074754,E061020,섬유유연제,샤프란 2000mlx6개/ 3100x4개 피죤 섬유유연제 다우니,11500,11500,0
2018-06-01,2078430902,C013010,점퍼,남아 쿠션지 웜업 집업 점퍼_EAJB7142BN0/ 오션스카이,7000,6160,-840
2018-06-01,441541267,C015040,장갑,스마트터치 눈꽃 니트 벙어리 여자 장갑 장갑 벙어리,24350,24350,0
2018-06-01,508097879,E061010,세탁세제,유한양행 아름다운세탁세제 BOL 2.8Lx2 +사은품,16800,16800,0
2018-06-01,1296246629,C013010,점퍼,MJ-222 카라배색 호시 린넨 마 자켓-블루 남성캐주얼,132440,132440,0
2018-06-01,1017621870,C021020,구두,[루플랫] 1308562 (해외) 18SS 크리스찬 루부탱 서브뮬 100MM 스웨이드 펌프스,1708200,1472830,-235370
2018-06-01,463747560,C012060,여자내의,V넥 롱셔츠 캐주얼 여성 V넥티셔츠,29510,28330,-1180
2018-06-01,1017621872,C021020,구두,[루플랫] 1308564 (해외) 18SS 크리스찬 루부탱 점핑 페이턴트 레더 펌프스,1222000,1053570,-168430
2018-06-01,1165073579,A022020,두유,뼈로가는칼슘두유 190ml 72팩 플레인 검은콩 호두땅콩,26600,26600,0
2018-06-01,989074121,F011150,건강기능식품,동아제약박카스F120ML,800,800,0
2018-06-01,66809194,L021030,가방,여성가방/여자숄더백/크로스/백팩/핸드백/클러치/여행,35000,35000,0
2018-06-01,744737772,E011040,소파,레이디가구 3인 용 가죽 소파 + 오리 거위 털 쇼파,265550,265550,0
2018-06-01,628596877,C011030,남자학생복,여름신상 와이셔츠/남자드레스솔리드/정장체크/남방,13800,13800,0
2018-06-01,1277831413,E061050,청소용세제,Mr.홈스타 락스 청소세제 모음전,8900,8900,0
2018-06-01,1149446068,A012050,소시지,진주햄 천하장사Q 소세지 500gx2봉 (100개입),9900,9900,0
2018-06-01,848013499,C011030,남자학생복,신상,14900,14900,0
2018-06-01,1294313012,F012020,생리대,좋은느낌 슬림 날개 생리대 소/대형 160p/중형180p,42900,42900,0
2018-06-01,1299079661,I031040,생화,SOS 긴급 구호세트 캠핑장비 캠핑공구 캠핑용품 야외,24330,22170,-2160
2018-06-01,2036153596,E031070,에어컨,한일 16인치 천정용 선풍기 FC-62LB-S(조절기없음),58900,55960,-2940
2018-06-01,417781658,A016070,귤,동결건조 무농약 밀감가루 80g 감귤 귤 가루,8000,8000,0
2018-06-01,1779514101,L021020,장신구,[바보사랑]925실버Tuka 태슬 팔찌 JATK01000,25900,25900,0
2018-06-01,1779514102,L021020,장신구,[바보사랑][부모님커플팔찌] 실버&천연원석 SET,70800,70800,0
2018-06-01,357087090,C012040,여자학생복,[매그제이(MAGJAY)]롱슬리브니트 (J11PVE011),39900,37510,-2390
2018-06-01,1779514100,L021020,장신구,[바보사랑]925실버Allie 별자리팔찌 JACA01010,25900,25900,0
2018-06-01,971290214,C013050,운동복,카니발2-미르웨이 후사경/4WD/RV용품/사각지대/후진주차/현대/기아/대우/쌍용,27000,24600,-2400
2018-06-01,1779514103,L021020,장신구,[바보사랑]925실버 천연원석 팔찌 4종택1 JAM0100,35400,35400,0
2018-06-01,1779514104,L021020,장신구,[바보사랑]925실버 담수진주팔찌 Mom&Kids JARN01020,58800,58800,0
2018-06-01,1588616959,E061060,살충제,해피홈 좀벌레 아웃 옷장용2입/서랍장용10입,3200,3200,0
2018-06-01,516341300,A016090,참외,게르마늄 성주참외 10kg 맛 정말좋음,24600,24600,0
2018-06-01,1124091481,C011050,남자내의,남자슬랙스/여름슬랙스/캐주얼바지/남자바지/주름방지,17800,17800,0
2018-06-01,747270822,D031010,주택수선재료,녹환원제/녹전환제 러스트 컨버터 앤 프라이머 250ml,9000,9000,0
2018-06-01,1998716968,F012020,생리대,쏘피 바디피트 볼록맞춤 88P+증정8P 특가/생리대,13500,13500,0
2018-06-01,1341340474,A011020,현미,[2017년 햅찹쌀] 충남서천찹쌀 20kg+사은품미강500g,58000,58000,0
2018-06-01,886047099,C011030,남자학생복,[빅사이즈 솔리드 5버튼 가디건411] / 라운드넥니트 빅사이즈가디건 직장인패션 남성빅,65300,50940,-14360
2018-06-01,1472868165,C012040,여자학생복,로로텐 레이스/셔츠/루즈핏/블라우스/남방/빅사이즈,26900,26900,0
2018-06-01,1017621868,C021020,구두,[루플랫] 1308559 (해외) 18SS 크리스찬 루부탱 엘토네테 크리스탈 엠벨리쉬 스,2928000,2524480,-403520
2018-06-01,1777259408,A016120,바나나,무배 멕시코 신선 그린 바나나 freshgreenbanana 13kg,57900,57900,0
2018-06-01,34959519,L021010,손목시계,벨카리노/나토밴드 남자여자 손목시계 40종/밴드 1+1,27900,27900,0
2018-06-01,1377941816,C012040,여자학생복,머플러 어깨숄 여성 겨울 패션 망토 가디건 담요 자켓,16640,16640,0
2018-06-01,532954342,A013070,굴,다인 생새우살 (51/70) 실중량 200g/냉동새우/새우살,4100,4100,0
2018-06-01,507306275,C012040,여자학생복,소녀 지퍼 카드 반지갑/미니 손지갑(랜덤발송),3500,3400,-100
2018-06-01,272147570,A017050,미나리,양배추/양배추가루/양배추분말/양배추환/초댐식품,9000,9000,0
2018-06-01,387566996,L021030,가방,Targus 타거스 정식 총판 수입 제품 TCG660 15.6인치 배낭형/백팩 노트북가방,73000,67190,-5810
2018-06-01,805420324,C013010,점퍼,[피플엠][제시뉴욕] 울 무스탕 코트,14900,14160,-740
2018-06-01,1401587809,L012010,면도기,도루코 100EA 원터치포장 2중면도날 일회용면도기,7500,7400,-100
2018-06-01,1590221979,A018070,파이,롯데초코파이 8갑 96봉 1박스 무료배송 과자 간식,16300,15980,-320
2018-06-01,1369683738,C013060,등산복,[빈폴아웃도어]애쉬 남성 BREEZE 후드 바람막이 (BO8339D014),125300,98990,-26310
2018-06-01,328390673,C012060,여자내의,디지털플라워PT C(VA87SLM201C)/ 반에이크,49800,46320,-3480
2018-06-01,152210799,A013020,명태,광림 대구포450g 2개,62550,62550,0
2018-06-01,181204550,A022010,주스,제주감귤주스 1.5L X 12펫 쥬스 음료 음료수 무배,15500,15500,0
2018-06-01,456705768,I011010,TV,NEX 43인치 TV/ 100% 무결점/ LG패널 아닐시 1억 배상,269800,259000,-10800
2018-06-01,985417420,L012060,샴푸,LG 리엔 자윤 모근강화 중건성샴푸 500ML,14990,3990,-11000
2018-06-01,1310788574,C013020,티셔츠,남여 냉감 쿨티셔츠 90~130 빅사이즈/반바지 트렉수트,4900,4900,0
2018-06-01,1955205621,L012030,칫솔,래디어스 유아칫솔 5종 6종 토츠플러스 퓨어베이비,14900,14900,0
2018-06-01,1599813134,E041060,수저,수저세트10P 티스푼 숟가락 젓가락 외국인선물 답례품,34800,34800,0
2018-06-01,1242616844,C012030,여자상의,[무료배송]DWW013A 반오픈 롱 원피스 802 여성원피스,50810,50810,0
2018-06-01,1106993162,C013050,운동복,다용도 비상망치 후레쉬 차량용품 손전등 차량용품 차,12840,12460,-380
2018-06-01,108721445,G011070,자전거,K2BIKE 클래식 여성용자전거 프리데이24/26인치 7단,93700,84330,-9370
2018-06-01,1779514097,L021020,장신구,[바보사랑]925실버 Round Donut 팔찌_A26202B101,15900,15900,0
2018-06-01,1120270085,E031080,선풍기,[전국기본설치무료] 위니아 인버터 냉.난방기 PBV-15BHC (48.8㎡ 1등급),1700000,1700000,0
2018-06-01,1779514098,L021020,장신구,[바보사랑]925실버 Thin 커프 팔찌 3종 택1 JACF40,59900,59900,0
2018-06-01,1779514095,L021020,장신구,[바보사랑]925실버 Emilia 원석 팔찌 A26505B101,39900,39900,0
2018-06-01,1120270087,E031080,선풍기,[전국기본설치무료] 위니아 인버터 중형 냉.난방기 PBV-25BHC (81.8㎡ 1등급),2200000,2200000,0
2018-06-01,1779514096,L021020,장신구,[바보사랑]925실버 Lace 팔찌 3종 택1_A26205B101,15900,15900,0
2018-06-01,1120270082,E031080,선풍기,홍진테크 컨벡션 히터 SF-2000CV,37000,37000,0
2018-06-01,1138115415,E031020,가스레인지,GOR-B5T01V/동양매직 빌트인 가스오븐레인지+4구 가스렌지 일체형 제품/화재예방/안심,950000,950000,0
2018-06-01,1120270081,E031080,선풍기,홍진테크 세라믹 키높이 히터 SF-1411C,27500,27500,0
2018-06-01,1509480905,C021040,실내화,9800원 여름신상 운동화 스니커즈 런닝화 슬립온,14800,14800,0
2018-06-01,1120270084,E031080,선풍기,대성쎌틱 라디에이터 DSRA-15 (15핀),106000,106000,0
2018-06-01,1120270083,E031080,선풍기,홍진테크 컨벡션 온풍 히터 SF-2000FV,43000,43000,0
2018-06-01,440945007,C012040,여자학생복,쉬폰 비치 로브가디건 2color / 빅사이즈 55~120까지,52500,49420,-3080
2018-06-01,1120270080,E031130,보온매트,아나테크 동력조절기/온수보일러 SMART-480SE,79900,79900,0
2018-06-01,684095810,C012060,여자내의,[나인(NAIN)](PT-3180)린넨 스트라이프 숏 팬츠(광주신세계),42000,38710,-3290
2018-06-01,1313139866,A013020,명태,두레생협 대구토막(450g 러시아산) 냉동대구토막 요리,28120,28120,0
2018-06-01,2083173479,C013010,점퍼,스테판조셉 프린티드 레인코트 스포츠B (택1) /(참고),86800,76390,-10410
2018-06-01,1093079024,C013040,청바지,[에이인]SHALOM straight ver.8 (s  m  l),32000,30400,-1600
2018-06-01,132336081,E011030,거실장,헤라 거실장/제우스거실장/TV장식장/티비다이/장식장,109000,109000,0
2018-06-01,1120270079,E031130,보온매트,아나테크 동력조절기/온수보일러 SMART-520AT,78900,78900,0
2018-06-01,246662932,E021020,커튼,GT 강아지 고양이 철문 이동장 걸리버 디럭스4 특대형,252310,252310,0
2018-06-01,1623761092,A021010,커피,[쿠폰가29 900원]맥심 화이트320T/모카320T+텀블러,32900,32900,0
2018-06-01,2078899581,E021020,커튼,/벌집블라인드 그레이 호프발스 140x155 cm/ 롤스크린,71460,63600,-7860
2018-06-01,1123164537,E021020,커튼,호텔식 암막커튼 방한방풍 거실커튼 창문커텐,31400,26220,-5180
2018-06-01,45735118,A013100,마른멸치,[하늘뜰] 산지직송 참전복 1kg 선물세트 모음전,43900,43900,0
2018-06-01,1254278749,L021050,우산,최고급/우의/우비/비옷/등산용우의/오토바이우의/형광우의/경찰용우의/레저우의/골프우,26900,26900,0
2018-06-01,1675587139,C011020,남자상의,남성 봄 코트/자켓/오버핏/정장/롱/면/남자/수트,41800,39800,-2000
2018-06-01,392183685,C012060,여자내의,[난닝구]핑클리 린넨밴딩스커트,25900,23830,-2070
2018-06-01,890995603,E011030,거실장,린넨 3단 서랍장 (대),62900,62900,0
2018-06-01,890995600,E011030,거실장,린넨 4단 서랍장 (대),74800,74800,0
2018-06-01,410977484,C012030,여자상의,KD 앙고라 라운드 롱원피스 앙고라원피스 롱니트 롱니,89690,89690,0
2018-06-01,571830143,C012020,원피스,컬러배색 코트IZ6WH450/ 코인코즈,47000,39950,-7050
2018-06-01,563731857,D031010,주택수선재료,순앤수100 4L 내부수성 무광 벽지 벽면 친환경페인트,11900,11900,0
2018-06-01,1115917338,I012010,컴퓨터,[가온씨앤씨] 2015 NEW iMac MK142KH/A 21.5형/코어i5/8GB램/1TB하드/애플코리아정품,1465000,1465000,0
2018-06-01,1779514099,L021020,장신구,[바보사랑]925실버 Chain 별자리팔찌 JACO01105,34900,34900,0
2018-06-01,1510958847,E061050,청소용세제,유원락스18kg  유한락스18kg 살균 소독 세정 업소용,8600,8600,0
2018-06-01,1154092885,C012030,여자상의,[헤이레이디] 핫 여름 아이템 티셔츠/원피스/팬츠,8900,8900,0
2018-06-01,405839078,A013130,오징어채,[맘쿠킹 무료배송] 국내가공 진미채/홍진미 700g,18900,18900,0
2018-06-01,965825818,E061060,살충제,해충퇴치기 뉴다자바큐 다잡아큐 벌레퇴치기 모기퇴치,29800,29800,0
2018-06-01,1601877849,C013020,티셔츠,[라코스테] 남성 히든 폴라켓 반팔 폴로 LCST PH552E-18B166,138000,131100,-6900
2018-06-01,465451975,G011070,자전거,삼천리 700C 러쉬 14R 드롭바 하이브리드 자전거,245000,148500,-96500
2018-06-01,213768769,C013050,운동복,프론트 리어 범퍼 가드 보호대 몰딩 화이트 범퍼 자동,22500,20500,-2000
2018-06-01,857919053,D031010,주택수선재료,[물에빠진벽지][셀프도배]벨린다민트 1롤_MP408,29800,29800,0
2018-06-01,230275380,I053010,공책,신학기 과목노트(한문)(10개입)-랜덤 한문공책 한자공,11370,11370,0
2018-06-01,1107082479,E021020,커튼,마음대로 믹스 프로방스 플라워커튼 거실 안방 커튼,23800,21900,-1900
2018-06-01,1120269060,F011130,홍삼,[참꿀마을]프리미엄 홍삼진액 70mlⅹ21포,20900,20900,0
2018-06-01,1997626614,A017010,배추,치자(슬라이스 한진 500g)X20개 / 피치자 치자가루 분말 반죽치자김치 치자효능 치자차,138100,133960,-4140
2018-06-01,440945037,C012040,여자학생복,팜트리 로브가디건 2color / 빅사이즈 55~110까지,27500,25890,-1610
2018-06-01,1120269064,F011130,홍삼,[참꿀마을] 6년근 고려홍삼정 골드 250g x 2,29900,29900,0
2018-06-01,2007653891,C013010,점퍼,[구김스]구김스 129_ 후드 집업 자켓,92000,87400,-4600
2018-06-01,1120269063,F011130,홍삼,[참꿀마을] 6년근 고려홍삼정 골드 250g,19900,19900,0
2018-06-01,416979156,E011050,책상,ET101-M 전동식 높이 조절 워크스테이션 높이조절책,1308780,1308780,0
2018-06-01,1120269062,F011130,홍삼,[참꿀마을] 6년근 고려홍삼정 골드 250g x 2병,34900,34900,0
2018-06-01,1120269061,F011130,홍삼,[참꿀마을]프리미엄 홍삼진액 (70mlⅹ21포) x 2박스,39900,39900,0
2018-06-01,415996919,C013040,청바지,EX1629 밴드 청반바지 청반바지 청5부 청 반바지 남자,65670,64360,-1310
2018-06-01,416019031,C013010,점퍼,바람막이 야상 WS-JM23 바람막이 야상 점퍼 남자야상,69700,68310,-1390
2018-06-01,620547984,L021020,장신구,귀걸이 이어링 귀고리 은침귀걸이 체코스톤 유색보석 925은침 큐빅귀걸이 패션귀걸이,4500,4370,-130
2018-06-01,1379780237,E041010,식기,안성/방짜/유기/수공예/손조각/십장생/반상기/세트/무형문화재/혼수/예단/선물/외국인,598000,598000,0
2018-06-01,348464311,C011030,남자학생복,애드혹 스트라이프 헨리넥 셔츠 HU5SS30,29500,25080,-4420
2018-06-01,1082821379,A014020,분유,순산양유아식 3단계 800g/ 아이배냇,32900,32900,0
2018-06-01,2064069010,C012060,여자내의,SK1386-러플 랩 스커트(데일리룩내추럴룩세련여성의류,37070,37070,0
2018-06-01,1218201105,C014010,아동복,한국 생산 야구 상하3종세트 블루 (3-36개월)800013,53560,51960,-1600
2018-06-01,2003827971,C012040,여자학생복,남성 여성 목만있는 목 폴라 티셔츠 티 니트 목토시,3500,3400,-100
2018-06-01,1779514035,L021020,장신구,[바보사랑]925실버 Potta arrow 반지 A0168571,39900,39900,0
2018-06-01,693074765,F012010,종이기저귀,리베로기저귀 밴드형 2팩 모음,31600,31600,0
2018-06-01,1779514036,L021020,장신구,[바보사랑]925실버 Pitta 반지 A100615,19900,19900,0
2018-06-01,1098983183,E041020,컵,남여아이얼굴 뚜껑 머그컵 세트(2P) / 커플머그 커피,23800,23800,0
2018-06-01,1779514033,L021020,장신구,[바보사랑]925실버 스마일반지 A6023R000,29900,29900,0
2018-06-01,1779514034,L021020,장신구,[바보사랑]925실버&각인 Plain 커플링/우정링,39900,39900,0
2018-06-01,1779514039,L021020,장신구,[바보사랑]925실버 Wide flat 반지-OR A0604151,39900,39900,0
2018-06-01,1927196257,F012020,생리대,[청결제증정]나트라케어 유기농 생리대 4팩,28900,28900,0
2018-06-01,1779514037,L021020,장신구,[바보사랑]925실버 Heda 반지 A030415,45900,45900,0
2018-06-01,2111351915,C012030,여자상의,[패션24시30%쿠폰]시원한이쁨주의원피스!M~3XL,12900,12900,0
2018-06-01,1434219662,A017210,파,예지원팜 찰토마토 특상품 5kg 약 25~30개,15900,15900,0
2018-06-01,956785447,A014030,치즈,[덴마크]덴마크 인포켓치즈 200G(20G*10입),9900,7600,-2300
2018-06-01,383124602,C013010,점퍼,가죽점퍼 라이더점퍼 WS PU_05 모직 패치 라이더점퍼,154850,154850,0
2018-06-01,1902181021,I031040,생화,등산/무릎보호대/스프링4개/기능성극대화/3댄밴딩/,7900,6900,-1000
2018-06-01,1082821381,A014020,분유,순산양분유 2단계 800g/ 아이배냇,32900,32900,0
2018-06-01,378806282,C013030,스웨터,MJ_1140 라인 니트 집업 시보리네크라인 니트 니트집,56680,56680,0
2018-06-01,964017406,I053040,기타문구,[오피스코아]3M 양면테이프 모음/테이프/플러스/청테이프/스카치테이프/박스테이프/디,800,800,0
2018-06-01,1120269059,F011130,홍삼,[한일인삼][1+1]_6년근 명품홍삼진액 80ml*30포+명품 흑마늘 진액 80ml*30포,64900,64900,0
2018-06-01,451029188,A012060,햄및베이컨,태림 훈제삼겹살 400g2개 삼겹살 훈제삼겹살 냉동식품,31740,28570,-3170
2018-06-01,632925801,A012010,국산쇠고기,(목우촌 선물세트)제주생고기 돔베팸 1호 고급 쇼핑백,75100,66090,-9010
2018-06-01,1082627188,A017050,미나리,양배추분말(국산) 1kg/양배추/분말/가루/파우더/생식/선식/천연/조미료/찌개/국/양념/,21000,21000,0
2018-06-01,1026462874,C012040,여자학생복,이프네 수술로브가디건 DI5WCD05,31000,31000,0
2018-06-01,1998209905,E031130,보온매트,일월 전기매트 전자파차단 열선 싱글 더블 장판 온수,68400,68400,0
2018-06-01,206865990,A012010,국산쇠고기,축협 1등급 한우 갈비선물세트 3.2kg 한우갈비 찜갈비,260000,257400,-2600
2018-06-01,1775166394,C011050,남자내의,[쇼타임] DJ1094린넨8부배기 남자 남성 마바지 밴딩 빅사이즈,29800,29800,0
2018-06-01,1779514042,L021020,장신구,[바보사랑]925실버 simple bar 반지,25900,25900,0
2018-06-01,1779514040,L021020,장신구,[바보사랑]925실버 Leaf crown cubic line 반지-OR A1402151,35900,35900,0
2018-06-01,681262779,E061040,부엌용세제,커피머신세정제 어넥스퓨로 - 커피머신세정제 커피머,45410,40420,-4990
2018-06-01,1779514041,L021020,장신구,[바보사랑]925실버 zigzag cubic line 반지 A5168711,39900,39900,0
2018-06-01,1779514068,L021020,장신구,[바보사랑]925실버 행운의 클로버 소원팔찌/발찌 A7408B001,14900,14900,0
2018-06-01,1533746637,C013020,티셔츠,[앨빈클로-정품]공용 맨투맨 후드 집업 무지 긴팔티,24900,14900,-10000
2018-06-01,1779514069,L021020,장신구,[바보사랑][액세서리키친] 925실버 Merci 진주팔찌 A7406B002,35900,35900,0
2018-06-01,37610235,E011020,침대,[가구야]매트리스+큰서랍포함 싱글/슈퍼침대,129000,129000,0
2018-06-01,1779514066,L021020,장신구,[바보사랑]925실버 EXPLORE 소원 반지 16113035,35900,35900,0
2018-06-01,1779514067,L021020,장신구,[바보사랑]925실버 Kira&Lira 팔찌 SET,35800,35800,0
2018-06-01,326489847,A019020,참깨,발아볶은검정깨 120g 국산검정깨 볶은깨 국산검정통깨,18400,18400,0
2018-06-01,398244230,C013020,티셔츠,[잠뱅이]남) AH2WTS02 ( 기획 기능성 쿨소재 브이넥 티셔츠 )(센텀시티점),7000,6120,-880
2018-06-01,1927979226,A013050,오징어,오뚜기 고등어 280g X 24EA 캔꽁치 통조림캔 가공식품,66830,66830,0
2018-06-01,1753689243,A019110,드레싱,타바스코 핫소스 150ml,8500,8500,0
2018-06-01,805649573,C021010,아동화,[MLB키즈] 2018 신상 뉴욕 양키스 전체 밴드 매쉬 벨크로 운동화 (택1) 72SH31811,69000,58650,-10350
2018-06-01,1997319916,E011020,침대,[골든잼]소나무 원목 카우치(고재)/흙침대 카우치소파,3900900,3783880,-117020
2018-06-01,1779514071,L021020,장신구,[바보사랑]925실버 Kira 팔찌 3종택1 A26809B001,15900,15900,0
2018-06-01,1779514072,L021020,장신구,[바보사랑]925실버 Lira 팔찌 3종택1 A26808B001,19900,19900,0
2018-06-01,132578181,A012060,햄및베이컨,[청정원공식몰] 청정원 런천미트 115gx5캔,9460,9460,0
2018-06-01,361172574,A022050,탄산음료,코카콜라 185ml x60can/박스포장,28900,28900,0
2018-06-01,1174499884,A016160,과일가공품,미국산 A그레드 냉동블루베리1kgx3개/애플망고,20900,20900,0
2018-06-01,406460312,C014020,유아복,[트윈키즈]미치코런던항공점퍼 (T7MM9J71),21400,13910,-7490
2018-06-01,358038576,C013050,운동복,코란도스포츠 리무진 콘솔박스 팔걸이 쿠션 팔걸이쿠,61430,55960,-5470
2018-06-01,1779514070,L021020,장신구,[바보사랑][액세서리키친] 925실버 May 팔찌 JAM0134,35400,35400,0
2018-06-01,529497753,C012060,여자내의,스판 네이비 교복치마 교복 예쁜교복 교복쇼핑몰 중학,37070,35960,-1110
2018-06-01,1779514073,L021020,장신구,[바보사랑]925실버 Waterface coin 팔찌 A1410151,45900,45900,0
2018-06-01,1288253581,C021040,실내화,[나이키]에어 베이퍼맥스 플라이니트 2 남/여 7종 택1(942842 942843),239000,239000,0
2018-06-01,402949923,A015020,식용유,카놀라유 라이트 (백설 0.9L) X12,124000,110360,-13640
2018-06-01,1010317897,A011140,부침가루,필라델피아 치즈케이크라즈베리스월 794G,23000,23000,0
2018-06-01,177030108,F012010,종이기저귀,[신상품]베베몬 시즌2 팬티기저귀 2팩/3팩/4팩,21800,20900,-900
2018-06-01,1748029661,A011070,혼식곡,글루텐(프랑스산 소맥밀글루텐100%) 1kg,7500,7500,0
2018-06-01,1441538324,C021040,실내화,스티유 18 S S 81305bk-81306co 크로스 지 샌들,43870,43870,0
2018-06-01,1010317899,F012020,생리대,[유한킴벌리]유한킴벌리)좋은느낌오가닉코튼커버슬날소32P,10700,10700,0
2018-06-01,1126081278,C013040,청바지,[수비진]여름신상/스키니/청반바지/일자바지/부츠컷,9900,9900,0
2018-06-01,986375598,D031010,주택수선재료,접착식 장판 시트지/바닥재/바닥타일/베란다 리폼,9000,8500,-500
2018-06-01,1659194714,C015020,모자,군모 모자/야구모자/볼캡/빈티지/남자/여자/캡모자,5900,5900,0
2018-06-01,1398901901,C012040,여자학생복,수지네 일본 구제 네이비 베스트 여성 M 19-01,13170,13170,0
2018-06-01,2081570993,C014010,아동복,센트로 윈드 자켓 KDD0600,31680,31680,0
2018-06-01,1400497476,A013140,북어채,바다여왕 국내가공콜라겐 황태껍질 황태껍질부각,12800,12800,0
2018-06-01,1295555696,E041050,냄비,한일스텐 프라임 통3중 이유식냄비 밀크팬 14cm,22000,22000,0
2018-06-01,1120270056,E031080,선풍기,이노크아든_ 콘센트형 미니 온풍기 IA-WH500W (490w),39800,39800,0
2018-06-01,1466493123,A012030,돼지고기,[한돈사랑]목살 100g당1480원/국내산돼지고기모든부위,11800,9900,-1900
2018-06-01,1779514064,L021020,장신구,[바보사랑]925실버 Overlap 반지 A516779,35900,35900,0
2018-06-01,1120270055,E031080,선풍기,이노크아든_ 온풍 컨벡터히터(스탠드/벽걸이겸용) IA-1520CF,79000,79000,0
2018-06-01,989074181,A011130,시리얼,사조해표 부침가루 1KG,2650,2650,0
2018-06-01,989074180,F011150,건강기능식품,큐원 상쾌환 3G,2500,2500,0
2018-06-01,854340074,E031080,선풍기,SAPA 세티즈 전기라디에이터 소형 SPH-007M (7핀/0.8KW),42000,42000,0
2018-06-01,1749902682,A019110,드레싱,칼 퀴네 요구르트 드레싱 250ml,4900,4900,0
2018-06-01,854340076,E031080,선풍기,SAPA 세티즈 전기라디에이터 대형 SPH-009 (9핀/ 1.5KW),65500,65500,0
2018-06-01,854340075,E031080,선풍기,SAPA 세티즈 전기라디에이터 대형 SPH-007 (7핀/ 1.2KW),56900,56900,0
2018-06-01,1999134308,E061020,섬유유연제,FC 베이비전용 세탁세제 refill 유아용 어린이세탁세,20800,20800,0
2018-06-01,1736984667,C013050,운동복,그랜드 스타렉스 2단 콘솔박스 수납함 (5인승/11인승),188000,169510,-18490
2018-06-01,907263992,A016070,귤,보석건귤 선물세트 8호 x 3박스]말린귤 귤,40790,40790,0
2018-06-01,1758694108,C013010,점퍼,[지오다노] 378513 여 오버사이즈 레인코트/ 지오다노,29800,24140,-5660
2018-06-01,1102946897,I031070,애완동물관리비,테니스라켓 모음전 윌슨 바볼랏 US오픈 페더러 주니어,26500,23320,-3180
2018-06-01,1655385312,C013010,점퍼,[인디안][인디안(INDIAN)]베이직바람막이점퍼_MITCLSM3201_56,62500,59380,-3120
2018-06-01,2092201804,D031010,주택수선재료,욕실매트 조립잔디 조립매트 논슬립매트 미끄럼방지,4460,4460,0
2018-06-01,579728579,A014010,우유,특가 매일 멸균우유 200ml 24팩 /파스퇴르 최신제조,13700,13700,0
2018-06-01,570339979,E061010,세탁세제,[EM 살리미 발효 세탁세제 1000ml]3배고농축 천연세제 이엠 EM세제 액체세제 민감성 유,17000,14950,-2050
2018-06-01,174573624,I012010,컴퓨터,[E]Z70EV-AP75S1/7세대/i5/8G/SSD128G+500G/윈10프로,966000,917700,-48300
2018-06-01,1129925240,C013010,점퍼,DDJ0109R 기본 후드 집업 803 후드 여성용후드 여성후,48800,48800,0
2018-06-01,177284290,E031090,공기청정기,다이슨 공기청정 핫앤쿨 HP03 /이벤트,806000,757640,-48360
2018-06-01,1612966315,I012010,컴퓨터,삼성컴퓨터 사무용 가정용 3세대 슬림 Win7/Win10,249000,179000,-70000
2018-06-01,1941949176,C013020,티셔츠,남여공용 소문자 지프 작은로고 반팔 티셔츠(GJ0TSU092)/ 지프,15000,12750,-2250
2018-06-01,704902124,A018010,초콜릿,골든버그 츄엣2.5kg/피넛츄/미니초코바/넛바/초콜릿,30500,30500,0
2018-06-01,1159535764,C013050,운동복,디지털 공기압 측정기 타이어 공기압 휴대용 자동차,7200,7200,0
2018-06-01,586362593,E031030,전자레인지,[LG전자] LG전자 MW23CD 23L 인버터 전자레인지 LG공식(대명),149000,138000,-11000
2018-06-01,423324730,A019090,카레,3분카레(쇠고기 오뚜기 200gx24),41050,41050,0
2018-06-01,1048896568,A021010,커피,[1kg]갓볶은 신선한 원두커피 45종/무료배송/당일출고,20500,20500,0
2018-06-01,639950342,F011120,인삼,내장산 산삼7~9년근 5뿌리 장뇌삼 산양산삼 홍삼 인삼,90000,89000,-1000
2018-06-01,895799278,A015020,식용유,[CJ]CJ 백설유 콩기름 (900ml),4300,4300,0
2018-06-01,415996955,C011030,남자학생복,슬림 카라포인트 클로버패턴 블루스카이 셔츠 긴팔남,20390,20390,0
2018-06-01,1197714662,A013170,생선통조림,유동 번데기캔 130g X 48EA_1BOX 번데기 유동번데기캔,63010,61120,-1890
2018-06-01,221723324,L021030,가방,라코스테 가방 쇼퍼백 크로스백 클러치백,77500,77500,0
2018-06-01,895799277,A015020,식용유,[CJ]CJ 백설유 콩기름 (500ml),2600,2600,0
2018-06-01,1735599584,A019090,카레,일본카레/바몬드카레230g SB카레220g 자바카레185g,3290,3290,0
2018-06-01,538631235,C012060,여자내의,린넨 리본 살로페트 780927/ 니코앤드,49900,47410,-2490
2018-06-01,895799273,A019110,드레싱,CJ 다담 바지락 순두부찌개용양념 (140G),1590,1590,0
2018-06-01,632960183,C011030,남자학생복,자켓 골프점퍼 2042 MK 마크 2041 빅사이즈,115640,111020,-4620
2018-06-01,897704038,A019140,이유식,[남양]남양 뉴호프 닥터(설사분유) 300G,13200,13200,0
2018-06-01,2070930832,C012060,여자내의,빅사이즈/엔젤/쉬폰/스커트 / 참고 엔젤쉬폰스커트 빅,51200,43520,-7680
2018-06-01,978941095,A013010,갈치,제주 은갈치+옥돔 선물세트 제주갈치 명절 추석선물,220000,217800,-2200
2018-06-01,1598896768,E031120,믹서,블레스 파스텔 유리 믹서기 BP35 고속 블렌더 SI,43500,41000,-2500
2018-06-01,2061322445,C012020,원피스,[미니멈][MINIMUM]소프트 롱코트 MRDOWH9830-SB,159000,151050,-7950
2018-06-01,1010171012,E041040,프라이팬,라체나)다이아몬드점보웍36cm,29900,29900,0
2018-06-01,222221255,C012040,여자학생복,FREE 니쥬타입브이넥여자긴팔니트티,13070,13070,0
2018-06-01,1180777548,C012060,여자내의,Y-JIN089 뒤트임5부청치마-스판 스커트 여성스커트 여,12200,11840,-360
2018-06-01,1305205558,A018020,사탕,막대사탕/롤리팝 츄파춥스 미니 수입캔디 달고나스틱,8000,7920,-80
2018-06-01,1010171016,A011010,쌀,대왕님표여주쌀(추청)/10KG,36900,36900,0
2018-06-01,1329377012,C021040,실내화,[정품] 나이키 에어맥스97 화이트 실버 블랙 아시아,140000,138000,-2000
2018-06-01,2048205533,L021060,유모차,크라운S 유모차 디럭스형 요람형 시트형 양대면 원터,530000,530000,0
2018-06-01,1207799388,C013010,점퍼,오버핏 후드집업 VER2 여름 비치웨어 빅사이즈 후드티,12900,12900,0
2018-06-01,662543085,A022010,주스,까로망 마이 청포도 농축액 2kg,23900,23900,0
2018-06-01,1180777550,C013050,운동복,229_고구마베이비 아기옷-무형광 강아지 민소매 상하,10910,10590,-320
2018-06-01,268396404,C012040,여자학생복,[ab.plus][ab.plus] 투스타 비즈장식 숏 가디건 (LSQ2WW19A)_N1K4,19000,16150,-2850
2018-06-01,1325299147,C012060,여자내의,발목 스타킹 10족 양말 발목스타킹 기모레깅스 레깅스 스타킹 겨울스타킹 기모레깅스,7160,6380,-780
2018-06-01,2008927649,E041020,컵,본차이나 프리미엄 커피잔세트 2인/5인 찻잔 12종,17900,17900,0
2018-06-01,268396401,C012040,여자학생복,[ab.plus][ab.plus] 비비드컬러 브이넥 가디건 (LSQ2GW11A)_H7L3,19000,16150,-2850
2018-06-01,487704968,C011030,남자학생복,남여용 숄가디건/남성남자여성여자니트롱후드숄가디건,98690,88830,-9860
2018-06-01,268396400,C012040,여자학생복,[ab.plus][ab.plus] 라운드넥 노버튼 가디건 (LSQ2GW16A)_M3P6,19000,16150,-2850
2018-06-01,1029232290,C013020,티셔츠,RT6 빅사이즈 차이나넥라인남자긴팔남방,53260,52200,-1060
2018-06-01,1387883706,C012020,원피스,[올리브데올리브]테일러드 카라 H라인 울 코트(OW7WH562),166000,129480,-36520
2018-06-01,1101090083,E011060,의자,철재의자모음-인테리어의자 식탁의자 카페의자 철재,32900,29610,-3290
2018-06-01,1111732688,E061040,부엌용세제,닥터큐 우유분해 세정제,50610,45050,-5560
2018-06-01,1730221775,E031090,공기청정기,LG 공식인증점 퓨리케어 공기청정기 AS181DAW,809000,759000,-50000
2018-06-01,749198196,A011140,부침가루,[삼립] 삼립 초코무스 조각케익 (85g 5입) 케이크,13000,12870,-130
2018-06-01,1294036171,C021010,아동화,아동 단화 슬립온 운동화 아동화 유아 신발 슈즈 여아,24900,24900,0
2018-06-01,504509164,G011070,자전거,미르 노멀2 퍼슛픽시 삼발이픽시 / 입문픽시 가성,132200,121630,-10570
2018-06-01,1196958989,E061050,청소용세제,Mr.홈스타 청소세제 모음전(락스/세탁조/배수관/변기),11900,11900,0
2018-06-01,530565360,A018110,물엿,9번구운 알갱이개암자죽염250g(15g사은품) 황토죽염,99290,96320,-2970
2018-06-01,1395156243,A012010,국산쇠고기,대관령한우 알뜰세트 3호,79730,79730,0
2018-06-01,714138034,E011040,소파,보니타빈백 BD09 북유럽스타일/빈백소파/쇼파/독서,95900,95900,0
2018-06-01,745916675,A022050,탄산음료,환타 355ml x24can (포도 오렌지 파인애플),18100,18100,0
2018-06-01,1449388233,F012010,종이기저귀,유니프레임 미니로스터 665817 정식정품 당일출고,28000,28000,0
2018-06-01,201751670,E041020,컵,소울빈)TEAUS 프리미엄 찻잔 5종 다기용품 본사직판,2900,2900,0
2018-06-01,1206704621,C013040,청바지,[루미씨] 데이 부츠컷 아이보리 팬츠,17800,17800,0
2018-06-01,924715560,C011050,남자내의,남성 마 반바지 남자 린넨 비치웨어 빅사이즈 4XL 5XL,24900,24900,0
2018-06-01,895775255,A022020,두유,[정식품]정식품 베지밀A 950ML,2500,2500,0
2018-06-01,1412410170,L021030,가방,롱샴 여성 가방 르플리아쥬 네오 라지,108000,108000,0
2018-06-01,441034257,A019060,된장,식자재 별미 조선맛된장 14kg,54270,54270,0
2018-06-01,728271902,C012040,여자학생복,꾸제꾸제/Calvin Klein 집업 니트 가디건/여성 S/면/스웨터/세일/브랜드/빈티지/중고구,23900,23900,0
2018-06-01,410530156,A012010,국산쇠고기,고급향신료 선물세트 B형/유럽풍 향신료세트,65470,65470,0
2018-06-01,895775251,A022020,두유,정식품 검은콩 고칼슘 베지밀 (190ML*16입+8입),14180,13200,-980
2018-06-01,215783515,C013050,운동복,사계절워셔액 1.8L 1박스(12개) 자동차/사계절/에탄올,20500,18860,-1640
2018-06-01,1825438058,C021040,실내화,윌슨 러쉬 프로2.5 테니스화 ( WRS322630 ) 그레이,159780,142210,-17570
2018-06-01,1309506408,C011030,남자학생복,[디즈니] 어벤져스 남아 마크 후드집업 F6SKEUM01,9800,9800,0
2018-06-01,423527259,A011100,라면,당면(알뜰 오뚜기 2.4K)X5,81660,81660,0
2018-06-01,1850947352,E011040,소파,[동서가구]제이홈스외천연가죽 4인소파/가죽소파모음,439000,439000,0
2018-06-01,293148129,C013010,점퍼,DBN1538 사키 라이더 자켓 803S 여성재킷 여자재킷 패,108260,108260,0
2018-06-01,511265579,C021040,실내화,여름 여성운동화 스니커즈 키높이 웨지힐운동화,29000,29000,0
2018-06-01,1946008583,C012020,원피스,루즈핏 트렌치 코트,117220,117220,0
2018-06-01,1266573806,C011030,남자학생복,린넨 라이크 포켓 롤업 셔츠 남방 남자셔츠 남자남방,26160,26160,0
2018-06-01,1560533560,L012040,치약,메디안 치석케어 치약 120g x 9개/오리지널/화이트,10900,10900,0
2018-06-01,1536107414,E011050,책상,[블루밍홈] 심플H형입식책상/컴퓨터/사무용/학생/책장,39900,33300,-6600
2018-06-01,705828141,A021010,커피,카누 다크/마일드 미니 120T,18500,18500,0
2018-06-01,2058891862,F012050,의료측정기,케어센스2+ 혈당측정기 풀세트/시험지60+침210+솜100,20000,20000,0
2018-06-01,895834026,A019100,식초,청정원 고소한 마요네즈 (500g),4190,4190,0
2018-06-01,1010317828,E041070,밀폐용기,락앤락클래식직사각850ML(3P),12600,12600,0
2018-06-01,415042653,C011030,남자학생복,피쉬본 패턴 화이트셔츠 남방 남자남방 남성남방 긴팔,34610,34610,0
2018-06-01,800669593,C013050,운동복,M-5XL까지/긴바지/7부바지/5바지/트레이닝팬츠/운동복,13900,13900,0
2018-06-01,1619708538,A019100,식초,참소당 오므라이스소스0.9L 오믈렛 미트볼 햄버거소스,6500,6500,0
2018-06-01,1010317829,E041070,밀폐용기,락앤락클래식직사각1L(3P),12600,12600,0
2018-06-01,681115444,A015020,식용유,[CJ] 백설 포도씨유 900mlX2+카놀라유 900mlX3_식용유,19900,19900,0
2018-06-01,1422300936,A013010,갈치,제주 해바라기 은갈치 3호 팩당 400g x 4팩 깨끗한,202440,202440,0
2018-06-01,2045589204,E061040,부엌용세제,액큐 친환경 1종식기세척기고농축세제 유독물0% 린스,15000,14850,-150
2018-06-01,440291584,A013170,생선통조림,유동자연산골뱅이 140gX48개식품 식자재 골뱅이 유동,277900,236220,-41680
2018-06-01,713655777,L021030,가방,백팩 가방 학생 여성 여행용 배낭 꽃무늬 책가방 여행,13900,13900,0
2018-06-01,2127873483,A018090,잼,오뚜기)딸기쨈 300g x 5개 국산딸기 신선한 과일 알,24760,24760,0
2018-06-01,476493649,C013010,점퍼,MJ-995 ( 인기) 와펜워싱 청자켓 (FREE) 연청 남자청,45720,45720,0
2018-06-01,895775277,A022020,두유,[정식품]정식품 베지밀A 190ML,800,800,0
2018-06-01,38668034,A014030,치즈,크로네 모짜렐라치즈 1kg 2.5kg /무료배송/아이스망고,11200,11200,0
2018-06-01,1093309605,A011100,라면,(냉동)사조오양 대림선해물땡1kg,10530,10530,0
2018-06-01,1349462723,C021040,실내화,아디다스 운동화 듀라모 8 W 화이트 (CP8756),48000,48000,0
2018-06-01,2065938844,L012040,치약,EM풀라무 치약세트4개입/천연계면활성제/입냄새제거,17950,17950,0
2018-06-01,420733818,C012060,여자내의,클래식 망사패턴 H스커트 MQDAWS9030/ 미니멈,99000,87120,-11880
2018-06-01,494431149,A017080,무,온참 2018년산 무농약 아스파라거스_1kg /웰빙 채소,17900,17900,0
2018-06-01,891305649,C013010,점퍼,[포에버21]오간자 봄버 자켓/FOREVER21/점퍼/블루종,43900,21950,-21950
2018-06-01,246033500,E011010,장롱,원마인드비비시리즈5단서랍장와이드체스트수납장책상,25000,25000,0
2018-06-01,322916842,C011030,남자학생복,FSSF18004 롤업 스트라이프 셔츠 남자남방 남성용스트,22050,22050,0
2018-06-01,391925700,A019040,소금,나쵸치즈소스(리코스 3K) 나쵸치즈소스 식자재도매 업,37000,33300,-3700
2018-06-01,537190996,C011030,남자학생복,오투웜발열점퍼-A타입] 발열조끼 등산 낚시 야영,58600,58600,0
2018-06-01,1007221868,C012020,원피스,리스트 솔리드 심플 롱 트렌치코트_TWWBYH70080/ 리스트,139000,115370,-23630
2018-06-01,1318933678,E061060,살충제,사용하기 편한 바퀴벌레약 뉴다이아플러스 450g 지네,15610,15610,0
2018-06-01,1735333426,A017220,양파,대파분태(국산)300g/말린/파/대파/후레이크/육수/라면,12000,12000,0
2018-06-01,482805913,L012090,기초화장품,안나홀츠 주름개선 미백 기능성 아이크림 30 100g,16800,16800,0
2018-06-01,43380736,E031130,보온매트,특가 11%쿠폰할인 일월 M2 워셔블 전기매트 /세탁가능,50000,45600,-4400
2018-06-01,1337865145,C014020,유아복,그린애플/봄신상/유아점퍼/유아상하복/유아원피스,15900,15900,0
2018-06-01,701669453,E061050,청소용세제,닥터크린세스 실리콘 곰팡이게저제 화장실 욕실 청소,10000,9900,-100
2018-06-01,979178592,C021040,실내화,[아디다스오리지널스][New Originals] 스탠스미스_[CQ2201](인천점),65400,54570,-10830
2018-06-01,1502823130,C012040,여자학생복,수지네 빈티지 유니클로 브라운 다운 패딩조끼 여성 M,27030,27030,0
2018-06-01,954010145,A021020,차,[동서]동서 미떼 핫초코 마일드 10T*30G,5980,5980,0
2018-06-01,1283545536,F012050,의료측정기,*브라운 귀적외선체온계 IRT-6030 기본필터21개/굿Q,75260,70000,-5260
2018-06-01,208368916,L021030,가방,라코스테가방 롱스트랩 미디움 세로형 쇼퍼백 토트백,80000,76900,-3100
2018-06-01,1119138058,E031080,선풍기,홍진테크 히터/컨벡션히터/온도조절/타이머기능 SF-2000FV,44000,44000,0
2018-06-01,1119138057,E031080,선풍기,홍진테크 히터/컨벡션히터/온도조절기능 SF-2000CV,35500,35500,0
2018-06-01,1817193319,A017090,열무,두손애약초 건비트 230g,13000,13000,0
2018-06-01,79761162,C011030,남자학생복,공용_쿨기능 써머 후드짚업(PHX2TC1510)/ 폴햄,15000,12750,-2250
2018-06-01,957771467,A013060,게,P)참가자미(대/마리),12900,12900,0
2018-06-01,423525433,A011100,라면,납작당면(화미 1K)X10,70830,70830,0
2018-06-01,354496529,C013010,점퍼,[크로커다일레이디] 폴리점퍼 CL7SJP201 NC아울렛,199000,60000,-139000
2018-06-01,1262037173,C021020,구두,VA-132 남성구두 정장화 천연가죽 로퍼 남성신발 스니,62590,62590,0
2018-06-01,1936826565,C012040,여자학생복,봄신상 체크/긴팔/오버핏/커플룩/여성셔츠/남방,10900,9900,-1000
2018-06-01,1608260357,L021020,장신구,실버)더블 스틱 목걸이 은 실버 목걸이 주얼리 선물,20850,20850,0
2018-06-01,1280344282,A017170,풋고추,놀러와농장 친환경 건조수세미(150g) 1봉,13800,13800,0
2018-06-01,648091475,A019080,고추장,청매실고추장/잘되는맛집된장/해찬들/태양초고추장,14900,14900,0
2018-06-01,1819919295,A021010,커피,맥심 아이스 블랙커피 110T,10900,10900,0
2018-06-01,1385829162,A011160,빵,안흥찐빵마을 우리밀우리팥 수제 단호박찐빵 (500g 10,36920,36920,0
2018-06-01,1700582232,E021010,침구,직접생산 사계절 이불세트/침구세트/신학기 이불모음,29900,29900,0
2018-06-01,1600008604,C011030,남자학생복,반팔셔츠 30종 택일상품/ 루이까또즈(셔츠),26600,26600,0
2018-06-01,2017221707,I011030,사진기,[소니정품]DSC-RX100 M5/64G+배터리+가방/풀패키지ED,1190000,1093880,-96120
2018-06-01,934875168,L021030,가방,레노버 씽크패드 타거스ODM 서류가방 노트북가방,31800,29800,-2000
2018-06-01,371236637,A017040,양배추,말린 고추잎 100g,4290,4290,0
2018-06-01,758635907,E011060,의자,벤치의자/스툴의자/1인/2인/간이의자/보조/원목의자/,28900,28900,0
2018-06-01,2057605258,C013010,점퍼,아르크네 양털 무스탕 DM-4044-양털무스탕자켓 양털,102690,102690,0
2018-06-01,1286373484,C013020,티셔츠,[30% 패션쿠폰]신상 반팔티 무지 스트라이프 남자,8900,8900,0
2018-06-01,1373356895,C013020,티셔츠,[필골드] SL3004 빙하아일랜드 폴라 티셔츠,25800,25800,0
2018-06-01,1308329364,E011020,침대,[미즌하임] 모노폴리 원목 철재침대[SS] (매트리스제외),99000,97020,-1980
2018-06-01,532418202,C012040,여자학생복,교복치마 베이지 슬림치마 H라인 유니폼 교복 교복셔,35270,34220,-1050
2018-06-01,1438799921,E061060,살충제,인섹트원/모파리/천연해충퇴치제/에코존/내추럴에너미,14900,14900,0
2018-06-01,2020092630,C021040,실내화,편안함에 디자인을 더하다~운동화/키높이/단화/슬립온,12900,7900,-5000
2018-06-01,906309338,E011050,책상,1인~8인/접이식테이블/공부방/컴퓨터책상/이반가구21,48800,48800,0
2018-06-01,1250026918,L012040,치약,메디슨화이트 치아미백제 2주분,18900,17900,-1000
2018-06-01,1257126848,E031120,믹서,필립스 공식 정품 판매사/믹서기/믹서/필립스믹서기,38900,38900,0
2018-06-01,1029569031,C012060,여자내의,36인치까지/빅사이즈 스커트/데님치마/청치마,23900,23900,0
2018-06-01,1261027950,C012060,여자내의,[샤트렌]사이드벨티드 기본슬랙스_B4R2,17900,17010,-890
2018-06-01,283511487,C014020,유아복,미니쥬리 스판팬츠 유아레깅스 유아레깅스 유아바지,5690,5520,-170
2018-06-01,1355465965,A022040,기능성음료,파워에이드/포카리/게토레이/이온음료,15400,15400,0
2018-06-01,1010199599,A017300,미역,[1+1]동원김 16봉,13980,7990,-5990
2018-06-01,264638894,C012060,여자내의,[로코식스][로코식스] 티코 데님 스커트,26000,24700,-1300
2018-06-01,264638893,C012040,여자학생복,[트위]스모크 X블라우스,29700,27030,-2670
2018-06-01,1312422162,E031110,청소기,유니맥스 터보 싸이클론 유선 진공청소기 UVC-1718,37800,37800,0
2018-06-01,895770693,E061060,살충제,[헨켈]홈키파 수성에어졸 기획(500ML*2),8500,8500,0
2018-06-01,1995207018,C014010,아동복,싱글투버튼 유아정장 3종세트(0-24개월)203294,39900,35520,-4380
2018-06-01,1089619020,E031080,선풍기,신일산업 팬히터/석유난로/온풍기 SFH-C337MVP,314500,314500,0
2018-06-01,1519853394,C012030,여자상의,퍼플스완 달콤한 이야기 루즈핏 메이크 롱원피스,11900,11900,0
2018-06-01,1772326060,A011010,쌀,홍국쌀 2kg (1kgx2봉) 기능성쌀 홍국미,12900,12900,0
2018-06-01,598943469,A014030,치즈,파마산 블렌드 치즈가루 227g 12개,54200,54200,0
2018-06-01,784548408,A019060,된장,청정원 안심 생된장(500G),2980,2980,0
2018-06-01,985236696,A018010,초콜릿,롯데 크런키 3번들(34G*3),2400,2200,-200
2018-06-01,1564954222,A017300,미역,삼각김밥김세트(지퍼팩포장)100매(50매x2개)+삼각틀,9900,9900,0
2018-06-01,442423329,F012050,의료측정기,케어센스2 혈당계 시험지110장+침210+솜100+사은품,36600,36600,0
2018-06-01,183448369,A016040,포도,지리산 햇 산머루(냉동)5kg/10kg/토종산머루/산지직송,26800,26800,0
2018-06-01,2047071160,C011030,남자학생복,슬림 카라포인트 퍼피패턴 블루스카이 셔츠 남성남방,20190,20190,0
2018-06-01,1144209360,E041050,냄비,샤브샤브 복전골 낮은전골냄비20 22 24 26 28 30 32cm,12100,12100,0
2018-06-01,1115215454,I053040,기타문구,리얼 나뭇잎 접착식 포스트잇 점착메모지 접착메모지,3990,3990,0
2018-06-01,229842298,A022010,주스,자연은 감귤 외 11종(1.5LX3)+토마토or알로에 1펫증정,7900,7900,0
2018-06-01,507146800,C013050,운동복,모비스 크루저 루프백 차량용캠핑용품 자동차캠핑용품,272750,272750,0
2018-06-01,1342119985,C012040,여자학생복,수지네 일본 구제 퍼플패턴 베스트 여성 S 19-39,14950,14950,0
2018-06-01,1297203044,C012040,여자학생복,린넨지퍼조끼 린넨 마 조끼 박시 루즈 지퍼 vest,34800,34800,0
2018-06-01,1124328175,A013010,갈치,제주 해바라기 은갈치 특3호(팩당 500g x 4팩) 깨끗한,301800,292750,-9050
2018-06-01,481671110,E021020,커튼,세진아트 프리미엄 통풍 파리문발/투명발/현관문발/대나무발/비즈발/목각발/그림발/인,49700,49700,0
2018-06-01,604729864,A017280,김,세명 치자 통단무지 600g,2790,2790,0
2018-06-01,1116288246,C013010,점퍼,카모시스루집업/프린트집업/밀리터리집업/쉬폰집업,8900,8900,0
2018-06-01,891063383,A011040,보리쌀,미국 흰강낭콩2kg(500gX4봉)/캐나다산 검은강낭콩2kg,5900,5900,0
2018-06-01,1073208550,E011050,책상,나드레L형컴퓨터책상/컴퓨터책상/책상/학생책상/코너,79800,79800,0
2018-06-01,1221806928,C012060,여자내의,여성슬랙스 팬츠/빅사이즈/정장바지/부츠컷/스키니,29900,29900,0
2018-06-01,1242710316,C012040,여자학생복,[무료배송]DEB1238 배색 미니 포켓 조끼 802 니트베스,30410,30410,0
2018-06-01,550816699,G011070,자전거,GIFT 2018 삼천리 샘트라이크 800+ 유모차 세발자전거,166660,150000,-16660
2018-06-01,1154854420,E061030,전구,삼파장전구 형광등 램프 모음/스탠드램프/조명/전등/,900,900,0
2018-06-01,571746692,C011020,남자상의,블랙 체크 밍크털 코트 남성용코트 남성털코트 남성코,114550,114550,0
2018-06-01,208486162,C013050,운동복,PH 프리미엄 성에제거기 손잡이성에제거기 자동차성에제거 차량성에제거기 자동차성에,6930,6170,-760
2018-06-01,52539325,C013010,점퍼,[스탭키즈] 스탭키즈 배색매쉬안감바람막이 SIJA183P1 NC아울렛,25900,15900,-10000
2018-06-01,592735559,C013010,점퍼,MNC 봄신상/청자켓/데님자켓/바람막이/자켓/코트/남자,30000,26800,-3200
2018-06-01,1415652920,C021020,구두,[지오지아] 남성 정장화 스니커즈 16종 택1 AAW5AS1102DBR,46000,41400,-4600
2018-06-01,105759622,A013140,북어채,A++ 대관령 자연건조 황금빛 황태채 황태포 황태머리,9900,9900,0
2018-06-01,1999724977,A019020,참깨,검정깨가루 (한1K),24960,22220,-2740
2018-06-01,325074459,A017180,호박,건고추(호식이네 1k)X10 식자재 업소용식자재 대량구,154720,148540,-6180
2018-06-01,684412031,E031080,선풍기,상진 야외용 가스파티오히터 SJP-1003(사은품 방수커버),511900,511900,0
2018-06-01,1133558506,C013010,점퍼,리바이스 정품 71377-0592 청자켓 JEAN 레드탭 레드룹,89000,89000,0
2018-06-01,684412033,E031080,선풍기,홍진테크 바닥형 쿼츠히터 DES-903,21100,21100,0
2018-06-01,1011092521,F011150,건강기능식품,[네이처드림]맛있게 배부른 곤약젤리 깔라만시 150g x 10포,20000,9900,-10100
2018-06-01,1654279822,A019040,소금,구운소금 청정원 1k 천일염 신안소금 알칼리성소금,11330,11330,0
2018-06-01,750087014,A017280,김,초생강(적색 참존 1.2k)X10,33110,33110,0
2018-06-01,1159533652,C012060,여자내의,[르샵]허리 벨트 통바지 (LI5PT586)(광주신세계),49000,39790,-9210
2018-06-01,1353120685,F012050,의료측정기,(NEW)서흥 전자동혈압계 혈압측정기 혈압기 고혈압,39800,39800,0
2018-06-01,1608259396,L021020,장신구,실버)2mm 샤론 볼 체인 목걸이 주얼리 악세사리 기념,15690,15690,0
2018-06-01,1290942915,A013060,게,정직한수산 국내산 손질오징어 200g 금징어/동태/대구,2900,2900,0
2018-06-01,1810868653,C013020,티셔츠,[온더리버]여름신상 전상품 5900원 균일가!,5900,5900,0
2018-06-01,656290887,E061030,전구,필립스 적외선램프 적외선전구 100w 150w 250w 조사기,4150,4150,0
2018-06-01,1556914801,C014010,아동복,유아 아동 여아 여름 공주 캐주얼 원피스 스커트 바지,34000,34000,0
2018-06-01,1387699051,C011030,남자학생복,AG 빅사이즈 바투스 청남방 BW 남성용데님셔츠 데님셔,73840,73840,0
2018-06-01,1473051470,E061010,세탁세제,아스타 빨래판 전용볼 손빨래 입식 씽크대 인테리어,402810,402810,0
2018-06-01,618179595,C013050,운동복,자동차/경광봉/안전/투톤멀티경광봉/안전봉,4500,4140,-360
2018-06-01,895769674,A011090,국수,[삼양]삼양 열무 비빔면 멀티(130G*5입)*8봉지,31920,31920,0
2018-06-01,1861906644,C013040,청바지,[게스]남성 그레이 스키니(MI1D5060),117600,99960,-17640
2018-06-01,895769669,A011090,국수,[삼양]삼양라면 120G*5+1입 증정입고,3300,3090,-210
2018-06-01,1085086798,E031010,전기밥솥,[리홈쿠첸] 정품 열판밥솥/IH압력밥솥 고무패킹 13종,5430,5110,-320
2018-06-01,693131341,C012060,여자내의,[르샵]린넨 반바지 (LI4PT580)(강남점),49000,43730,-5270
2018-06-01,1597088788,F011130,홍삼,정관장 올칸(650MG*120정),200000,200000,0
2018-06-01,2069361079,C011030,남자학생복,[올젠] 남성 미니 깅엄체크 반소매 셔츠 남방 ZRY2WC1303,30000,24000,-6000
2018-06-01,1762700513,A018070,파이,수박통통 초코파이 아이들어른사무실간식 디저트 12개,6000,6000,0
2018-06-01,957771495,A018060,스낵과자,[롯데]롯데 빈츠 204G,3890,3290,-600
2018-06-01,2051250775,C013010,점퍼,[푸마] (사이즈 : M(95)) 아스널 컵 롱 벤치 자켓,206530,206530,0
2018-06-01,901547237,C013010,점퍼,바람막이 옷 수선 접착 테이프 패치 패딩 여자 점퍼,9000,9000,0
2018-06-01,989916392,C012040,여자학생복,[에이인][에이인]dress down cardigan,72450,65210,-7240
2018-06-01,1522669496,I053040,기타문구,3M 포스트잇 월 패드 대형포스트잇 큰포스트잇,64700,64700,0
2018-06-01,1339760593,I031010,장난감,뽀로로 목욕 분수놀이 / 목욕장난감 물놀이 목욕놀이,11350,11350,0
2018-06-01,394053622,C011020,남자상의,[세컨에디션] 캐주얼 남성정장/자켓/슬랙스/정장세트,43900,43900,0
2018-06-01,2104382065,C012030,여자상의,여성 바네사 양V넥 뒷트임 원피스V넥 니트니트골지니,48320,48320,0
2018-06-01,1141444746,C013010,점퍼,[인디안][인디안(INDIAN)]지퍼장식심플하이넥집업점퍼_MITCLQM3221_56,36300,34490,-1810
2018-06-01,1088020411,A017220,양파,대파분태(중국산) 1kg/말린/건조/대파/파/분태/후레이크/분말/가루/생식/선식/천연/조,16800,16800,0
2018-06-01,2073917579,A011160,빵,참맛안흥찐빵 50개입/호빵/감자떡/찰보리찜떡,9900,9900,0
2018-06-01,984366000,A019090,카레,농심 하우스 바몬드카레 약간매운맛 115G,3150,3150,0
2018-06-01,1764761191,A017250,고사리,동결건조 건강한 유기농 브로콜리 분말 가루 60g 3개,33480,33480,0
2018-06-01,818285062,E011020,침대,(홈잡스) 저상형침대/싱글~퀸 매트리스포함,100000,88900,-11100
2018-06-01,1991699096,C011030,남자학생복,(SR)KHM768-770 남성빅사이즈차이나ST긴팔남방셔츠 큰,63950,63950,0
2018-06-01,309358677,C011030,남자학생복,[레노마셔츠] 한여름 시원한 아사원단 긴소매일반핏 RILSG0-050-WH,30000,24900,-5100
2018-06-01,1594438235,L021020,장신구,원석sale/0.8캐럿 천연에메랄드/반지목걸이에 세팅,64000,64000,0
2018-06-01,259171285,A017080,무,2017 제주도산지 햇 백년초열매3kg/5kg/환/줄기/분말,17900,17900,0
2018-06-01,1197797186,A013070,굴,도매 냉동 라운드 숫꽃게 실중량 4.5KG,39000,39000,0
2018-06-01,961311702,A018040,아이스크림,부라보콘 10개,12000,7000,-5000
2018-06-01,1453519948,L021060,유모차,** NEW 키루스 프리미엄** 등받이5단 조절+종아리시트,75000,52500,-22500
2018-06-01,1142961479,C011020,남자상의,버버리 포코노원단 허리밸티드 사파리 점퍼/니폰필사요나라,790000,790000,0
2018-06-01,305734697,F012010,종이기저귀,신생아 기저귀 팸퍼스 스와들러 1단계 20p X 3팩 할인,30500,30500,0
2018-06-01,2008472057,C013020,티셔츠,반폴라 스튜디오 티셔츠 남아폴라티 긴팔폴라티 긴팔,10530,10530,0
2018-06-01,1599609393,I031040,생화,1+1 페어아일 팔걸이 캠핑의자 2p/캠핑용품/낚시의자,28900,26590,-2310
2018-06-01,2047553619,C013050,운동복,자동차/사이드포켓/틈새/수납/콘솔박스/정리함,9800,9800,0
2018-06-01,456301702,C013020,티셔츠,[지니골프] 여름자외선차단티 여름여성골프웨어,39900,39900,0
2018-06-01,416083413,C012040,여자학생복,입새 여자 롱셔츠 KD 여자셔츠 롱셔츠 여성셔츠 셔츠,59470,58290,-1180
2018-06-01,1064129166,A022010,주스,와일드/와이드/망고분말//망고가루/망고주스/망고씨드,19900,19900,0
2018-06-01,1753531167,L021060,유모차,예꼬맘 쿨한 유모차 선풍기 플러스UP 휴대폰&USB겸용 사은품3종증정,15550,15550,0
2018-06-01,1580022550,A018060,스낵과자,Enaak 게메즈 에낙 라면과자 30gX24봉/라면땅,9490,9490,0
2018-06-01,61462303,A021010,커피,[당일출고/무료배송]맥심 아이스블랙 200T+아이스보틀,20900,20900,0
2018-06-01,386425428,C021020,구두,로하 샌들 LKR2722 여자샌들 여성샌들(YA02004),58200,54710,-3490
2018-06-01,149407343,E011030,거실장,(아이잠)해피 800 3단서랍통,116000,116000,0
2018-06-01,1169570474,A018110,물엿,[오뚜기] 오뚜기 옛날 물엿 5kg /유통기한2020년2월1일이상,7300,7300,0
2018-06-01,338052447,E031130,보온매트,한일의료기 한일꽂잠 온열매트 더블 전기장판 전기매,145000,143550,-1450
2018-06-01,416977265,E011050,책상,MT101-M 높이조절 워크스테이션 블랙 높이조절책상/,630150,630150,0
2018-06-01,14035601,A017170,풋고추,2018년 경남 합천 가시오이 - 보통/상/특 - 10kg,17500,17500,0
2018-06-01,1093401296,E011030,거실장,[채우리] 레인 접이식 소파베드,275000,275000,0
2018-06-01,1230540111,A016040,포도,동원)황도 슬라이스 400g x 12개 사시사철 맛있는,41360,41360,0
2018-06-01,2006502737,A011030,찹쌀,군산 흰찰쌀보리4kg/흰찰보리/찰보리,12800,12800,0
2018-06-01,1093401294,E011030,거실장,[채우리] 에바 접이식 소파베드,350000,350000,0
2018-06-01,749341844,E011070,식탁,로뎀나무 아카시아 원목식탁/원목테이블/책상,129000,124000,-5000
2018-06-01,256820968,C012020,원피스,루즈핏타탄체크자켓(N181XSF004)/ 나이스클랍,179500,161550,-17950
2018-06-01,1305695242,C013010,점퍼,[트레직스][트레직스] 노카라 점퍼,49000,46550,-2450
2018-06-01,392844419,A019040,소금,마늘가루(신영 500g)X12 마늘가루 김치 식자재 업소용,259890,233910,-25980
2018-06-01,1397484286,C011050,남자내의,마운틴벨리 1+1찬스 여름 남성 기본A형 등산팬츠 B003 (일상/등산/나들이까지OK!)/ 마,25900,24610,-1290
2018-06-01,371824369,A021020,차,롯데 칸타타 헤이즐넛향 원두커피 600g(분쇄형) 분쇄,34600,34600,0
2018-06-01,2083097878,C021010,아동화,[아디다스키즈][adidas kids]포타런 엑스 쿨 CFI(CM8242)(본점),49000,42780,-6220
2018-06-01,1451517699,A013090,전복,[유진수산] 백합조개 / 시원한 조개탕  조개칼국수  해물탕,7430,7430,0
2018-06-01,106639661,A017230,마늘,(무안군 위더스) HACCP 빨간양파즙 양배추즙1+1(총60),20900,20900,0
2018-06-01,861933598,C013020,티셔츠,긴팔티/긴팔라운드/반팔티/반팔라그랑티/반팔무지티/긴팔라운드티/긴팔무지티/단체티/,1000,1000,0
2018-06-01,1608260322,L021020,장신구,실버)다빈치 럭스 큐빅 목걸이 20대 30대 여자 여성,28080,28080,0
2018-06-01,1353829840,A017250,고사리,온참 2018년산 무농약 아스파라거스 _2kg /국내산,33900,33900,0
2018-06-01,1451943195,F012050,의료측정기,[녹십자MS] 자동전자 피트커프 혈압측정기 650A 간편커프 혈압계,85000,85000,0
2018-06-01,758670294,I031040,생화,초특가 캠핑용품 소품/스토퍼 단조팩 랜턴걸이 망치,1000,640,-360
2018-06-01,1198973425,C012040,여자학생복,반에이크 VA86CDM402 기본 롱 슬리브 가디건,19800,18810,-990
2018-06-01,300142446,E021010,침구,국내산 순면 요 이불 세트 차렵이불+요커버요솜풀세트,69800,69800,0
2018-06-01,1021546034,A013050,오징어,동원 꽁치캔 (400g) x4,11780,11780,0
2018-06-01,1798664615,A011180,파스타면,garofalo 펜네 500gx6개,12400,12400,0
2018-06-01,510857716,E061050,청소용세제,버블윅/그린 뚜러펑 2L 6개/1L 12개/중 선택,9900,9900,0
2018-06-01,216408802,C013020,티셔츠,맥블랙 18S/S신상 ~5XL 빅사이즈 프린팅긴팔티 52TYPE,10900,10900,0
2018-06-01,902189636,E021010,침구,무더운 여름엔 시어서커 여름이불+패드+베개/토퍼세트,39900,39900,0
2018-06-01,1212030356,L012010,면도기,도루코 이중날 일회용면도기 100P 박스,32050,28530,-3520
2018-06-01,1706645341,F011150,건강기능식품,[큐원] 상쾌환 3gx 20포 /숙취해소제/최신제조품/우체국택배,29900,29900,0
2018-06-01,2037454040,A018100,꿀,100% 천연 지리산 아카시아 벌꿀(유리병벌꿀) 2.4kg,40000,38000,-2000
2018-06-01,870170374,A017250,고사리,랜시 냉동 콜리플라워 1kg(1kgx1ea)/냉동야채,7000,5950,-1050
2018-06-01,1385830115,A011160,빵,안흥찐빵마을 수제 찐빵 500g(10입) 2봉 애플찐빵 간,25370,25370,0
2018-06-01,1303197834,C013030,스웨터,골지 반폴라 티셔츠 MRO라운드티티셔츠긴팔티니트겨울,54700,54700,0
2018-06-01,738026635,A019050,간장,타마고간장300ml/간장계란밥/계란에 뿌리는소스,6190,6190,0
2018-06-01,806326542,A014020,분유,아이배냇 순 산양분유 4단계 800g 3캔,88500,88500,0
2018-06-01,92248786,C013010,점퍼,여름 후드집업 남자 남성 점퍼 자켓 무지 티 기모,24800,24800,0
2018-06-01,985415378,E061070,가정용비닐용품,롯데지퍼백(소)1+1(알뜰형),1990,1990,0
2018-06-01,2070099478,C013020,티셔츠,베이직 후드티 LTT0036 여성티셔츠 여성후드티 / 참고,30400,25840,-4560
2018-06-01,985415379,E061070,가정용비닐용품,롯데 위생백(중) 1+1 (알뜰형),2490,2490,0
2018-06-01,1550971576,A012010,국산쇠고기,와우한우구이1+이상/등심/채끝/치마/살치/안심/500g,32600,32600,0
2018-06-01,2009631828,C012020,원피스,말표구두약 이코노 갈색 40g,5970,5740,-230
2018-06-01,551774116,C013050,운동복,포드 익스플로러 2018 올트렁크매트 5D 6D 고급형 차,168000,154560,-13440
2018-06-01,1122353529,E031120,믹서,[SK매직] Magic 다용도 미니믹서기 MCH-B608 (컵4개/칼날2종),29680,27900,-1780
2018-06-01,298021195,L021030,가방,KINMAC 무스탕 노트북파우치 가방 13.3 15.6인치10~17,9800,9800,0
2018-06-01,981662893,A019080,고추장,해찬들 수라상에 올리던 약고추장(120G),2990,2990,0
2018-06-01,1571443559,C011030,남자학생복,[TATE]오프숄더밴딩블라우스KA8U4-WRC110,47920,36420,-11500
2018-06-01,537301104,A018100,꿀,뉴질랜드 타히 UMF10+ 마누카꿀 400g 야생화꿀 벌꿀,118000,116820,-1180
2018-06-01,756652860,I053020,스케치북,파브리아노 워터칼라 스케치북 모음 /수채화지,10500,10500,0
2018-06-01,1687671132,L021060,유모차,(베렝구어)리틀큐티스 쌍둥이 유모차No.16982,81980,81980,0
2018-06-01,41143645,E011050,책상,[블루밍홈] 베이직책상40/테이블/사무용/학생/컴퓨터,30900,26910,-3990
2018-06-01,1550458218,E041070,밀폐용기,[보르미올리]스테지오니/콰트로/보뜰레/드링크자,1400,1110,-290
2018-06-01,1010344954,A013020,명태,영광 법성포 황토굴비 특선 2호,85000,75000,-10000
2018-06-01,1951607495,A011170,떡,금성 떡국 쌀떡 떡국떡 3kg,7630,7630,0
2018-06-01,208523670,I011030,사진기,출시이벤트 사은품증정 캐논정품 EOS M50 15-45 DKS,868000,798560,-69440
2018-06-01,324139614,A013140,북어채,신선한 황금 황태채 1kg 황태 명태포,21500,21500,0
2018-06-01,564772564,C013040,청바지,아둘 NEW YORK 쥬니어 기모 후드 양키 상하세트 29,31900,31900,0
2018-06-01,2079993107,C021040,실내화,리복 정품 BS8390 아하리 러너,41900,41900,0
2018-06-01,1059277296,A013070,굴,두레생협 손질꽃게(500g) 손질꽃게 튀김용손질꽃게 튀,52070,52070,0
2018-06-01,1438917706,C012030,여자상의,+봄신상 롱원피스+빅사이즈77-99 니트/터틀,27800,27800,0
2018-06-01,409258527,C013010,점퍼,[블랙야크키즈]2018년 신상품 BK홉킨스 자켓(대구신세계),45000,37110,-7890
2018-06-01,2139873089,C013010,점퍼,아디다스 유소년 콘디보16 스타디움자켓 (AB3152 ),151850,135150,-16700
2018-06-01,1286023267,A014010,우유,서울우유200ml X 24팩/1000ml X 10팩,11640,11640,0
2018-06-01,1457815628,A018100,꿀,잡화꿀 (다드림 2K),30360,27030,-3330
2018-06-01,599073456,E011040,소파,상일리베가구 리브 패브릭 소파 시리즈,107380,107380,0
2018-06-01,1317230910,C013040,청바지,핑크돼지 여성슬림융털트레이닝 운동복 겨울트레이닝,25580,25580,0
2018-06-01,522021082,A019050,간장,[샘표] 샘표 양조간장 501 15L,49500,49500,0
2018-06-01,1506083667,C011050,남자내의,남성 여름 냉장고바지 21종 빅사이즈 포함 아이스팬츠,5900,5900,0
2018-06-01,959466669,A014040,발효유,파스퇴르 오직우유100% 요구르트 플레인 (500ML),3200,3200,0
2018-06-01,1557490801,A013130,오징어채,정화 진미오징어 전기 50gx5.,27440,24430,-3010
2018-06-01,1387550306,C013010,점퍼,나이키 드라이 스쿼드 SDF 후드 자켓(832236-452) 남,259230,259230,0
2018-06-01,180916801,E051030,디지털도어록,[자가설치] 삼성 푸시풀 도어락 SHP-DP710/카드키2개,200000,180000,-20000
2018-06-01,1011177990,A016150,아몬드,구운아몬드 800G/봉,14990,14990,0
2018-06-01,1497239248,A017170,풋고추,햇 무우 18년산 전라도 햇 무 18kg 산지직송 햇무,15900,15900,0
2018-06-01,1619368182,L021030,가방,태블릿 가방 노트북 넷북 파우치 케이스,12900,12900,0
2018-06-01,399097188,C012060,여자내의,[메이드제이] A라인 기본 청치마바지 (3color/5size),15800,15800,0
2018-06-01,1033191795,I053030,복사용지,HP A4 복사용지(A4용지) 70g 2BOX/더블에이,34760,29900,-4860
2018-06-01,1468198418,C013010,점퍼,캡스록 여성 초경량 바람막이 자켓(CSR-4017) 여성점,34390,34390,0
2018-06-01,654571999,L012090,기초화장품,1+1/대용량/이니스프리 슈퍼푸드 블루베리 스킨/무배,14300,14300,0
2018-06-01,382320247,A017080,무,건두부 음식재료 중국식품 1kg (5묶음판매),6000,6000,0
2018-06-01,1373320920,L012060,샴푸,아모스샴푸녹차실감퓨어스마트컬링2x에센스비듬쿨탈모,18900,18900,0
2018-06-01,1262723315,A013090,전복,조개 동죽/바지락/월남게/갯가재/갑오징어/물김,14900,14900,0
2018-06-01,1453772673,E011050,책상,[프리마]105독서실책상/입식/5칼라선택가능/DIY,38400,38400,0
2018-06-01,1951607590,A011170,떡,금성 떡국 쌀떡 떡국떡 1.4kg,3870,3870,0
2018-06-01,2091791103,L012040,치약,NEW/시린메드 에프 125gX5개 /잇몸케어/부광탁스,24500,24500,0
2018-06-01,1414752593,F012010,종이기저귀,리베로 기저귀/팬티형 7단계36매x4팩+무티슈70매,69900,69900,0
2018-06-01,2074214226,E011040,소파,지지독 특별세일가/프린스 유라인 쇼파 시리즈csp704,99800,99800,0
2018-06-01,1275324726,L021010,손목시계,전자 패션 손목 시계 마라톤 군인 밀리터리 스포츠,7850,7850,0
2018-06-01,2069265205,C013020,티셔츠,베이직 후드티 LTT0036 여성티셔츠 여성후드티(YA0200,32100,28250,-3850
2018-06-01,417842938,C013020,티셔츠,T1322-브이넥 반소매 슬라브 티셔츠 브이넥반팔티 반,12620,12620,0
2018-06-01,380528011,A011010,쌀,가바현미증정! 알차고 실하다! 영미 추청 쌀 10kg,25500,25500,0
2018-06-01,572633723,C014020,유아복,[트윈키즈]트윌칼구제5부팬츠 (M7MB9P05),15900,10340,-5560
2018-06-01,1991699123,C011030,남자학생복,(SR)KHM749-751 남성빅사이즈버튼카라긴팔남방셔츠 큰,62500,62500,0
2018-06-01,516481126,C013010,점퍼,로또 주니어 아동용 오리털 다운 자켓 파격할인 특가,18900,18900,0
2018-06-01,2002927942,A011050,콩,산과들에 국산/수입 볶음 우유 커피 찹쌀땅콩 등 14종,2500,2500,0
2018-06-01,1389202573,A018090,잼,트라피스트수녀원 유기무화과잼 410g 무화과잼 과일,17590,17590,0
2018-06-01,1011177960,E041070,밀폐용기,PET)투명사각과실주병12L,8000,8000,0
2018-06-01,1011177961,E041070,밀폐용기,PET)투명사각과실주병8L,5500,5500,0
2018-06-01,493386676,C013010,점퍼,포켓 스트링 롱 점퍼_M75JPM211Z/ 미센스(여성의류),42000,33600,-8400
2018-06-01,961311671,A018040,아이스크림,하겐다즈 샌드 녹차3개 + 리치몬드 2개,11700,11700,0
2018-06-01,895745707,A013170,생선통조림,[동원]동원 고추참치 150g*3입,7750,7750,0
2018-06-01,1294917202,E061060,살충제,강력한 연쇄살충 효과 바퀴약 크린베이트플러스 200g,19770,19770,0
2018-06-01,1922804241,E011050,책상,프린터책상/복합기책상/보조책상/컴퓨터책상/테이블,50000,45900,-4100
2018-06-01,274837820,L021050,우산,무료배송 고급 대형장우산 8종/골프/의전용장우산,7900,7900,0
2018-06-01,1469725155,E061010,세탁세제,애경산업 스파크 11kgx2개 (총20kg) 11kg 대용량 P,23900,23900,0
2018-06-01,325561515,C012060,여자내의,셋업 얼발란스 페플럼 스커트(SK-2868)/ 나인(NAIN),49000,46550,-2450
2018-06-01,349136370,C012060,여자내의,탑텐 (MSY2PP1904) 남성 코튼린넨 하프밴드 팬츠,29900,27510,-2390
2018-06-01,214787801,A022040,기능성음료,포카리스웨트 500ml x 20펫트 이온음료,19900,19900,0
2018-06-01,1047857040,L021010,손목시계,로제타 메탈 손목시계 FW-13 이쁜시계 패션시계 티켓,17200,17200,0
2018-06-01,640620468,A018010,초콜릿,허쉬초콜릿 쿠키앤크림 100gX4개 자이언트 허쉬초콜렛,13700,10900,-2800
2018-06-01,1215805005,C013040,청바지,[행텐주니어](행텐주니어)여아롤업3부청바지 _14120-156-407-10_평촌점,12000,12000,0
2018-06-01,510621197,F012010,종이기저귀,하기스 네이처메이드 기저귀 밴드형3팩/팬티형2팩 구성택일,53400,53400,0
2018-06-01,534295222,C012040,여자학생복,[루코루코]17-371 블라우스 2color(RSC4BL013),24000,22800,-1200
2018-06-01,50689402,A014030,치즈,썬리치 자연99 모짜렐라 치즈 2.5kg/피자치즈/썬리취,22750,21750,-1000
2018-06-01,538041997,C012030,여자상의,빅사이즈 DWB1572 루단 쉬폰 원피스 803S 빅사이즈 여,63640,63640,0
2018-06-01,386041496,I031040,생화,도날드-5 낚시 레저의자 앞 뒤다리 상하조절기능/캠핑,61630,61630,0
2018-06-01,895745711,A013170,생선통조림,[동원]동원 고등어 400G,2990,2990,0
2018-06-01,684341214,A017040,양배추,건작두콩 국내산 잘말린 슬라이스 300g 빛고을장터,16000,16000,0
2018-06-01,620372183,L021020,장신구,스와로브스키스톤 귀걸이 이어링 귀고리 은침 유색보석 비즈 실버 패션귀걸이 악세사리,9800,9510,-290
2018-06-01,1026905663,I031070,애완동물관리비,[아리몰]당구공/큐대/당구대/포켓볼/4구 3구당구공,11900,11900,0
2018-06-01,402176457,C014010,아동복,아디다스키즈 주니어 칠부팬츠 반바지-CF7151,34000,34000,0
2018-06-01,956783561,A016050,밤,밤(500G/봉),3990,3990,0
2018-06-01,193674977,E041010,식기,[순금 학 수저 5벌-우단케이스] 스푼세트 수저세트 숟가락세트 부부수저세트 예쁜수저,78300,77200,-1100
2018-06-01,774213956,A013070,굴,(맛나)박스/절단꽃게(3L)*12팩,64100,57690,-6410
2018-06-01,630500873,C011050,남자내의,[컨셉원]남성 라이트 웨이트 쿨 울 슬랙스 10118501[갤러리아],79800,61450,-18350
2018-06-01,1424248839,E061060,살충제,살충제 파비 바퀴벌레 옴진드기 좀약 거미 지네,35000,35000,0
2018-06-01,764787123,E031130,보온매트,일월 극세사 전기방석 1인용 /전기방석/겨울방석,18600,18600,0
2018-06-01,764787124,E031130,보온매트,일월 극세사 전기방석 2인용(1인 의자용) /전기방석/겨울방석,27800,27800,0
2018-06-01,1298033899,C013030,스웨터,MNT-054 세미클래식 왕꽈배기 라운드 니트 니트티 남,49700,49700,0
2018-06-01,500791554,C013040,청바지,힙허거 벨트대용 헐리웃패션시크릿 허리사이즈조절기능서스펜더 멜빵 청바지허리조절기,13500,13500,0
2018-06-01,2112605994,A022010,주스,델몬트 오리지널 알로에1.5Lx12펫 펫음료 알로에음,44110,44110,0
2018-06-01,411005171,C012030,여자상의,KD 빈스 단가라 롱니트 루즈핏원피스 니트롱원피스 단,84010,84010,0
2018-06-01,790929034,C013040,청바지,[인디고뱅크키즈]경량 5부 워싱 데님 IKTH17F06,14900,14900,0
2018-06-01,439637332,A021020,차,(무)동서 식물성크림 프리마1kgX12개식물성크림 동서,101000,88880,-12120
2018-06-01,1418152058,A013070,굴,붉은대게살/붉은대게모듬살/홍게/홍게파살,13300,13300,0
2018-06-01,1084859647,L012060,샴푸,올뉴TS샴푸 500ml/100ml/탈모샴푸/뉴프리미엄,21400,21400,0
2018-06-01,367646007,C013040,청바지,[버블트리]~23호/여아/가디건/티셔츠/아동/유아,19800,19800,0
2018-06-01,264732078,C013040,청바지,생지느낌 그대로 팬츠 SXL 흑청 DP279 데님스키니 남,24480,24480,0
2018-06-01,1084762012,E031010,전기밥솥,CRP-N0680SR/쿠쿠/압력/6인용/비음성/GH,106200,97520,-8680
2018-06-01,365796054,E031070,에어컨,[포시엠] 포시엠 12단 조절 DC 음이온 벽걸이 선풍기 CM-216DC,69000,69000,0
2018-06-01,1159930741,A017200,토마토,푸른채-2018년 국내산 햇 가지(특) 2kg 한정특가판매,9900,9900,0
2018-06-01,2084156613,C012060,여자내의,목각 오링 왕골백- 왕골가방 목각오링가방 숄더왕골가,54700,48140,-6560
2018-06-01,1446122219,E011030,거실장,가온리빙 천연무늬목/거실장/TV다이/티비다이/장식장,155000,146300,-8700
2018-06-01,165120906,E021010,침구,올리비아데코 순면 이불커버/매트커버 22종,17900,17900,0
2018-06-01,880497938,A012050,소시지,(최저가) 천하장사Q 150개특가/키스틱 40개/소세지,13900,13900,0
2018-06-01,632962046,C011030,남자학생복,덕다운 빅사이즈 패딩점퍼 LM202,174490,167520,-6970
2018-06-01,1903834172,L012040,치약,(CMIT/MIT 無) 프리미엄 덴티스테 전상품 골라담기,5900,5300,-600
2018-06-01,1381636599,C011030,남자학생복,[마인드브릿지]남성 오픈카라 세미오버셔츠 MSWS3151,49900,40420,-9480
2018-06-01,1090466215,C011030,남자학생복,[디바옴므]TOM 라이트 경량 베스트_6883_M8060_1,25800,22710,-3090
2018-06-01,1951181178,E061030,전구,일월조명/갓등/청갓/쉐도우갓/확산갓/다이야갓/12 14 16 /조명/간판등/써치등/전등,14000,14000,0
2018-06-01,879362594,A019060,된장,[청정원]순창콩된장900g사각,7310,7310,0
2018-06-01,879362593,A019060,된장,[청정원]순창콩된장450g사각,3800,3800,0
2018-06-01,1010319970,A013020,명태,[수협] 가을장대 굴비세트 2.4kg (2두름/40마리),75900,61500,-14400
2018-06-01,563920383,C013050,운동복,굿모닝 차량용 앞유리커버(외부차단형)/성에방지커버/햇빛가리개/블랙박스용-별매/자동,8000,7360,-640
2018-06-01,879362592,A019080,고추장,[청정원]순창떡볶이고추장300g,4700,4700,0
2018-06-01,879362596,A019060,된장,[청정원]순창조개멸치된장900g,9880,9880,0
2018-06-01,879362595,A019060,된장,[청정원]순창조개멸치된장450g,5350,5350,0
2018-06-01,1024677693,A012040,닭고기,[베스틱]닭가슴살 소시지 꼬치형 외11종 1팩구성/훈제,1490,1490,0
2018-06-01,1894104594,A017090,열무,[e-fresh] 아삭아삭 콜라비 4개 / 개당 500g 내외,10900,10530,-370
2018-06-01,1342974984,E011060,의자,베스트리빙 캘빈의자 1+1/식탁의자/원목의자,54900,54900,0
2018-06-01,1709961582,C012040,여자학생복,[디어제인][디어제인]박스트임롱셔츠M4343,10900,10360,-540
2018-06-01,1059300175,A013090,전복,두레생협 생홍합살(300g 국산) 탕용홍합 생홍합살 요,25600,25600,0
2018-06-01,898483531,A018090,잼,복음자리 딸기쨈 (380G),4790,4790,0
2018-06-01,1235267406,C011020,남자상의,MJ_1132 블루 래글런코트 남성코트 겨울잠바 겨울코트,93080,93080,0
2018-06-01,989106707,E041060,수저,테팔인지니오국자,9900,9900,0
2018-06-01,677012477,I031010,장난감,굿베이비 전동오토바이(21352),173130,173130,0
2018-06-01,518914220,A016030,복숭아,경북 김천 하우스자두 1.5kg 1박스 [25과내],43900,42410,-1490
2018-06-01,1010319967,A013050,오징어,[선물세트][1+1 하나 더!] 안동간고등어 14마리+14마리+사은품 2마리 더(손당 350g),51900,43900,-8000
2018-06-01,1010319968,A013020,명태,[우등국화굴비]법성포 영광굴비 장줄 5호(1.6kg이상  18-20cm  20미),71900,59300,-12600
2018-06-01,2062990469,E061030,전구,직관 형광등 32W 삼파장 전구 오스람 번개표 필립스,30000,30000,0
2018-06-01,961311639,A018040,아이스크림,하겐다즈 미니컵 3개 + 리치몬드 2개,11700,11700,0
2018-06-01,846910302,I011030,사진기,캐논공식총판 정품 익서스 IXUS 185 + 케이스 디카,110000,105600,-4400
2018-06-01,1280104502,C012060,여자내의,S M L XL/구김없는린넨워싱 트리린넨밴딩팬츠/M4483/ 디어제인,10900,10140,-760
2018-06-01,2084587019,C011030,남자학생복,B칸쿤B 여름가디건/남자수영복/커플비치웨어/반바지,9900,9900,0
2018-06-01,1695172334,L021020,장신구,(실버) 오팔 쉐도우 목걸이,24280,24280,0
2018-06-01,238841059,C015020,모자,(COLOR : 브라운) MC-019 투버튼 포인트 군,12740,12740,0
2018-06-01,816205349,I011030,사진기,소니 최소형 광학30배줌 DSC-WX500 /공식대리점,399000,367080,-31920
2018-06-01,1011153991,A018090,잼,청우 훼미리통팥빙수 850G,6980,5990,-990
2018-06-01,1047050999,C012060,여자내의,휘트니스 스포츠레깅스 SD-5955 레깅스 운동복 피트니스 요가 쫄바지,10300,9170,-1130
2018-06-01,1159903157,E031120,믹서,[신일산업] 신일 대형 대용량 4L 티타늄 믹서기 SMX-6500JS,100000,98500,-1500
2018-06-01,507030121,A012030,돼지고기,듀팜 친환경 암돼지 1등급이상 냉장육 부위별 300g,8360,8360,0
2018-06-01,1356066066,C013050,운동복,에어워크 스판츄리닝세트/츄리닝/운동복/단체복,49800,48800,-1000
2018-06-01,1475179679,C013050,운동복,후드집업/치마바지/요가복/요가바지/트레이닝복세트,18900,18900,0
2018-06-01,672876650,A012060,햄및베이컨,[사조] 런천미트 200g 10캔 묶음,16800,16800,0
2018-06-01,1397518089,A013080,조개,두레생협 농어스테이크(300g/자연산) 농어스테이크 농,32210,31570,-640
2018-06-01,1095873514,E021020,커튼,/롤러블라인드 그레이 스콕스클뢰베르 140x195 cm/ 블,78720,70070,-8650
2018-06-01,395449451,C013020,티셔츠,콜핑 MD추천 봄 긴팔티셔츠 균일 23종,8500,8500,0
2018-06-01,976204263,C013020,티셔츠,여자 빅사이즈 나시티 L~3XL 까지 민소매 나시 빅나시,3900,3900,0
2018-06-01,680461669,F012050,의료측정기,오므론 프리미엄 자동혈압계 HEM-7322 (아답터 포함),134500,125000,-9500
2018-06-01,1065697410,G022020,자동차타이어,넥센타이어 고급형 CP672 225/55R18 정품 무료배송,77500,65450,-12050
2018-06-01,1064036876,C021040,실내화,나이키 플렉스 2017 RN 898457-001,62000,62000,0
2018-06-01,836658598,C011030,남자학생복,2XL~4XL빅사이즈 정장셔츠/반팔남방/큰옷/체크/드레스,22700,22700,0
2018-06-01,745188680,A015010,참기름,업소용 참기름 1.8L 들기름 볶음 참깨 검정깨 HACCP,19900,19900,0
2018-06-01,1384435859,A022050,탄산음료,펩시콜라500ml/1.25ml/칠성사이다/음료수,12230,12230,0
2018-06-01,1065962732,A011090,국수,컵라면 50종/신라면/진라면/육개장사발면/참깨라면,13720,13720,0
2018-06-01,889182317,E031130,보온매트,마이프랜드 전기방석 MF-DC3 [극세사 원단 / 자동온도조절기 / 푹신한 두께],49800,49800,0
2018-06-01,895769733,A022020,두유,[삼육]삼육두유 A(950ML),2390,2390,0
2018-06-01,2016502565,A016110,딸기,23311307/ 냉동가당딸기(1kgX15개)-청솔,92660,92660,0
2018-06-01,468715145,C011030,남자학생복,슬림핏 정장셔츠 긴팔셔츠 체크셔츠 스판셔츠 화이트,31000,30690,-310
2018-06-01,2139429778,C012040,여자학생복,[모다아울렛][온앤온]플라워 롱 가디건(JZ8MD607아이보리),39000,39000,0
2018-06-01,879362561,A019080,고추장,[청정원]순창찰고추장500g,7730,7730,0
2018-06-01,879362565,A019080,고추장,[청정원]순창초고추장170g사각,1550,1550,0
2018-06-01,879362562,A019080,고추장,[청정원]순창찰고추장1kg,11250,11250,0
2018-06-01,1212402416,C015020,모자,남녀착시볼캡 빅사이즈모자,4900,4900,0
2018-06-01,2090227900,C012060,여자내의,엔비룩 슬림핏 팬츠/스커트/청바지/,13900,13900,0
2018-06-01,1297600162,I053020,스케치북,(CERGIO) 뉴세르지오 스케치북 200g /3종류(4절 5절 8절)/미술용품/스케치용품/드로윙,2900,2900,0
2018-06-01,1171762086,A022010,주스,타코파우더/ 타코캔/ 타코리필모음전/ 아이스티/,7500,7400,-100
2018-06-01,743182938,F011150,건강기능식품,삼성제약 까스명수GOLD 75mlx50병 건강음료 소화제,48380,45970,-2410
2018-06-01,1059169333,G022020,자동차타이어,넥센타이어 고급형 CP672 205/55R16 정품 무료배송,56900,47940,-8960
2018-06-01,1596098247,C011020,남자상의,[레노마]S/S 춘하 세련된 스크레치패턴 모&린넨혼방 캐주얼정장 RJJMSJ55A MRT19,158000,137310,-20690
2018-06-01,222071757,A022030,생수,빅토리아 탄산수/탄산음료 500mlx20페트外,9900,9900,0
2018-06-01,2047071091,C011030,남자학생복,슬림 카라포인트 비취패턴 블루스카이 셔츠 남성남방,20190,20190,0
2018-06-01,1385736904,A011160,빵,안흥찐빵마을 국산팥 수제 흑미찐빵 1.5kg 30개 주전,30370,30370,0
2018-06-01,2138224417,C013050,운동복,아둘 패밀리룩 여름 반팔 조던 쥬니어 상하세트 12,15900,15900,0
2018-06-01,896787369,A017070,부추,영해시금치 (단),3990,2490,-1500
2018-06-01,1883751004,F011150,건강기능식품,옻가네/파워마카/마카분말100%/마카가루/효능/페루마카/페루의산삼/남성건강/포맨/피로,198000,198000,0
2018-06-01,1900264704,F012010,종이기저귀,리베로기저귀 밴드형/팬티형 2팩 모음전,31600,31600,0
2018-06-01,1300296432,C012060,여자내의,[크로커다일레이디스](크로커다일레이디) 솔리드 7부 팬츠 (CL6MPT116),32300,28110,-4190
2018-06-01,1409984786,C012040,여자학생복,[모다아울렛][에이비에프지]후드 롱가디건 (AFS3GY09) 블랙  화이트,39000,36660,-2340
2018-06-01,1300296439,C012060,여자내의,[크로커다일레이디스](크로커다일레이디) 스트레이트 핏 9부 스판 팬츠 (CL6MPT216),32300,28110,-4190
2018-06-01,2147482075,C012060,여자내의,슬랙스 슬렉스 여자 여성 바지 나팔 통 슬림 정장바지,17800,17800,0
2018-06-01,314416912,C012040,여자학생복,[올리비아로렌]내추럴 쉬폰 레이어링 블라우스 VOCNSRM4331/ 올리비아로렌,22990,22990,0
2018-06-01,1978419369,A018070,파이,[캔디마을]17가지/초코파이/카스타드/오예스/오뜨/몽,9900,9900,0
2018-06-01,828268309,C013060,등산복,[웨스트우드] 18ss신상/이월 여름상품 특가전,9900,9900,0
2018-06-01,250041788,E011070,식탁,다니엘우드 홈바 다용도 사이드 원목테이블,60000,60000,0
2018-06-01,1093329365,C013040,청바지,[지오다노]118525 라이트웨이트 펜슬핏 치노,24000,21600,-2400
2018-06-01,1866820713,C013020,티셔츠,[에이와비] 여름신상 데일리룩의 정석,14900,14900,0
2018-06-01,1741434456,C013050,운동복,A4/상하세트 19800원~/~3XL 빅사이즈/요가복/헬스복,9900,9900,0
2018-06-01,1967923205,A019010,고춧가루,흑후추가루(맷돌 400g)X20 파우더 식자재용 분 하이백,192820,192820,0
2018-06-01,1377777140,C013020,티셔츠,루투 남녀공용 무지 라운드 브이넥 나시 티셔츠(M~3XL빅사이즈)브이넥 긴팔티/흰색면티,4900,4900,0
2018-06-01,1067452621,E031130,보온매트,일월_ M2 효성 단면 워셔블 온열매트 세트(더블+싱글),160890,160890,0
2018-06-01,1067452622,E031130,보온매트,일월_ M2 효성 단면 워셔블 온열매트 더블(투난방),106950,106950,0
2018-06-01,1067452623,E031130,보온매트,일월_ M2 효성 단면 워셔블 온열매트 싱글(원난방),80910,80910,0
2018-06-01,1217020060,C013010,점퍼,[버블트리]~23호/여아/아동/유아/야상/자켓/점퍼,29800,29800,0
2018-06-01,1318247707,C011030,남자학생복,빅사이즈 남방 L~4XL 긴팔 반팔 7부 체크 청 셔츠,29900,29900,0
2018-06-01,624466643,C012040,여자학생복,킬라이트 옆트임 롱니트 SD-6467,15680,15680,0
2018-06-01,1300296463,C012060,여자내의,[크로커다일레이디스](크로커다일레이디) 체크 패턴 9부 팬츠 (CL6MPT220),22300,19410,-2890
2018-06-01,349234711,C012040,여자학생복,V넥 꽈배기형 오색니트 캐주얼 스웨터 니트,36830,36830,0
2018-06-01,994307653,A017200,토마토,(무)(면)냉동청학 대파1kgX10개,36260,36260,0
2018-06-01,502864563,L021010,손목시계,BELCARINO 남성정장시계 손목시계 시계 MV206170B 학,68500,68500,0
2018-06-01,1085471772,C012040,여자학생복,린넨 카라 베스트 LRT095 린넨조끼 여자조끼 (YA02004,80640,80640,0
2018-06-01,2006921177,A017140,콩나물,신토불이 청정 약 도라지 1kg 9 900원~,9900,9900,0
2018-06-01,1326870068,C013020,티셔츠,[모다아울렛][웨스트우드]웨스트우드]여성반넥냉감티셔츠,19800,17820,-1980
2018-06-01,955710863,A018070,파이,오리온 초코파이(12입)420G,3840,3840,0
2018-06-01,1347741584,C013050,운동복,인기!! 트레이닝세트~ 빅사이즈 운동복 배기세트,34000,29900,-4100
2018-06-01,673768670,A015020,식용유,프리미엄 냉압착 엑스트라버진 올리브오일1L 올리브유,14900,14900,0
2018-06-01,2069289227,C012040,여자학생복,빅사이즈/리치/반팔/블라우스 / 참고 리치반팔블라우,64800,55080,-9720
2018-06-01,1372545047,E011020,침대,동서가구 Top9 슈퍼싱글 수납침대,142200,142200,0
2018-06-01,1014496453,C013010,점퍼,아디다스 여성 헬리오닉 패딩자켓(BQ1938),158570,158570,0
2018-06-01,919288177,C012040,여자학생복,심플브이넥블라우스/화이트셔츠/V넥블라우스/솔리드,9900,9900,0
2018-06-01,900301587,E061100,습기제거제,파르텔 미향탈취 목화향 (400ML),6110,4990,-1120
2018-06-01,2047156685,C011030,남자학생복,피쉬본 패턴 화이트셔츠 패션셔츠 남자긴팔셔츠 남방,34270,34270,0
2018-06-01,348942565,A017210,파,소양강 토마토 5kg/10kg /못난이/쥬스용/정품/혼합형,9900,9900,0
2018-06-01,1520709526,E031120,믹서,추가사은푸증정]리큅 RPM 블렌더 LB-32HP/믹서기/원액,282260,236480,-45780
2018-06-01,282437094,A017220,양파,[무료배송] 산지직송 웰빙 천연 대파 5단,18000,18000,0
2018-06-01,879362570,A019060,된장,[청정원]순창재래식 안심生된장2kg,10900,10900,0
2018-06-01,1018637931,C011050,남자내의,책임질 최고의 슬렉스 정장바지 9부 시원한 이제 걱정,16700,16700,0
2018-06-01,2010101328,C012040,여자학생복,[조이너스] 조이너스 큐빅민소매 블라우스 JA7U4-WRB060,139000,41700,-97300
2018-06-01,879362569,A019060,된장,[청정원]순창재래식 안심生된장500g,3100,3100,0
2018-06-01,955891566,A018040,아이스크림,구구 콘 (10개),12000,7000,-5000
2018-06-01,879362568,A019060,된장,[청정원]순창재래식 안심生된장1kg,5730,5730,0
2018-06-01,879362567,A019080,고추장,[청정원]순창초고추장500g튜브,3730,3730,0
2018-06-01,879362566,A019080,고추장,[청정원]순창초고추장300g튜브,2600,2600,0
2018-06-01,975404775,C013020,티셔츠,남자 빅사이즈 나시티 L~3XL 까지 나시 민소매 빅나시,3900,3900,0
2018-06-01,1700912423,E031120,믹서,[PN풍년] 풍년 꾸노 멀티미니믹서 다이얼 초강력모터 세트구성,40000,38900,-1100
2018-06-01,1283858763,C013020,티셔츠,신상/맨투맨/긴팔/후드/항공/엠보/네오프렌/커플,12900,12900,0
2018-06-01,1271001253,E061010,세탁세제,1+1 비트 일반 액체세제/액츠/리큐 진한겔/울샴푸,6600,6600,0
2018-06-01,125352711,E011070,식탁,다크올리브암멀바우티테이블세트(의자2개+테이블1개),111900,111900,0
2018-06-01,480276849,C012040,여자학생복,밍크털오픈조끼 BR1712 밍크털베스트 베스트 여자조끼,144660,144660,0
2018-06-01,738825650,E061020,섬유유연제,소프트 빈스 섬유유연제 2Lx2개 천연 세제 빨래 세탁,9900,9900,0
2018-06-01,1966514372,C013050,운동복,신축성좋은 트레이닝복 헬스 요가복 실내복 롱 루즈핏,10000,7900,-2100
2018-06-01,565713986,I053030,복사용지,HP A4 복사용지(A4용지) 80g 2500매 2BOX/더블에이/,33510,33510,0
2018-06-01,2021574999,L021010,손목시계,P0000HOS_G505 가죽밴드(브라운22mm) 시계줄 가죽 밴,11900,11900,0
2018-06-01,2045219415,C013020,티셔츠,남녀공용V넥면티3팩(NTZ330)/ 뱅뱅,17900,16470,-1430
2018-06-01,366959366,F012050,의료측정기,뉴 아큐첵 퍼포마 NC 혈당계[시험지110매+침|솜100개],67700,62970,-4730
2018-06-01,2114300841,C013050,운동복,나이키 파크 트레이닝 반팔 반바지 세트 속팬츠X,58000,58000,0
2018-06-01,1341614037,C012060,여자내의,리코츠 가죽스키니 SD-6142,21980,21980,0
2018-06-01,1127020654,F012020,생리대,[위스퍼]순면감촉 위스퍼 피부애 베스트 모음전,15700,15700,0
2018-06-01,1113207253,C012060,여자내의,[올리비아로렌][올리비아로렌] 스티치 배색 큐롯팬츠 VVCDSRM3221,16100,15300,-800
2018-06-01,452627169,A017010,배추,강화도 토박이 강화도순무김치/깍두기/석박지/순무우,22900,22900,0
2018-06-01,988989459,E041060,수저,[지홈] 우드 조리도구 1+1 묶음상품(우드 실리콘 뒤집게  우드 밥주걱),13700,5800,-7900
2018-06-01,245708440,C012040,여자학생복,(예사랑)여성 인견 조끼 16YB15,59000,58410,-590
2018-06-01,2014544819,A021010,커피,맥심 카누 미니 아메리카노150T/커피믹스/커피빈/커피,23900,23900,0
2018-06-01,1509750100,A022030,생수,싱하 소다워터 325ml 24병/페리에/뷰핏/트레비/탄산,16900,16900,0
2018-06-01,1776325846,C013020,티셔츠,[테이트]남녀공용 기본 후드집업(KA7F7-UKC920),19000,16720,-2280
2018-06-01,371584242,C012060,여자내의,페이크삭스 10족 양말 스타킹 발목스타킹 기모레깅스 기모레깅스 레깅스 스타킹 겨울스,11730,10440,-1290
2018-06-01,2034964345,C012060,여자내의,빅사이즈/제이스타일 브래크 아이스 쿨 레깅스/ 제이스타일,17100,13170,-3930
2018-06-01,445516824,C012020,원피스,더블 루즈핏 코트(Z174MSG512)/ 쥬크,239000,203150,-35850
2018-06-01,284608887,L012040,치약,[특가판매]암웨이 글리스터 치약 200gX4개/6개,25500,25500,0
2018-06-01,2057666285,I031040,생화,PSG-612 DC 서큘레이터 선풍기 차량용 낚시 캠핑 용품,57500,52900,-4600
2018-06-01,988989461,E041060,수저,[지홈] 우드 조리도구 1+1 묶음상품(우드 샐러드 주걱  우드 밥주걱),13700,5800,-7900
2018-06-01,989072979,A014040,발효유,덴마크 드링킹 요구르트 복숭아 310ML,1100,1100,0
2018-06-01,666290759,C013040,청바지,티아이포맨 M174MPT737 그레이 세미와이드 핏 반배기 밴딩 팬츠,49000,39200,-9800
2018-06-01,1362072437,E011050,책상,[동서가구]LV 리빙스 정면책상SET 3종택 /학생책상,89000,89000,0
2018-06-01,2061904787,E011050,책상,카운터/안내데스크/인포메이션/PC방/주문제작가능,440000,418000,-22000
2018-06-01,989072973,A014030,치즈,매일 후레쉬 모짜렐라 125G,5700,5700,0
2018-06-01,1011067502,A014020,분유,[베베쿡] 처음 먹는 어린이 간장 소스 1병,4200,3900,-300
2018-06-01,1235629943,C012040,여자학생복,[공구우먼] 슬라잉 스트라이프 남방 29730 빅사이즈 여성의류,32000,32000,0
2018-06-01,1011067504,A014020,분유,[베베쿡] 처음먹는 어린이 장조림 돼지고기 1봉,4500,3500,-1000
2018-06-01,632866064,A011170,떡,전북고창 울어매 모시잎개떡 100개(25개 4팩) / 삼경,84000,73920,-10080
2018-06-01,1000175605,C012060,여자내의,핫팬츠 여성팬츠 바지 반바지 3부 5부 여름바지 팬덤1,12950,12950,0
2018-06-01,1200028523,E061040,부엌용세제,화인식초13L/대용량식초/퐁퐁/락스/석쇠크리너/물엿/,9500,9500,0
2018-06-01,1262652592,A019030,생강,하지카미 (생강순 605g),33920,30190,-3730
2018-06-01,254482668,E021020,커튼,스타크 휴대용 훈중기 USB전자모기향 ZT U100,7310,6950,-360
2018-06-01,2056918617,A011170,떡,전북고창 울어매 복분자송편 100개(25개 4팩),63640,63640,0
2018-06-01,1643867809,C013050,운동복,미키정품/시원한바지/쿨팬츠/여름바지/냉장고/남자,7900,7900,0
2018-06-01,1865986079,C021040,실내화,윌슨 엠플리필 amplifeel 테니스화(WRS322840) 차콜,218110,202850,-15260
2018-06-01,379233029,C015030,넥타이,패션니트넥타이/면모직자동넥타이/부토니에 행커치프,8000,7800,-200
2018-06-01,1252844748,C021040,실내화,[네츄럴월드] 캠핑 여성스니커즈 BLACK/106-501,45000,45000,0
2018-06-01,401957844,C012040,여자학생복,[비키]레더 빅포켓 가디건 (TMCBC2180)_U4X2,25900,24610,-1290
2018-06-01,1387582922,C013010,점퍼,남자 베이직 무지 후드 집업 무지티셔츠 후드집업 킹,26920,26920,0
2018-06-01,578265931,C012060,여자내의,로엠 레이스 스커트 RMWH727R11,19000,17290,-1710
2018-06-01,1520528169,C012060,여자내의,캐서린 쉬폰바지 SD-6288,11790,11790,0
2018-06-01,1260729928,C013010,점퍼,봄신상 블루종/항공점퍼/스타디움점퍼/야구점퍼,25800,19800,-6000
2018-06-01,1245706668,C011050,남자내의,남성면반바지 7부바지 캐주얼면스판 골프반바지w027,17000,16800,-200
2018-06-01,1393394964,E061010,세탁세제,테크클린화이트리필 가루세제 테크3kgx4(총12kg),25900,25900,0
2018-06-01,1582911142,A014010,우유,아이스티(복숭아 립톤907g) X 12 가루 분말 dkdltmxl,108900,108900,0
2018-06-01,772233110,E031080,선풍기,[상진미크론] 야외용 가스파티오히터 SJP-1003 /야외/테라스/카페/가스난로,494000,494000,0
2018-06-01,879362539,A019080,고추장,[청정원]순창찰고추장200g,3100,3100,0
2018-06-01,879362538,A019080,고추장,[청정원]순창찰고추장60*3,7600,7600,0
2018-06-01,1008918777,A014030,치즈,동서 리치골드 모짜렐라 치즈 2.5kg (피자치즈),23900,23900,0
2018-06-01,879362537,A019080,고추장,[청정원]쇠고기볶음고추장60*3,6800,6800,0
2018-06-01,934045178,F011150,건강기능식품,[동화약품] [동화약품] 까스활 75ml 20개 / 빠른 소화제,16000,16000,0
2018-06-01,1608343189,L021020,장신구,실버)데자뷰 큐빅 목걸이(W)주얼리 악세사리 기념일,27050,27050,0
2018-06-01,487038653,A014040,발효유,풀무원다논 떠먹는액티비아 무설탕플레인90g*24개,15900,15900,0
2018-06-01,2122858811,C015040,장갑,실버D 국내제조 성인용 손싸게 2개 1세트 할아버지 노,87330,87330,0
2018-06-01,410650436,A011100,라면,고구마전분(FO 20K),78780,78780,0
2018-06-01,898568997,F011120,인삼,전용농장 백만송이버섯 (팩/150G),1000,1000,0
2018-06-01,1429838217,E051020,건전지,방수 배터리팩 12V(10.8V) 6800mAh 리튬이온 18650,54000,54000,0
2018-06-01,547849263,C013020,티셔츠,[FH패션]반팔티/여름가디건/여름원피스/나시 무료배송,4500,4500,0
2018-06-01,328750703,C013020,티셔츠,나이키 구제매니아몰 여성 80 라운드 면 5부 반팔 티,24660,24660,0
2018-06-01,1208539968,C013020,티셔츠,반팔 S-XL 무지 SD-6601 후드티셔츠,13820,13410,-410
2018-06-01,2083533295,L021030,가방,모노그 핸디 노트북파우치 가방 11인치 13인치 15인치,19900,19900,0
2018-06-01,1302773682,C011050,남자내의,(색상:사이즈 : 카키:XL) DON 1846 린넨9,28220,28220,0
2018-06-01,190582808,L012010,면도기,카이 레그트리머 2입+코털가위/다리숱면도기/다리털,6000,6000,0
2018-06-01,796135320,E031080,선풍기,[캐로스] 가스 온풍기 CAH-275GK 사무실온풍기 히터 난로 난방,1573000,1573000,0
2018-06-01,1536219074,C013020,티셔츠,(남여공용)브이넥 포켓 아트웍 반팔티셔츠 JI2TSU402/ 지프,19900,16920,-2980
2018-06-01,266433111,C012060,여자내의,트임롱데님스커트(715-74613)/ 오조크,99000,84150,-14850
2018-06-01,2047071000,C011030,남자학생복,슬림 카라포인트 클로버패턴 블루스카이 셔츠 남방 긴,20190,20190,0
2018-06-01,637391730,C013020,티셔츠,갭후드티/GAP 후드집업/갭 맨투맨/단체티 반팔티,26500,26500,0
2018-06-01,987050035,A012010,국산쇠고기,[평창영월정선축협]대관령명품 한우불고기600g특품,48000,36000,-12000
2018-06-01,268394536,C012020,원피스,[쉬즈미스][쉬즈미스] 코튼 블렌드 버튼다운 체크 셔츠_SWWSTI20010_BL,69000,65550,-3450
2018-06-01,1829188426,C021040,실내화,[리복(Reebok)][REEBOK CLASSIC/UNISEX] 클럽 씨 85 엠보스 (BS9526 BS9529)(경기점),45000,37980,-7020
2018-06-01,1215988626,C013010,점퍼,[인디안][INDIAN] 남성 원착 스트레치 펀칭배색 점퍼_MIGCLTM3261,100000,95000,-5000
2018-06-01,60209755,A018010,초콜릿,킨더 초콜릿 T4x20개 / T8x10개,17000,17000,0
2018-06-01,2122954725,I012010,컴퓨터,LG데스크탑 Z70EV-AR7P16 펜티엄 4G 500G 윈도우10,584040,549000,-35040
2018-06-01,1674807779,A019030,생강,리얼편강 (국산 200gX2통) 선물세트,32780,29180,-3600
2018-06-01,1101885116,I031010,장난감,멜로디 물놀이 장난감 (10종) 목욕놀이 친구들 완구,10600,9300,-1300
2018-06-01,448222324,C013020,티셔츠,[무료배송]스웨이드폴라티1 목폴라티셔츠 폴라티 캐주,12070,12070,0
2018-06-01,1541302272,I011030,사진기,명품 니콘 D5600 본체 정품 대박사은품+이벤트,610430,589670,-20760
2018-06-01,318274421,A019020,참깨,2017년산 수입 참깨 800g/검은깨 800g/들깨900g 선택,4900,4900,0
2018-06-01,616375282,I031070,애완동물관리비,윌슨 테니스라켓 하이퍼 햄머 5.3,120680,100900,-19780
2018-06-01,2084012686,C013040,청바지,(SR)MHA512 남자빅사이즈청바지 /(참고)빅사이즈 남자,73100,62140,-10960
2018-06-01,1287277300,C014020,유아복,[게스키즈](2015년여름신상품)4부배색반바지G55DBP030N3[갤러리아],21000,16170,-4830
2018-06-01,322999775,C012040,여자학생복,[쟈스킨by혁비][쟈스킨by혁비] 로맨틱 leaves 집업 가디건_ZB2094910A-13,115200,103680,-11520
2018-06-01,468801542,C012060,여자내의,SK1220-워싱 데님 스티치 스커트 청스커트 패션청치마,25550,25550,0
2018-06-01,1159533742,C012040,여자학생복,스트라이프 베이직 니트 (CD311Q899)/ 스튜디오화이트,43000,40850,-2150
2018-06-01,1287037871,C012040,여자학생복,[체리코코][CHERRYKOKO] likey  blouse,27000,27000,0
2018-06-01,611419152,C013040,청바지,[9단주]구단주 쥬르 히든밴딩 데님,19900,18910,-990
2018-06-01,478175084,A011050,콩,볶음땅콩 3.75kg 대용량 햇17년산,12900,12900,0
2018-06-01,1207070458,C013020,티셔츠,시크폭스 라이크펄 트위드티셔츠/ 시크폭스,31700,24730,-6970
2018-06-01,1468306775,E031030,전자레인지,삼성 전자레인지 MS23K3535AW / 오늘발송,96750,96750,0
2018-06-01,519970157,C014010,아동복,젠키/어린이정장/주니어정장/돌복/연주복/남방/정장,45000,45000,0
2018-06-01,526704537,A017040,양배추,(전남오픈마켓/행운가족농원)절임알타리2kg/3kg/5kg/,26000,26000,0
2018-06-01,995958614,L021060,유모차,리안 그램플러스 기내반입형 휴대용유모차 2018그레이,198000,198000,0
2018-06-01,268370543,C012040,여자학생복,[막스까르띠지오]레이스 콘트라스트 후드가디건,141000,133950,-7050
2018-06-01,1562342719,C013010,점퍼,무료배송/빅사이즈/ 캐주얼자켓/후드티셔츠/카고후드,17800,17800,0
2018-06-01,278791472,E021010,침구,국내산 요차렵 침구세트/차렵이불+요커버+요솜 풀세트,69800,69800,0
2018-06-01,1671426209,E031070,에어컨,한라 SKY 실링팬 브론즈/크롬/리모콘/52인치/실링팬,188000,188000,0
2018-06-01,598943593,A014030,치즈,아담스 파마산치즈 치즈가루 1kg,12540,12540,0
2018-06-01,1138760591,E011020,침대,NOOMAㅡHUSH BED/쇼파베드/싱글침대/침대/쇼파/3인용쇼파/철제침대/원룸용쇼파침대/게,149000,141550,-7450
2018-06-01,2099563861,C012040,여자학생복,cc90 투포켓 니트조끼 민트 여자겨울조끼 겨울니트베,13260,13260,0
2018-06-01,564591351,C021020,구두,[무크] 여름을 맞이하는 남여화 71종~!,39900,39900,0
2018-06-01,1552353525,C013020,티셔츠,말풍선원피스티/라운드티/미니원피스/크루넥/캐주얼..,7900,7900,0
2018-06-01,1317744178,I011010,TV,SHE-320XL / 32인치LEDTV / 100%무결점 삼성패널2년AS,149000,149000,0
2018-06-01,613209185,C013050,운동복,[보문기업] 윈스톰/다기능국기봉/보조미러/깃봉/후사경/국기봉/보문/사각지대해소/주차,20970,19210,-1760
2018-06-01,1992793738,E061020,섬유유연제,피죤 건조기용 시트섬유유연제40매x3/샤프란/리치퍼퓸,13800,13800,0
2018-06-01,1722113059,L021020,장신구,자석팔찌 건강팔찌 건강목걸이 게르마늄팔찌 실버팔찌,2500,2500,0
2018-06-01,325620259,C012040,여자학생복,[블루종][블루종]여름추천 핫한 블라우스티셔츠外 24종택일_[B1806CO009FP],21900,20810,-1090
2018-06-01,718013742,E011040,소파,보니타빈백 초대형 파우치 P302 쇼파/1인용쇼파,101900,101900,0
2018-06-01,1592975831,A016040,포도,[거북농산]칠레산 거봉포도 적포도 3kg,17500,17500,0
2018-06-01,268370551,C012040,여자학생복,[막스까르띠지오]브이넥 슬릿 블라우스,119000,113050,-5950
2018-06-01,895770573,A014010,우유,서울 커피우유 (200ML),850,850,0
2018-06-01,1276155190,E011020,침대,무중력매트리스무료 깔판증정 퀸 슈퍼킹 패밀리 침대,298000,298000,0
2018-06-01,34257332,C011030,남자학생복,스트라이프셔츠/반팔/7부/여름셔츠/오버핏셔츠남방,12900,9900,-3000
2018-06-01,895770572,A014010,우유,[서울]쵸코우유 (200ml),850,850,0
2018-06-01,1348362386,C012030,여자상의,[제이투엘] 린넨리한나원피스(2color)린넨자켓원피스,36000,36000,0
2018-06-01,895770574,A014010,우유,서울 커피우유포리백 200ML_4개이상구매가능,830,830,0
2018-06-01,1736078849,C013010,점퍼,와펜시보리점퍼/초등점퍼/항공점퍼/아동점퍼/ 주니어,22900,17900,-5000
2018-06-01,895770571,A014030,치즈,서울 체다치즈 (20P/400G),6800,6400,-400
2018-06-01,895770570,A014030,치즈,서울 체다치즈 (200G),3120,3120,0
2018-06-01,313115850,A018020,사탕,츄파춥스 팝아트틴 150입 미니츄파춥스/사탕/캔디,24900,24900,0
2018-06-01,1691361141,C012060,여자내의,COMPAGNA 꼼빠니아 슬림 레그라인 스판 정장팬츠 4종,59900,56910,-2990
2018-06-01,1229852479,I012010,컴퓨터,삼성 노트북3 NT300E5S-KD5A,699000,648000,-51000
2018-06-01,1229042645,C013050,운동복,자동차외과 트라이클론 흠집제거+광택기/누구나 손쉽게/YKM,66000,59800,-6200
2018-06-01,895769582,A014010,우유,[빙그레]빙그레 바나나우유 240ML*4입,4280,3600,-680
2018-06-01,895769581,A014010,우유,[빙그레]빙그레 바나나우유 240ML,1070,900,-170
2018-06-01,351668719,A011010,쌀,17년산 그리운 다담쌀 20kg /무료배송,42900,42900,0
2018-06-01,716476957,A013030,조기,영광굴비/굴비/조기굴비/법성포굴비/참조기/선물세트,449900,449900,0
2018-06-01,271300854,A019110,드레싱,케찹/핫소스/바베큐소스/우스타소스/칠리소스/드레싱,4200,4200,0
2018-06-01,1627435849,I031070,애완동물관리비,특대형 3in1멀티게임 콤보플레이어 당구대 탁구대,109000,87620,-21380
2018-06-01,893865717,C013060,등산복,쿨티셔츠 등산복 작업복 아웃도어 등산바지,8900,8900,0
2018-06-01,1249241736,A013050,오징어,[동원FnB] [동원]꽁치(1.88kg×6캔/1박스/무료배송)/꽁치캔,66000,66000,0
2018-06-01,389300370,C015030,넥타이,(색상 : 스카이) BTIE_095 꽃 수묵 보타이,13420,13420,0
2018-06-01,1654031224,L021030,가방,천연소가죽 여성백팩 50종 /가방/여자,34600,34600,0
2018-06-01,313282069,A016040,포도,동원)황도 슬라이스 400g x 12개 사시사철 맛있는,41360,41360,0
2018-06-01,482795943,C012060,여자내의,-샤론 글리터 브이넥 뷔스티에- 글리터뷔스티에 유니(,36000,31680,-4320
2018-06-01,1434488227,C012060,여자내의,잇걸 멜빵청롱스커트 SD-9106 여성청스커트 여자청치,46850,46850,0
2018-06-01,845645395,A022040,기능성음료,수분보충음료 토레타 500mlx24PET/저칼로리,21900,21900,0
2018-06-01,1163830593,C013050,운동복,코토 로드스타 200 박스캐리어/루프박스/캠핑/서울,432030,371460,-60570
2018-06-01,573273430,C013010,점퍼,[카라]KARRA 시스루나염스타디움점퍼_KBI5JP204C,14800,14060,-740
2018-06-01,194268178,C014010,아동복,여아 럭셔리 원피스/드레스/의류/아동복/공주옷/유아,15600,15600,0
2018-06-01,989141269,A019180,즉석식품,[대광]대광 박진덕순대 500G+500G,5980,4990,-990
2018-06-01,656300881,L012010,면도기,플라이코 FS300KR 플로팅 전기면도기 3컬커/IPX7 방수,58000,49500,-8500
2018-06-01,1699999663,L021030,가방,LG그램 울트라PC 13인치 14인치 15인치 노트북 파우치,13900,13900,0
2018-06-01,1043238889,C011030,남자학생복,초특가 남자 가디건 롱가디건 숄 남성 집업 면 후드,30000,16800,-13200
2018-06-01,1266526016,E021010,침구,[아망떼] 호텔식 순면 침구세트 (이불+베개+매트커버),32900,29900,-3000
2018-06-01,1976916180,A011090,국수,[2종선택]라면20+20 신라면/농심/오뚜기/삼양/진/봉지,20000,19800,-200
2018-06-01,1096182231,A014010,우유,베지밀 A B 24팩/두유/남양/정식품/푸르밀/멸균우유,11750,11750,0
2018-06-01,1900646308,E021010,침구,일본수출 신상 차렵이불 북유럽풍 100%자연소재 광목,67000,64900,-2100
2018-06-01,91305208,C012040,여자학생복,니트 숄 가디건 스웨터 베스트 조끼 자켓 여성 캐주얼,14530,14530,0
2018-06-01,990004369,E061020,섬유유연제,샤프란소프트코튼용기3.1L,7980,3490,-4490
2018-06-01,1967947288,C011050,남자내의,여름신상 커플/5부반바지/면반바지/밴딩/쭈리/스판/기본/카모/비치/남성/남자반바지,12800,12800,0
2018-06-01,491360556,C011050,남자내의,[하프클럽/MNC]무지 하프 밴딩슬랙스 (MDSP203HS),12500,12500,0
2018-06-01,1733117763,C011050,남자내의,(체크9부바지)넓고 편안한 바짓단 남여공용 9부바지,10630,9470,-1160
2018-06-01,905594500,E011070,식탁,다니엘우드 아일랜드 원목가구 다용도테이블 삼나무,54900,54900,0
2018-06-01,2081449945,E031130,보온매트,더블 프레이야 전기요(180 135) /(참고)전기매트 방한,159400,140280,-19120
2018-06-01,1572450498,E021010,침구,겨울왕국 면기모 패드 - 뷰티선샤인 (064187) 요매트,58590,53370,-5220
2018-06-01,598943564,A014030,치즈,아담스 파마산치즈 치즈가루 1kg 10개,118400,118400,0
2018-06-01,300744719,C013010,점퍼,[대구백화점 II관] [멜로디가든]쿨링 점퍼(M8M5R01),40000,36000,-4000
2018-06-01,1342911302,E031010,전기밥솥,쿠첸10인용 CJH-VES1009SD IH압력밥솥.무쇠내솥,185000,172000,-13000
2018-06-01,304168537,E051020,건전지,페어맨 깜냥 18650 리튬 건전지 충전지 배터리 충전기,10000,9900,-100
2018-06-01,1011067472,A019180,즉석식품,에쓰푸드 치킨브레스트필렛 120G,2880,2390,-490
2018-06-01,1011067471,A019180,즉석식품,에쓰푸드 직화치킨브레스트필렛 110G,2880,2390,-490
2018-06-01,2038698672,C013050,운동복,[아트로마] SM6 리무진 콘솔박스 팔걸이 쿠션 콘솔 콘솔박스 콘,57640,52510,-5130
2018-06-01,1011092401,L012110,색조화장품,일리윤 데일리디펜스 피팅선플루이드30ml 2입,19900,10900,-9000
2018-06-01,895770509,A022010,주스,[서울]서울 아침에 쥬스 오렌지 950ML,3000,3000,0
2018-06-01,609685630,L012030,칫솔,20%쿠폰! [오랄비X리스테린]프리미엄 패키지+증정,26000,26000,0
2018-06-01,895745587,A021010,커피,동서 맥심 모카골드믹스 50T*12G,7590,6300,-1290
2018-06-01,390048124,C015020,모자,(컬러:사이즈 : 베이지:FREE) ACC-CAP103 빈,19630,19630,0
2018-06-01,895770540,A014010,우유,서울우유 1.8L,4790,4790,0
2018-06-01,895770542,A014010,우유,[서울]서울우유 200ML,850,850,0
2018-06-01,895770541,A014010,우유,서울우유(1L),2550,2450,-100
2018-06-01,1160282531,C013010,점퍼,[화이트폭스][화이트폭스]하이넥 무스탕 떡볶이 코트,63000,57330,-5670
2018-06-01,123127628,C011030,남자학생복,[바젤]빅사이즈90110남녀공용BJ552집업 울트라 경량패딩조끼다운베스트남자패딩조끼남,25800,24510,-1290
2018-06-01,1249037879,C015040,장갑,롱가죽장갑/가죽롱장갑/컬러가죽장갑/코트장갑/긴장.,3900,3900,0
2018-06-01,1397978608,A012010,국산쇠고기,두레생협 닭날개(2kg/무항/국내산),77760,76210,-1550
2018-06-01,1949569298,A014020,분유,[아이배냇]DIY레시피 쇠고기와 새송이버섯,7920,7920,0
2018-06-01,1385881860,A011160,빵,안흥찐빵마을 수제 슈크림 찐빵 500g(10입) 수제 초코,26120,26120,0
2018-06-01,895769551,E061010,세탁세제,[CJ]CJ 라이온 비트 (3KG/파우치),9900,9900,0
2018-06-01,1011092431,L012110,색조화장품,일리윤 데일리디펜스 멀티선크림 기획2입,23900,22800,-1100
2018-06-01,1011092434,L012110,색조화장품,해피바스 아쿠아모이스춰 선크림70g 2입,14900,12300,-2600
2018-06-01,990028329,A017180,호박,가지(3입/봉),3990,2000,-1990
2018-06-01,895745586,A021010,커피,[동서]동서 맥심 모카골드믹스 100T*12G,14900,14900,0
2018-06-01,86749948,C012040,여자학생복,롱 라운드 넥 긴팔 니트 티 티셔츠 스웨터 여성 여자,15600,15600,0
2018-06-01,1011092433,L012110,색조화장품,해피바스 마일드 선스틱20g 2입,18900,14200,-4700
2018-06-01,459551928,C014020,유아복,아동바지 주니어 베이직 데님 팬츠 KIDBOK-61 반바지,11720,11720,0
2018-06-01,620252340,E051020,건전지,티웨이USB충전건전지(4입)친환경충전지/5핀케이블포함,19800,15840,-3960
2018-06-01,895745582,A021010,커피,[동서]동서 맥심 오리지날 (리필/170g),7990,6990,-1000
2018-06-01,1948077357,C013050,운동복,롱타임블랙왁스/수개월지속/타이어왁스/타이어코팅제,28000,28000,0
2018-06-01,268394545,C012020,원피스,[쉬즈미스][쉬즈미스] 코튼 스트라이프 러스틱 셔츠_SWWSTI20030_BL,89000,84550,-4450
2018-06-01,1011092429,L012110,색조화장품,일리윤 데일리디펜스워터리선젤45ml 2입,28900,27500,-1400
2018-06-01,1944405855,A016090,참외,[하루특가]달콤한 성주 꿀참외7kg,8500,8500,0
2018-06-01,895770539,A014040,발효유,[서울]서울 요구르트 65ML*15입,2250,2250,0
2018-06-01,895769546,E061010,세탁세제,[CJ]비트 카톤 (4KG),15990,9900,-6090
2018-06-01,2143306692,E061030,전구,LED바 완제품(선택형) /LED간접등/LED캠핑등/국내제작,4900,4900,0
2018-06-01,321961580,C013010,점퍼,MJS18011 라벨 워싱 진청자켓 남자데님자켓 청자켓 남,70940,70940,0
2018-06-01,169439434,E011020,침대,동서가구 마샤 소나무 통원목 침대 SS/Q,125100,125100,0
2018-06-01,1244008475,E031110,청소기,(행사)신제품 한경희강력살균 멀티스팀청소기HS-600VI,62250,57900,-4350
2018-06-01,2096229507,C013020,티셔츠,[올젠]컬러블럭 반소매 카라티셔츠 3종 택1(ZOX2TT1112)(센텀시티점),35000,28860,-6140
2018-06-01,589744384,A013100,마른멸치,살아있는 웰빙 완도전복오늘만특가15~17미크기1~1.5kg,34200,34200,0
2018-06-01,480929556,C015020,모자,전상품 무료배송!!볼캡 야구모자 캡모자 슈프림,12900,12900,0
2018-06-01,441065966,C013050,운동복,차량용 소화기 0.7kg (거치대포함),46590,42440,-4150
2018-06-01,1079134352,C011050,남자내의,[디키즈]남여공용 코튼 7부 트레이닝 팬츠(DMP2UPKH533),22000,19140,-2860
2018-06-01,192214474,E041070,밀폐용기,Full밧드 스텐밧트/pc바트/반찬/통/보관/용기/급식/11,10000,8740,-1260
2018-06-01,835695753,C013040,청바지,리바이스/리바이스청바지/청바지/남자청바지/남성/501,45000,45000,0
2018-06-01,1011092427,L012110,색조화장품,일리윤 데일리디펜스 무기자차선크림50ml 2입,28900,27500,-1400
2018-06-01,1312157015,D031010,주택수선재료,KCC속건청 방청하도 광명단 녹방지페인트 4리터 철재,19800,19800,0
2018-06-01,1417561189,E041060,수저,[아렉스]고려방자 금수저 티타늄수저 선물용 수저세트,25800,23800,-2000
2018-06-01,2107091313,C011030,남자학생복,여름신상 체크남방/솔리드데님청/남자옷/스판셔츠,13800,13800,0
2018-06-01,598943534,A014030,치즈,파마산 블렌드 치즈가루 227g,5100,5000,-100
2018-06-01,1229201115,F012010,종이기저귀,하기스 매직팬티 5단계 특대형 50매x3팩,55900,55900,0
2018-06-01,447486193,C013020,티셔츠,[무료배송]NY후드티 여자후드티셔츠 캐주얼후드티 후,22570,22570,0
2018-06-01,85519806,F012020,생리대,500원할인)바디피트생리대 볼록맞춤중형22Px5팩 110매,11900,11900,0
2018-06-01,1510794418,C011030,남자학생복,[럭스옴므]캐주얼/옥스포드 데님 청남방 슬림핏셔츠,12800,12800,0
2018-06-01,482374906,F012020,생리대,[나트라케어] 유기농 생리대 5박스,37500,36750,-750
2018-06-01,714985723,A011030,찹쌀,2017년 햇 국산 보리쌀 5kg/찰보리/쌀보리/늘보리,12300,12300,0
2018-06-01,799456435,C012060,여자내의,[쉬즈미스] 2018 SWWSKI11030 앞트임 H라인스커트,68600,54880,-13720
2018-06-01,623273641,C014010,아동복,[블루독] 브이넥포켓티셔츠 (27375-332-03),23000,18860,-4140
2018-06-01,141108512,A022050,탄산음료,바크 루트비어 355ml x24can,24000,24000,0
2018-06-01,2119776275,A013150,어묵,인기! 사각 유부초밥 60장,6800,6800,0
2018-06-01,370721189,A016120,바나나,고당도 바나나 4kg내외(3손),13600,13220,-380
2018-06-01,285363471,E011040,소파,1인쇼파 좌식소파 패브릭소파 커버탈착세탁가능,25500,25500,0
2018-06-01,311201128,A022030,생수,빅토리아 피치/콜라/라임/레몬/플레인/자몽(500mlx20),9900,9900,0
2018-06-01,2005514868,E061020,섬유유연제,미국산 고농축 섬유유연제 스너글4.96L/7.56L 다우니,19900,19900,0
2018-06-01,202621517,C011050,남자내의,[아디다스] 아디다스 정품 에센셜 3S 3/4 칠부팬츠,39800,39800,0
2018-06-01,1774977168,F011130,홍삼,굿베이스 홍삼이랑 튼튼(20ML*28입),77000,77000,0
2018-06-01,275062362,A018010,초콜릿,버터쿠키/12곡물과자/15곡물과자/16곡물과자/로투스커피과자/나쵸칩/고다스와플과자/팝,4500,4500,0
2018-06-01,988926065,E061020,섬유유연제,한.입 향수담은 섬유유연제 그린 2.4L_3P,31300,31300,0
2018-06-01,1061722032,C011030,남자학생복,by STCO 18ss신상 린넨/셔츠/티셔츠/팬츠,10000,10000,0
2018-06-01,2012806639,C012040,여자학생복,COUPS.꾸즈가디건 CI6KE34 숏기장로브가디건,68000,55760,-12240
2018-06-01,988926069,E061020,섬유유연제,[한입]반만액체 레몬&라벤더 드럼용2.4L_3입,41700,32700,-9000
2018-06-01,76095779,C011050,남자내의,[지오다노]남 슬림핏 치노팬츠 117922,15000,12000,-3000
2018-06-01,1356103545,C012020,원피스,스타일리쉬한반코트(N181XSG401)/ 나이스클랍,97650,78120,-19530
2018-06-01,1430771901,E041020,컵,심플 머그컵 유리컵 모음 맥주잔 물컵 유리잔 머그잔,1500,1430,-70
2018-06-01,1606035374,C011020,남자상의,[에크미]9부 소시오 밴딩 슬랙스,13900,13900,0
2018-06-01,988926061,F012020,생리대,[엘지생활건강]유기농순면 팬티라이너 그린 롱 66P x2,10200,10200,0
2018-06-01,838664141,E061020,섬유유연제,FC 베이비전용 세탁세제 refill 유아용 그린세탁세제,22100,22100,0
2018-06-01,256633715,C013010,점퍼,여성여름비취용가디건/후드집업/쉬폰망사자켓/카디건,35000,34000,-1000
2018-06-01,1328601331,C013020,티셔츠,베이직 후드티 LLTT0035 여성티셔츠 후드티,23510,23040,-470
2018-06-01,178913499,A014030,치즈,크로네 모짜렐라치즈 1kg /자연치즈/아이스망고 20개,7900,7900,0
2018-06-01,1492996879,C013040,청바지,뱅뱅(BANGBANG) 남성 핫썸머 데님 팬츠 3종(남),69900,64310,-5590
2018-06-01,1286299076,C012040,여자학생복,롱 청자켓 띠우리V넥청훌OPS 여성용롱셔츠 여자셔츠,37870,37870,0
2018-06-01,1361245411,A021020,차,4구 컵트레이 1세트-50개 카페 종이컵,9900,9900,0
2018-06-01,1445957399,A011090,국수,컵라면/신라면큰사발/불닭볶음면/육개장사발면/진라면,17000,17000,0
2018-06-01,1198708624,A019020,참깨,들깨가루 (산들샘 1k) X10,330580,294220,-36360
2018-06-01,2039679529,E051030,디지털도어록,[빠른배송] 삼성 푸시풀 도어락 SHP-DP710/카드키2개,173500,155880,-17620
2018-06-01,425603255,E061040,부엌용세제,퐁퐁 안심설거지 주방세제 용기 3000ml x 4개 (택일),15900,15900,0
2018-06-01,2104240955,C013030,스웨터,골지 반폴라 티셔츠 MRO라운드티티셔츠긴팔티니트겨울,54700,54700,0
2018-06-01,659837976,E031020,가스레인지,2018년형) 판매1위 2구 가스렌지 GRA-811SR 메탈실버,122940,115000,-7940
2018-06-01,1285800974,A017110,감자,쥬스용 생흙당근 세일 신선농장,7000,7000,0
2018-06-01,202183463,C012060,여자내의,[에이지도르]하트스커트(A8MK010)(인천점),50000,46000,-4000
2018-06-01,961428072,E061070,가정용비닐용품,필아띠 쿠킹호일 (25cm*15m),1990,1990,0
2018-06-01,748791445,A012010,국산쇠고기,가평잣 2단세트(고품격 웰빙 선물세트)사은품 답례품,73980,73980,0
2018-06-01,1010320841,A017150,버섯,CJ 행복한콩콩나물 380G,2290,2290,0
2018-06-01,1893151284,C012030,여자상의,빅사이즈 여름 민소매 롱 원피스 66-110 끈 나시 모음,21000,18900,-2100
2018-06-01,1997264050,E011020,침대,[골든잼]잣나무 천연 생황토 싱글 돌침대/효도 흙침대,1974200,1914980,-59220
2018-06-01,2068493107,A022050,탄산음료,웰치스 355ml x 24캔/포도/청포도/딸기/탄산음료,12800,12800,0
2018-06-01,988062067,L012080,화장지,초L) 양면 화장솜 100매,1500,1500,0
2018-06-01,565953802,C013040,청바지,[까레라진]리미티드에디션 세미보이핏 데님 여자 (화이트),19900,19900,0
2018-06-01,1403362865,C012040,여자학생복,수지네 일본 구제 네이비 울 베스트 여성 M 19-01,14260,14260,0
2018-06-01,961428076,E061070,가정용비닐용품,필아띠 롤백 (25cm*35cm),1990,1990,0
2018-06-01,989943830,A011110,당면,간편반모국산콩두부(부침) 210G,1490,1490,0
2018-06-01,1367010961,E031110,청소기,아이클레보 A1 로봇청소기 + 런칭기념 사은품증정,315060,315060,0
2018-06-01,1276914867,L012010,면도기,도루코 면도기 페이스7 페이스6 페이스XL 페이스파워,8900,8900,0
2018-06-01,1517767122,L012010,면도기,도루코면도기 페이스6기획행사/면도날4개증정/페이스7,8800,8700,-100
2018-06-01,943903044,E041070,밀폐용기,국산 글라스락 반찬통/밀폐용기/찬합/도시락,6400,5430,-970
2018-06-01,1497756023,A019080,고추장,비빔양념장(2kg)/국수/비빔장/비빔국수/비빔밥/비빔냉면/비빔소스/비빔면/쌀국수/잔치,16600,16600,0
2018-06-01,615052865,I012060,저장장치,게이밍 마우스 G1마우스 DG1 아바고3050 4000dpi,16200,15700,-500
2018-06-01,989943829,A011110,당면,간편반모국산콩두부(찌개) 210G,1490,1490,0
2018-06-01,44066265,C012060,여자내의,[퍼스트레인] PuzzlSK 스커트/롱스커트/니트스커트,49800,24900,-24900
2018-06-01,2133944818,C012060,여자내의,36인치까지/빅사이즈스커트/플레어/테니스/청치마,23900,23900,0
2018-06-01,797595774,A019080,고추장,ⓒ 해찬들 수라상 약고추장(200G),1950,1950,0
2018-06-01,370721153,A016120,바나나,고당도 바나나 3kg내외(2손),11900,11500,-400
2018-06-01,1997288076,E011020,침대,[골든잼]소나무 천연 생황토 평상/돌평상 돌침대 쇼파,2463900,2389990,-73910
2018-06-01,1864002820,F012020,생리대,바디피트 102 중형18Px4팩 신제품출시 특가/생리대,9900,9900,0
2018-06-01,293177768,C013020,티셔츠,DSHN0117R 루즈빅 단가라 맨투맨 803 여성용라운드티,46840,46840,0
2018-06-01,445301954,I031040,생화,아이스박스 9.5L 22L 보냉가방 보냉백 쿨러백 아이스,19000,16920,-2080
2018-06-01,1324076301,E021020,커튼,루베스 콤비 블라인드 소형 1 플러스 1 암막커튼 블라,59890,58100,-1790
2018-06-01,533758758,E031070,에어컨,한일 40cm 벽걸이형 리모컨 선풍기 FW-604R,49300,46840,-2460
2018-06-01,1119586804,I012010,컴퓨터,삼성전자 DM500T7Z-AD5A(키보드+마우스포함) 당일발송,722100,686000,-36100
2018-06-01,1949108859,C014010,아동복,[알로봇] BI나염티셔츠 (17429-332-07),19000,15580,-3420
2018-06-01,1011092495,F011150,건강기능식품,[네이처드림]맛있게 배부른 곤약젤리 풋사과 150g x 10포,20000,9900,-10100
2018-06-01,2112629799,A022010,주스,웅진 자연은 알로에 1.5L X 12개,50250,50250,0
2018-06-01,637173249,A022010,주스,스내플 망고 주스 snapple 473mlX24(Glass),59800,57120,-2680
2018-06-01,201224420,G011070,자전거,[삼천리] 유니키즈FA / 18인치 접이식자자전거 폴딩,149000,134010,-14990
2018-06-01,1389202443,A018090,잼,트라피스트수녀원 유기귤잼 410g 귤잼 과일잼 빵 식,17590,17590,0
2018-06-01,1010258374,A019170,냉동식품,동원 심야식당뼈없는불닭발 160G,6980,6980,0
2018-06-01,958633518,A018030,껌,[롯데]롯데 왓따 복숭아 23G,490,490,0
2018-06-01,732382093,C012040,여자학생복,[제쉬나인][제쉬나인]레이스프릴매쉬가디건망사가디건숏가디건,22000,19800,-2200
2018-06-01,1806889495,A019170,냉동식품,비비고 왕교자 1.05kg 2개 /김치왕교자/한섬만두 외,15900,15900,0
2018-06-01,895770596,A014030,치즈,서울 피자 치즈 (200G),6300,6300,0
2018-06-01,78610456,A011090,국수,삼양 까르보불닭볶음면 10개/마라 / 짜장불닭볶음면,10300,10300,0
2018-06-01,1687443502,C013050,운동복,[핑크시슬리]SET/비트도널드 치마바지세트,32800,32800,0
2018-06-01,1112014076,L012030,칫솔,죽염칫솔 12개(4+4+4) 잇몸 시린이 전문칫솔 초극세모,16900,16900,0
2018-06-01,1179713306,E061010,세탁세제,자연 EM 활성액500ml-이엠 친환경 천연세제,2500,2250,-250
2018-06-01,1425483559,L012090,기초화장품,한율 진액 어린쑥 자초 스킨 에멀젼 수분크림 미스트,11400,11400,0
2018-06-01,1093080727,C012040,여자학생복,[에이인]FRESH A half shirts,32000,30400,-1600
2018-06-01,1775130146,F011130,홍삼,정관장 무설탕홍삼캔디수(600G),27000,27000,0
2018-06-01,1314150959,A012030,돼지고기,순빛살 구룡농장 No항생제 돼지 목살1kg(구이)-(fresh,67610,67610,0
2018-06-01,1357382670,F012020,생리대,바디피트 순간흡수16Px4팩+증정10P/생리대/오버나이트,9900,9900,0
2018-06-01,1447807341,A017230,마늘,[함평천지농협] 해풍맞은 함평 황토 햇양파 5kg/10kg,6500,6500,0
2018-06-01,858486226,C014010,아동복,젠키/주니어셔츠정장구두/주니어벨트/커프스/행사복,12900,12900,0
2018-06-01,707674731,A014030,치즈,코리원/썬리취 어린이 슬라이스치즈 100매/아기치즈,21500,21500,0
2018-06-01,1727726755,C011020,남자상의,봄여름/신사정장바지/허리밴딩/스판/노턱/원턱/30-40,19000,18800,-200
2018-06-01,1674014421,C011030,남자학생복,신상 가디건 롱가디건/니트/브이넥/숄/자켓/남성/남자,11900,11900,0
2018-06-01,1196871641,C013010,점퍼,지컷 벨티드 롱 구스다운 점퍼 7227417504,327610,327610,0
2018-06-01,229470315,C013020,티셔츠,[빈폴아웃도어]블루 여성 롱 셔츠 원피스 (BO8364C01P),111300,87930,-23370
2018-06-01,1662682818,A018110,물엿,백설 물엿 요리당 올리고당 요리올리고당 2.45kg,4600,4600,0
2018-06-01,1451517546,A013090,전복,[유진수산] 가리비살/ 청정 자연산 가리비살,5450,5450,0
2018-06-01,243851126,C014010,아동복,[게스키즈] 레이어드레이스티 G65KAT050-N3,34000,27200,-6800
2018-06-01,2011265355,A017210,파,무농약 찰완숙토마토 5kg-무료배송,14300,14300,0
2018-06-01,563059051,C013010,점퍼,어스앤뎀 남성 셔츠형 린넨점퍼 V11US TBUB605,46270,46270,0
2018-06-01,892736276,C011030,남자학생복,[인터페이스] 간절기 필수템! 가디건 모음전 모두의,17700,17700,0
2018-06-01,1210389108,A017300,미역,동원 양반김 참기름/ 들기름/ 올리브유 김 32봉,9500,9500,0
2018-06-01,1347000128,A018020,사탕,[캔디마을]실비아/1봉-400개/비타민c/레모나/건강식품,16000,16000,0
2018-06-01,1434190690,E061040,부엌용세제,크로바 하얀퐁13L/1종 주방세제/리필/퐁퐁/트리오,12500,12500,0
2018-06-01,10812036,A019180,즉석식품,육개장 내장탕 양평 해장국 갈비탕 설렁탕 국밥,3200,3200,0
2018-06-01,1754008341,I031070,애완동물관리비,빙고게임/숫자/영어/성씨/빙고카드/OX퀴즈/게임용품,8800,8800,0
2018-06-01,2104201339,F012020,생리대,위스퍼 슈퍼롱 오버나이트 10p,3500,3500,0
2018-06-01,7500664,C015040,장갑,[지맥스] 지맥스 아이스 장갑 친환경 쿨 매쉬 UV차단 자외선차,6200,6200,0
2018-06-01,1610958594,C012040,여자학생복,ab f z 옆트임 루즈핏 롱 가디건 AFR3GY11,35100,35100,0
2018-06-01,2117906384,C013050,운동복,LED 심플 재떨이/차량용재떨이/자동차/휴대용/재털이/,5500,5060,-440
2018-06-01,1548504140,E011040,소파,[잉글랜더]가넷&하임 3인용 라텍스 가죽 소파/쇼파,459000,412900,-46100
2018-06-01,500083824,C011030,남자학생복,[마인드브릿지]PV오픈카라세미오버반팔셔츠MSWS3151[갤러리아],49900,44910,-4990
2018-06-01,1029401290,C013010,점퍼,빈폴자켓/빈폴점퍼/면자켓/헤지스/엠비오/후드/패딩점퍼/벨벳/가디건/닥스/정품/새제품,97000,97000,0
2018-06-01,1010320777,A013070,굴,초이스엘프레시))꼴뚜기70G/봉,6990,6990,0
2018-06-01,851572121,A019060,된장,해찬들 그대로 끓여먹는 된장찌개 1+1 기획,5750,5750,0
2018-06-01,1010320775,A013110,마른오징어,초L프)두절새우40G/봉,5990,5990,0
2018-06-01,217418212,C014010,아동복,[붐붐키즈]상하복/세트/츄리닝세트/치마세트,8900,8900,0
2018-06-01,1271368291,C012020,원피스,[엄마옷 데드라] 8B-PT115 지퍼포켓밴딩팬츠,14700,12350,-2350
2018-06-01,7306013,E041050,냄비,키친아트 프리미엄 세라믹냄비 4종세트 최강전,47900,47900,0
2018-06-01,1330758248,E011060,의자,피오르 장의자/인테리어의자/대기용의자/간이의자,99000,98010,-990
2018-06-01,771071225,E031080,선풍기,[신한일] OHG-19700FT 캠프파이어 /난로/히터/겨울가전/,480900,480900,0
2018-06-01,1304846747,A018050,비스킷,[7만무배]빼빼로17종/포키7종 10갑 빼빼로데이 선물,7400,7400,0
2018-06-01,549809773,I031010,장난감,[노는역] PS4 아날로그 스틱커버 나인볼 16P 듀얼쇼크,6000,5940,-60
2018-06-01,2104514312,C012030,여자상의,[바이너리원] 원피스/니트/가디건/블라우스,6900,6900,0
2018-06-01,1413490934,C011050,남자내의,빅사이즈 반바지 30~46 청 면 린넨 마 반바지 7부,23900,23900,0
2018-06-01,117598124,A015010,참기름,오뚜기 옛날 참기름 / 백설 진한 참기름 500ml,3950,3950,0
2018-06-01,1806779007,E061050,청소용세제,더쎈 매직크리너 세정제 초강력폼 곰팡이제거제,29800,29800,0
2018-06-01,1227274165,C012030,여자상의,팬지 원피스 - 홀터넥 플라워 패턴 비치 드레스,23400,19800,-3600
2018-06-01,319176073,F012050,의료측정기,녹십자 CF155f 전자 혈압계 혈압측정기+사은품3종,53970,45000,-8970
2018-06-01,550764799,A011100,라면,납작당면 500g/1kg 당면 화미랑면/잡채/찜닭당면,3900,3900,0
2018-06-01,1228384566,C012040,여자학생복,포켓 청 단가라 셔츠 BN1147M801S 빅사이즈 여성셔츠,65380,65380,0
2018-06-01,1708405277,A014030,치즈,건국모짜렐라 피자치즈2.5kg /건국하모니2.5kg,18900,18900,0
2018-06-01,607308121,C013040,청바지,[게스키즈] 게스키즈오리지널스키니진G81KDP931,59000,49000,-10000
2018-06-01,760240593,F012020,생리대,[위스퍼]보송보송 오버나이트 슈퍼롱 20Px2팩,15900,15900,0
2018-06-01,1733044315,E031030,전자레인지,대우전자 전자레인지 전자렌지 대우 혼밥 KR-M202BGP,52900,52900,0
2018-06-01,324957512,A013070,굴,[새우몰]손질이 필요없는 꽃게 절단꽃게/양념꽃게장,2900,2900,0
2018-06-01,197375909,I031040,생화,나노카본 레베즈 첼린져 루어낚시대/쭈꾸미 갈치 농어,47000,44650,-2350
2018-06-01,208209559,A012060,햄및베이컨,특가 베이컨 슬라이스 1kg / 뭉치형 다이싱 파지 4종,8500,8500,0
2018-06-01,798294333,C012040,여자학생복,[로엠][로엠] 시스루 숄더 블라우스 RMYW525100,6700,6370,-330
2018-06-01,1805493708,L021020,장신구,스와로브스키Swan Facet Black 5281275 목걸이,152000,152000,0
2018-06-01,1242589039,C013020,티셔츠,셔링미니슬림티(RDD_1603) 박스티셔츠 캐주얼티셔츠,15000,15000,0
2018-06-01,1245122109,F012010,종이기저귀,하기스 네이처메이드 first care 1~4단계.기저귀,20500,20500,0
2018-06-01,1480565207,I031010,장난감,와우토이즈 맥스 모터바이크,34450,34450,0
2018-06-01,566261145,A018060,스낵과자,청정원 츄앤 군밤츄 80gx10봉/고구마츄,16910,16910,0
2018-06-01,75543573,C012020,원피스,미니 롱 섹시원피스 투피스 비치웨어 비치원피스 정장,93000,46500,-46500
2018-06-01,545952743,C013020,티셔츠,여성 I LOVE PARIS 스판 반팔티셔츠(힙커버),14900,14900,0
2018-06-01,1958401325,C014010,아동복,여아블라우스 티셔츠 남방 주니어17호 사이즈까지,20900,20900,0
2018-06-01,1290416112,I031010,장난감,PSN 플러스 12개월 이용권 / 050 안심번호 금지,42800,42800,0
2018-06-01,542408673,C012060,여자내의,[스튜디오럭스]여성린넨슬림핏팬츠3종세트,29900,28410,-1490
2018-06-01,1402412296,C011050,남자내의,[하루특가]르젠 슬랙스/반바지/린넨/면바지/밴딩/데님,14800,14800,0
2018-06-01,122573690,A013160,맛살,올리브녹차 돌자반 70gx20개 입안에서 살살녹는 고,54690,54690,0
2018-06-01,308202874,C013020,티셔츠,봄신상 긴팔 라운드/커플티/남자/여자/티셔츠 면 티,8900,8900,0
2018-06-01,206865769,A012010,국산쇠고기,축협 1등급 한우 갈비선물세트 2.4kg 한우세트 갈비,200000,198000,-2000
2018-06-01,1967610009,A018010,초콜릿,[해태]미니자유시간1통(약80개입) 초코바 초콜릿 간식,11500,11500,0
2018-06-01,1947364000,L021050,우산,명화우산 : 장우산 3단우산 자동우산 고흐 카페테라스,11900,11900,0
2018-06-01,294165767,C012040,여자학생복,아이우먼 루즈 니트 롱 조끼 RM0321RM805 빅사이즈,43900,38710,-5190
2018-06-01,996226959,C013050,운동복,뉴싼타페-미르웨이 후사경/4WD/RV용품/사각지대/후진주차/현대/기아/대우/쌍용,27000,24600,-2400
2018-06-01,631915765,A016060,감,달콤샤르르 자연그대로 만든 아이스 홍시 18개(컵)/개,39300,34590,-4710
2018-06-01,2095952916,A014030,치즈,아메리칸 싱글즈 치즈 16개입 4개+4개 [총 8개],23900,23900,0
2018-06-01,1310489578,C012040,여자학생복,[블루종][블루종]쿨링 베이직 롱 가디건_[B1805CD026B],20800,18720,-2080
2018-06-01,1839870817,C013020,티셔츠,[젤리스푼] 아동 데일리티셔츠 특가모음,4900,4900,0
2018-06-01,521312809,C013050,운동복,트레이닝복/여자트레이닝복세트/추리닝/운동/봄신상,17800,17800,0
2018-06-01,899556844,A013160,맛살,초L프라임) 크랩 맛살 (170G*2),4280,4280,0
2018-06-01,1311380141,C013010,점퍼,(4688)CT200226 검정 슈퍼재생토너 제록스 DP-C1618 (,66340,63030,-3310
2018-06-01,1811188297,C013020,티셔츠,남 솔리드 브이넥 반팔 티 028526/ 지오다노,8000,6560,-1440
2018-06-01,767903359,C013040,청바지,[젤리스푼]HIT패셔니스타배기핏섬머데님팬츠_RMO,14900,13410,-1490
2018-06-01,1493837027,E041070,밀폐용기,[락앤락] 숨쉬는 유리용기 2P세트 발효용기 과실주병,9900,9900,0
2018-06-01,1298031114,C013030,스웨터,MNT-051 믹스 꽈배기 보카시 단가라 니트 캐주얼니트,42800,42800,0
2018-06-01,431291459,E011020,침대,레이디가구 네스트 저상형 패밀리침대 SS+SS/SS+Q,499000,499000,0
2018-06-01,385002046,I031040,생화,아웃팅 흔들림 없는 캠핑테이블+의자세트 야외테이블,21900,21900,0
2018-06-01,623273574,C014010,아동복,[블루독] 스트라이프티셔츠 (27375-332-10),29000,23780,-5220
2018-06-01,1093401269,E011030,거실장,[채우리] 뮤토 3인용 소파,640000,640000,0
2018-06-01,1967565893,E011060,의자,디자인 원목의자/카페의자/식탁의자/식당의자/의자,24900,24900,0
2018-06-01,1093401268,E011030,거실장,[채우리] 래빗 4인용 소파,710000,710000,0
2018-06-01,1470234102,C013050,운동복,RT8 상하세트 유아상하세트 그레이상하세트,40850,40040,-810
2018-06-01,1757667631,F011150,건강기능식품,여명808 119mlx24캔/다미나909 140mlx15캔/컨디션,69000,69000,0
2018-06-01,1093401267,E011030,거실장,[채우리] 드롭 3인용 소파,530000,530000,0
2018-06-01,631940714,C011030,남자학생복,성조기 빅사이즈 가디건 STJ 빅사이즈,82750,80270,-2480
2018-06-01,1093401266,E011030,거실장,[채우리] 챕터 3인용 소파,300000,300000,0
2018-06-01,1656863694,G011070,자전거,삼천리 700C 다코스 FX 픽시 자전거 스틸 클래식,200000,200000,0
2018-06-01,450164375,C015040,장갑,아놀드파마_APGW_BY1207(여성가죽장갑) 장갑 가죽장갑,21010,18910,-2100
2018-06-01,2100111915,C013010,점퍼,영문후드지퍼야상/항공집업/바람막이점퍼/야구점퍼.,16900,16900,0
2018-06-01,1008640094,E031030,전자레인지,[LG전자] LG전자 MW23ED 인버터 전자레인지 23L (주)대명,128500,128500,0
2018-06-01,1362245486,A016150,아몬드,[아몬드협회공급]1등급 햇 구운아몬드 700g(350gx2봉),8900,8900,0
2018-06-01,451921153,C012060,여자내의,앞슬릿롱데님SK(VA84DKN201Z)/ 반에이크,39800,37020,-2780
2018-06-01,1337121712,C021040,실내화,드라이버 2(런닝화) 런닝슈즈 남성런닝화 남성운동화,78220,78220,0
2018-06-01,1927914094,C013010,점퍼,봄신상 후드집업/후드점퍼/짚업점퍼/후드자켓/운동,19800,17800,-2000
2018-06-01,1939216769,C013040,청바지,봄신상 유아 아동청바지/아동바지/면바지/인기엄선,10000,9900,-100
2018-06-01,220987024,A015020,식용유,오타비오 포도씨유 1L X 4개/코스트코 오일 식용유,22190,22190,0
2018-06-01,485048188,A012010,국산쇠고기,등심세트 4호 (등심 2.4kg)[1+등급이상 / 쇠고기 이력 추적시스템]/ 롯데식품관,315000,315000,0
2018-06-01,351945635,L012060,샴푸,려 자양윤모 샴푸 400mlx3개/4개/탈모방지/트리트먼트,14900,14900,0
2018-06-01,1266431280,C013020,티셔츠,[3+1]M~4XL/반팔티/7부/빅사이즈/오버핏/박스티/남자,9900,9900,0
2018-06-01,2057967218,C012030,여자상의,여름 탑나시원피스/쉬폰/비치/롱/민소매/플라워/끈/랩,29800,29800,0
2018-06-01,674486500,A019180,즉석식품,빅마마 이혜정 즉석요리 골라담기 육개장 갈비탕 외,4350,4350,0
2018-06-01,1249625545,C013050,운동복,컴팩트 팜 광택기 6인치 3300RPM/울트라파워 9인치,53100,51510,-1590
2018-06-01,1093401272,E011030,거실장,[채우리] 버디 2인용 소파,220000,220000,0
2018-06-01,899556821,A013160,맛살,초이스L 게맛살 (300G),1980,1490,-490
2018-06-01,382358940,L021030,가방,페브릭가방/크로스백/숄더백/기저귀/백팩/여행/FR02,24800,24800,0
2018-06-01,1093401271,E011030,거실장,[채우리] 타로 3인용 소파+스툴,350000,350000,0
2018-06-01,1233319374,I031040,생화,아오맥스 TV쇼핑/프리미엄 멀티 낚시대 4종세트/원투,139000,132050,-6950
2018-06-01,468093380,C011050,남자내의,여름신상/슬랙스/빅사이즈/9부/밴딩/남자/남성/슬렉스,19700,19700,0
2018-06-01,899556818,A019150,김치,초L)하선정 맛김치 (500G),4480,4480,0
2018-06-01,1093401270,E011030,거실장,[채우리] 플랫 좌식 소파베드,150000,150000,0
2018-06-01,1206657679,C013050,운동복,[마운틴리서치] 성인 아동 봄가을 트레이닝바지 모음,7900,7900,0
2018-06-01,1015626114,A019100,식초,오뚜기 케찹 3.3kg/오뚜기 케찹스파우트팩 3.3kg,4000,4000,0
2018-06-01,981686913,A015010,참기름,오뚜기 옛날 참기름 160ML,5590,5590,0
2018-06-01,981686914,A015010,참기름,오뚜기 옛날참기름 320ML,7590,3490,-4100
2018-06-01,2116245233,A013040,고등어,[새우몰] 12마리 국산 간고등어 무배,9900,9900,0
2018-06-01,652424946,E061060,살충제,퀀텀개미약 마툴키더존킬라 소독셀프겔바퀴벌레약살충,6900,6900,0
2018-06-01,1983287798,C013020,티셔츠,[인디고뱅크/헌트키즈] 핫썸머 준비 특가!(앵콜),10300,10300,0
2018-06-01,1114240549,E041050,냄비,네오플램 롯데 세신 이유식냄비/소스팬/밀크팬,10900,10900,0
2018-06-01,1662655198,A022040,기능성음료,분말 1L용x20팩+물통포카리스웨트/게토레이파워에이드,21800,21800,0
2018-06-01,1486616316,A022050,탄산음료,코카콜라 스프라이트 1.5L x 12펫/킨사이다/탄산음료,14400,14400,0
2018-06-01,956783496,A016050,밤,생율(150G/봉),5990,5990,0
2018-06-01,198098597,A017220,양파,[흙살림] 친환경 대파 1kg,3500,3400,-100
2018-06-01,1144151553,E011050,책상,높이조절책상/컴퓨터/사무용/작업대/간이/보조/테이블,30000,29000,-1000
2018-06-01,1530592491,C012020,원피스,MELODY F118 아이보리/코트/여자코트/겨울코디/겨울코트/자켓/점퍼 미국 여성토탈브랜,54700,54700,0
2018-06-01,538327782,E011020,침대,(홈잡스) 아메리칸스타일침대 매트리스무료포함,84900,84900,0
2018-06-01,529676462,C012060,여자내의,허리조절 스판 그레이 교복치마 교복 예쁜교복 교복쇼,43580,42280,-1300
2018-06-01,1148461829,A019040,소금,마스코바도설탕20kg 비정제 사탕수수 완정비정제원당,89900,89900,0
2018-06-01,1350617798,A011160,빵,삼립 햄버거빵 36개/핫도그빵 불고기버거 패티 소스,6700,6700,0
2018-06-01,671575600,E061040,부엌용세제,프릴 주방세제 1000ml x 3개 특가 퐁퐁 참그린 트리오,9100,9100,0
2018-06-01,169393620,C014010,아동복,[밍크뮤] 포켓와펜티셔츠 (37445-332-03),29000,23780,-5220
2018-06-01,2104239995,C013030,스웨터,민자 니트 반폴라 티셔트 MRO반폴라니트 목폴라목폴라,48660,48660,0
2018-06-01,1387677844,C013010,점퍼,AG 여성 기모 후드 집업점퍼 AG 점퍼 후드집업점퍼 후,26230,26230,0
2018-06-01,1193153537,C012060,여자내의,32-40 여름반밴딩슬랙스 키큰언니밴드바지 빅사이즈,34800,34800,0
2018-06-01,1630510911,E061020,섬유유연제,FC 베이비전용 세탁세제 (refill) (#10046),18440,16420,-2020
2018-06-01,1661332944,L021030,가방,[메트로시티]메트로시티 숄더겸 크로스백 J71MF150Z/J71MF150N/J71MF150M[갤러리아],248040,198440,-49600
2018-06-01,895745646,A011120,두부,동서 콘푸라이트 600G,5950,3490,-2460
2018-06-01,1722522185,E031140,비데,대림도비도스 방수비데2 음성 DLB-860vo +정품필터2개,239000,235000,-4000
2018-06-01,895745649,A021020,차,[동서]동서 프리마 (500g),2800,2800,0
2018-06-01,895745648,A021020,차,[동서]동서 프리마 (1kg),4900,4900,0
2018-06-01,1010319820,F011130,홍삼,정관장 홍삼원골드 50ml x 30포 X 2박스/쇼핑백 증정,140000,61800,-78200
2018-06-01,895745645,A011120,두부,[동서]동서 콘푸라이트 (300G),3590,3590,0
2018-06-01,895745644,A011120,두부,[동서]동서 오곡 코코볼(300G),3990,2990,-1000
2018-06-01,2104418587,C013010,점퍼,빅사이즈 야상 딜러자켓 야상바람막이점퍼남자 바람막,108650,108650,0
2018-06-01,60065609,I012010,컴퓨터,폭풍할인 199만원구매더블할인쿠폰증정DM800V7A-A716A,2207360,2097000,-110360
2018-06-01,490438865,C011030,남자학생복,남자셔츠 헨리넥 도트 패턴 셔츠 남성셔츠 셔츠 남성,34840,34840,0
2018-06-01,892714981,C011030,남자학생복,[인터페이스] 간절기 필수템! 가디건 모음전 모두의,17700,17700,0
2018-06-01,21063082,A014010,우유,녹차(라떼 세미 500g) X 6 분말 파우더 보성 식당용,51040,51040,0
2018-06-01,1698698780,A012060,햄및베이컨,[홈플러스][행사상품]CJ_스팸클래식+스팸마일드_200Gx5+200G,15790,15010,-780
2018-06-01,1314198898,A019160,밑반찬,[행사/20+2개 추가증정]안동낫또 생청국장 22개/낫토,25900,21900,-4000
2018-06-01,294165709,C012040,여자학생복,아이우먼 쿨니트 버튼 조끼 EB2246M805 빅사이즈,31800,28000,-3800
2018-06-01,1724205180,A011120,두부,독일 하네 뮤즐리 1Kg 3개 시리얼 오트밀,20700,20700,0
2018-06-01,413970130,E011020,침대,20년전통 효암 돌침대 / 보료 흙침대 퀸 HM1000SQ,900000,890000,-10000
2018-06-01,1270356270,A016040,포도,동원)황도 슬라이스 400g x 12개 사시사철 맛있는,39920,39920,0
2018-06-01,242420631,C015030,넥타이,(색상 : 골드) BTIE_062 파스텔 유광 보타이,12740,12740,0
2018-06-01,985236878,L012080,화장지,초L)미용티슈180매,990,990,0
2018-06-01,1988951557,E061030,전구,백열전구 백열램프 크립톤 미니크립톤 60W 100W E26,1300,1300,0
2018-06-01,2095553260,C013020,티셔츠,[대구백화점 I관] [애녹]고양이핫피스티셔츠(AU414T),15000,13350,-1650
2018-06-01,1987647015,E031140,비데,{사은품증정} 노비타비데 BD-N330T 생활방수 ipx4,159000,159000,0
2018-06-01,831446885,A019040,소금,3년간수 뺀 천일염10kg (5kg*2팩)신안군추천상품 소금,19000,19000,0
2018-06-01,631579691,C013040,청바지,남자청바지 패치청바지 빈티지진 스키니진 일자청바지,27500,27500,0
2018-06-01,421843599,I011010,TV,[아남TV] 가정의달 특가 할인/55인치 UHD TV/삼성패널,499000,469000,-30000
2018-06-01,1450127983,C012030,여자상의,왕박시청후드원피스(WW_1711) 빅사이즈,58080,58080,0
2018-06-01,889253025,A013030,조기,제주 해바라기 참조기 3호500g이상 x 3줄 깨끗한 해역,121500,121500,0
2018-06-01,889255688,C011020,남자상의,빅사이즈 패딩 패딩점퍼 WC 남자 헤비패딩 JK045M 패,114700,114700,0
2018-06-01,1223500796,C011020,남자상의,MJ_1136 네이비 더블트렌치,241920,215310,-26610
2018-06-01,797054846,E031140,비데,[본사직영점][중소형도기전용] 노비타비데 BD-N330AS,179000,159000,-20000
2018-06-01,491811923,C013010,점퍼,(냉장)서울우유슬라이스치즈업소용 1.8kgX4개-묶음배,144940,144940,0
2018-06-01,1372089015,C013050,운동복,후드 반팔 티 5부 팬츠 바지 봄 여름 트레이닝복 세트,24900,24900,0
2018-06-01,1597182190,F011130,홍삼,정관장 레네세홍삼캔디후(喉),14000,14000,0
2018-06-01,826281820,A012010,국산쇠고기,[무항생제 한우선물세트] 한우 명절 1호 1.5kg,123500,123500,0
2018-06-01,2090046639,C013020,티셔츠,커터앤벅 남성 면 반팔티셔츠 - SL-12-162-101-62,54900,49900,-5000
2018-06-01,495945462,C013050,운동복,카엑스512 일반승용차용 차량트렁크 네트 그물망 차량,19810,18060,-1750
2018-06-01,331299027,A013070,굴,대게살 1kg 동해안 자연산 홍게로 만들어 바로먹는,18500,18500,0
2018-06-01,1000175703,C012060,여자내의,남성래쉬가드긴바지 DHO3370-1 커플여자비치웨어시원,8840,8840,0
2018-06-01,43064135,A013140,북어채,고소한 황태채/북어채/진미채/반건조노가리 700g/안주,7500,7500,0
2018-06-01,226499584,E041050,냄비,HM 퀸센스 인덕션 스텐 냄비 모음/편수 양수 국 찌개,11000,11000,0
2018-06-01,1092330462,C012040,여자학생복,[어반프랑] 피그 에이라인 린넨탑 나시블라우스/ 어반프랑,31300,25040,-6260
2018-06-01,1823453016,A021010,커피,화이트골드커피믹스 400T/모카골드420T,40900,40900,0
2018-06-01,2094227388,F012020,생리대,쏘피 귀애랑 중형20x2팩+증정10P/생리대/바디피트,9500,9500,0
2018-06-01,1471618285,A015020,식용유,참푸드 참맛기름(맛기름대용) 1.8L/맛기름/향기름/,8600,8600,0
2018-06-01,1630857603,I031040,생화,NS 서프25-450(신형)원투낚시대가장선호하는사이즈,79000,71300,-7700
2018-06-01,1763063094,I031040,생화,대한민국 재난용품 전문 브랜드-은박 비상 담요 침낭,350,350,0
2018-06-01,1825247723,E021010,침구,겨울왕국 면기모 패드 - 뷰티선샤인 (064187) 패드 캐,61750,55110,-6640
2018-06-01,895745673,A014030,치즈,[동서]동서 필라델피아 크림치즈 200G,5750,5750,0
2018-06-01,1150736382,A022050,탄산음료,데미소다/250mlx30캔/애플/오렌지/사과/탄산음료/,11900,11900,0
2018-06-01,1776171986,C013020,티셔츠,아동기본반팔티셔츠/유아나시/남아여아의류/아기옷,7800,7800,0
2018-06-01,1346043670,C012060,여자내의,쿠스피아 밍크퍼 밴드스키니 SD 5303,18020,18020,0
2018-06-01,967134790,I031070,애완동물관리비,설치가 간편한 스포츠 네트형 3m/5m 멀티네트,47000,40710,-6290
2018-06-01,384004652,E061030,전구,필립스 산쿄 TUV 자외선 살균램프 4W 6W 8W 10W 15W,4000,4000,0
2018-06-01,62372386,C011050,남자내의,남자/여자/3부/5부/7부/고무줄반바지/밴드반바지,9900,9900,0
2018-06-01,764787092,E031130,보온매트,한일의료기 편백나무 온열매트 2인용,75400,75400,0
2018-06-01,961311578,A018040,아이스크림,하겐다즈 파인트 1개 + 리치몬드 1개,9900,9900,0
2018-06-01,506901627,C014010,아동복,(숲자람) 기능성 키즈 바람막이 어린이점퍼 유아용바,68780,66720,-2060
2018-06-01,590483786,C013020,티셔츠,베르사체 여성 85 반팔 라운드 면 스판 티 이태리 굿,44060,44060,0
2018-06-01,1540039877,C012040,여자학생복,여성 원피스 롱니트 여자 니트 목폴라 세터,48970,48970,0
2018-06-01,2000918510,A018010,초콜릿,[킨더] 킨더초콜릿 킨더조이 보이 T1 1개 어린이 초코 과자,1090,1090,0
2018-06-01,672020144,A019080,고추장,청정원 쇠고기볶음 고추장(60G*3입),4760,4760,0
2018-06-01,1244346860,C013020,티셔츠,T1430-절개 후드 롱 심플 티셔츠 여성데일리셔츠 여자,22100,22100,0
2018-06-01,591615950,A016090,참외,대용량 성주참외 9kg 특가,11900,11900,0
2018-06-01,1531457112,C012020,원피스,MELODY F101/코트/여자코트/겨울코디/겨울코트/자켓/점퍼 미국 여성토탈브랜드 멜로디,64700,64700,0
2018-06-01,2070291392,E031140,비데,{본사직영점} 노비타 비데 BD-KA311SG / BD-KN330,179000,179000,0
2018-06-01,105037461,L021060,유모차,[[보온성~기능성~UP~!!]]마니또/쿨키즈/마루스/엘레강스~유모차커버모음전/스토케/바람,26400,25900,-500
2018-06-01,344031070,A021010,커피,[맥널티]포션커피(4종) 8개입 3개 무료배송 골라담기,10530,9900,-630
2018-06-01,2095240363,C012020,원피스,[베스티벨리]나그랑 스트라이프 트위드 오픈 자켓 (BMJAD2129)_J2C6,49900,47410,-2490
2018-06-01,1353959131,G011070,자전거,700C 레브 7 자전거 여성용자전거 커플하이브리드 휠,310840,254520,-56320
2018-06-01,461174826,G011070,자전거,[아펙스]상품평행사/샤인 20인치 7단 접이식자전거,79900,76900,-3000
2018-06-01,2143208360,A017200,토마토,햇 가지-1.5kg.2.5kg.5kg,14900,14900,0
2018-06-01,1709841970,C013040,청바지,마인드브릿지[컬러5종] 남성 허리옆사이드밴딩크롭테이퍼드팬츠_MRPT3101,59900,47920,-11980
2018-06-01,852779916,C012040,여자학생복,라코스테 여성 폴로티 원피스 스웨터 가디건,89900,89900,0
2018-06-01,29863824,A014040,발효유,[파스퇴르] 파스퇴르 쾌변요구르트 150ml 15개,18500,18500,0
2018-06-01,661946520,L021020,장신구,실버/팔찌/은팔찌/팔찌/염주/불교용품/합장주/부적/향,59900,59900,0
2018-06-01,361850704,E021020,커튼,/롤러블라인드 화이트 스콕스클뢰베르 140x195 cm/ 블,78720,70070,-8650
2018-06-01,2098428551,E061040,부엌용세제,(초특가)주방세제1L x6개 자연퐁 트리오 퐁퐁,10000,7800,-2200
2018-06-01,2024013327,C021040,실내화,윌슨 러쉬 프로2.5 테니스화 ( WRS322600 ) 차콜,137290,137290,0
2018-06-01,204449975,I031040,생화,GDF 인피니티A2 1-530 바다찌낚시대/1호대/국산낚시대,175000,161000,-14000
2018-06-01,1160882252,C013020,티셔츠,[엠폴햄] 오픈카라 파자마 반팔 셔츠 EPY2WC1382A,49900,44910,-4990
2018-06-01,1999469250,A013170,생선통조림,[특가]참치캔100g/동원참치/오뚜기참치/고추참치캔,10900,10900,0
2018-06-01,1607103570,A014020,분유,프랑스직수입 베비언스 가루분유 0~36개월 800g,12000,12000,0
2018-06-01,1345295596,C013050,운동복,삼항ㅁ12V용 차량용 LED디지털시계+디지털볼트메타+디지털온도계 3개를 한번에/시거잭,16900,14540,-2360
2018-06-01,802450435,C015020,모자,모자 메쉬캡 매쉬캡 메쉬모자 볼캡 야구모자 여름모자,9900,9900,0
2018-06-01,135123485,L021050,우산,[우산 149종 초특가] 우산 장우산 3단우산,3300,3300,0
2018-06-01,1077402340,E031140,비데,NK[신제품]노비타 스마트 비데 BD-AE500 (생활방수),209000,189000,-20000
2018-06-01,347136460,A014020,분유,순산양유아식 4단계 800g/ 아이배냇,32900,32900,0
2018-06-01,1099694036,E031050,냉장고,1등급 김치냉장고 102L 클라쎄 FR-Q12RASK,519000,498240,-20760
2018-06-01,355720896,C013010,점퍼,[포래즈]감싸안는 바람막이_F17D2JP401/ 포래즈,15000,14100,-900
2018-06-01,2126361361,I031040,생화,쿨러백 보온보냉가방 도시락가방 보온백 아이스박스,7900,6870,-1030
2018-06-01,986279568,E041040,프라이팬,실바트 인덕션겸용 IH궁중팬 28CM,31900,31900,0
2018-06-01,1483339427,C013010,점퍼,[포에버21]새틴 봄버 자켓/FOREVER21/점퍼/블루종,30900,15450,-15450
2018-06-01,393443896,C012040,여자학생복,다니엘크레뮤 코튼 니트 재킷(800469810)/ 스타일온에어플러스,59000,53100,-5900
2018-06-01,315528121,F011150,건강기능식품,[동화약품] 동화약품 부채표 까스활 75ml(10병)소화제/까스활명수,6900,6900,0
2018-06-01,978869901,E011020,침대,파로마 마들렌 LED 올인원 수납 침대(매트리스 포함),140400,140400,0
2018-06-01,877058104,A019160,밑반찬,놀부밥버거 소불고기 제육볶음 닭불고기 3종,16680,16680,0
2018-06-01,1429383431,F012010,종이기저귀,팸퍼스 베이비드라이 기저귀 파우더향 2~6단계,65900,62600,-3300
2018-06-01,322938857,C011030,남자학생복,FSSF18005 배색포켓 스트라이프 셔츠 남자셔츠 스트라,22050,22050,0
2018-06-01,1985968840,A012010,국산쇠고기,정남진 장흥한牛 장흥한우 국거리용 1kg/500g 2팩 /(,107500,94600,-12900
2018-06-01,430386232,C012040,여자학생복,[모다아울렛][메케나]오버핏블라우스MX2A2BL0990,49000,45570,-3430
2018-06-01,1836823227,E031110,청소기,무선청소기/진공청소기/핸디청소기/UVC-1891P,87000,87000,0
2018-06-01,1744550366,C012040,여자학생복,하얀비2000원쿠폰/롱조끼/폴라/라운드니트가디건100종,21800,19800,-2000
2018-06-01,978201481,A019050,간장,계란에뿌리는 간장소스150ml/일본계란간장/타마고간장,4250,4250,0
2018-06-01,1161223896,A019170,냉동식품,아하만두 특가 사은품증정행사 감자만두 꼬물이만두,6500,6500,0
2018-06-01,439493220,E021020,커튼,일루션 9800원암막특가판매/방풍방한/DTP/북유럽커튼,9800,9800,0
2018-06-01,2074598004,C013040,청바지,본(BON) BN5FTA302 BE 베이지 컬러 슬림핏 캐쥬얼 면 바지,30000,24900,-5100
2018-06-01,321397466,F012050,의료측정기,브라운 체온계 IRT-6520 IRT-6510 IRT-6030 /굿,76080,70000,-6080
2018-06-01,1526677461,A017220,양파,쪽파/종자/종구/씨앗/kg단위/소포장/국내산쪽파종자,12500,12500,0
2018-06-01,458945802,A022020,두유,삼육 두유 24/32/48팩 파우치 모음 검은 콩 두유 A B,15000,9900,-5100
2018-06-01,1806420301,L021020,장신구,[바보사랑]팔찌 211544102,125000,125000,0
2018-06-01,989106580,E061040,부엌용세제,[애경]애경)엄마의선택베이킹소다1KG,3000,3000,0
2018-06-01,1806420300,L021020,장신구,[바보사랑]팔찌 121626002,99000,99000,0
2018-06-01,1693728415,A013140,북어채,AAA 최고급 설원 황태채 500g×2봉,24900,24900,0
2018-06-01,866335346,E031080,선풍기,이엠케이 벽걸이 PTC히터 EWH-S1516 [12시간 타이머 / 자동온도조절 / 과열 안전장치],72000,72000,0
2018-06-01,1806420305,L021020,장신구,[바보사랑]팔찌 241533102_PMMAPB24001,95000,95000,0
2018-06-01,1177274134,C013040,청바지,지오다노 01117515 라이트웨이트 테이퍼드 슬랙스 117515,35000,29050,-5950
2018-06-01,1806420303,L021020,장신구,[바보사랑]팔찌 601533092_PMMAPB60022,95000,95000,0
2018-06-01,1915506448,A015020,식용유,오뚜기 프레스코 포도씨유 500ml X 20EA(Hanworld),154500,131330,-23170
2018-06-01,1806420306,L021020,장신구,[바보사랑]팔찌 161533102_PMMAPB16002,105000,105000,0
2018-06-01,2005201510,C011020,남자상의,(무료배송) AG 체크자켓 자켓 DB789 790 바둑체크 체,208920,183850,-25070
2018-06-01,507349729,C013040,청바지,[나나진]신상/배기진/슬림/스판/밴딩/면바지/와이드,23900,19900,-4000
2018-06-01,1597208920,F011130,홍삼,정관장 레네세홍삼젤리,15000,15000,0
2018-06-01,1857070959,A022050,탄산음료,롯데 칠성 사이다 190ml 30캔/ 캔음료 음료수 탄산음,10200,10200,0
2018-06-01,895802126,A019100,식초,[대상]대상 유기농 케찹 (400g),5700,5700,0
2018-06-01,1078859242,G011070,자전거,알톤 코렉스 HCR 21 / 700C하이브리드형 /시마노 원터,215000,189630,-25370
2018-06-01,971432930,C013020,티셔츠,3XL/베이직남자티/스트라이프/헨리넥/기본티/빅사이즈,14800,13800,-1000
2018-06-01,157559665,E031070,에어컨,프리미엄타워형선풍기/리모컨식/음이온방출/UMF-TR161,59700,59700,0
2018-06-01,11339394,A013140,북어채,무료배송/ AAA 최고급 설원 황태채 300g/ 시원한국물,13900,12900,-1000
2018-06-01,949316977,A013030,조기,[영광굴비] 영광굴비/굴비/보리굴비/법성포굴비/참조기/명절선물,128900,128900,0
2018-06-01,267032692,C012030,여자상의,원피스토리/아사면레이스 끈조절원피스/레이어드나시,16900,16900,0
2018-06-01,1319081552,C011050,남자내의,하복 스판 연베이지 교복치마 학생 고등학교교복 교복,43950,43950,0
2018-06-01,1397268722,A011030,찹쌀,두레생협 오가닉햇보리3곡 식당햇보리 햇보리 국산보,20160,20160,0
2018-06-01,1473278353,C012030,여자상의,청원피스/멜빵원피스/데님원피스/뷔스티에 원피스,22900,22900,0
2018-06-01,592280813,A022050,탄산음료,델몬트 175mlx30캔 외 음료수 캔음료 캔커피,5400,5400,0
2018-06-01,20068036,F011150,건강기능식품,여명808 119ml 10캔//음주전/음주후/헛개/숙취/음료,32000,32000,0
2018-06-01,1875336131,A019130,스프,오뚜기 쇠고기스프 ( 80g x 10 ),26400,23500,-2900
2018-06-01,1046353071,E011020,침대,침대판매1위/삼익가구 앤디 LED 6단 멀티 수납 침대,116100,116100,0
2018-06-01,866335320,E031080,선풍기,세신 소형 PTC히터 SP-1800W,26970,26970,0
2018-06-01,866335321,E031130,보온매트,동천 웰빙 다용도 쇼파 전기방석 DC-701 [3인용 / 전자파 차단 원단 내장],69000,69000,0
2018-06-01,265506637,A011010,쌀,17년산 임실농협 행복드림 신동진 쌀 20kg / 최근도정,46200,46200,0
2018-06-01,90373631,C013010,점퍼,딸기퍼집업/보아털안감집업/여아점퍼/아동겨울집업,33900,19900,-14000
2018-06-01,627220544,L012010,면도기,도루코 일회용면도기/휴대용면도기/터치3/3중날/6중날,12000,12000,0
2018-06-01,1857043308,A022050,탄산음료,총 24종/음료모음/레쓰비/맥콜/캔커피/캔음료/음료수,5800,5800,0
2018-06-01,1722573356,E011060,의자,시팅포인트 컴퓨터 사무용 학생 메쉬의자,52900,47610,-5290
2018-06-01,866335324,E031080,선풍기,PTC 미니 히터 KA-P16 [쾌속난방 / 전도안전장치 / 온도조절 2단계 / 탁상형],39000,39000,0
2018-06-01,1577567886,C011050,남자내의,아디다스 여성 에센셜 리니어 타이츠 ( BR2523 ),51740,43980,-7760
2018-06-01,2135944814,F012010,종이기저귀,(신제품)팸퍼스 베이비드라이 밴드4단계 L60매 x1팩,19900,19900,0
2018-06-01,578202151,L021030,가방,여성가방/숄더백/크로스/클러치/미니/체인/가죽/OP01,38900,38900,0
2018-06-01,193731041,I031040,생화,캠핑 해먹스탠드 그물 해먹 거치대 스텐드 야전침대,50000,45910,-4090
2018-06-01,170644032,C013040,청바지,[게스]GUESS 여성_[기획] L톤 구제 앵클스키니(YI2D9081),70200,58970,-11230
2018-06-01,350304209,C013020,티셔츠,T691-세련된 여성 데일리 티셔츠 캘리t 롱티셔츠 라운,19940,19940,0
2018-06-01,2000085576,E061020,섬유유연제,F C 베이비전용 세탁세제 refill 유아세정제 유아세탁,22480,22480,0
2018-06-01,1783184225,E011030,거실장,로딘 아슬란 4인 식탁세트,572000,572000,0
2018-06-01,1783184224,E011030,거실장,로딘 아슬란 4인 식탁세트,603000,603000,0
2018-06-01,866335319,E031080,선풍기,한일 PTC히터 HEFW-2170R [벽걸이형 오토스윙기능 순간난방 가능 리모콘조작,129000,129000,0
2018-06-01,1077778762,E041010,식기,면기 우동기 라면그릇 우동그릇 볼 공기 멜라민그릇,3650,3300,-350
2018-06-01,866335315,E031130,보온매트,탄소전기장판 DEM-3607 [더블 / 절전조절기 / PVC원단],69000,69000,0
2018-06-01,866335316,E031130,보온매트,탄소전기장판 DEM-102 [싱글 / 절전조절기 / PVC원단],59000,59000,0
2018-06-01,397690078,E011060,의자,의자[델타체어][난초체어]책상의자/사무용의자/학생의자/컴퓨터의자/아동의자/회전의자,59900,59900,0
2018-06-01,1295175823,C012020,원피스,[더아이잗][더아이잗] 더아이잗 집업 울혼방 코트 IGAA0CT26 (P000363380),79000,71100,-7900
2018-06-01,522922164,C011030,남자학생복,커플반바지/꽃남방/하와이안셔츠/레시가드/레쉬가드,23200,23200,0
2018-06-01,455242816,E061030,전구,LED전구/할로겐/조명/삼파장/램프/형광등/연장소켓/볼,1000,890,-110
2018-06-01,431641715,C011030,남자학생복,설레는 핏 봄신상 남성 그레이 노버튼 골지 롱가디건,37010,37010,0
2018-06-01,926992355,A022050,탄산음료,천연사이다190mlX30캔/콜라/캔커피/음료수/사이다,5210,5210,0
2018-06-01,285728621,C012040,여자학생복,[꼼빠니아][꼼빠니아] 앞뒤배색 블라우스 CA6U4-WRB010_380 (P000339663),21600,19440,-2160
2018-06-01,711393321,C011050,남자내의,남자 린넨바지 마바지 9부 밴딩바지 와이드 린넨팬츠,20000,18500,-1500
2018-06-01,508490446,C012060,여자내의,[쿠키세븐]P6556 린넨 슬릿 큐롯팬츠,29800,28310,-1490
2018-06-01,1530624102,C012020,원피스,MELODY F139 핑크/코트/여자코트/겨울코디/겨울코트/자켓/점퍼 미국 여성토탈브랜드 멜,98700,98700,0
2018-06-01,1046928258,E041050,냄비,특가 통 스텐냄비/스텐후라이팬/인덕션후라이팬/냄비,24000,24000,0
2018-06-01,1118415629,A018080,설탕,유기농 비정제설탕 마스코바도설탕 1kg,6200,6200,0
2018-06-01,1878453211,I031010,장난감,(1년as 1장게임증정) ps2 플스2 모든 플레이스테이션2,34990,34990,0
2018-06-01,1751132070,I012060,저장장치,씽크웨이 CROAD M560 WHEEK 게이밍 마우스 7버튼,36100,31000,-5100
2018-06-01,790330527,I031040,생화,♣초강력 Q3 CREE LED♣X2000줌라이트/랜턴/헤드랜턴/손전등/후레쉬/렌턴/LED후레쉬/L,8000,6900,-1100
2018-06-01,320348601,A013040,고등어,노르웨이 고등어 순살 10팩(특품),19500,19500,0
2018-06-01,1701604192,C013010,점퍼,라운드패딩 루즈핏 겨울 패딩코트(블랙 그레이),68000,68000,0
2018-06-01,1320806612,A018090,잼,오뚜기)딸기쨈 300g x 5개 국산딸기 신선한 과일 알,24760,24760,0
2018-06-01,60712365,C013050,운동복,[스타일리쉬위즈] 스타투스 신형 도어가드 자동차가드 보호대 차량용품,8700,7750,-950
2018-06-01,832025472,A022010,주스,해태)썬키스트포도 1.5L-M805018 문구 커피 녹차 사무,8020,8020,0
2018-06-01,1173969819,C014020,유아복,[파코라반베이비]유니여아상하PT310369[갤러리아],29600,22800,-6800
2018-06-01,1342864362,E061040,부엌용세제,참그린 순수발효 주방세제500gx4개 퐁퐁/트리오/리필,6900,6900,0
2018-06-01,1609152515,E061050,청소용세제,(초특가)정품 유한락스 2L 레귤러 박스/말통/무료 P,22290,22290,0
2018-06-01,1499602871,L021010,손목시계,젤리 아쿠아 방수시계 아쿠아손목시계 방수시계 방수,13790,13790,0
2018-06-01,1997858297,A013160,맛살,다인 크래미 1kg 모음전/샐러드/게맛살/맛살/게살,4070,4070,0
2018-06-01,1255827435,A017210,파,특가 4kg 맛있는 찰토마토,12900,12900,0
2018-06-01,1407306340,F012010,종이기저귀,(공식) 18년 군기저귀 오리지널 팬티 XXL (28매)X3팩,43900,43900,0
2018-06-01,605902019,C012020,원피스,[나인(NAIN)]린넨 시스루 베이직 더블 코트(CT-994)(센텀시티점),98000,90310,-7690
2018-06-01,773188432,A013090,전복,무배 HACCP 냉동 손질한 자숙 홍합살 400g 2봉 해산물,17380,17380,0
2018-06-01,1679065548,C013010,점퍼,패치시보리점퍼/초등학생점퍼/ 아동아우터/여아잠바,22900,17900,-5000
2018-06-01,419469837,A018010,초콜릿,워커스 어쏘티드 토피 대용량/오스카초콜릿 초코렛,8800,8800,0
2018-06-01,659620399,C012040,여자학생복,[에이비에프지] 여름특가 자켓/티셔츠/블라우스 9 000원~,69000,19000,-50000
2018-06-01,577155881,C013020,티셔츠,폴로 랄프로렌 빅포니 PK 카라 티셔츠 / 하루배송,29000,29000,0
2018-06-01,247366165,L021030,가방,소가죽서류가방/책가방/학생/남성/백팩/크로스백/CM02,118900,118900,0
2018-06-01,1721223342,C013010,점퍼,[대구백화점 II관] [리바이스]여성 밀리터리 자켓(38987 0000),99000,86130,-12870
2018-06-01,1800342091,A017140,콩나물,도라지가루 200g 도라지가루효능 약도라지 도라지효능,18660,18660,0
2018-06-01,350068828,C012040,여자학생복,여성 롱니트 KKS 랙앤볼 사선지퍼 니트,55840,55840,0
2018-06-01,1383295495,C021040,실내화,치어리더 7cm 키높이 통굽 운동화 도우미신발 스탠딩,34000,34000,0
2018-06-01,2109099679,F012020,생리대,뉴 화이트슬림 일반 특대형 생리대 10pX10팩=100p/화이트생리대/화이트특대형생리대,31900,31900,0
2018-06-01,603013437,F012010,종이기저귀,[마미포코] 마미포코 보송허그 밴드기저귀 신생아 공용 70매x3팩,39500,39500,0
2018-06-01,733396662,C014010,아동복,한국생산 쫑긋 유아정장5종세트(3-36개월)203418 유아,66120,66120,0
2018-06-01,1290712885,A017150,버섯,머리딴 두절 콩나물 1Kg,4440,4440,0
2018-06-01,321167137,E031050,냉장고,K417SW11 o클릭o/402L/정온냉동/쿨링케어,1523680,1523680,0
2018-06-01,1663036441,C012040,여자학생복,[무료배송]Y702_따뜻한 울혼방 베이직가디건,17900,17900,0
2018-06-01,421444022,C013050,운동복,타이어압력게이지_3.0-99.5PSI_1EA 압력게이지 타이어,36050,36050,0
2018-06-01,408142377,C012040,여자학생복,[젬마월드]Ringo-체크반팔셔츠 파스텔/데일리,27000,27000,0
2018-06-01,1265986795,C013010,점퍼,빅사이즈 박스후드티 TD 후드집업 후드 후드자켓 패션,65000,64350,-650
2018-06-01,690280051,C011050,남자내의,엔투시아즘 투 라인 트랙팬츠,50000,34900,-15100
2018-06-01,1314375130,E061030,전구,금호전기 고효율 LED직관형광등/LED형광등/LED주차등,20900,20900,0
2018-06-01,54173015,C021040,실내화,[페이퍼플레인] 운동화/커플신발/키높이/에어쿠션,24800,24800,0
2018-06-01,1224505079,A022010,주스,프리미엄 천연 코코넛워터 지코 ZICO 330mlx24개,34500,34500,0
2018-06-01,287446286,C013010,점퍼,[바비앤펌킨]촉감대박 무스탕자켓,145600,131040,-14560
2018-06-01,983505961,A013100,마른멸치,전복(중),1780,1700,-80
2018-06-01,1296374420,C013020,티셔츠,신상 반팔티/티셔츠/롱티/루즈핏/여성의류/빅사이즈,10800,9800,-1000
2018-06-01,1151677399,A018080,설탕,비정제설탕 원당(천연당) 고그린원당15Kg(마대) 설탕,19900,19900,0
2018-06-01,1760455966,D031010,주택수선재료,건축용 수성발수제(워터씰 SI1200Z) 18L 실리콘/발수,55000,52250,-2750
2018-06-01,220737945,C013040,청바지,바잉몰 스판 스키니/와이드청바지/부츠컷/슬랙스,9900,9900,0
2018-06-01,1206332526,I031040,생화,캠핑악세사리/팩망치/캠핑해머/야광로프/스트링/단조,6800,6260,-540
2018-06-01,705642796,E061010,세탁세제,(PLM바르는테크 220ml 남방카라세제 기능성세제 찌든,8970,8970,0
2018-06-01,1589514842,E041050,냄비,키친아트 국산 일품 스테인레스 전골냄비 인덕션 겸용,39600,39600,0
2018-06-01,1704314436,A021010,커피,(드립커피모음) AGF블랜디/UCC/맥심/일본커피,6200,6200,0
2018-06-01,1237143434,I031010,장난감,PS4 프로7117B(1TB)새제품/국내정발/바로택배발송,670000,670000,0
2018-06-01,1089622463,A022050,탄산음료,동]데미소다 250ml x30/애플/오렌지/레몬/포도/자몽,11700,11700,0
2018-06-01,1836607408,E031120,믹서,사은품 공식인증점 리큅 RPM Cube BS5 블랜더 믹서기,215240,187010,-28230
2018-06-01,77046934,A017110,감자,장흥표고_백화고세트500g건강식품 명절선물세트 특산품 추석선물세트 효도선물 표고세,243000,243000,0
2018-06-01,108383733,L012060,샴푸,아로마티카 티트리 퓨리파잉 샴푸 900ml+미니50ml,31100,31100,0
2018-06-01,383419921,C013020,티셔츠,빅사이즈민짱/나시모음/55~100/롱/망고/무지/라운드,5900,5900,0
2018-06-01,1743057746,A019180,즉석식품,[베지푸드]인기 콩고기 모음전/다이어트식품,4900,4900,0
2018-06-01,605088638,A019080,고추장,다인 푸른식품 초고추장 말통 13kg 초장 회초장,28900,28900,0
2018-06-01,657892859,A017010,배추,곰보배추건초 300g - 국산 건곰보배추 말린곰보배추,20000,19800,-200
2018-06-01,422491516,C013050,운동복,SET054-단추 뷔스티에 스커트 투피스 세트 트레이닝복,29850,29850,0
2018-06-01,79919912,C014020,유아복,삠뽀요여름신상/상하복/원피스/티셔츠+무료배송,7900,7900,0
2018-06-01,1258765843,I012010,컴퓨터,[가온씨앤씨] 2015 NEW iMac 5K 디스플레이 MK462KH/A 27형 6세대 코어i5/8GB램/1TB하,2470000,2470000,0
2018-06-01,962610324,C011030,남자학생복,[아메리칸웨스트] Ripob 가디건/롱가디건/망또가디건,29800,14900,-14900
2018-06-01,518223030,C014020,유아복,단가라 골지레깅스 아동복 유아동복 유아레깅스 아동,5040,4890,-150
2018-06-01,2065052271,C012060,여자내의,SK1622-체크 플레어 미디 스커트 FREE(44~66) 플레어,23270,23270,0
2018-06-01,440918002,C012040,여자학생복,[블루종]엔젤 쉬폰 소매 미니 가디건_[B1806CD029B],31000,24520,-6480
2018-06-01,896511833,L012010,면도기,질레트/프로쉴드/프로글라이드/퓨전4입 면도날/면도기,19800,19800,0
2018-06-01,450250868,A015020,식용유,백설 카놀라유 0.9L 식용유 튀김용오일 다용도식용유,14400,14400,0
2018-06-01,732443258,E041020,컵,한국도자기 2인조 커피잔 모음 부부찻잔  선물세트,42400,42400,0
2018-06-01,1840423431,L012060,샴푸,루트하우스 앤코어 샴푸 500ml 탈모완화 천연샴푸,37000,36000,-1000
2018-06-01,1341579272,C011020,남자상의,여름용 허리밴드 스판 가볍고 시원한 정장바지,19800,19800,0
2018-06-01,1370417370,E041070,밀폐용기,락앤락 간편식 글라스 컵 용기 550ml/전자렌지 오븐,7900,7900,0
2018-06-01,458536337,A013170,생선통조림,특가/오뚜기 참치 150gx12개/고추참치/살코기/참치캔,19900,19900,0
2018-06-01,2092292074,C012030,여자상의,데일리앤 여름신상 무지원피스 롱원피스 홈드레스,24400,23400,-1000
2018-06-01,188772508,C011030,남자학생복,[지오다노] 048303 포플린 셔츠 (40수)/ 지오다노,23000,18630,-4370
2018-06-01,2021920610,E011040,소파,네이처 소파 (Nature Sofa) 1인용쇼파/소파/패브릭,139000,109000,-30000
2018-06-01,1435038482,A018010,초콜릿,수입 초콜릿 초콜렛 사탕 과자 초코바/허쉬 스니커즈 본오본 가나 자유시간 ABC 미니쉘,10000,9900,-100
2018-06-01,1949929046,I031040,생화,[지아이엘]접이식 다기능 야전삽/캠핑삽/모종삽/휴대,6300,5800,-500
2018-06-01,988926188,E061050,청소용세제,[홈스타] 락스와세제후로랄X2개,7300,6600,-700
2018-06-01,1857696841,C012060,여자내의,[제쉬나인][제쉬나인]펄니트 A플리츠스커트니트스커트롱스커트,27600,24840,-2760
2018-06-01,988926187,E061050,청소용세제,[홈스타] 락스와세제 허벌시트러스 750MLx3개,10850,9900,-950
2018-06-01,117322429,E011030,거실장,[채우리] 라미 소나무 원목 좌탁 A형 1300,260000,260000,0
2018-06-01,1922733674,I011030,사진기,판매1위 터치스크린 스마트 캠코더 V2500 카메라 삼성,389000,379000,-10000
2018-06-01,1387550153,C013010,점퍼,AG 후드 집업점퍼 BBB 오픈 CC 집업 후드점퍼 후드집,49050,49050,0
2018-06-01,393129275,F011150,건강기능식품,까스활 75ml x 20병_소화제_부채표 동화약품 소화제,20900,20490,-410
2018-06-01,1780202674,A022030,생수,씨그램 350ML X24PET (레몬 플레인 라임),15800,15800,0
2018-06-01,311117439,C015040,장갑,아디다스 COND 니트장갑(BR9919) 털장갑 니트장갑 남,31140,31140,0
2018-06-01,961842970,E011020,침대,효암 숯침대 싱글HM2000CS 5종모음/돌침대 황토흙침대,1040000,990000,-50000
2018-06-01,1929840255,C013020,티셔츠,아베크롬비/홀리스터/갭/폴로모자/반팔티/카라티/로고,26200,26200,0
2018-06-01,1775749455,L021060,유모차,리안로드 유모차 요람겸용,515000,499550,-15450
2018-06-01,423501283,A011180,파스타면,프레스코 마카로니500gX24개(1박스)/스파게티/후실,91050,91050,0
2018-06-01,1234887534,C011030,남자학생복,트윌 조끼 빅사이즈조끼 MC221 - 조끼 베스트 빅사이,30410,27070,-3340
2018-06-01,797896863,E031080,선풍기,[캐로스] 가스 온풍기 CAH-425GB 사무실온풍기 히터 난로 난방,1765000,1765000,0
2018-06-01,668430934,A017210,파,완숙토마토 정품/토마토/겨울작기 햇출하,8900,8900,0
2018-06-01,990089682,E061020,섬유유연제,[아토세이프] 대용량 섬유향수 4종 3L+공병용기1개,12900,12900,0
2018-06-01,193696119,E041010,식기,[산삼문양 장수금수저 4P-우단케이스] 스푼세트 수저세트 숟가락세트 부부수저세트 예,84500,84500,0
2018-06-01,228119003,C013040,청바지,엘라모 여름 남자청바지 28~40사이즈 7부 데님 팬츠,14900,14900,0
2018-06-01,2058362814,C012040,여자학생복,[임부복닷컴][임부복닷컴]제니스 임부용 여름 니트 가디건,25300,23030,-2270
2018-06-01,564796300,C011050,남자내의,베이직 면반바지 남자 여름 린넨 바지 트레이닝복,20000,12900,-7100
2018-06-01,1263605783,C012060,여자내의,캐서린 쉬폰바지 SD-6288,18000,16020,-1980
2018-06-01,1940452939,C013010,점퍼,신상 블루종/항공점퍼/자켓/점퍼/네오프렌/커플/남성,26000,22800,-3200
2018-06-01,258004968,A013160,맛살,(냉동)한성 꽃맛살F 2kg 한성 꽃맛살 식품 맛살 식자,28630,28630,0
2018-06-01,856503991,C013020,티셔츠,[후아유]후아유 공용 18년 신상 W 베이직 레터 반팔티 WHRP82202C,12900,12900,0
2018-06-01,896594208,E021020,커튼,1+1 레이스 망사 속커튼/거실창문 속지 이너커텐봉,18900,18900,0
2018-06-01,77139194,C011030,남자학생복,마크 투웨이 오리털 자켓솜털 깃털 보온 따뜻 포근 패딩 탈부착후드 YKK지퍼 착한가격,209340,209340,0
2018-06-01,675584540,E031130,보온매트,2018년형 일월 카페트매트/특대형/온열/전기장판/거실,110000,108000,-2000
2018-06-01,924369300,E031080,선풍기,홍진테크 벽난로 전기히터 SFR-201F,72600,72600,0
2018-06-01,1017718195,C011050,남자내의,완벽한 슬랙스 밴드형팬츠 9부바지 정정수트하의 당신,17700,17700,0
2018-06-01,1172121351,L012030,칫솔,오랄비 고탄력 초미세모 그린티 블랙티 칫솔 12개 택1,14900,14900,0
2018-06-01,988123659,L012080,화장지,초L) 미용티슈 260*6,8490,8490,0
2018-06-01,988926162,E061050,청소용세제,[홈스타] 락스와세제후로랄X3개,10950,9900,-1050
2018-06-01,1135247856,L012090,기초화장품,[프리메라] 프리메라 스무스 클렌징크림 250ml,13440,13440,0
2018-06-01,988123658,L012080,화장지,초L)미용티슈 260매*3입,4990,3990,-1000
2018-06-01,1774977262,F011130,홍삼,굿베이스 홍삼이랑쑥쑥(30ML*28입),88000,88000,0
2018-06-01,1620492424,F012010,종이기저귀,리베로 기저귀 3팩/밴드형/팬티형,46500,46500,0
2018-06-01,274786008,C013010,점퍼,[시에로(siero)]후다포켓 포인트 항공 점퍼(SC2JPF006)(인천점),122150,109010,-13140
2018-06-01,1686446097,A017210,파,새콤달콤 맛나는 正品토마토 3kg판매,6900,6900,0
2018-06-01,381454632,C012040,여자학생복,리틀마켓 / teen 소장각여름린넨셔츠,11700,11700,0
2018-06-01,1909741117,E031050,냉장고,파트너M 삼성 김치냉장고 RQ33M7001W1 전국무료배송,1092700,1049000,-43700
2018-06-01,1801753145,E031120,믹서,대용량믹서기 HMF-3260S 믹서분쇄커터다지기 칼날3종,77320,77320,0
2018-06-01,1579659799,C013010,점퍼,[대구백화점 I관] [크로커다일레이디]주머니사각펀칭점퍼(CL8MJP203),92500,78630,-13870
2018-06-01,1860830905,I011030,사진기,후지필름 Finepix XP130 방수카메라(충전기+스트랩),289000,265880,-23120
2018-06-01,445709863,E051020,건전지,에너자이저맥스AA/AAA/C/D/9V/어드밴스건전지듀라셀,8400,8080,-320
2018-06-01,1057271683,A021010,커피,커피(모카골드 맥심 500g) 커피가루 100%,24900,24900,0
2018-06-01,1399398939,A022030,생수,싱하 소다(325미리*24병)스파클링/무료배송/빠른배송,23800,23800,0
2018-06-01,988926155,E061050,청소용세제,Mr.홈스타 욕실을 부탁해 500mlx3P,10950,9900,-1050
2018-06-01,1295175894,C012020,원피스,[더아이잗][더아이잗] 더아이잗 모직 케이프 코트 IGBA0CT28 (P000363395),79000,71100,-7900
2018-06-01,720952634,E011010,장롱,모던 1600 옷장세트 장롱 서랍옷장+옷장,175000,167000,-8000
2018-06-01,1579660789,C013010,점퍼,[대구백화점 I관] [크로커다일레이디]나일론경량점퍼(CL8MJP211),92500,78630,-13870
2018-06-01,1106043605,A017210,파,최상품 무농약 대추방울토마토 3kg 개별포장 산지직송,18500,18500,0
2018-06-01,113368887,A013080,조개,왕중왕 해물나라 900g2개,36190,36190,0
2018-06-01,1318668483,D031010,주택수선재료,본덱스목제방부방충용도료 2.5L  5L 오일스테인,38000,34200,-3800
2018-06-01,1597208948,F011130,홍삼,정관장 레네세홍삼양갱,27000,27000,0
2018-06-01,1985295551,A022050,탄산음료,뚱캔코코팜/갈아만든배/포도봉봉/펩시콜라/칠성사이다,9900,9900,0
2018-06-01,1003515024,C015020,모자,무지스냅백/무지야구모자/단체모자/무지캡/체육대회,9000,8900,-100
2018-06-01,857397610,D031010,주택수선재료,에코로 천연오일스테인 16L 수성오일스테인,140000,140000,0
2018-06-01,886030759,E011040,소파,인텍스정품 에어소파 1인용소파 리클라이너 빈백소파,25900,25900,0
2018-06-01,1257459037,L012010,면도기,[도루코 3중날 터치쓰리 면도기100개입] 일회용면도기/사우나판매용/개별포장/쉐이빙폼,26000,26000,0
2018-06-01,497460332,C021020,구두,[루플랫] 1336118 (해외) 18 SS 처치스 TAMMI 스터드 더비슈즈 DE0118,752600,654770,-97830
2018-06-01,1245525522,L021050,우산,고급 올망사우의/무료배송/우비/비옷/우의/판쵸/바람막이/등산/낚시/일회용/오토바이/,22900,22900,0
2018-06-01,1412969931,C013010,점퍼,l젤리스푼l멋나는배색바람막이집업점퍼/ 젤리스푼,21900,17960,-3940
2018-06-01,577952171,C013020,티셔츠,빅사이즈 DHG1694 여리 레이스 반팔 티 804S 반팔티,38800,38800,0
2018-06-01,155728061,A018090,잼,트라피스트수녀원 유기포도잼 410g 포도잼 과일잼,17590,17590,0
2018-06-01,387540037,C013050,운동복,토요타 2018 캠리 하이브리드 PPF 도어컵/도어엣지,15800,14540,-1260
2018-06-01,1277371078,C012040,여자학생복,라운드 반팔티/무지티/브이넥/면티/라운드/흰티/단체,3600,3600,0
2018-06-01,415990200,C013030,스웨터,남성 니트 네줄 라운드 MRO 니트 가디건 남성니트 남,38990,38220,-770
2018-06-01,2111279667,D031010,주택수선재료,홈스타파스텔ok 1리터 다용도 친환경페인트,9900,9900,0
2018-06-01,1915156182,A016100,수박,[남도장터]영암 하우스 정품 꿀수박 3kg / 4kg,8900,8900,0
2018-06-01,1949569330,A014020,분유,[아이배냇]DIY레시피 단호박 당근 시금치,6320,6320,0
2018-06-01,1882199696,C012020,원피스,[대구백화점 I관] [라인]스타일 정장셋트(NGJKIC9800SL),238000,214200,-23800
2018-06-01,1648027386,A018070,파이,쿠크다스/초코하임/뽀또/버터와플/아이비/빈츠/에이스,2000,2000,0
2018-06-01,1933332318,E011010,장롱,아리아퍼니쳐 슬라이딩 장롱/전신거울장롱/고광택옷장,899000,899000,0
2018-06-01,724354348,C013040,청바지,[에이비에프지]허리밴딩심플바지[AFR3GP05F],30000,25500,-4500
2018-06-01,350740875,I031010,장난감,톨로 사파리쿼드바이크 행사 완구 장난감 어린이 아,38020,38020,0
2018-06-01,988926126,E061050,청소용세제,Mr.홈스타 찌든때를 부탁해 욕실550mlx3P,10950,9900,-1050
2018-06-01,1576000554,L021010,손목시계,전자/가죽 손목시계모음/남성/남자/패션/스포츠/정장,9000,9000,0
2018-06-01,791981796,C013050,운동복,[3M] 3M 공업용수세미 7440 1박스/100장/수세미/다목적수세,538320,538320,0
2018-06-01,131601631,E051020,건전지,태양광 충전지 정원등 건전지1800mAh 배터리 최고용량,1000,1000,0
2018-06-01,330253673,A011160,빵,[샤니/삼립] 한입꿀호떡 10개입/옛날꿀호떡 9개입,1800,1800,0
2018-06-01,1963882578,L021030,가방,[핑크지브라] 백화점몰브랜드 블랙 체인 퀼팅백 특가,27800,27800,0
2018-06-01,1453049652,F012010,종이기저귀,팸퍼스 베이비드라이 팬티형/밴드형 기저귀 모음전,44800,42800,-2000
2018-06-01,1447185372,C013010,점퍼,바람막이 썬프로텍트 자켓 (티폰),37030,37030,0
2018-06-01,2066558615,A017250,고사리,한농 유기농 브로콜리 분말 가루 100g 브로컬리,27960,27960,0
2018-06-01,582477436,A014010,우유,ORGA 유기농 저지방 우유 750ml,6200,6070,-130
2018-06-01,1357681161,C012020,원피스,프레임직사각쟁반 중,26780,26780,0
2018-06-01,117322407,E011030,거실장,[채우리] 라미 소나무 원목 좌탁 A형 1500,300000,300000,0
2018-06-01,829844209,I031040,생화,바낙스 슈퍼캐스터K 원투낚시대 바다 릴낚시대 원투대,48000,44160,-3840
2018-06-01,659404670,C013010,점퍼,봄자켓/여성자켓/봄야상/여성야상,16900,16900,0
2018-06-01,827533981,C013020,티셔츠,[스타일온리]프린트스타 무지 베이직 라운드 반팔티,5400,5400,0
2018-06-01,1056283818,I031040,생화,두꺼운 군용담요/다용도담요 무릎담요 침대패드 고스돕 다리미판 차량비치용품 게임 담,6800,6260,-540
2018-06-01,1112411470,A015020,식용유,코코라이프 유기농 코코넛오일 쿠킹오일 500ml × 5개,55000,27500,-27500
2018-06-01,941099432,A022020,두유,매일유업 매일두유 99.89 무설탕 190ml 48팩 식이섬유,20500,20500,0
2018-06-01,924369238,E031080,선풍기,동일 라디에이터 5핀 타이머 TKR-50T,46300,46300,0
2018-06-01,924369239,E031080,선풍기,동일 원 14 벽걸이 세라믹히터 TKE-901W,28900,28900,0
2018-06-01,924369237,E031080,선풍기,동일 원 14 좌식 세라믹히터 TKE-901S,30400,30400,0
2018-06-01,1433344983,C021040,실내화,아디다스 네오 어드벤티지 클린 벨크로 화이트 AW5211,56800,49990,-6810
2018-06-01,1893006582,I031040,생화,[특허인증] 무르펜 무릎관절보호대(좌/우 1Set),97000,82980,-14020
2018-06-01,359053483,C013010,점퍼,[블루독] 바람막이라이트점퍼 (28375-110-01),78400,64290,-14110
2018-06-01,1630471013,C012040,여자학생복,[포에버21]메쉬넷 후드 니트/FOREVER21/니트/스웨터/후드니트,43900,13170,-30730
2018-06-01,1997349484,E011020,침대,[골든잼]싱글 보료/흙침대 돌침대 보료매트 매트리스,821600,796960,-24640
2018-06-01,1265837032,L021010,손목시계,로제타 메탈 손목시계 FW-13 손목시계 팔찌 팔찌시계,16170,16170,0
2018-06-01,1371281396,F011150,건강기능식품,국내정품 센트룸 프로/실버/포맨/포우먼,34500,32430,-2070
2018-06-01,924369243,E031080,선풍기,이노크아든 욕실난방기 3구 FU-4775 (750W) + 골드램프 1개 추가,69800,69800,0
2018-06-01,605760784,F012010,종이기저귀,[토디앙] LG 토디앙 자운보순 기저귀 공용 중형 60매x3팩,31900,31900,0
2018-06-01,1995028065,I031010,장난감,PSVITA 비타 메모리카드 8GB (소니정품) / 비타 8기가,28800,27400,-1400
2018-06-01,924369241,E031080,선풍기,이노크아든 욕실난방기 2구 FU-4750 (550W) + 골드램프 1개 추가,49800,49800,0
2018-06-01,924369242,E031080,선풍기,이노크아든 욕실난방기(온풍기능) 2구 FU-4790F (1666W),118000,118000,0
2018-06-01,1266078420,C012060,여자내의,jj42 꽈배기니트 미디스커트_라이트그레이 스커트 미,14000,13860,-140
2018-06-01,458512306,C012040,여자학생복,[리스트]여름 레이스 패널 린넨 블렌드 가디건_TSKCDH60030_NA,29000,22620,-6380
2018-06-01,1660765850,C013020,티셔츠,남여공용 26수 슬럽 헨리넥 반팔 티셔츠(B182TS035P)/ 버커루,26100,22190,-3910
2018-06-01,326520624,A019010,고춧가루,고춧가루 1Kg 소포장고추가루 굵은고춧가루 다데기용,20100,20100,0
2018-06-01,2135856987,C013050,운동복,윌슨 남자 여자 트레이닝복 세트 단체 츄리닝,69800,69800,0
2018-06-01,415965270,C013010,점퍼,바람막이 야상 WS-JM28 바람막이 야상 점퍼 남자야상,69700,68310,-1390
2018-06-01,415184075,C013050,운동복,푸조 남여공용 니트 트레이닝 세트(FZ132-3) 남녀공용,63430,63430,0
2018-06-01,1286299259,A019010,고춧가루,선농 고춧가루 건고추 1kg 빨간빛깔고추가루 요리고추,22280,22280,0
2018-06-01,1265825031,C011030,남자학생복,(단품)오지호의 V.CUT(브이컷) 썸머 린넨 셔츠 1종,39900,38900,-1000
2018-06-01,2122295732,C013020,티셔츠,클러프나염티 MN1709 빅사이즈박스티 여성블라우스 엄,32450,32450,0
2018-06-01,1317915979,C012060,여자내의,바이오 오버핏 멜빵 린넨 원피스- 린넨원피스 오버핏,42010,42010,0
2018-06-01,2071293450,C013040,청바지,닉스/겟유즈드외 데님 클리어런스 5900원~ + 30%쿠폰,9900,9900,0
2018-06-01,1943094589,A017170,풋고추,(맛나)백오이(국내산)10개,21300,19170,-2130
2018-06-01,988037143,L012040,치약,초이스엘)더블후레쉬치약(허브민트향)130G,1000,1000,0
2018-06-01,1768427846,E031030,전자레인지,[LG전자] LG전자 MW22CD 인버터 전자레인지 22L (주)대명,136000,124000,-12000
2018-06-01,1808598856,A022020,두유,연세 순수두유/두유/피크닉 96팩무료배송/우유/음료수,25900,25900,0
2018-06-01,898631405,A021010,커피,동서 맥심 모카믹스 220T*12G,25900,25900,0
2018-06-01,1272389980,E011070,식탁,다니엘우드 테네로식탁 원목식탁 콘솔 아동책상 책상,64000,64000,0
2018-06-01,503640277,C012040,여자학생복,[지고트]그물롱볼레로(JI6E1KT34)(경기점),79000,71100,-7900
2018-06-01,1289680113,C013020,티셔츠,[공구우먼] 위드 슬럽 슬리브리스 23988 빅사이즈여성의류 롱나시,9000,9000,0
2018-06-01,1784678634,E041010,식기,도기야 임페리얼/테이블웨어/그릇/도자기/식기/단품,6200,6200,0
2018-06-01,910181238,E011040,소파,국내 최고 보니타 대형 P202야외용테라스 방수빈백,82900,82900,0
2018-06-01,2068312081,C011020,남자상의,(티티뱅크) JK755W 캐주얼 퀼팅 패딩 자켓 / 참고 퀼,76200,67060,-9140
2018-06-01,1185328720,C012060,여자내의,[모다아울렛][ENC]청스커트(ENWJ82691OBL),49000,46060,-2940
2018-06-01,1254781781,A012030,돼지고기,[홈플러스]돼지일품포크삼겹살_100 g,1590,1520,-70
2018-06-01,914342720,A019060,된장,살림&밑천 장&기름,6270,6270,0
2018-06-01,1302146694,E041020,컵,모던 커피잔 모음전/에스프레소잔 라떼잔 세트 찻잔,4500,4280,-220
2018-06-01,215533250,C013010,점퍼,[홈런]야상점퍼/자켓/바람막이/블루종/항공/남성/남자,29800,29800,0
2018-06-01,1165974218,C012040,여자학생복,루즈핏 스트라이프 반팔 블라우스,36900,36900,0
2018-06-01,1708539900,C013050,운동복,유노/VB-04 컴팩트 송풍구 거치 컵홀더 송풍구컵홀더/,5220,4720,-500
2018-06-01,1113572905,E021010,침구,순면 호텔식 컬러이불커버/매트커버/패드/베개,19800,19800,0
2018-06-01,467938376,C013020,티셔츠,SPG017 화이트스완 스팽글 라운드티 기본티셔츠 스팽,10840,10840,0
2018-06-01,984368939,L012060,샴푸,[LG]오가니스트 내츄럴 발효초 샴푸 500ML,13000,6990,-6010
2018-06-01,115278013,A018080,설탕,라빼르슈 앵무새 각설탕 가루설탕 집게 6종 선택형,5800,5800,0
2018-06-01,851114489,I031010,장난감,줄라이카 미니바이크 블루 무소음 바퀴 유아 붕붕카,49800,49800,0
2018-06-01,833760481,F012010,종이기저귀,하기스 네이처메이드 밴드 1-4단계/팬티 4-6단계(3팩),45500,45500,0
2018-06-01,1530592397,C012020,원피스,MELODY F118 블루/코트/여자코트/겨울코디/겨울코트/자켓/점퍼 미국 여성토탈브랜드 멜,54700,54700,0
2018-06-01,440293694,A019100,식초,오뚜기 2분의1케찹280gX30개(1박스)식자재 케찹 마요,72400,63720,-8680
2018-06-01,988062100,L021050,우산,스마트 원터치 그늘막 텐트 (GR),25900,25900,0
2018-06-01,1031005264,A017300,미역,동원 양반김 들기름김/올리브/참기름5gx24봉,7990,7990,0
2018-06-01,310288503,D031010,주택수선재료,한방에끝 방수제 BL300/지붕/내벽/외벽/옥상방수/베란다/텐트방수액,9900,9900,0
2018-06-01,1735328560,A017220,양파,대파분태(국산) 1kg/말린/파/대파/후레이크/육수/라면,32000,32000,0
2018-06-01,72872292,E021010,침구,순면이불커버(홑겹/누빔)사계절용/이불솜/여름이불,18800,18800,0
2018-06-01,1203675581,C015040,장갑,(ELH핫템 발열장갑 ( M ) 발보온기 장갑 겨울용아웃도,291040,291040,0
2018-06-01,461890765,E021010,침구,국내산 시어서커 여름이불 토퍼세트 이불세트,49800,45800,-4000
2018-06-01,1416361246,F012010,종이기저귀,밴드형팬티형3/4/5/6/7단계x3팩+물티슈(70매x2팩)증정,46900,46900,0
2018-06-01,319443472,A013070,굴,[요코몰]영덕게살장 90g/YD/영덕농수산/영덕대게/성게알통조림/대게살/게간장/게액장/,8000,7600,-400
2018-06-01,1533923939,A014030,치즈,코리원/썬리취 체다 슬라이스치즈 100매/치즈/토스트,13300,13300,0
2018-06-01,1185304759,C012040,여자학생복,[블루종][블루종]엔젤 쉬폰 가디건_[B1806CD029B],24800,23560,-1240
2018-06-01,396031757,F012020,생리대,나트라케어 유기농 생리대 3팩/팬티라이너/탐폰,21900,21900,0
2018-06-01,519548083,A016090,참외,제철맞은 경북 성주 꿀참외 대용량 8kg,12900,12900,0
2018-06-01,1956803898,A021010,커피,맥심 아이스 커피믹스 100T / 아이스커피 / 커피,16190,16190,0
2018-06-01,924369276,E031080,선풍기,유파 라디에이터 7핀 FJR-700MB,46700,46700,0
2018-06-01,924369277,E031080,선풍기,유파 라디에이터 9핀 FJR-900MB,50400,50400,0
2018-06-01,1649786328,C013010,점퍼,[바이퀸즈]써머아우터 린넨자켓 로브 가디건,22900,22900,0
2018-06-01,481333221,A018100,꿀,잡화꿀 (다드림 2K),30360,27030,-3330
2018-06-01,776220659,E051020,건전지,국산 3셀 11.1V(3S 12V) 15A 리튬이온 보호회로 BMS,9900,9900,0
2018-06-01,53578625,C011030,남자학생복,여름/남성/남자/긴팔/중년/마남방/셔츠/정장/바지,19800,19800,0
2018-06-01,1286299202,C011050,남자내의,기모바지 622 남자등산바지 남성긴바지 남성바지 남자,67670,67670,0
2018-06-01,693792216,A017050,미나리,(프랑스산)냉동미니양배추1kg,8000,8000,0
2018-06-01,117322336,E011030,거실장,[채우리] 매디 전통고리 원목 좌탁 1700,390000,390000,0
2018-06-01,117322337,E011030,거실장,[채우리] 매디 전통고리 원목 좌탁 1500,300000,300000,0
2018-06-01,117322338,E011030,거실장,[채우리] 매디 전통고리 원목 좌탁 1200,260000,260000,0
2018-06-01,895889676,E061070,가정용비닐용품,[크린랩]08크린랩15*30,2300,2300,0
2018-06-01,2128094718,L012060,샴푸,니심 뉴 패스트샴푸 1000ml+ 컨디셔너 set/페스트샴푸,140000,140000,0
2018-06-01,542433507,C014020,유아복,[뿌야뿌][뿌야뿌] 썸머번아웃원피스 PC2TGOP43N,17500,7880,-9620
2018-06-01,2068312073,C013010,점퍼,(SR)BIG805 남자빅사이즈차이나집업니트자켓 / 참고,67400,59320,-8080
2018-06-01,1160113365,C013020,티셔츠,[공구우먼] 새롬 스트라이프 나시 29746 빅사이즈 여성의류,17000,17000,0
2018-06-01,451111768,A015020,식용유,영미 고추맛기름1.8L2개 고추맛기름 영미고추맛기름,32780,29510,-3270
2018-06-01,393862271,A019040,소금,가쓰오부시(하나 야마끼 500g) 가시오부시 국물소스,46300,41670,-4630
2018-06-01,443252726,A018010,초콜릿,스위스 초콜릿 토블론100gx6/초콜렛/밀크/화이트/다크,13900,13900,0
2018-06-01,1216700811,A016060,감,달콤샤르르 자연그대로 만든 아이스 홍시 100개(컵)/,96740,87070,-9670
2018-06-01,327613173,A017120,고구마,2018년 햇감자 출하특가 5kg/10kg,8900,8900,0
2018-06-01,194391252,A021010,커피,카누120T/카누아이스블렌드/카누아이스라떼,18500,18500,0
2018-06-01,1805660168,A011070,혼식곡,큐원 밀가루 (다목적용)(1KG*4입),4090,4090,0
2018-06-01,492842913,C012060,여자내의,[바보디자인]내츄럴 워싱 수술 데님 언발 롱 스커트,39900,39900,0
2018-06-01,1518140822,C011050,남자내의,트레이닝바지/배기바지/조거팬츠/밴딩바지/츄리닝복,11900,11900,0
2018-06-01,713207150,A018070,파이,마가렛트/빈츠/빠다코코낫/애플쨈/칙촉/ABC초콜릿,35000,35000,0
2018-06-01,325620529,I031040,생화,접이식 낚시의자/파라솔 그늘막 캠핑의자 팔걸이의자,19800,18050,-1750
2018-06-01,1450918631,C012020,원피스,(해외직배송)리본 프릴 정장 원피스 여자원피스 프릴,72420,63730,-8690
2018-06-01,117322342,E011030,거실장,[채우리] 새론 소나무 원목 좌탁 1500,300000,300000,0
2018-06-01,2110377786,E031130,보온매트,홈쇼핑/일월매트/숲속애(퀸)/분리난방/일월양모힐링,168000,166320,-1680
2018-06-01,192263262,L012040,치약,메디안 치약 120g x 9개/치석케어/오리지널/화이트,10900,10900,0
2018-06-01,117322343,E011030,거실장,[채우리] 새론 소나무 원목 좌탁 1200,260000,260000,0
2018-06-01,117322344,E011030,거실장,[채우리] 새론 소나무 원목 좌탁 1000,200000,200000,0
2018-06-01,1062075314,A022030,생수,제주특별자치도개발공사 제주 삼다수 2L*12병,12190,11900,-290
2018-06-01,1403158959,C013020,티셔츠,후드티/후드집업/맨투맨/점퍼/커플티/단체티/빅사이즈,18900,18900,0
2018-06-01,1814075066,A013070,굴,★MD추천정품★조선대가 전통 간장 꽃게장 4.8Kg 간장게장/반찬/게장/꽃게/대게/킹크랩,94000,93060,-940
2018-06-01,924369299,E031080,선풍기,홍진테크 벽걸이 히터 SF-W1800NH,89900,89900,0
2018-06-01,351402486,E011020,침대,정품 단면매트리스 하포스침대/슈퍼싱글/더블/퀸,69000,61410,-7590
2018-06-01,2068312044,C011020,남자상의,(티티뱅크) JK750W 퀼팅 패딩 자켓 / 참고 퀼팅 자켓,69600,61250,-8350
2018-06-01,896631660,A011100,라면,[샘표]샘표 비빔국수 (100G),990,990,0
2018-06-01,1167720723,C011050,남자내의,[흄]남성 슬랙스 반바지 H172M451,15000,12000,-3000
2018-06-01,1726702736,I031010,장난감,야야 소프트지붕차 헬로키티(95969) /(참고) 어린이집,148200,125970,-22230
2018-06-01,1289919087,C013020,티셔츠,슬림면스판나시 짱짱하고늘어짐없는원단,6400,6400,0
2018-06-01,830607646,I031040,생화,SOS 긴급 구호세트 캠핑장비 안전용품 캠핑편의용품,24750,22550,-2200
2018-06-01,416860796,C015040,장갑,아놀드파마_APGW-BY322(가죽장갑_여성용) 선물용장갑,27420,27420,0
2018-06-01,895889699,E061070,가정용비닐용품,[크린랩]크린랩 30cm*50m,5500,5500,0
2018-06-01,1491188303,C013020,티셔츠,ASK주니어 빅로고 쿨맥 민트 티 바지 상하복 세트 JB2ZTR396FL,40120,40120,0
2018-06-01,1306648516,E011020,침대,삼익가구 루시드 LED 퀸 침대+7존 독립 매트리스 포함,305100,305100,0
2018-06-01,1773113548,L021060,유모차,코지 드림 유모차 / 보낭 증정 디럭스유모차 양대면,299000,299000,0
2018-06-01,345961904,A011180,파스타면,바릴라 스파게티 5호 (no.5) 1kg 파스타 농심,2230,2230,0
2018-06-01,2041927909,E061010,세탁세제,스파크 세탁세제 2.5kg x2개/가루세제/찬물세탁,7900,7900,0
2018-06-01,1334100471,C013010,점퍼,[코코애비뉴][코코애비뉴]래빗숏무스탕_71201,128700,123560,-5140
2018-06-01,1578403337,C013050,운동복,트레이닝세트/빅사이즈~2XL/커플세트/원피스/홈웨어,30000,27800,-2200
2018-06-01,1334100476,C013010,점퍼,[코코애비뉴][코코애비뉴]솔라래빗퍼카라무스탕_71201,126500,121440,-5060
2018-06-01,2064767142,A017080,무,2018년 담양 분죽순 생죽순4kg 삶은죽순1kg마른죽순,18000,18000,0
2018-06-01,696237981,C013050,운동복,[커스커즈] 커스커즈 3D 루프백 대용량 수납공간 320L 자동차루프,213770,194710,-19060
2018-06-01,301898035,E011050,책상,[누마]심플책상시리즈/2인용컴퓨터책상/학생용책상,79000,78210,-790
2018-06-01,176720093,C013050,운동복,A여름신상 추가 져지 트레이닝바지/츄리닝운동복남성,7800,7800,0
2018-06-01,344913198,L012090,기초화장품,아이오페 화이트젠 아이세럼 15ml 1개 아이케어 눈가,52590,52590,0
2018-06-01,1775095253,A017150,버섯,(맛나)숙주나물250g/샘이랑,1980,1790,-190
2018-06-01,497460393,C021020,구두,[루플랫] 1334669 (해외) 18 SS 로저비비에르 유광 가죽 CHIPS 발레리나,830700,722710,-107990
2018-06-01,1309621826,E061010,세탁세제,와이셔츠 약 와이셔츠세제 셔츠비누 셔츠깃때제거 부,6790,6790,0
2018-06-01,1185485424,I053010,공책,줄없는 종합장NO. 14501 76836 연습장노트 종합노트장,7000,7000,0
2018-06-01,1676129393,E021010,침구,무더운 여름엔 시어서커 여름이불+패드+베개/이불세트,46900,46900,0
2018-06-01,289361663,C012040,여자학생복,[대구백화점 I관] [NBA]OR 레귤러핏 후드집업(N181TJ030P),49000,42140,-6860
2018-06-01,1870529899,E041060,수저,천연 옻칠 수저 세트 우드 스푼 나무 숟가락 젓가락,3900,3900,0
2018-06-01,415928596,C013040,청바지,[플러스에스큐] 셔링데님팬츠(LU5DP03),49000,47250,-1750
2018-06-01,440293627,A015020,식용유,프레스코 포도씨유900mlX20개(1박스)옥수수유 카놀라,335400,295160,-40240
2018-06-01,1639201248,I012060,저장장치,로지텍코리아 G102 Prodigy 화이트 정품박스 마우스,28610,26900,-1710
2018-06-01,429914833,L012030,칫솔,크리오 미세모 칫솔 x 20개 특가! 2080 x 30개 페리오,7600,7600,0
2018-06-01,534852146,C012020,원피스,[쉬즈미스] 와이드 스트레치 데님 팬츠(SSMSLI10050),55200,49680,-5520
2018-06-01,911445393,E031130,보온매트,한일 레자황토 전기매트 2인용,108000,108000,0
2018-06-01,324644784,C012040,여자학생복,여성 밑단 절개 카라 롱 베스트(TUVAD2702)/ 비키,179000,161100,-17900
2018-06-01,911445394,E031130,보온매트,한일 단풍황토 전기매트 2인용,128000,128000,0
2018-06-01,991679749,A014010,우유,프리마(액상 동서 1000ml)X6 프림 휘핑 식물성 크림,29480,29480,0
2018-06-01,53407503,A022030,생수,동원샘물 500mlx40개/2Lx12개 동원생수 물,9800,9800,0
2018-06-01,1806420267,L021020,장신구,[바보사랑]목걸이 111622001_pmnspa11001,159000,159000,0
2018-06-01,958899694,E011020,침대,[안전한 베디스]KC인증 수납침대 서랍형침대 공간배치,109000,109000,0
2018-06-01,1806420269,L021020,장신구,[바보사랑]목걸이 101532441_PMMAPA10001,159000,159000,0
2018-06-01,711358948,I012010,컴퓨터,2017년 아이맥iMAC/8G/PC4-2400MHZ/삼성/SK/마이크론,116800,116800,0
2018-06-01,746282033,A013020,명태,523 먹태 1kg이상10마리 속초아바이,57240,57240,0
2018-06-01,2043087078,C013010,점퍼,봄기획.득템찬스.자켓트렌치야상.55-110..빅사이즈,28900,28900,0
2018-06-01,1833033206,C013020,티셔츠,남성 후드 집업(4ASKJH7)/ 캘빈클라인 진,78840,67020,-11820
2018-06-01,58027573,D031010,주택수선재료,폼블럭 인테리어 파벽돌 벽돌무늬 시트지 포인트시트,10300,9170,-1130
2018-06-01,1903741714,C013010,점퍼,[PLAC]Uni V-neckline Blouson_WH (PWOG2JPL02U0C2),99000,69000,-30000
2018-06-01,989967848,A014040,발효유,[빙그레]빙그레 닥터캡슐(플레인) 115ML*3,3600,1990,-1610
2018-06-01,1395555251,G022020,자동차타이어,(공식) 넥센 세단 프리미엄급 타이어 엔페라 전사이즈,85000,83000,-2000
2018-06-01,989967849,A022020,두유,정식품 애플망고두유(4+2) 190ML*6,4380,4380,0
2018-06-01,1835426668,C013010,점퍼,남자자켓 블루종 청자켓 트러커 코치자켓 항공점퍼,39800,39800,0
2018-06-01,601780183,E031020,가스레인지,/동우환풍기 150mm/ 가정용환풍기 일반환풍기 화장실,18500,17300,-1200
2018-06-01,1752854104,F011130,홍삼,홍삼의정석 홍삼 청소년홍삼 홍삼스틱 홍삼진액,68000,68000,0
2018-06-01,1797059104,C013010,점퍼,앙팡 래쉬가드 집엎 (핑크) 아동의류 핑크 물놀이용품,25790,25020,-770
2018-06-01,1018890845,C013020,티셔츠,[달리샵]봄신상 맨투맨/박시핏/티셔츠,5900,5900,0
2018-06-01,440293628,A015020,식용유,해표 카놀라유500mlx20개(B)포도씨유 올리브유 식용유,72200,63540,-8660
2018-06-01,633939674,A014050,달걀,닭볶음탕 토막닭 1+1 / 닭발 1+1 / 닭다리 / 모가지,6900,6900,0
2018-06-01,1017899472,E061040,부엌용세제,세이프 주방세제 리필 1000mlx3개 (택일),11900,11900,0
2018-06-01,1290046718,C011050,남자내의,마바지 린넨팬츠 슬랙스 밴딩 9부 여름 바지 반바지,14800,14800,0
2018-06-01,892641830,C013010,점퍼,[시에로][18S/S] 허리 속스트링 오버사이즈 롱 후드 점퍼(SE2JPF168)[갤러리아],299000,230230,-68770
2018-06-01,1656368059,A022050,탄산음료,일화 맥콜 355ml x 24캔/ 음료수 콜라 사이다 커피몰,12120,11400,-720
2018-06-01,1470320881,A018020,사탕,푸른농장 롤리팝 아이스1통(70개)/막대사탕/츄파춥스,9900,9900,0
2018-06-01,987977439,A019120,혼합조미료,대상 맛선생 황태육수티백 56G(7입),4980,4980,0
2018-06-01,440293600,A015020,식용유,해표 카놀라유900mlx12개(B)포도씨유 해표 식용유 올,76500,67320,-9180
2018-06-01,630002903,E031110,청소기,삼성 먼지따로 청소기 VC-TU52G(먼지봉투/에보니 블랙),70050,68650,-1400
2018-06-01,2087838979,C013050,운동복,식물성 에탄올 워셔액 1.8L / 영하25도 OK~KS인증,1130,1130,0
2018-06-01,1065433939,C014020,유아복,맨투맨샤스커트set/상하세트/유아복/외출복/행사복,9900,9900,0
2018-06-01,1397518280,C013050,운동복,고급형6인치 폼패드(블랙)80ppi/광택기/광택패드,10000,7360,-2640
2018-06-01,1933987681,F012010,종이기저귀,군기저귀 슬림앤드라이 밴드/소프트 팬티 4팩 행사,30900,30900,0
2018-06-01,511549419,C013010,점퍼,[로코식스][로코식스] 내츄럴 레더 항공 점퍼,44000,41800,-2200
2018-06-01,1806420241,L021020,장신구,[바보사랑]목걸이 171512401_PMMPPA17002,109000,109000,0
2018-06-01,1540039780,C012040,여자학생복,여성 원피스 롱니트 여자 니트 목폴라 세터,48970,48970,0
2018-06-01,989967850,A014040,발효유,빙그레 닥터캡슐(아로니아) 115ML*3,3600,1990,-1610
2018-06-01,183390234,A014050,달걀,바름푸드/송화단/숙성/오리알/피단/중화요리/60gx10ea,5200,5200,0
2018-06-01,1055151665,C011030,남자학생복,밀란시아 빅사이즈 가네꼬 조끼 bom11-1 빅사이즈 남,34650,33960,-690
2018-06-01,1320537428,E011020,침대,프리미엄 패밀리침대 SS+SS 가드형 본넬 매트리스,619200,600630,-18570
2018-06-01,549592260,I031040,생화,[코스트위드]자가발전랜턴/LED캠핑랜턴/태양열랜턴,18000,16470,-1530
2018-06-01,1806420244,L021020,장신구,[바보사랑]목걸이 121536001_PMMAPA12001,189000,189000,0
2018-06-01,100975961,C012060,여자내의,이프지 봄신상 정장바지 여성면 슬랙스 치마 청바지,19900,19900,0
2018-06-01,1806420243,L021020,장신구,[바보사랑]목걸이 141623001_PMNSPA14002,89000,89000,0
2018-06-01,1743212149,E061020,섬유유연제,F C 베이비전용 세탁세제 refill 아기 세탁 유아 세제,22920,22470,-450
2018-06-01,516228681,C012040,여자학생복,4900원할인/반팔티/박스티/롱티/빅사이즈 쁘니걸,8900,6900,-2000
2018-06-01,1931292886,C013020,티셔츠,맨투맨/독수리/프린트티셔츠/맨투맨/이글/스팽글/큐빅,26800,26800,0
2018-06-01,1915506504,A015020,식용유,오뚜기 프레스코 포도씨유 900ml X 20EA(Hanworld),273900,232820,-41080
2018-06-01,2067221260,C012030,여자상의,봄여름원피스뷔스티에꽃투피스빅사이즈미니롱플라워청,22800,22800,0
2018-06-01,399232941,C012040,여자학생복,[KOOGI]차이나카라핀턱단추블라우스 _KL1BL1210A,18800,17420,-1380
2018-06-01,513786000,E011030,거실장,HMC910 이동형스탠드 TV 브라켓 거치대 모바일카트,80000,80000,0
2018-06-01,114230297,E061030,전구,LED PAR30모음/LED전구/램프/파삼공/레일조명/레일등,4500,4500,0
2018-06-01,1746630352,F012010,종이기저귀,[아이커머스몰][일본 정품 내수용] 군기저귀 3/4팩 밴드형 팬티형 리뉴얼 최신상품 입,48400,47400,-1000
2018-06-01,2070219947,A016030,복숭아,청도 천도복숭아 신선/신비 딱딱이 2k 5k 예약판매중,35000,35000,0
2018-06-01,1286407655,C013020,티셔츠,나이키골프웨어 한정수량 2018 S/S 남성 티셔츠 37종,39900,35520,-4380
2018-06-01,1395459469,C012030,여자상의,러빠 끈 캉캉원피스 예쁜 스커트 DM-5776,31800,30210,-1590
2018-06-01,532347505,C013010,점퍼,핸드메이드 STYLEENTER 남자무스탕 양털무스탕 라쿤후드무스탕 남자후드무스탕,1190000,1190000,0
2018-06-01,1247679689,A011050,콩,[서래푸드] 햇 볶음땅콩3.75kg 구운/견과,12600,12600,0
2018-06-01,2095240461,C012020,원피스,[베스티벨리]하이넥 히든버튼 트위드 배색 자켓 (BMJAA2122)_Y3T9,149800,142310,-7490
2018-06-01,550841896,F012020,생리대,순수한면 팬티라이너 120매 / 생리대 / 릴리안,9500,9500,0
2018-06-01,1168173883,A011090,국수,오뚜기 컵누들 30입,23900,23900,0
2018-06-01,1605371220,L012060,샴푸,려 자양윤모 지성 민감 3개/함초수 3개/트리트먼트,12900,12900,0
2018-06-01,146887440,C012020,원피스,[모다아울렛][에이비에프지]핸드메이드 밍크 장식롱코트,245000,225400,-19600
2018-06-01,1100488440,E031130,보온매트,TV홈쇼핑정품!!일월 참 진 황토매트 (더블)/슈퍼마이콤/전기세/취침버튼/전기장/전자파,168000,166320,-1680
2018-06-01,940224628,C014020,유아복,캉가 포켓 팬츠_UR73SL557 포켓 주머니 팬츠 남녀공용,14810,14810,0
2018-06-01,1263992812,C013040,청바지,웨딩청반바지 주니어반바지 여아반바지/ 제이키드 주니어,16900,16900,0
2018-06-01,1806420239,L021020,장신구,[바보사랑]목걸이 181526221_PMMSPA18001,159000,159000,0
2018-06-01,1806420238,L021020,장신구,[바보사랑]목걸이 601513001_PMMPPA60003,99000,99000,0
2018-06-01,1806420236,L021020,장신구,[바보사랑]목걸이 171533001,69000,69000,0
2018-06-01,2067343817,D031010,주택수선재료,노루페이트 미끄럼방지 논슬립큐(250ml)/미끄럼방지,13900,13900,0
2018-06-01,863364445,C012020,원피스,말표구두약 이코노 흑색 40g,5980,5750,-230
2018-06-01,336848299,A018090,잼,[복음자리]과일잼 모음전_사은품 기프트박스 증정,3900,3900,0
2018-06-01,528231731,A017020,상추,몬 뉴월남쌈300g(16cm) 2개,11830,11830,0
2018-06-01,1291107928,C012060,여자내의,177 르프랑 와일드 여성 청바지 YY 여자청바지 여성청바지 청바지 나팔청바지 여자청바,33820,30100,-3720
2018-06-01,111261876,C012060,여자내의,[탐나나]핫여름 NEW&BEST 크롭 티 린넨 청바지 치마,12000,12000,0
2018-06-01,1876255628,A018060,스낵과자,무료배송/두부과자X10/양파과자/단호박과자/아기간식,28000,28000,0
2018-06-01,258922493,C013040,청바지,[공구우먼] 썸머블랙 히든밴딩 스키니 21118 빅사이즈여성의류,36000,36000,0
2018-06-01,2002567634,L012010,면도기,질레트 플렉스볼 파워 면도기+면도날8입,36900,36900,0
2018-06-01,2095240492,C012020,원피스,[베스티벨리]노카라 배색 스티치 트위드 롱 자켓 (BMJAB2125)_I4V1,125300,119040,-6260
2018-06-01,1286853098,C012060,여자내의,JJ지고트 H라인 체크 트임스커트 GI4M0SKP2,50150,50150,0
2018-06-01,1886387034,A017120,고구마,지금 수확 파근파근 햇 감자 10kg 5kg,15900,15900,0
2018-06-01,193674700,E041010,식기,[거북문양 은수저 5벌-우단케이스] 스푼세트 수저세트 숟가락세트 부부수저세트 예쁜수,60300,59200,-1100
2018-06-01,2019017935,C012040,여자학생복,[엄마옷데드라]엄마옷 데드라 8B-BL195 리프쉐도우블라우스,43500,33500,-10000
2018-06-01,271468762,C011050,남자내의,빅사이즈 여름 면반바지/린넨마바지/밴딩/청반바지,21000,19800,-1200
2018-06-01,1037992747,E021010,침구,바이알러 진드기방지 쿨 메쉬 향균 요토퍼 2장세트 (SK+SS),99900,99900,0
2018-06-01,890313362,E021020,커튼,요루 쉬폰커튼 호텔식 쉬폰속커튼 시폰커튼 속커튼,19800,18220,-1580
2018-06-01,1423993408,E021010,침구,시원한 국내산 윈디 쿨매트/쿨방석/친환경 하이드로겔,18000,16560,-1440
2018-06-01,2100933756,C012040,여자학생복,A라인 루즈핏 66 77 빅사이즈 롱 청 데님 셔츠,22900,22900,0
2018-06-01,548425711,C013010,점퍼,[메이드] 자켓 블레이져 코트 하프 모직 롱 남성 남자,29800,29800,0
2018-06-01,415904575,C013010,점퍼,바람막이 야상 WS-JM26 바람막이 야상 점퍼 남자야상,69700,68310,-1390
2018-06-01,266374550,C011030,남자학생복,남자셔츠 소라 배색 반팔셔츠 J0417010 남자여름셔츠,27390,26030,-1360
2018-06-01,2002648437,A013170,생선통조림,락교SS(2S 화풍 3K)X6 영락교회 식자재용 식당 손가락,77940,77940,0
2018-06-01,1806420297,L021020,장신구,[바보사랑]팔찌 201612102,99000,99000,0
2018-06-01,1009928350,C013010,점퍼,bb99 숨김 원버튼 fur 도톰 자켓 크림 여성자켓 여성,48030,48030,0
2018-06-01,1200680731,C013010,점퍼,바이에른 뮌헨 UCL 프리젠테이션 자켓,142400,126740,-15660
2018-06-01,579924171,C012040,여자학생복,[어스앤뎀] 어스앤뎀 여성 민소매 셔츠 TBSZ511-A 기획5_NC아울렛,59800,12900,-46900
2018-06-01,900445715,A016160,과일가공품,[미국산]냉동 블루베리 (1KG/봉),19900,19900,0
2018-06-01,1806420298,L021020,장신구,[바보사랑]팔찌 121622002,99000,99000,0
2018-06-01,2084012470,C013040,청바지,(SR)MHA516 남자빅사이즈청바지 /(참고)남성빅사이즈,73100,62140,-10960
2018-06-01,1631225247,E031090,공기청정기,[캐쉬백5만원]특가 다이슨 공기청정기 DP04 /이벤트,724000,677740,-46260
2018-06-01,1532166997,F012010,종이기저귀,리베로기저귀 밴드형 7단계(42매) x 3팩,46900,46900,0
2018-06-01,472209722,C013030,스웨터,BIGWM WN 116 (남) 빅사이즈 꽈배기긴팔니트티(4XL까,34330,34330,0
2018-06-01,409692321,F011150,건강기능식품,까스활 75ml x 20병_소화제_부채표 동화약품 소화제,19530,19140,-390
2018-06-01,451923879,E031130,보온매트,한일의료기웰빙 리얼생황토악어투톤 전기매트더블 분,212500,212500,0
2018-06-01,1182427321,C012020,원피스,[탑걸](TIB4JK721F) 원버튼 기본정장자켓,94600,77580,-17020
2018-06-01,877823906,A019080,고추장,해찬들 알찬고추장(6 500G),21500,21500,0
2018-06-01,1172752264,C014020,유아복,아둘 패밀리룩 가족티 유아 메쉬 조던 비치웨어 11,23900,23900,0
2018-06-01,244816847,C013010,점퍼,우먼스 AZ 런닝 테크니컬 트랙자켓 후드점퍼 스포츠점,131020,128400,-2620
2018-06-01,1325943437,E061030,전구,일월조명/에디슨전구/에디슨램프/LED에디슨전구/LED에디슨램프/백열전구/인테리어/공간,4900,4900,0
2018-06-01,1597233898,F011130,홍삼,정관장 홍삼정타브렛(500MG*240),160000,160000,0
2018-06-01,292891256,E011040,소파,베스트리빙 시드니 1인용소파/1인용의자,59000,59000,0
2018-06-01,26587081,E041010,식기,라면그릇/라면기/스텐/면기/라면용기/우동기/우동그릇,3500,3500,0
2018-06-01,496837371,A012040,닭고기,[아임닭] 닭가슴살 BEST 15종 맛보기패키지!,31500,31500,0
2018-06-01,402969809,A019030,생강,적초생강 (참존 1.2k) X10,41780,37190,-4590
2018-06-01,1943227049,C013060,등산복,[마모트][MARMOT] 17FW 남성·여성 [벤투라] 벤치구스다운자켓 (1MMPAW7902)(인천점),169000,136470,-32530
2018-06-01,1249503498,C012030,여자상의,nn66 스트랩 베이직 린넨원피스 - 소라,39740,35370,-4370
2018-06-01,687543534,E041060,수저,까사부가티 알라딘무광 디너세트 3p/한식 양식세트 2p,35000,33000,-2000
2018-06-01,1472332643,I031040,생화,톱 목공 줄톱 접톱 외날 전지 대나무 꼬리 톱 접이식,6000,5940,-60
2018-06-01,313019874,A012050,소시지,특가/오뗄 모듬소세지420g + 사조오양 모듬소세지450g,8800,8800,0
2018-06-01,1354467176,C011030,남자학생복,[닥스셔츠] DKES2CSS110-V1 (닥스 기본체트 반팔 남방 ),60000,51000,-9000
2018-06-01,1384523567,A017090,열무,무농약 펀치볼 시래기 1kg 건 무우청 우거지,16500,16500,0
2018-06-01,499022340,E041050,냄비,무광 전골뚝배기,21000,21000,0
2018-06-01,440293657,A015020,식용유,해표 카놀라유250mlx30개(B)포도씨유 해표 올리브유,67500,59400,-8100
2018-06-01,984403728,A012020,수입쇠고기,척롤 불고기 샤브샤브 500G,25900,25900,0
2018-06-01,527157555,C013010,점퍼,아스토레 6018(CHA) 골프 캐주얼 남성 경량 다운자켓,188300,182660,-5640
2018-06-01,1619741420,L021010,손목시계,미니포커스/남성가죽밴드 크로노그래프 메시 메탈시계,29900,29900,0
2018-06-01,2063635892,A012010,국산쇠고기,정선 수리취떡_ 실속형 2kg (60개),45740,45740,0
2018-06-01,1361282321,C012040,여자학생복,아도라블/잭니클라우스/카라포인트모직니트/66/77,19800,19800,0
2018-06-01,937489770,A013070,굴,(장군수산) 속초 홍게 고급형 3kg/ 찜비용 무료,20500,20500,0
2018-06-01,632962223,C011030,남자학생복,스키 빅사이즈 롱패딩 LM901,173860,166910,-6950
2018-06-01,1806420270,L021020,장신구,[바보사랑]팔찌 291513052,125000,125000,0
2018-06-01,1517922076,C014020,유아복,아동바지 주니어 베이직 데님 팬츠 KIDBOK-61 반바지,11930,11930,0
2018-06-01,1806420274,L021020,장신구,[바보사랑]팔찌 171523122,105000,105000,0
2018-06-01,1451228268,C014010,아동복,[블루독] 스누피바람막이점퍼 (28375-110-51),102400,83970,-18430
2018-06-01,1719733982,C013050,운동복,카보이 에탄올워셔액(원액)희석용 10말제조가능,38000,34960,-3040
2018-06-01,1451228267,C012060,여자내의,플라스틱아일랜드 PJ2WS364 러플 2단 미니 SK,55300,45350,-9950
2018-06-01,1806420272,L021020,장신구,[바보사랑]팔찌 121616002,99000,99000,0
2018-06-01,1711854818,E021010,침구,고밀도 광목이불 자수 이불커버/매트커버/패드/이불솜,41000,39900,-1100
2018-06-01,1378405280,I031040,생화,[블루앤피쉬] 나노카본 아이원투 명량 원투낚시대,67000,63650,-3350
2018-06-01,1729998815,I031040,생화,NS/로드스 RODS KN 루어낚시대+시마노/다이와릴 세트,61000,49940,-11060
2018-06-01,1396903154,L021020,장신구,순은99% 체인38g 75g 은팔찌 은목걸이 은반지 은수저,95000,94050,-950
2018-06-01,1718033302,E011020,침대,크렌시아 라텍스탑투매트 평상형 LED침대 킹,699000,677000,-22000
2018-06-01,2029461299,L021030,가방,생활방수 고급 폴리프라다원단 백팩/크로스백/숄더백,18900,18900,0
2018-06-01,811386870,A018080,설탕,100%사탕수수당 10kg/비정제사탕수수당/무료배송,16800,16800,0
2018-06-01,1105779439,C013020,티셔츠,반팔티/카라/기본/PK/프린트/자수/단가라/티셔츠/남자,12900,12900,0
2018-06-01,766925280,A018090,잼,트라피스트수녀원 유기귤잼 410g 귤잼 과일잼 빵 식,17590,17590,0
2018-06-01,1121058966,C012060,여자내의,아떼바네사브루노 블루 프린트 실크 밴딩롱스커트 VLSK7C211B2,275940,246320,-29620
2018-06-01,372261355,C014010,아동복,[빈]BS27TS02CG/BS27PT01CG 선인장티 다이마루팬츠 세트,44000,36520,-7480
2018-06-01,1385830022,C013010,점퍼,DBA1433 라운드카라 숏 자켓 803S 여성라운드카라자켓,93230,93230,0
2018-06-01,1009272919,C011030,남자학생복,MCD-917 빈티지 스타일 롱가디건 남성가디건 남성롱가,45670,45670,0
2018-06-01,1991201215,I031010,장난감,[지나월드] 에디카클래식쿠페 / 붕붕카 승용완구,106000,106000,0
2018-06-01,1325025883,C012030,여자상의,[로즐리] 아가사 시스루 레이스 머메이드 롱 원피스,63900,62900,-1000
2018-06-01,1403896771,C011050,남자내의,남자 린넨바지 밴딩 와이드팬츠 남성 마바지 크롭팬츠,31500,29000,-2500
2018-06-01,1212510167,E021020,커튼,[윈홈스] 어썸 화이트 맞춤 암막커튼 (아일렛형),28900,26590,-2310
2018-06-01,1272088923,C011020,남자상의,클래식 네이비컬러 더블수트 리즈코 남자옷도매 도매,170630,153570,-17060
2018-06-01,2084012441,C012060,여자내의,#NAME?,76600,65110,-11490
2018-06-01,856170964,E031020,가스레인지,린나이 RTR-R2101 가스레인지 2구+그릴/고효율/dh,229000,212970,-16030
2018-06-01,1905589486,E011050,책상,전제품무료배송/좌식책상 시리즈10종/컴퓨터책상/학생,23000,21900,-1100
2018-06-01,1063964040,A019080,고추장,[CJ직배송] 수라상에 올리던 약고추장 1kg x 2개 (총2개),23100,23100,0
2018-06-01,718735517,C012060,여자내의,봄 씨어리티 스커트 핑크 간절기 여성 정장/ 세인트마리,35900,32310,-3590
2018-06-01,2144713368,E031070,에어컨,"aeratron 실링팬- AE3-50""-화이트",790000,790000,0
2018-06-01,919685068,A018110,물엿,명인 쌀조청 2.5kg/꿀 조청 물엿/국가지정명인 강봉석,15000,15000,0
2018-06-01,246354446,C012060,여자내의,무릎패치 반바지레깅스 DK-2047 기본레깅스 레깅스 치마레깅스 반바지레깅스 면레깅스,11430,10180,-1250
2018-06-01,2080864796,C012020,원피스,올리비아 하슬러[OH8MPT202]JJ 7부 시원한 바지,69300,65840,-3460
2018-06-01,557286372,A019070,양념소스,기꼬만 혼쯔유 1L /코이다시,9900,9900,0
2018-06-01,291661449,C011020,남자상의,익스플로릭 벤치 코트 긴패딩 벤치롱코트 남성롱패딩,366330,366330,0
2018-06-01,2073883997,A013160,맛살,(냉장)한성통통맛살H(1kg)x5개,35000,34650,-350
2018-06-01,845430420,A018070,파이,빅파이 216gx4곽 카스타드 몽쉘 마가렛트 과자 간식,11900,11900,0
2018-06-01,987324051,A011160,빵,[미샵]M-수제다쿠아즈 세트(9개) 1호,18900,16900,-2000
2018-06-01,1320537360,E011020,침대,프리미엄 패밀리침대 Q+SS 가드형 프레임,422300,409640,-12660
2018-06-01,454638972,C021040,실내화,정품 나이키운동화 에어맥스/조던 100종파격가/당일무,89000,79660,-9340
2018-06-01,987324050,A011160,빵,[미샵]M-수제마카롱 세트(9개) 1호,19900,16900,-3000
2018-06-01,222240770,L012090,기초화장품,일회용 파우치 50개 여행용 휴대용 샴푸 린스 바디,2500,2500,0
2018-06-01,1855443077,C013020,티셔츠,[슈프림]2장 3장 세트 무지티 라운드티 면티 흰티 R넥,8800,8800,0
2018-06-01,1297939785,C013030,스웨터,MNT-909 언더 컬러배색 라운드 니트 니트티 니트티셔,20220,20220,0
2018-06-01,874461318,E011030,거실장,벤(BEN) 아카시아  멀바우 원목 거실장/TV다이/티비장,128000,128000,0
2018-06-01,1059003820,C013010,점퍼,밀레 롱패딩(한정판매)기획상품,89000,89000,0
2018-06-01,533313913,C012040,여자학생복,보풀방지 와인네이비라인 교복조끼 남자 교복 예쁜교,23160,22470,-690
2018-06-01,575112551,E041020,컵,신기한 매직머그컵 변색 머그잔 포토 커플 선물 카페,8000,7920,-80
2018-06-01,1326808323,C013010,점퍼,윈드 에디션 지퍼 점퍼 (아이보리) 봄가을용 집업점퍼,17020,17020,0
2018-06-01,245649978,C013020,티셔츠,(AGC이너웨어 스포츠의류 주니어 상의4 주니어이너웨,83620,83620,0
2018-06-01,1860707745,A011010,쌀,2017년 햅쌀 경기미20kg 밥맛보장,49900,49900,0
2018-06-01,1185422037,C012040,여자학생복,[하프클럽/조이너스]예쁨주의! S/S데일리룩 티셔츠/자켓/원피스外,3900,3900,0
2018-06-01,420637686,C012020,원피스,[쉬즈미스][쉬즈미스] 깅엄체크 버튼 다운 셔츠_SWWSTI21020_NA,59000,56050,-2950
2018-06-01,1457040678,A014030,치즈,아담스 파마산치즈 치즈가루 1kg 10개,121100,121100,0
2018-06-01,779010389,C011020,남자상의,여름 정장바지/빅사이즈/스판 일자바지/신사바지,18800,17800,-1000
2018-06-01,536633548,A016090,참외,[하루특가]아삭달콤한 대용량 성주 꿀참외10kg,11900,11900,0
2018-06-01,1727288488,C011050,남자내의,남자바지/카고/데님/밴딩/조거팬츠/모음/변필남,28800,28800,0
2018-06-01,1357428705,E021020,커튼,홈데코커튼/주방/아치/오완식/바란스/장구/커튼봉/,19000,17480,-1520
2018-06-01,506168299,A017050,미나리,보령 무농약 친환경 유황농법 양배추 5kg 10kg,16500,16500,0
2018-06-01,1274904178,A015020,식용유,골든 호호바오일 100ml 비정제호호바오일 몸신,7000,7000,0
2018-06-01,775918129,E031090,공기청정기,파트너M 삼성 공기청정기 큐브 AX94N9880WFD,1500000,1348700,-151300
2018-06-01,1523405915,A013140,북어채,[가온애]국내건조 황태포 10미/5미 대관령 황태채,6500,6500,0
2018-06-01,1063964066,A019080,고추장,[CJ직배송] 해찬들/수라상에 올리던 약고추장 120g X2개,25400,25400,0
2018-06-01,2132173500,A013120,낙지,동해 참 잘마른 건오징어/마른오징어 중량별선택,41000,41000,0
2018-06-01,1403457495,E021010,침구,[올리비아데코] 프렌치 60수 아사 차렵이불(Q),39900,39900,0
2018-06-01,1298773848,E021020,커튼,실커튼 300*280/무료배송 찰랑찰랑 실커튼 /실커텐/커튼봉/비즈발/커튼봉/바란스 /문발,9900,9900,0
2018-06-01,24144394,E031140,비데,18년형 블루밍 비데 ICON-600 무료배송 건조 마사지,119000,119000,0
2018-06-01,1265000979,E041020,컵,리자인 국산 카페 머그컵 커피잔세트 찻잔 모음,2200,2090,-110
2018-06-01,377948133,A018070,파이,초코파이1170g(30봉)x2곽 오예스 몽쉘 과자 간식,17500,17500,0
2018-06-01,416107623,C013010,점퍼,바람막이 야상 WS-JM25 바람막이 야상 점퍼 남자야상,59470,58290,-1180
2018-06-01,817964616,I011010,TV,[LG전자]공식인증점(LG특급) 울트라HD TV 55UJ6620,1189360,1141790,-47570
2018-06-01,619853934,A013140,북어채,용대리 황태풍년 강원도 특산품 자연건조 황태채 육수,5900,5900,0
2018-06-01,1342455616,C013050,운동복,여름 아이스 7부 트레이닝바지 츄리닝 반바지 싸이클,14800,14800,0
2018-06-01,1755910186,A019140,이유식,오가닉맘 프리미엄 이유식 10+1!,2500,2500,0
2018-06-01,1213352800,I031040,생화,초강력 충전식 LED랜턴/37LED 써치라이트 후레쉬,16920,16920,0
2018-06-01,99287430,E021010,침구,풍기인견 엔디미온 유아용 어린이집 낮잠이불 세트,70000,40000,-30000
2018-06-01,2106933875,A011170,떡,전재료 국내산아올 오메기떡 30구,38900,34800,-4100
2018-06-01,521564551,C013020,티셔츠,[MRBOB] 두꺼운 헤비 기모 후드티 후드집업 M~3XL,36800,33800,-3000
2018-06-01,127966359,F012010,종이기저귀,NEW 치쿨 더블 울트라씬 여름용 기저귀 6팩,34900,34900,0
2018-06-01,1960211801,A014040,발효유,프로스티보이-요원요거트파우더 요파이브요거트파우더,13000,12800,-200
2018-06-01,1900357121,A011130,시리얼,오뚜기 부침가루 500g X 20EA 쌀튀김분말 요리용튀김,36440,36440,0
2018-06-01,498411006,C012060,여자내의,A_라인 랩 스커트 롱,32800,31820,-980
2018-06-01,1967685426,C013010,점퍼,홈쇼핑의류 한정수량 특가! 린넨가디건/세트 ~88까지,4900,4900,0
2018-06-01,784260147,L012010,면도기,[20%쿠폰!]*도루코 페이스XLⅡ 면도기+면도날(총11입),25900,25900,0
2018-06-01,896545136,A018050,비스킷,[크라운]크라운 버터와플(316g),4400,4400,0
2018-06-01,1664628702,L021020,장신구,로즈골드 반지/세련/큐빅/RING/OPR842,197000,197000,0
2018-06-01,2142404006,A017010,배추,(yk) 절임배추 10kg/김치/배추/절임/김장,34360,34360,0
2018-06-01,1153962741,C012040,여자학생복,[제이애비뉴]에스닉 무드 블라우스 3종 - HP181F0301BL,49000,49000,0
2018-06-01,1753594879,E011030,거실장,마켓비 JUSTIN 커피테이블 내추럴,333100,333100,0
2018-06-01,1753594878,E011030,거실장,마켓비 TETOS 거실테이블 1000523,77500,77500,0
2018-06-01,1753594877,E011030,거실장,마켓비 SEKON 거실테이블,290000,290000,0
2018-06-01,802670987,A016030,복숭아,백도캔(백도 2절 펭귄 400g)X4/복숭아캔 푸드피아백도,8350,7850,-500
2018-06-01,1063964009,A019080,고추장,[CJ직배송] 해찬들 태양초골드 매운고추장 900g x2개 (총 2봉지),11830,11830,0
2018-06-01,240364637,E031070,에어컨,한일전기 벽걸이형 선풍기 FW-678R/FW-676,38800,38800,0
2018-06-01,284826763,I031040,생화,다용도 야전삽/ 야외용 멀티툴/ 접이식3단 야전삽,6800,6800,0
2018-06-01,1063964007,A019080,고추장,[CJ직배송] 해찬들 수라상에 올리던 약고추장 120g X7개,14000,14000,0
2018-06-01,1806420213,L021020,장신구,[바보사랑]목걸이 121543011,109000,109000,0
2018-06-01,1687798775,F011150,건강기능식품,[솔가] 남성용 멀티비타민 미네랄 (60정) 무료배송,35100,35100,0
2018-06-01,1806420211,L021020,장신구,[바보사랑]목걸이 601532021,99000,99000,0
2018-06-01,581000652,F012010,종이기저귀,[토디앙] 핑크퐁 팬티기저귀 특대형 남아 36매X3팩,33500,33500,0
2018-06-01,2090994290,A012060,햄및베이컨,[사조남부햄]정통 수제모듬 소세지/비엔나/햄/소시지,3490,3490,0
2018-06-01,1029285989,F012020,생리대,[시크릿데이]시크릿데이 생리대 러브 울트라 날개 오버나이트 10PX5팩,12500,11630,-870
2018-06-01,803991104,E011030,거실장,[파로마] 제티 거실장 3종 모음,53010,53010,0
2018-06-01,832049556,A022010,주스,웅진)자연은포도쥬스 1.5L-M805080 사무용품 생활용품,9210,9210,0
2018-06-01,446089314,E061020,섬유유연제,스너글 다우니 고농축 섬유유연제 피죤 샤프란 섬유린,18490,18490,0
2018-06-01,2070122476,C012060,여자내의,빅사이즈/그란데/망사/스커트 / 참고 그란데망사스커,61600,52360,-9240
2018-06-01,1761306239,D031010,주택수선재료,크롬도금제/CR-3/스프레이/도금/머플러코팅/보수용/마후라/크롬스프레이/금속도금제/페,17700,17700,0
2018-06-01,1493984242,A022030,생수,씨그램 350ml x24 레몬/라임/플레인,14990,14990,0
2018-06-01,1252937261,C021020,구두,남성 옥스포드 AOM814 2종 택 1 (3cm)/ 소다,92000,77280,-14720
2018-06-01,361536983,L012030,칫솔,유아칫솔x12개+칫솔홀더/어린이 아동 키즈,9900,9900,0
2018-06-01,144694109,C013020,티셔츠,롱/원피스티모음 루즈핏티셔츠 F-4XL 빅사이즈,21800,21800,0
2018-06-01,315205700,E021010,침구,싱글침구세트/차렵이불/기숙사이불/신학기이불,39800,39800,0
2018-06-01,2083203301,C012060,여자내의,윈트 마통바지 DM-6750 /(참고)통바지 마반바지 밴드,22800,20070,-2730
2018-06-01,1339092078,C015040,장갑,라인 포인트 피혁장갑(여성) 여성가죽장갑 장갑 여성,12320,12320,0
2018-06-01,350304367,C013020,티셔츠,T693-세련된 여성 데일리 티셔츠 릴리t 긴팔티셔츠 프,19940,19940,0
2018-06-01,2066703854,C011050,남자내의,남성카고바지/건빵바지/포켓/카고팬츠/조거/밴딩바지,25900,25900,0
2018-06-01,378082058,L021010,손목시계,벤자민 팔찌손목시계 JW-12-색상임의배송 손목시계 패,14440,14010,-430
2018-06-01,267357711,A011100,라면,고구마전분 네모난당면300g 잡채당면 다용도당면 요식,14800,14510,-290
2018-06-01,1553407728,L021020,장신구,은팔찌 은발찌 순은 체인 실버925 뱀줄 볼 발찌 팔찌,22000,19900,-2100
2018-06-01,384608398,C011050,남자내의,[뱅뱅][뱅뱅] 여성 미쮸리 트레이닝 바지-NPBT31,13800,13110,-690
2018-06-01,1806420206,L021020,장신구,[바보사랑]목걸이 131612001,159000,159000,0
2018-06-01,19560223,A021010,커피,유자차 유자청 유자쨈 유자즙 쥬스 분말 가루 생강차/,12700,12700,0
2018-06-01,517473823,C013050,운동복,퀄리티Good.여름신상/트레이닝세트/여성트레이닝복,29800,29800,0
2018-06-01,1806420204,L021020,장신구,[바보사랑]목걸이 131613001,159000,159000,0
2018-06-01,519839731,A017090,열무,국내산 레드비트 5kg 내외,14900,14400,-500
2018-06-01,474366289,C013050,운동복,여성 트레이닝 반바지 핫팬츠 숏팬츠 츄리링 속바지,8000,7900,-100
2018-06-01,1806420209,L021020,장신구,[바보사랑]목걸이 601534021,99000,99000,0
2018-06-01,321875087,E041010,식기,르크루제 푸드픽set - 2018 SUMMER 소르베컬렉션,39010,39010,0
2018-06-01,493115580,A013060,게,바다해수산 국내산 냉동오징어 1박스 국산오징어,29000,29000,0
2018-06-01,509359937,C013010,점퍼,[마인드브릿지] 여폴리와펜장식숏스타디움점퍼 MRJP221A_NC아울렛,159000,79000,-80000
2018-06-01,1806420207,L021020,장신구,[바보사랑]목걸이 601533021,99000,99000,0
2018-06-01,1908202765,L012090,기초화장품,[브리올옴므] 브리올옴므 화이트닝 아이크림 밤,34000,34000,0
2018-06-01,472550233,A021010,커피,맥심 아이스블랙 100T/사은품/커피믹스/아이스커피,12900,12900,0
2018-06-01,297388098,I031010,장난감,볼크원 산업용 12V 밧데리 무보수 밀폐형 전동 배터리,33000,33000,0
2018-06-01,69606748,A013070,굴,수월한 무뼈 닭발 350g,5300,5300,0
2018-06-01,386401563,E021020,커튼,롤스크린 그림 일반_1413,26990,26990,0
2018-06-01,415150896,C011020,남자상의,오아시스 싱글수트 M2XL 네이비 MTF066 정장수트 슬림,171090,171090,0
2018-06-01,1303134373,C013010,점퍼,여성 기모 후드 집업점퍼 AG집업점퍼후드점퍼후드집업,25220,25220,0
2018-06-01,1338999543,E031070,에어컨,[파세코] 파세코 DC타워선풍기 PTF-MP7500AW 타워팬 선풍기,69000,69000,0
2018-06-01,657892925,F012010,종이기저귀,[리베로]리베로기저귀 밴드형5단계 56매 2팩,38600,36670,-1930
2018-06-01,1035379853,E031070,에어컨,[한일] 한일 천장용선풍기 FC-62LB-S/한일선풍기,58000,55100,-2900
2018-06-01,1016309879,C013060,등산복,여름 남성 등산바지 등산복 반바지 작업복 트레이닝,16000,14150,-1850
2018-06-01,2129332644,A018080,설탕,비정제설탕/원당(천연당)5kg 3kg/사탕수수100%/매실,7900,7900,0
2018-06-01,898424912,A017100,당근,무(특/개),3990,3990,0
2018-06-01,1408357665,C012020,원피스,김발(속대 에브리홈)X2,2290,2290,0
2018-06-01,1041243900,C021040,실내화,[월드컵] 메모리폼깔창 에어창 런아웃 남성 여성운동화 런닝화,21690,21690,0
2018-06-01,478021874,C012020,원피스,[엄마옷 데드라] 8B-SET002 플레어와이드트레이닝,25100,21090,-4010
2018-06-01,826449752,A022010,주스,[해태htb] 해태 썬키스트 훼미리 제주감귤 2L 6펫,10300,10300,0
2018-06-01,371368587,C012030,여자상의,빅사이즈 원피스 66~150 여름원피스 봄원피스 임부복,16800,16800,0
2018-06-01,1257944830,L021060,유모차,신상품 크라운s 에스/블랙 에디션/유모차/양대면 블랙,510000,510000,0
2018-06-01,1200122068,C011030,남자학생복,꾸제꾸제/GIORDANO 집업 니트 가디건/size M/면/스웨터/자켓/세일/빈티지/중고/구제/지,17900,17900,0
2018-06-01,447273658,C012040,여자학생복,[무료배송]빅사이즈 DWW001A 편한 데님 롱 셔츠 802,59480,59480,0
2018-06-01,432371460,A015020,식용유,오뚜기 프레스코 카놀라유 500ml X 20EA,76730,68290,-8440
2018-06-01,1010199847,A016090,참외,[ZIAO][참예과] 명품 사과6과+배6과 혼합 선물세트 (5.5kg내외),44900,39100,-5800
2018-06-01,1343156892,E061020,섬유유연제,LG 샤프란 아로마시트-핑크센세이션 (30매) 샤프란,10900,10900,0
2018-06-01,839144439,I031070,애완동물관리비,윌슨 페더러26 쥬니어 테니스라켓/나달/바볼랏/아동용,52000,51480,-520
2018-06-01,770291826,E031080,선풍기,캐리어 인버터 천장형 냉난방기 CTVR-Q406FX,3320000,3320000,0
2018-06-01,770291827,E031080,선풍기,캐리어 인버터 천장형 냉난방기 CTVR-Q366FX,3110000,3110000,0
2018-06-01,1798806711,I031070,애완동물관리비,윌슨 US OPEN 25/23/21/19 매직 주니어 테니스라켓,25000,22130,-2870
2018-06-01,560395273,C013020,티셔츠,폴라나시 목폴라 반폴라 목티 폴라티/롱나시 맨투맨,7900,7900,0
2018-06-01,1031987413,I031040,생화,써치라이트/DC 12V/투광등/써치등/캠핑등/작업등/LED,24000,23760,-240
2018-06-01,2068312136,C011020,남자상의,(티티뱅크) JK850W 노르딕 헤비 패딩 자켓 / 참고 돕,100300,88270,-12030
2018-06-01,1252937289,C021020,구두,남성 옥스포드 AJM858 2종 택 1 (3.5cm)/ 소다,109000,91560,-17440
2018-06-01,2013023121,A019180,즉석식품,많이살수록 저렴/맛있는 삼계탕 1팩(1kg)/내가먹어봄,7400,6660,-740
2018-06-01,942820370,C012060,여자내의,SK1101-기하학 패턴 미디 플레어스커트 플레어치마 주,21040,19990,-1050
2018-06-01,1878129352,L021020,장신구,스타샵 EGS1941 재고보유 당일발송 엠포리오 알마니 EMPORIO ARMANI 엠포리오 아르마니,180000,160120,-19880
2018-06-01,1387550027,C013010,점퍼,AG 후드 집업점퍼 MX 후드오픈 CC 후드집업점퍼 집업,49050,49050,0
2018-06-01,385472303,C011030,남자학생복,오투아이스_쿨링조끼/애견용,29620,27850,-1770
2018-06-01,705155172,A019080,고추장,ⓒ 해찬들 볶음요리장(300G),4380,4380,0
2018-06-01,953988010,A013050,오징어,고등어(중/냉),2490,2490,0
2018-06-01,1214384080,I011030,사진기,(컴온탑)니콘정품 D750 BODY (18년3월/캐시백),1536670,1469000,-67670
2018-06-01,416024791,C015020,모자,스냅백 볼캡 빅사이즈 일루미나티 모자 큰모자 빅볼캡,22420,21980,-440
2018-06-01,1348966964,E031110,청소기,블랙앤데커 차량용청소기 NV1210,32210,29900,-2310
2018-06-01,574291161,L021030,가방,러브캣 (베이직49)미니숄더백(LIS2S600WHLC01),220800,176640,-44160
2018-06-01,675716831,C013020,티셔츠,루즈핏 7부/5부/반팔 박스 오버핏 빈티지 남자 롱티,12900,12900,0
2018-06-01,420059006,A019090,카레,청정원 카레여왕 인도식 마크니커리 100g/코르마커리,2500,2500,0
2018-06-01,988123569,A019180,즉석식품,CJ 비비고 육개장 500G,4580,3590,-990
2018-06-01,2097986155,C013020,티셔츠,국산 반팔티/무지티/라운드티/기본티/흰색면티/아동,3600,3600,0
2018-06-01,1084835473,A019170,냉동식품,비비고 왕교자+김치왕교자 455gx6봉 외 냉동식품/만두,22900,22900,0
2018-06-01,1300068883,A011080,밀가루,월남쌈 베트남쌀국수 식재료 모음 월남쌈소스 장국,1450,1450,0
2018-06-01,1212331492,A017210,파,국내산 찰 토마토 5kg(5~6번/소과),9900,9900,0
2018-06-01,58304509,A018110,물엿,[두레촌] 식품 명인 도라지 조청 세트 (3병) 쌀 생강 물엿 꿀,39900,39900,0
2018-06-01,1371317709,E011060,의자,홈인테리어 식탁의자 바텐 간이 등받이 카페 홈바,12900,12900,0
2018-06-01,1294942150,C013010,점퍼,앙팡 래쉬가드 집엎 (핑크) 아동의류 아동집업 어린이,24660,24660,0
2018-06-01,728386671,E021020,커튼,BHF 별 펀칭 암막커튼2장4장/린넨룩펀칭 디망쉬펀칭,32900,32900,0
2018-06-01,1918986969,L012090,기초화장품,프리메라 와일드 씨드 퍼밍 아이크림 25ml 1개 아이케,70600,68490,-2110
2018-06-01,418730038,C011050,남자내의,(남자옷도매) DP-252 9부스판 면팬츠 (S-XL) 베이지,38670,38670,0
2018-06-01,953988043,E061070,가정용비닐용품,[크린랩]크린랩 지퍼백 (대),3700,3700,0
2018-06-01,380411702,C014020,유아복,상하세트 유아상하세트 핑크상하세트 아동상하복 유아,41280,41280,0
2018-06-01,1517361450,E021020,커튼,[디자인갤러리]국산3중직/별 암막커튼/특별한 디자인~,35000,30270,-4730
2018-06-01,1026418279,C011030,남자학생복,여름신상 남성용 린넨 솔리드/셔츠/남방/와이셔츠,10800,10800,0
2018-06-01,1547304063,A016150,아몬드,[가온애]슬라이스아몬드 볶음아몬드 아몬드가루,4900,4900,0
2018-06-01,1504326488,C021020,구두,[모다아울렛][에스콰이아]에스콰이아 남성 정장구두 PF6WHT002B7,99000,89100,-9900
2018-06-01,985320482,A011110,당면,CJ 두부기획(단단한부침300G+300G),3490,2490,-1000
2018-06-01,1372053388,E021010,침구,굿몽 시어서커 여름이불 이불세트 이불패드 패드 토퍼,22800,22800,0
2018-06-01,1190719494,C013050,운동복,L~3XL 간지짱! 트레이닝팬츠 반바지 쿨배기 5부바지,14900,14900,0
2018-06-01,1210257087,A018020,사탕,츄파춥스 미니 6g x 100개입 / 미니 츄파춥스,7500,7500,0
2018-06-01,2033909935,C011030,남자학생복,당일발송 반팔/긴팔 와이셔츠 솔리드 드레스 남방,14800,14800,0
2018-06-01,1753594810,E011030,거실장,마켓비 HUNTELA 사이드테이블 WFST030,33400,33400,0
2018-06-01,326519698,A019010,고춧가루,굵은 고춧가루 2.5Kg 업소용고추가루 건고추가루 양념,50900,50900,0
2018-06-01,532359672,L021030,가방,WR)/타거스 노트북가방 17.3인치 TSB280AP backpack,100000,99000,-1000
2018-06-01,1015096972,L021030,가방,브랜드 서류가방 /15.6 노트북가방/남자/여자/정장,27700,27700,0
2018-06-01,1753594812,E011030,거실장,마켓비 KORKU 600 접이식테이블 KS1047TB,43200,43200,0
2018-06-01,386425554,E021020,커튼,롤스크린 그림 암막_1468,44800,44800,0
2018-06-01,1753594811,E011030,거실장,마켓비 KORKU 400 접이식테이블 KS1046TB,32400,32400,0
2018-06-01,741367842,L021030,가방,리바케이스 8365 17.3인치 노트북 가방/게이밍 백팩,89000,87220,-1780
2018-06-01,1876519604,A011120,두부,[당일출고/무료배송]포스트 시리얼 초특대 1.1kg+증정,7900,7900,0
2018-06-01,1169354407,C012060,여자내의,국산 면쭈리 5부 반바지 S-5XL 단정한반바지 면반바지 빅사이즈반바지 5부반바지 국산,16420,14620,-1800
2018-06-01,467806759,A013010,갈치,제주도 토막 은갈치/칼치/선물세트/특산물/특산품,68000,68000,0
2018-06-01,717062451,E011040,소파,보니타빈백 초대형LT505 상품후기작성100L충전재증정,154900,154900,0
2018-06-01,1326011706,C013040,청바지,마넬뉴욕 여성 쿨크롭 데님 3종 ARS 할인,69000,63480,-5520
2018-06-01,1382271797,L021030,가방,[무료배송] 노트북파우치/노트북가방/노트북액세서리/파우치케이스/노트북파우치케이스,11300,10300,-1000
2018-06-01,226992103,C013020,티셔츠,S/S 신상 빅사이즈 롱 티셔츠/원피스/여성의류/임부복,9700,9700,0
2018-06-01,620925109,L021030,가방,[오야니(ORYANY)]제롬 미니 숄더 O8SBSD85_BK(강남점),175200,158060,-17140
2018-06-01,1078538730,C012060,여자내의,[공구우먼] 슬리뮤 데님 스커트 29747 빅사이즈 여성의류 청치마,34000,34000,0
2018-06-01,90867643,E041070,밀폐용기,글라스락/박스단위/국산/유리병/쨈병/패트병/밀폐용기,40000,36620,-3380
2018-06-01,988123595,A019110,드레싱,CJ 이탈리안드레싱 235G,3980,3980,0
2018-06-01,1186639435,I031040,생화,무료배송 용성 파도기/1호 2호 3호 바다낚시대/갯바위,47000,39480,-7520
2018-06-01,564772473,C013040,청바지,아둘 NEW YORK 쥬니어 기모 후드 양키 상하세트 20,31900,31900,0
2018-06-01,1063964071,A019060,된장,[CJ직배송] 백설 다담된장찌개전용 530g X6개,30400,30400,0
2018-06-01,1182897641,C013010,점퍼,헤링본양털박시무스탕,45800,45800,0
2018-06-01,1753594809,E011030,거실장,마켓비 SQUARE 원목스툴/협탁 자작나무,35500,35500,0
2018-06-01,291949419,I031010,장난감,물레방아 놀이 아기목욕 장난감 목욕놀이,18000,13800,-4200
2018-06-01,861489786,A011170,떡,특허받은맛 아리울 떡 공방 굳지않는 앙꼬 절편 앙금,7800,7800,0
2018-06-01,396966294,A018100,꿀,잡화꿀 (오뚜기 1k) X6,220710,196440,-24270
2018-06-01,1143961156,A014010,우유,일회용핫소스(태원 4gx1000),38000,38000,0
2018-06-01,1970126108,C013020,티셔츠,[앨빈클로]바캉스룩 남자 나시티 나시후드 나시집업,16900,9900,-7000
2018-06-01,537472291,C013050,운동복,올뉴카니발 프런트 바디킷/리어 바디킷/사이드실(GSC),163500,150420,-13080
2018-06-01,1431095148,A014040,발효유,(선인)슈크림라떼믹스1kg,8000,8000,0
2018-06-01,1328601545,C013020,티셔츠,베이직 후드티 LLTT0034 여성티셔츠 후드티,23510,23040,-470
2018-06-01,371792836,L021020,장신구,핸드메이드- 실버- 피칸 목걸이 레브라도 블랙스피넬,40350,40350,0
2018-06-01,590300175,C011020,남자상의,윈터 18 자켓 코트 심플패딩 남성롱패딩 롱패딩코트,277430,277430,0
2018-06-01,1118498010,D031010,주택수선재료,에폭시 바닥재 상도 16L 유니폭시/코팅/투명/빈티지,89000,89000,0
2018-06-01,1977936294,C015020,모자,[1+1]신상 남녀공용 /무지볼캡/빅사이즈모자/야구모자,5900,5900,0
2018-06-01,2097453267,C014010,아동복,[노스페이스] 키즈 짚 업 래쉬가드 세트 NJ5JJ05 4종 택1,102400,98310,-4090
2018-06-01,2068312107,C011030,남자학생복,(SR)MJI2-5 남자빅사이즈밀리터리집업자켓 / 참고 밀,73000,62050,-10950
2018-06-01,2068312108,C011030,남자학생복,(SR)BIG803 남자빅사이즈빗살니트가디건 / 참고 니트,73000,64240,-8760
2018-06-01,924369210,E031080,선풍기,나노 욕실용 온열기(2구) NI-R2,55000,55000,0
2018-06-01,13232508,A017080,무,[남도장터]장성 최요석님의 약용새싹삼/당일산지수확,19900,19900,0
2018-06-01,924369211,E031080,선풍기,나노 욕실용 온열기(3구) NI-H3D,67400,67400,0
2018-06-01,441038191,C012060,여자내의,[로로텐]올엑스레이구제팬츠,36200,34770,-1430
2018-06-01,988123570,A019180,즉석식품,CJ 비비고 사골곰탕 500G,1980,1490,-490
2018-06-01,1063964097,A019080,고추장,[CJ직배송] 해찬들 찰골드고추장 14kg,37800,37800,0
2018-06-01,988123572,A019180,즉석식품,CJ 비비고 두부김치찌개 460G,4980,3990,-990
2018-06-01,988123571,A019180,즉석식품,CJ 비비고 된장찌개 460G,4980,3990,-990
2018-06-01,895865681,E051020,건전지,[에너자이져]에너자이저 e2어드벤스 AAA 2입,3990,3990,0
2018-06-01,207576286,C013010,점퍼,[리스트] 린넨 펀칭 7부 점퍼(TWWJPH60050)(마산점),59000,52660,-6340
2018-06-01,760262170,F012010,종이기저귀,보솜이 디오가닉 팬티 대형 108개/특대형 90개/기저귀,26960,26960,0
2018-06-01,924369214,E031080,선풍기,동일 라디에이터 7핀 타이머 TKR-70T,51300,51300,0
2018-06-01,924369215,E031080,선풍기,동일 라디에이터 9핀 타이머 TKR-90T,60600,60600,0
2018-06-01,924369212,E031080,선풍기,동일 라디에이터 11핀 타이머 TKR-110T,69200,69200,0
2018-06-01,1873656499,E021010,침구,아이르 국내산 시어서커 여름 홑이불/세트 (SS/Q),9900,9900,0
2018-06-01,108635498,C011050,남자내의,[상세페이지참조] 푸마 트레이닝 팬츠(65382437),58600,58600,0
2018-06-01,627628068,C013060,등산복,신상 등산바지 등산복 작업복 남성 아웃도어 남자,16800,13990,-2810
2018-06-01,820520298,E041010,식기,포트메리온 보타닉가든 팔각접시6p,61000,61000,0
2018-06-01,729807490,E061050,청소용세제,락퐁 대용량 13리터 락스 청소 욕실청소 화장실청소,13500,13500,0
2018-06-01,1999376933,E031020,가스레인지,SK매직 2구 POP 원터치 가스렌지 GRA-813SR,120000,114000,-6000
2018-06-01,1533646151,E041050,냄비,[네오플램] 네오플램 마이다스 9P 냄비세트 후라이팬 냄비,92000,89000,-3000
2018-06-01,924369209,E031080,선풍기,홍진 공업용 원 카본히터 SF-K2400,127300,127300,0
2018-06-01,1061041603,L021010,손목시계,CASIO 카시오 LQ-142E-2ADF 여성 우레탄밴드 패션시계,23500,23500,0
2018-06-01,1061041604,L021010,손목시계,CASIO 카시오 LQ-142E-7ADF 여성 우레탄밴드 패션시계,23500,23500,0
2018-06-01,1061041605,L021010,손목시계,CASIO 카시오 LQ-142E-1ADF 여성 우레탄밴드 패션시계,23500,23500,0
2018-06-01,82597568,D031010,주택수선재료,KCC우레탄 방수재 하도/중도/상도 손쉬운 옥상방수,59500,59500,0
2018-06-01,1061041606,L021010,손목시계,CASIO 카시오 LQ-142-7EDF 여성 우레탄밴드 패션시계,22000,22000,0
2018-06-01,1061041607,L021010,손목시계,CASIO 카시오 LQ-142-7BDF 여성 우레탄밴드 패션시계,22000,22000,0
2018-06-01,1061041608,L021010,손목시계,CASIO 카시오 LQ-142-1EDF 여성 우레탄밴드 패션시계,22000,22000,0
2018-06-01,1061041609,L021010,손목시계,CASIO 카시오 LQ-142-1BDF 여성 우레탄밴드 패션시계,22000,22000,0
2018-06-01,1354362976,C013020,티셔츠,심플 후드집업 LTT0045 여성후드집업 트레이닝복,30210,29610,-600
2018-06-01,1640160219,F011150,건강기능식품,삼성제약 까스명수GOLD 75mlx50병 건강음료 소화제,47670,46240,-1430
2018-06-01,1597088826,F011130,홍삼,정관장정 홍삼쿨(2G*100입),85000,85000,0
2018-06-01,79352461,A016030,복숭아,영덕 청년농부 김태양님의 복숭아 병조림과 잼,21900,21900,0
2018-06-01,895865677,A022010,주스,[롯데]롯데 네퓨어 매실(병)180ML*12입,7200,7200,0
2018-06-01,698324105,I031010,장난감,레고호환 오시니 슬루반 90종 모음전,10000,8900,-1100
2018-06-01,50171174,C011030,남자학생복,인터페이스 제작 특양면가디건 Double_u 후드집업자,29700,29700,0
2018-06-01,2035763867,C012040,여자학생복,[다바걸]볼륨폭발랩블랑,16000,15200,-800
2018-06-01,808368141,A011040,보리쌀,[입점기념특가] 일본 시가야 낫또 50gx30팩/나또,25900,25900,0
2018-06-01,896631566,A011070,혼식곡,[CJ]CJ 우리밀 밀가루 750g,3220,3220,0
2018-06-01,896631565,A011070,혼식곡,[CJ]CJ 우리밀 밀가루 750g,3220,3220,0
2018-06-01,831639820,A018050,비스킷,과자/간식/몽쉘/마가렛트/빈츠/카스타드/오예스/젤리,7800,7800,0
2018-06-01,841452749,A011140,부침가루,코주부 바나나크림치즈케익 40g/낱개,700,670,-30
2018-06-01,336208848,C012040,여자학생복,[스타일빅걸][스타일빅걸]골지 쉬폰 가디건 DOT12,34270,32900,-1370
2018-06-01,957673354,A014040,발효유,동원 덴마크 드링킹 요구르트 플레인 (310ML),1100,1100,0
2018-06-01,783742572,I031040,생화,러그 캠핑 전기릴선 연장 작업선 캡형 캠핑용품 신형,34000,30430,-3570
2018-06-01,1301730835,C013020,티셔츠,USA맨투맨긴팔면티 1개 맨투맨티 기본티 간절기티셔츠,59200,50320,-8880
2018-06-01,764787215,E031080,선풍기,KAYA_전기용 히터 KJE-2045B (20KW),1375000,1375000,0
2018-06-01,122343211,E021020,커튼,[베베데코] 바람막이 현관/방문 방풍커튼 극세사커튼,21900,18310,-3590
2018-06-01,1395425959,C012030,여자상의,베니토 옆셔링원피스 예쁜 스커트 DM-5604,27300,25940,-1360
2018-06-01,1343095456,C012060,여자내의,[폴햄]스판소재의 컬러별 면반바지 PHY2PH1012,19900,16520,-3380
2018-06-01,479694450,A019070,양념소스,시아스 샐러드 모음전/감자/고구마/단호박/피자/소스,5500,5500,0
2018-06-01,1126315887,C013050,운동복,DYTMCN 루카노 긴팔 져지 남성의류 남성트레이닝복 트,138880,138880,0
2018-06-01,1679756686,I011010,TV,(공식파트너) 삼성 138cm커브드 TV UN55M6200AFXKR,920000,809000,-111000
2018-06-01,1246411292,C013020,티셔츠,[크루클린] 반팔티 빅사이즈 오버핏 루즈핏 무지,14900,9900,-5000
2018-06-01,1903716819,C013010,점퍼,[PLAC]Uni V-neckline Blouson_NV(W)PWOG2JPL02U0B7,99000,69000,-30000
2018-06-01,450225944,C013050,운동복,앞뒤 성에방지커버 자동차용품 보호커버 차량커버 성,7360,6710,-650
2018-06-01,2055835729,C012030,여자상의,[공구우먼] 샤이 레이스 뷔스티에 원피스 29669 여성 빅사이즈,38000,38000,0
2018-06-01,451172504,C013010,점퍼,PUM03 지퍼포켓이중후드 4계절가죽점퍼패딩,120080,120080,0
2018-06-01,1086880971,A017010,배추,그린나래[브로컬리1kg]/컬리플라워/아스파라거스/빈스,4100,4100,0
2018-06-01,1786458623,E061010,세탁세제,슈퍼매직10kg+10kg=20kg/세제/세탁세제/가루/드럼겸용,9900,9900,0
2018-06-01,2028718547,A019180,즉석식품,우리우리 특갈비탕 600gx10팩 외 (김하진 감수한 탕),69900,69900,0
2018-06-01,674423139,A019180,즉석식품,빅마마 이혜정 육개장 갈비탕 외 맛보기 특가,30500,30500,0
2018-06-01,1148595969,A011030,찹쌀,초간편 보리 엿기름 10봉 보리가루 식혜가루 엿질금,33990,33990,0
2018-06-01,1080361903,C021020,구두,[SODA] 남성화 8종 택 1,79000,63200,-15800
2018-06-01,1355357966,C013010,점퍼,빈폴 아웃도어 공용 도브 다운 5종 택1 5종 택1,152640,152640,0
2018-06-01,584695568,I031040,생화,라이프스트로우 휴대용 정수기 필터 전쟁 지진 대비,16800,15460,-1340
2018-06-01,1197690679,C013020,티셔츠,헤지스키즈 티셔츠 HOM33TP25MBU,97200,97200,0
2018-06-01,2018390773,E031020,가스레인지,[SK매직] 실속형 2구 안심센서 가스렌지 GRA-813SR (LNG),126590,119000,-7590
2018-06-01,1894104632,A017090,열무,[e-fresh] 아삭아삭 비트 4개 / 개당 400g 내외,15900,15360,-540
2018-06-01,952197808,A019080,고추장,㉭ 사조해표 순창궁 태양초 고추장(4.5KG),8900,8900,0
2018-06-01,1960235798,A013100,마른멸치,청산바다 선물용 완도 전복 활전복 1Kg (7-8미 특대),53000,53000,0
2018-06-01,1509725200,L012060,샴푸,아모스 녹차실감 탈모샴푸/컬링에센스2X/헤어팩/선택,19900,19900,0
2018-06-01,465072673,E061010,세탁세제,[체험행사+바구니증정]*액츠 고농축 액체세제 2.7L+1L,15900,15900,0
2018-06-01,1847934539,C013010,점퍼,바람막이 윈드자켓 단체마킹인쇄가능 훼르자바람막이,15800,15800,0
2018-06-01,1894307169,L021020,장신구,헤메라 키 롱 목걸이 쥬얼리 네크리스 여성 스네이크,24080,24080,0
2018-06-01,415989364,C013040,청바지,EX 88 5 청반바지 청반바지 청5부 청 반바지 남자청반,54190,53110,-1080
2018-06-01,1724729628,A018090,잼,샹달프 284g 2종세트(딸기잼 블루베리잼),11900,11900,0
2018-06-01,1773390736,L021020,장신구,테니스팔찌/은팔찌/로얄큐빅/목걸이 세트가능/보증서,49500,49500,0
2018-06-01,987231793,F011150,건강기능식품,[종근당] 비타민D 1000 IU(1일 1정으로 비타민D 1000IU섭취) -1병(3개월분),25000,8900,-16100
2018-06-01,1046990180,C012040,여자학생복,빅사이즈 DMS1133 레이스 옆리본 조끼 801S 니트조끼,41400,41400,0
2018-06-01,987231792,F011150,건강기능식품,[종근당건강] 코큐텐 플러스(500mgX60캡슐) -1병(2개월분),40000,17500,-22500
2018-06-01,619625579,L021020,장신구,스와로브스키스톤 귀걸이 이어링 귀고리 은침 유색보석 비즈 실버 패션귀걸이 악세사리,9800,9510,-290
2018-06-01,987231794,F011150,건강기능식품,[종근당] N-아세틸글루코사민(연골성분을 생성하는 핵심성분 600mgX90정) -1병(3개월분),43000,15700,-27300
2018-06-01,804295642,E031110,청소기,(행사)한경희 회전스팀 물걸레청소기 AM-7000S 민박집,149000,135000,-14000
2018-06-01,267249936,A021010,커피,맥심 아이스 커피믹스 블랙 110T,10000,10000,0
2018-06-01,1681032814,C013020,티셔츠,[크루클린] 남녀공용 후드집업/후드티/맨투맨/오버핏,19800,13800,-6000
2018-06-01,688339730,C013020,티셔츠,로드스타 신상 PK티셔츠/카라티/스트라이프/반팔티,5900,5900,0
2018-06-01,193674854,E041010,식기,[순금 입체 거북수저2벌세트-우단케이스] 스푼세트 수저세트 숟가락세트 부부수저세트,40500,39400,-1100
2018-06-01,995094520,E061030,전구,LED 에디슨전구 모음/인테리어조명/백열 에디슨전구,2400,2400,0
2018-06-01,1263992780,C013040,청바지,스티치청반바지주니어청바지여름/ 제이키드 주니어,17900,17900,0
2018-06-01,490882062,C012060,여자내의,피핀 헤브링 플리츠 와이드팬츠 #73611/ 피핀,17200,13590,-3610
2018-06-01,182686936,L012090,기초화장품,민감피부 추천! 아크네스 더마 릴리프 모음전,10500,10500,0
2018-06-01,285218519,C013060,등산복,S/S 남성 기능성 카라 반팔 티셔츠 CY2-AE0126/ 컬럼비아,39000,33150,-5850
2018-06-01,1667637920,A022050,탄산음료,[산펠레그리노] 산펠레그리노 아란시아타 오렌지 330ml x 24캔,30590,30590,0
2018-06-01,989967911,E051020,건전지,[에너자이져]에너자이저AA(12입+4입),10900,10900,0
2018-06-01,1152000358,C013010,점퍼,써스데이아일랜드 (T184MJP233) 레이스 블루종 점퍼,329000,263200,-65800
2018-06-01,2058443130,E061050,청소용세제,파워싹 다목적클리너 곰팡이제거제 11종 찌든때제거제,29800,29800,0
2018-06-01,479464261,A013020,명태,[한바다몰]아구/아귀찜/아구탕/대구찜/대구두,4000,4000,0
2018-06-01,1588465175,C012060,여자내의,면스판 화이트 데미지 스키니팬츠 TK-5726 스키니진 스키니바지 여름바지 밴드바지 면,20310,18080,-2230
2018-06-01,460572191,A012050,소시지,[CJ제일제당] cj 맥스봉 치즈 1080g (27g*40개) 무료배송,15900,15900,0
2018-06-01,2133089347,C013020,티셔츠,BOD0018 BYC 여자 캐릭터 부드러운 순면 편면 큐티 여성 반팔 립브티 티셔츠 여 주니어,11250,11250,0
2018-06-01,193503507,A018110,물엿,명인 쌀조청스틱 64g/꿀 조청 물엿/국가명인 강봉석,4900,4900,0
2018-06-01,78803707,E041010,식기,이중스텐 냉면기/물컵/이중물컵/공기/밥공기/대접,1500,1400,-100
2018-06-01,774959875,C013010,점퍼,럭셔리/패딩점퍼/남성패딩/야상/패딩/무스탕/가죽자켓,128700,128700,0
2018-06-01,1211343982,C012040,여자학생복,[톰앤래빗] 오프홀터넥니트 /나시티/나시니트/홀터니트/기본나시,16000,14400,-1600
2018-06-01,89367708,E011060,의자,메리페어 와우체어 책상의자 컴퓨터의자 학생의자,229000,206100,-22900
2018-06-01,189867625,E061080,키친타월,코디 키친타올&미용티슈&물티슈 모음전/화장지/휴지,9900,9900,0
2018-06-01,1479655462,G022020,자동차타이어,[전국무료배송] 2018 넥센타이어 최신정품 12-20인치,45000,45000,0
2018-06-01,1886530308,C013020,티셔츠,[팡팡샵]신상 임부티셔츠/롱티/임부복/빅사이즈,14900,14900,0
2018-06-01,1509666477,F012010,종이기저귀,2018 보솜이 리얼코튼 밴드 공용 2단계 소형 54매3팩/ 보솜이,34900,33860,-1040
2018-06-01,410615968,A012010,국산쇠고기,CJ 특별한선택 2호,48040,48040,0
2018-06-01,1783184088,I031040,생화,휴대용 접이식 팔걸이 낚시의자 야외의자 캠핑의자,8900,7840,-1060
2018-06-01,486181040,I031010,장난감,스마트베베 다기능3in1 메가붕붕카-무독성,33500,33500,0
2018-06-01,441185500,E031110,청소기,[공식파트너]삼성전자 VC33M4151LR 진공청소기 팝레드,259000,245000,-14000
2018-06-01,1488142094,E011050,책상,집중력 독서실 실속형 책상,38600,38600,0
2018-06-01,1298183942,C013030,스웨터,MTS-018 특양면 저지 집업 남성의류 저지 캐주얼점퍼,34010,34010,0
2018-06-01,1040554747,C013040,청바지,[크로커다일] 경량 투톤 바지 CDAA4PT2522,49500,39600,-9900
2018-06-01,631915573,A016060,감,달콤샤르르 자연그대로 만든 아이스 홍시 30개(컵)/개,53300,46910,-6390
2018-06-01,1530592243,C012020,원피스,MELODY F111 브라운/코트/여자코트/겨울코디/겨울코트/자켓/점퍼 미국 여성토탈브랜드,98700,98700,0
2018-06-01,2045643604,L021060,유모차,예약판매 리뉴얼 세스토라이트 휴대용유모차 기내반입,368000,368000,0
2018-06-01,1297110503,C011030,남자학생복,FS080 스트라이프 포켓 셔츠-블루 캐쥬얼셔츠 남방 셔,29010,29010,0
2018-06-01,1460799350,E011040,소파,레이디가구 천연면피가죽 무빙헤드 벨르 4인 소파,732970,659680,-73290
2018-06-01,961396726,A017170,풋고추,오이10kg(못난이)1박스 두리반농산,23000,23000,0
2018-06-01,399940882,C013040,청바지,[보리보리/제이키드주니어]소다청스키니반바지_청색 주니어 여아반바지,16900,16900,0
2018-06-01,1424934728,C013040,청바지,[대구백화점 I관] [HUM]보이핏 밴딩 데님팬츠(FHMMDDB524M),39900,32720,-7180
2018-06-01,378241844,C013020,티셔츠,라코스테 기본 카라 티셔츠 / 남녀공용,49000,49000,0
2018-06-01,984283443,A018030,껌,초L)졸음 탈춤껌(105G/리필),3200,3200,0
2018-06-01,990187953,C013020,티셔츠,[공구우먼]티셔츠/원피스/바지/블라우스/스커트 모음,10000,10000,0
2018-06-01,504896493,L012010,면도기,쉬크 하이드로5 프리미엄 10입/총14입+기+사은품,22900,22900,0
2018-06-01,434190222,A018090,잼,딸기잼 1kg+1kg(2kg) 딸기쨈,10500,10500,0
2018-06-01,1588117867,E041010,식기,칠기멜라민 우동기 우동그릇 라면기 면기 라면그릇,1800,1580,-220
2018-06-01,1290240979,C013050,운동복,매끄럽고 부드러운 초극세사 폴리기모 남성 상의내의,11540,11540,0
2018-06-01,901222230,E061080,키친타월,초이스L 뽑아쓰는 키친타올 (150매*4입),6990,6990,0
2018-06-01,989106613,E041080,부엌용용구,테팔인지니오Y필러,9900,9900,0
2018-06-01,542433410,C014020,유아복,[뿌야뿌][뿌야뿌] 심플치마팬츠 PC2TGPT31N,14500,6530,-7970
2018-06-01,901222228,E061080,키친타월,초이스L 뽑아쓰는 냅킨 (120매*6입),5100,5100,0
2018-06-01,901222229,L012080,화장지,초이스L 미니티슈 (250매*6입),7990,7990,0
2018-06-01,2032114452,C013050,운동복,[균일가+세트]30수/쿨론 귀여운 프린팅 반팔티 반바지,9900,9900,0
2018-06-01,946456668,A011020,현미,두레생협 찹쌀백미(2kg 유기) 가정용백미 흰쌀 찹쌀,27530,27530,0
2018-06-01,1946889891,C013050,운동복,[앙투] 여름신상 트레이닝44~110빅사이즈 운동복 후드,27800,27800,0
2018-06-01,757442914,E011070,식탁,최고급 싱크대용 대리석 아일랜드 홈바/식탁,185000,185000,0
2018-06-01,1976216996,C013020,티셔츠,엠포르스 여름반팔티/7부티셔츠/린넨셔츠/7부반팔셔츠,11800,11800,0
2018-06-01,989106609,E041060,수저,[지홈] 우드 조리도구 1+1 묶음상품(우드 뒤집게  우드 미니 볶음 스푼),12700,6900,-5800
2018-06-01,1985751945,I031040,생화,헤머스 /8400루멘 /고품격 /손전등 /등산랜턴/ 신상,50900,40900,-10000
2018-06-01,1622876245,A019100,식초,하인즈 유기농토마토케찹1.25kg핫도그/피자/코스트코,6570,6570,0
2018-06-01,691410077,C013010,점퍼,[루시제이]벨티드 하이넥 무스탕,141000,124080,-16920
2018-06-01,752305386,A022050,탄산음료,씨그램 플레인/라임/레몬/자몽 450ml x20pet,13900,13900,0
2018-06-01,402945934,A019030,생강,백초생강 (참존 1.2k) X10,45570,40560,-5010
2018-06-01,2123330890,A012010,국산쇠고기,[무항생제] 찜갈비 800g 1등급,89900,89900,0
2018-06-01,260237569,F012010,종이기저귀,LG 마미포코 골드퍼피 에디션 기저귀 밴드/팬티 1박스,35900,35900,0
2018-06-01,693851154,C011030,남자학생복,여름신상 체크 남방 7부 솔리드남방 반팔셔츠 남자 스,14700,14700,0
2018-06-01,1213931155,C012060,여자내의,[대구백화점 II관] [리바이스]여성 델피나 데님 원피스(35876-0002),99000,86130,-12870
2018-06-01,314573789,C013010,점퍼,[크록스키즈] 3종 래쉬가드 세트,39900,33920,-5980
2018-06-01,30416189,A011170,떡,[제주직송]쫄깃한 오몰오몰오메기떡 50개입+선물포장,39900,38110,-1790
2018-06-01,1681343160,E031120,믹서,신일 믹서기 SMX-350SKH/칼날2종/용기3종/미니믹서기,28900,28900,0
2018-06-01,960298775,A018030,껌,[롯데]롯데 츄잉껌 3번들(51G),1000,1000,0
2018-06-01,989106636,E041080,부엌용용구,테팔프레쉬키친마늘다지기,9900,9900,0
2018-06-01,1243023956,E061040,부엌용세제,메소드 1000mlX6개 주방세제 친환경세제 퐁퐁 자연퐁,23800,23800,0
2018-06-01,1489707352,A018090,잼,트라피스트 수녀원 유기 포도 잼 410g 과일잼 과일쨈,18130,18130,0
2018-06-01,1593782846,C014010,아동복,아디다스 키즈 아동 반팔 반바지 칠부 아디다스세트,12900,12900,0
2018-06-01,2009736215,A017220,양파,흙쪽파 1단(소) / 국내산,7990,7990,0
2018-06-01,1791346446,C015020,모자,야구모자 볼캡 모자 남자 골프모자 등산 연예인모자,7000,6900,-100
2018-06-01,440293751,A019100,식초,오뚜기 토마토케찹800gX12개(1박스)마요네즈 케찹 드,64800,57030,-7770
2018-06-01,1010378376,A018020,사탕,시크릿쥬쥬 립스틱캔디 5G(색상랜덤배송),960,960,0
2018-06-01,1135715465,C012030,여자상의,밴딩/탄력스커트1,28000,28000,0
2018-06-01,1209401931,C013040,청바지,[Blouson]모던 심플 5부 팬츠_[B1806PT054B],41000,36450,-4550
2018-06-01,1435439580,C012040,여자학생복,[모다아울렛][조이너스][조이너스]JOINUS-셔링나시블라우스-JA7U4-WzkT110-(행담도모다,35700,35700,0
2018-06-01,1629887321,E061060,살충제,[가가호호]바퀴벌레 먹이캡 60개/먹이통 60개/맥스포스겔/마툴키/ 바퀴 개미 해충퇴치,9000,4500,-4500
2018-06-01,811791071,A021010,커피,이태리 킴보 네스프레소 호환 캡슐,5700,5700,0
2018-06-01,1466011939,C013050,운동복,PG멜란지 반팔트레이닝복세트 여름츄리닝 남자운동복,19800,19800,0
2018-06-01,505120617,C012060,여자내의,(원모어) 여성 밴딩 H라인 양트임 데님 청 스커트,24900,24900,0
2018-06-01,440293722,A019100,식초,오뚜기 토마토케찹1kgX12개(1박스)마요네즈 드레싱 마,77800,68470,-9330
2018-06-01,897790416,C021010,아동화,[베네통키즈]아쿠아런닝화 택1 -네이비 코랄 핫핑크(QCSH07731-NY CO HP),49000,39200,-9800
2018-06-01,2065946028,I011030,사진기,명품마을 캐논 정품 EOS M50 + 15-45mm 이벤트,807080,742430,-64650
2018-06-01,2128114071,I053030,복사용지,HP A4 복사용지(A4용지) 75g 2500매 2BOX/더블에이,35930,30900,-5030
2018-06-01,746948219,A011130,시리얼,오뚜기 바삭하고 고소한 부침가루 1kg X 10EA 튀김가,38180,37040,-1140
2018-06-01,1741456121,A017010,배추,동수농원 시래기(건무청) 100g * (10봉/20봉) 자연건조[삶지않음]/청정지역 물맑은 양,35000,35000,0
2018-06-01,1240553262,L012090,기초화장품,안나홀츠 클렌징크림 500 1000ml 메이크업리무버 로션,15000,15000,0
2018-06-01,1886389550,I053040,기타문구,[3M] 포스트잇 이젤패드 559/560/561/흰색/격자/라인,35900,35900,0
2018-06-01,805326822,L021030,가방,고컬리티 백팩 트윌 여성 남자 가죽 여행 학생 배낭,46900,46900,0
2018-06-01,1354553453,F012020,생리대,[특가]좋은느낌 유기농순면 오버나이트 20P 외 18종,8900,8900,0
2018-06-01,1405864260,C013020,티셔츠,(메이룸)원더반팔티 나염티 프린트티 반팔티 기본티,11900,11900,0
2018-06-01,386413502,C015030,넥타이,(색상 : 네이비) BTIE_084 에이트 와이드 보,13420,13420,0
2018-06-01,7855936,D031010,주택수선재료,아트 조립식마루 베란다 욕실 바닥재 장판 깔판 발판,43800,39420,-4380
2018-06-01,1320537300,E011020,침대,프리미엄 패밀리침대 SS+SS 가드형 프레임,381700,370250,-11450
2018-06-01,1132890481,C013020,티셔츠,2018 Best 신상 7부/반팔/반바지/팬츠/밴딩/데님/셔츠,10900,10900,0
2018-06-01,1395518152,C012040,여자학생복,아미가르 양포켓 청롱남방 STLD-6290/청남방 여성청남,27300,25940,-1360
2018-06-01,294261281,C013010,점퍼,[젤리스푼] 아동 아우터모음(가디건/집업/바람막이),10900,10900,0
2018-06-01,440293780,A019100,식초,오뚜기 토마토케찹500gX20개(1박스)케찹 마아가린 식,72400,63720,-8680
2018-06-01,2089863812,A021010,커피,[자판기커피]커피믹스/코코아/율무차/국산차 자판기용,3000,3000,0
2018-06-01,2054705353,I031010,장난감,점보 지프와 피규어 초등학생장난감 재미있는장난감,58530,58530,0
2018-06-01,1228264527,C021040,실내화,[푸마] PILSE IGNITE XT 펄스 이그나이트 런닝화 189455 03,99000,49500,-49500
2018-06-01,1384014871,E011050,책상,[블루밍홈] 베이직입식책상1200/테이블/컴퓨터/사무용,29900,23850,-6050
2018-06-01,1233102008,C013050,운동복,[하루비나] 신상트레이닝복세트모음/런닝맨/남여공용,29800,29800,0
2018-06-01,831049998,C012040,여자학생복,[대구백화점 II관] [슈퍼콤마비]Dolman cropped hood(W6TEX18102BLK),89500,80550,-8950
2018-06-01,725246963,C012020,원피스,빅사이즈/라운드/쉬폰/베스트 빅사이즈,60570,58150,-2420
2018-06-01,957709781,L012070,바디워시,LG 온더바디 퍼퓸바디워시 해피브리즈 900ML,14900,6990,-7910
2018-06-01,371584117,C012060,여자내의,발목 스타킹 10족 양말 발목스타킹 기모레깅스 레깅스 스타킹 겨울스타킹 기모레깅스,7160,6380,-780
2018-06-01,1425711382,E021010,침구,순면 차렵이불/이불세트/패드/요토퍼 26종,36900,33950,-2950
2018-06-01,31825261,C013010,점퍼,랜더스 남여공용 노르딕 헤비 패딩자켓 ( JK850W ) 레,79470,70730,-8740
2018-06-01,957709783,L012070,바디워시,LG 온더바디 퍼퓸바디워시 스위트러브 900ML,14900,6990,-7910
2018-06-01,548724100,L012090,기초화장품,비오템 옴므 아쿠아파워 모이스처라이저75ml/모이스춰,42900,42900,0
2018-06-01,989106673,E041040,프라이팬,테팔그래픽단청멀티팬28cm,34800,32800,-2000
2018-06-01,1800251867,F012020,생리대,[좋은느낌] 좋은느낌 오가닉100% 순면커버 슬림 날개형 대형 32p,11500,11500,0
2018-06-01,2023399836,C021040,실내화,아키클래식 프리미엄라인 브랜드 정품 운동화/런닝화/,29800,29800,0
2018-06-01,882092122,I031040,생화,풀세트/5200루멘/5발/초강력/헤드랜턴/최고사양/8종/,27800,24800,-3000
2018-06-01,1806420178,L021010,손목시계,[바보사랑]Gc-3 남성시계(가죽)_X12001G2S,538000,538000,0
2018-06-01,2053563364,C014010,아동복,어린이 방한 마스크 WH0170 파쿠몬마스크 M,8720,8720,0
2018-06-01,1676311649,A019100,식초,오뚜기 일회용케찹9gx 1000개,26900,26900,0
2018-06-01,1759194275,C011050,남자내의,남자린넨밴딩바지/린넨반바지/빅사이즈스판면반바지,16900,16900,0
2018-06-01,1395604550,C012030,여자상의,키섬 라운드 원피스 예쁜 스커트 니트세트 STLD-6520,48000,45600,-2400
2018-06-01,2038660209,D031010,주택수선재료,미앤미 일본산 히노끼 원목 21p 조립식 베란다 마루,59500,53550,-5950
2018-06-01,1071475939,L021020,장신구,[동은쥬얼리]피어싱 실버피어싱 큐빅피어싱,5000,5000,0
2018-06-01,578405416,D031010,주택수선재료,노루 슈퍼에나멜 플러스 유성 에나멜 페인트 1L,6400,6400,0
2018-06-01,99454087,A011090,국수,팔도 왕뚜껑 110g x 18개/김치/짬뽕/도시락,13900,13900,0
2018-06-01,1313292660,C011030,남자학생복,밀란시아 베이직 3버튼 조끼 sh171-003 남성캐쥬얼 캐,45500,44590,-910
2018-06-01,607600845,C014010,아동복,유아 놀이복 코튼정글 면 1개 미술복 아기놀이복,18520,18520,0
2018-06-01,560210254,C013010,점퍼,빅사이즈 에어지퍼후드집업 MN1712 빅사이즈 여성의류,69800,69800,0
2018-06-01,1695279255,F011120,인삼,천봉산삼 5~6년근 20뿌리 산삼 산양삼 장뇌삼,59000,59000,0
2018-06-01,451172592,A019010,고춧가루,늘푸른 특 고추가루 2.4kg2개 가루 고추가루 늘푸른고,107410,96670,-10740
2018-06-01,1450837797,C011020,남자상의,여름용쿨정장바지/시어써커/아이스/스판/물세탁/30-40,15800,15800,0
2018-06-01,1996871527,C011050,남자내의,푸마 트레이닝 팬츠 ( 65382437 ),61000,61000,0
2018-06-01,2111054993,E061020,섬유유연제,바운스 드라이시트 섬유유연제 320매,17490,17490,0
2018-06-01,755517239,E061020,섬유유연제,피죤 섬유유연제 2100ml 3~8개 / 3500ml 피존,9900,8900,-1000
2018-06-01,1633318361,C013050,운동복,세컨드맨션 - ICON CAR DOOR GUARD,3460,2880,-580
2018-06-01,2078003991,C012040,여자학생복,[로렌즈앤]로렌즈앤 야자잎로브가디건,25800,24510,-1290
2018-06-01,1028768189,I011030,사진기,(정품) 소니 ILCE-6000L (SELP1650 포함) A6000L,635000,584200,-50800
2018-06-01,469548087,E041010,식기,델키 보온아이스페일/와인쿨러/쿨러/아이스버켓/아이,74900,73410,-1490
2018-06-01,825392058,A012010,국산쇠고기,[무항생제 한우선물세트] 한우 불고기 2호 2kg,149200,149200,0
2018-06-01,1599830924,L021050,우산,기라로쉬 튼튼한 2단 3단 자동우산 고급 장우산 41종,9900,9900,0
2018-06-01,1169163927,C013040,청바지,[탑걸]화이트일자핏데님팬츠(TIZ4DP711F)(의정부점),39000,31650,-7350
2018-06-01,2989073,A019050,간장,옹고집 어간장 1.8L/ PET/ 국산콩 저염간장,25000,25000,0
2018-06-01,1268140772,A011160,빵,자체생산/매일 신선한빵/수제 햄버거빵 18개/핫도그빵,9500,9500,0
2018-06-01,502791457,I053020,스케치북,전문가용 5절스케치북(10권)/4절스케치북/8절스케치북,13000,13000,0
2018-06-01,1478696375,C013010,점퍼,[에고이스트]캐쥬얼 롱 야상 점퍼 EH2WZ360,179000,139620,-39380
2018-06-01,546921381,C013060,등산복,콜핑 여름 기능성 티셔츠/팬츠 96종 특가전,9500,9500,0
2018-06-01,535427092,F012050,의료측정기,VT 정품 브라운체온계 IRT-6030 IRT-6520 A/S보장,80000,74400,-5600
2018-06-01,1295136495,A019080,고추장,해표 순창궁 태양초 고추장 4.5kg/6.5kg/햅쌀/업소용,10200,10200,0
2018-06-01,565686362,A017300,미역,우체국 직송/대천김 재래김/파래김 10봉/15봉/25봉,13900,13900,0
2018-06-01,1830290128,A017220,양파,대파분태(중국산) 300g/말린/건조/대파/파/분태/후레이크/분말/가루/생식/선식/천연/조,7500,7500,0
2018-06-01,582793103,F012010,종이기저귀,[마미포코] 마미포코 보송허그 밴드기저귀 중형 남아 52매X3팩,35900,35900,0
2018-06-01,1779490106,L021020,장신구,[바보사랑]넘버 23 팔찌-화이트(7색상),15000,15000,0
2018-06-01,684668580,L012010,면도기,도루코 일회용면도기20개30개 터치3/페이스4/1개340원,10500,10500,0
2018-06-01,1779490107,L021020,장신구,[바보사랑]넘버 23 팔찌-블랙(7색상),15000,15000,0
2018-06-01,1779490108,L021020,장신구,[바보사랑]축구공 밴드 팔찌(SOCCER BALL BRACELET)-화이트(WHITE),15000,15000,0
2018-06-01,1779490109,L021020,장신구,[바보사랑]축구공 밴드 팔찌(SOCCER BALL BRACELET)-블랙(BLACK),15000,15000,0
2018-06-01,1779490102,L021020,장신구,[바보사랑]커피 컷팅 실버 은팔찌,14000,14000,0
2018-06-01,1741458044,A017010,배추,동수농원 시래기(건무청) 100g * (10봉/20봉) 자연건조[삶지않음]/청정지역 물맑은 양,17500,17500,0
2018-06-01,1779490105,L021020,장신구,[바보사랑]샤무드 리본 스트랩 초커(SUEDE RIBBON STRAP CHOKER)-6색상,12000,12000,0
2018-06-01,415160787,C013010,점퍼,레쟈점퍼 스웨이드 자켓 BW 남자점퍼 점퍼 매터자켓,97780,95830,-1950
2018-06-01,693224002,A014020,분유,[아이배냇] 순 산양분유 1/2/3단계 400g 1캔,16900,16900,0
2018-06-01,499130035,C011030,남자학생복,[찐링] 긴팔반팔 국내산 차이나와이셔츠 슬림차이나,22800,22800,0
2018-06-01,1873270357,C012040,여자학생복,[랩턴]랩턴 리버시블울코트,29900,29900,0
2018-06-01,1842529720,A019170,냉동식품,(사조) 고기/김치/브로콜리 포자만두 180g / 3종 선택,730,730,0
2018-06-01,1239070243,A022010,주스,망고원액(참존835ml)X12개/망고 원액 스무디 망고스틴 젤라또 아이스크림 재료 푸딩 버,51720,49140,-2580
2018-06-01,1346199828,F012020,생리대,쏘피 한결 오버나이트 모음 5팩/생리대/바디피트,12900,12900,0
2018-06-01,306349829,C012040,여자학생복,[대구백화점 I관] [애녹]린넨가디건(AU517K),45000,40050,-4950
2018-06-01,1140435531,E031020,가스레인지,PHD-FD900M 파세코 가로900 침니후드/플랫듀오 렌지후드/삼파장/알루미늄필터/벽부착형,259000,255000,-4000
2018-06-01,2046614036,A011020,현미,민가네 2017년햅곡 초특가행사 미소메뚜기 찹쌀 20kg,58000,58000,0
2018-06-01,1779490110,L021020,장신구,[바보사랑]야구공 밴드 팔찌(BASEBALL BRACELET)-화이트(WHITE),15000,15000,0
2018-06-01,1199863221,C013050,운동복,트레이닝바지/츄리닝/남성/조거/7부트레이닝/반바지,12800,12800,0
2018-06-01,711287492,C011030,남자학생복,여름셔츠 7부/반팔/롤업/남방/루즈핏/헨리넥,9900,9900,0
2018-06-01,985295439,A018060,스낵과자,[오리온]오리온 미쯔스낵팩 84G,1000,1000,0
2018-06-01,175808627,A011090,국수,삼양 까르보 불닭볶음면10개 짜장불닭볶음면10개 라면,10500,10500,0
2018-06-01,296065585,A017050,미나리,[홈플러스][행사상품]햇양배추_통,1990,1900,-90
2018-06-01,319768499,G011070,자전거,[삼천리] 시애틀레이디7+무료배송 18년 여성용자전거,139000,125100,-13900
2018-06-01,900673540,A015020,식용유,청정원 포도씨유 500mlx4병,14800,14800,0
2018-06-01,895802377,A019060,된장,[대상]청정원 조개멸치찌개 된장 (450g),6200,3490,-2710
2018-06-01,895802379,E061030,전구,[GE삼성]GE삼성)이관형광등주광색18W,5000,5000,0
2018-06-01,439011480,C011020,남자상의,[슈트파크]신상품/남성정장/춘추복/간절기/정장/수트,79900,79900,0
2018-06-01,990002296,A011040,보리쌀,손안의간편한끼 플레인 40G,2990,2990,0
2018-06-01,990002293,A016160,과일가공품,DOLE후룻볼슬라이스(망고) 198G,3990,1990,-2000
2018-06-01,896549820,A012050,소시지,CJ 정말맛있는소시지(마늘맛) 160G,990,990,0
2018-06-01,2085156894,A017090,열무,무농약 햇 무 5kg 동치미 무우 깍두기 김장양념,9000,8900,-100
2018-06-01,1320059985,D031010,주택수선재료,[테라코코리아]스터코빈티지/벽면세트/5평/10평/빈티지스타코/시멘트스타코/카페/인테,136000,136000,0
2018-06-01,1877806539,C015020,모자,신상볼캡/야구모자/캠프캡/볼캡/빅사이즈/남녀공용,13900,9900,-4000
2018-06-01,1010200653,A018100,꿀,[백화농원]프리미엄 매화 도자기꿀 1kg,34900,25200,-9700
2018-06-01,301561149,E021020,커튼,브라우니 린넨 아일렛 암막커튼160/거실커튼,23500,23500,0
2018-06-01,770720084,C013020,티셔츠,빈폴/폴로/헤지스/라코스테/반팔/카라티/남방/타미힐피거/구제/명품MARKET,13900,13900,0
2018-06-01,38543995,A011170,떡,HACCP 떡국떡1kg+1kg쌀떡볶이 떡국 무료배송,5900,5900,0
2018-06-01,1078137289,A012060,햄및베이컨,청정원 슬라이스햄1kg(50장입),6300,6300,0
2018-06-01,141111613,C012060,여자내의,여성 남성 밍크 융털 털 기모 바지 겨울 몸빼 일바지,9420,9320,-100
2018-06-01,1239070278,A022010,주스,망고주스(델몬트 롯데 1.5L)X12개/망고 원액 망고스무디 망고스틴 젤라또 아이스크림,49100,46650,-2450
2018-06-01,529640877,C012060,여자내의,백합주름치마 밤색 전체 주름 교복치마 교복 예쁜교복,55060,53410,-1650
2018-06-01,1465623361,L021050,우산,[초특가]패션브랜드우산/장우산/양산/돌답례품/판촉물,6500,6500,0
2018-06-01,1010200652,A018100,꿀,[백화농원]프리미엄 백상감 도자기꿀 1kg,34900,25200,-9700
2018-06-01,1710610273,E011070,식탁,런칭특가/샤인-홈바(아일랜드식탁)시리즈/식탁 수납장 주방가구 주방수납장 렌지대 테,139900,139900,0
2018-06-01,1010200651,A018100,꿀,[백화농원]프리미엄 매화 도자기꿀 1kg + 백상감 도자기꿀 1kg,59900,47200,-12700
2018-06-01,781987399,A021010,커피,돌체구스토 호환 캡슐커피 13종/까라로/이탈리아 돌체,6970,6970,0
2018-06-01,1320537269,E011020,침대,프리미엄 패밀리침대 Q+Q 밸런스 20T라텍스매트리스,897400,870480,-26920
2018-06-01,954038918,A014010,우유,남양 맛있는우유 GT기획(1L*2입),4780,3600,-1180
2018-06-01,373208662,C014010,아동복,티셔츠/바지5종택1(T73KK22000-00)/ 티파니,22000,19800,-2200
2018-06-01,57509976,A019010,고춧가루,보쌈김치소스5kg 보쌈김치양념장 겉절이양념 할인세일,45000,45000,0
2018-06-01,1692525259,F011150,건강기능식품,종근당건강 본사 원데이21 멀티비타민 2병/4개월분,19800,19800,0
2018-06-01,415821197,E031110,청소기,[악패+필터2증정]로봇청소기 아이클레보 아르떼 4종,399000,399000,0
2018-06-01,475966392,C011020,남자상의,[무료배송]남자 자켓 JK01 WS 슈트 재킷 자켓 남성슈,94450,94450,0
2018-06-01,455058546,L012030,칫솔,예꼬맘/360도/미세모/유아/칫솔/3P세트/신학기준비물,14500,14500,0
2018-06-01,981745381,E061080,키친타월,[미래생활]나무야 키친타올(150매*4),5990,5990,0
2018-06-01,310250635,C013020,티셔츠,나시/나시티/골지나시/망고나시/민소매/남자나시/무지,5900,5900,0
2018-06-01,407250574,C013010,점퍼,스테판조셉 레인코트 유니콘 (택1) 아동우비 레인코트,65290,62680,-2610
2018-06-01,652920360,C015020,모자,[NEWERA]뉴에라 스냅백 MLB NBA 야구모자 미첼엔네스,33000,31000,-2000
2018-06-01,1470790240,I031040,생화,텐트줄/줄/끈/파라코드/팔찌/매듭팔찌/텐트끈/로프,2500,2500,0
2018-06-01,1962509134,E011050,책상,로엠가구 홀다리 입식 좌식 테이블,2500,2500,0
2018-06-01,307636274,A011010,쌀,추청경기미 안성쌀10kg 밥선생,27900,27900,0
2018-06-01,931424372,A022050,탄산음료,펩시콜라/칠성사이다(업소용) 500mlx20펫 콜라/사이다,11500,11500,0
2018-06-01,444651987,A019020,참깨,국산참깨 200g 볶은참깨 가정용 국산통참깨 볶은참깨,14400,14400,0
2018-06-01,985381928,A013180,젓갈,[속초아바이마을전통젓갈]오징어젓500g,19000,14900,-4100
2018-06-01,985381929,A013180,젓갈,[속초아바이마을전통젓갈]오징어젓1kg,27000,22500,-4500
2018-06-01,985381924,A013180,젓갈,[속초아바이마을전통젓갈]명란젓(골드)1kg,42000,28500,-13500
2018-06-01,1010403332,A012030,돼지고기,[대패_HACCP인증]돌돌말이 한입삼겹 500G,11900,6900,-5000
2018-06-01,534793456,C012060,여자내의,탑걸 스커트 TIZ4SK726F 스트라이프 언발 롱스커트 New.,47200,38710,-8490
2018-06-01,1192190357,C012040,여자학생복,추가금NO.SUMMER 블라우스 자체제작상품.빅사이즈까지,19900,19900,0
2018-06-01,399699196,E031130,보온매트,[힐스톤]거실전기매트/온수매트/KCC모노륨/전기장판,59000,59000,0
2018-06-01,2000760020,A021010,커피,맥심 모카골드/화이트골드160T,17900,17900,0
2018-06-01,986159350,E061090,방향제,BL엣지도어가드,5990,5990,0
2018-06-01,1104867973,F012010,종이기저귀,2018 군 프렌드 도라에몽 팬티형 기저귀 3팩,23900,23900,0
2018-06-01,411902928,C013010,점퍼,제너럴 레이스 프릴 블루종- 레이스블루종 레이스항공,71400,64260,-7140
2018-06-01,1267923480,A013080,조개,왕중왕 해물나라 900g2개,36190,36190,0
2018-06-01,670612084,A019040,소금,3-5년묵은 최상품 소금 신안 비금도 명품천일염 20kg,19500,19500,0
2018-06-01,1767599215,A011010,쌀,[17년산 햅쌀]동송농협 철원오대쌀 20KG/당일도정!,60800,60800,0
2018-06-01,987316514,F011120,인삼,[참다올]설악산표고세트_동고260g(130g*2)  표고절편 80g,80000,56000,-24000
2018-06-01,1246508134,C012060,여자내의,[나인스토리]글로리플레어린넨스커트BN783,24800,23560,-1240
2018-06-01,1894200888,I031010,장난감,Step2 멜로디 지붕차 유아용품 운전놀이 유아용완구,243280,243280,0
2018-06-01,1089839533,E061040,부엌용세제,참그린 참숯 뽀드득 1.2L 리필 X 5개,13900,13210,-690
2018-06-01,451027201,C012040,여자학생복,여성 무스탕 조끼_베스트,28830,28830,0
2018-06-01,726846585,A014010,우유,바른목장/바나나/유산균음료/유기농우유125ml(24팩),13900,13900,0
2018-06-01,1814582824,C011050,남자내의,여름 남성 남자 마바지 린넨바지 밴딩 린넨 반바지 쿨,19800,19800,0
2018-06-01,1248594621,C011020,남자상의,(색상 : 네이비 | 사이즈 : L) WMJ-009 지,88300,88300,0
2018-06-01,479770987,C012040,여자학생복,[헤레이스]뒤트임베스트CHF18S770,98000,93100,-4900
2018-06-01,1087458923,C013010,점퍼,남성 캐주얼자켓 남자 자켓 빅사이즈 마이,51800,49800,-2000
2018-06-01,1366250521,C014010,아동복,18여아티셔츠여아의류여아레깅스롱티아동복아동의류,8900,8010,-890
2018-06-01,2015742048,L021030,가방,리얼 데일리 에코백 보조가방 캔버스백 천가방 숄더백,8000,6900,-1100
2018-06-01,1530565423,C012020,원피스,MELODY F5 블랙/코트/여자코트/겨울코디/겨울코트/자켓/점퍼 미국 여성토탈브랜드 멜로,68700,68700,0
2018-06-01,590507738,C013010,점퍼,타오 롱 후드 베어 코튼 조끼_236152/ 어썸,49900,42420,-7480
2018-06-01,2095460654,F012010,종이기저귀,킨도 독일 프리미엄 기저귀 팬티형 4팩 (4/5/6단계),61600,61600,0
2018-06-01,1156848653,C011050,남자내의,[뱅뱅][뱅뱅] 여성 썸머팬츠_I9B4,12900,12260,-640
2018-06-01,986184301,A019060,된장,해찬들 명품 집된장 900G,9650,9650,0
2018-06-01,1136088777,A018100,꿀,콤비타 UMF15+ 마누카꿀(250gx1병)/마누카꿀 100%,99000,99000,0
2018-06-01,446525968,C015020,모자,디자인군모 패션군모 예쁜군모 빈티지군모 군모,18750,18750,0
2018-06-01,954038972,A013170,생선통조림,동원 마일드참치 100G*4입 기획,7900,7900,0
2018-06-01,422863378,C012040,여자학생복,[바비앤펌킨]솔직담백 가디건,43200,38880,-4320
2018-06-01,1831926248,C012040,여자학생복,[꼼빠니아][꼼빠니아]하트 단추 트임 티-IC7S3WBB730,39900,33920,-5980
2018-06-01,1634225853,A013170,생선통조림,동원 참치 살코기/마일드 150g 특가 최다구성 참치캔,9800,9800,0
2018-06-01,1348602031,C013040,청바지,[공구우먼] 올웨이즈 히든밴딩 일자 구제 팬츠 28829 빅사이즈,39800,39800,0
2018-06-01,479770991,C012040,여자학생복,[헤레이스]샌드롱베스트CHF18S771,98000,93100,-4900
2018-06-01,966557998,C012060,여자내의,청롱스커트 청치마 롱청치마 데님 긴청치마 청롱치마,19000,18430,-570
2018-06-01,517251070,C013010,점퍼,[대구백화점 II관] [레코브]폴란 인조 무스탕(LX317ZJP513X),64000,60800,-3200
2018-06-01,990089802,E041070,밀폐용기,락엔락체스물병1.5L,3500,3500,0
2018-06-01,479770993,C012040,여자학생복,[헤레이스]트랜드로브가디건CHF18S772,98000,93100,-4900
2018-06-01,993830011,C012040,여자학생복,지홍 신상추가/XXXL~S/빅사이즈/루즈핏블라우스/셔츠,34900,34900,0
2018-06-01,896550867,E061070,가정용비닐용품,[크린랩]크린랩) 크린종이호일 (30CM*20M),4500,4500,0
2018-06-01,323875062,F012020,생리대,화이트 시크릿홀 울트라/슬림(소/중/대/오버/수퍼롱),34000,34000,0
2018-06-01,1619031490,C013010,점퍼,무스탕 라이더 가죽자켓 WS_PU_09 무스탕 가죽자켓 라이더자켓 무스탕 패딩자켓 가죽,227190,202200,-24990
2018-06-01,463390746,I031070,애완동물관리비,[헤드] 헤드 115sq 240g TIS6 테니스라켓 테니스공 N3,139000,121790,-17210
2018-06-01,1801234228,F012020,생리대,[좋은느낌] 좋은느낌 오가닉100% 순면커버 슬림 중형 36p X 2개,25500,25500,0
2018-06-01,1133524736,A011140,부침가루,필라델피아 치즈케익 794g 2개 / 1.7kg 1개,31900,31900,0
2018-06-01,1052348866,E031010,전기밥솥,쿠쿠공식몰/CRP-R1010FC/10인용/캐비어블루/2018년형,262460,246620,-15840
2018-06-01,130733028,C013020,티셔츠,(GROUP)초간지!나시티셔츠/나시티/남자나시/민소매/남,15600,15600,0
2018-06-01,1779490135,L021020,장신구,[바보사랑]체커보드 밴드 팔찌 블랙-골드(CHECKERBOARD BRACELET BLACK-GOLD),15000,15000,0
2018-06-01,1779490136,L021020,장신구,[바보사랑]체커보드 밴드 팔찌 블랙-실버(CHECKERBOARD BRACELET BLACK-SILVER),15000,15000,0
2018-06-01,1842180053,C013020,티셔츠,18아동티셔츠아동상하아동반바지여아레깅스여아롱티,6900,6210,-690
2018-06-01,1754263166,E041060,수저,[한국전통선물] H.jin 금수저/은수저/티타늄수저세트,26000,26000,0
2018-06-01,448437368,C013050,운동복,이너웨어 스포츠의류 주니어 상의6 스판헬스복 스판트,64860,64860,0
2018-06-01,1021198360,C011030,남자학생복,초특가 데님 셔츠 긴팔 솔리드 남방 남자 청남방 여름,24000,15800,-8200
2018-06-01,1779490132,L021020,장신구,[바보사랑]야구공 밴드 팔찌(BASEBALL BRACELET)-블랙(BLACK),15000,15000,0
2018-06-01,1779490133,L021020,장신구,[바보사랑]농구공 밴드 팔찌(BASKETBALL BRACELET)-화이트(WHITE),15000,15000,0
2018-06-01,1206212042,E041050,냄비,키친아트 냄비 4종세트 양수냄비 편수냄비 전골냄비,60800,59800,-1000
2018-06-01,1779490134,L021020,장신구,[바보사랑]페이즐리 밴드 팔찌 블랙(PAISLEY BRACELET BLACK),15000,15000,0
2018-06-01,984395880,A013150,어묵,CJ 안심부산어묵얇은사각 200G*2,3090,2690,-400
2018-06-01,875534362,A011110,당면,당면(옛 찰 모아 500g)X5/qhdcnWlaekfrekdaus,11690,11690,0
2018-06-01,1010200687,A019150,김치,CJ 비비고썰은배추김치 100G,1500,1500,0
2018-06-01,458221228,A011030,찹쌀,보리쌀 (7K),37150,33070,-4080
2018-06-01,440943207,C012040,여자학생복,[블루종]러블리 레이스 진주 가디건_[B1806CD032B],44000,34810,-9190
2018-06-01,150401303,A013090,전복,천우물산 자숙갯고동10kg(1kgx10),46150,46150,0
2018-06-01,440945869,C012040,여자학생복,[코코애비뉴]에어가오리핏니트탑_80504,26400,24170,-2230
2018-06-01,1452831253,C013010,점퍼,니트패치 패딩 집업 점퍼 EH4PZ061/ 에고이스트,119000,95200,-23800
2018-06-01,815004981,I031040,생화,코스모스 아이스물통 외 9종 피크닉물통 레저용물통,18700,17210,-1490
2018-06-01,800745580,I031040,생화,1+1팔걸이 낚시의자 캠핑의자 야외의자 낚시의자 캠핑,14900,13270,-1630
2018-06-01,863472025,I053030,복사용지,라인프렌즈 한솔 75g A4용지 2박스 5000매,36490,30820,-5670
2018-06-01,1822876286,C013040,청바지,[크로커다일] 서커 쿨스킨 팬츠 블랙 CDAA3PT2532_VIP,39000,31200,-7800
2018-06-01,990090888,A011010,쌀,[대월농협]임금님표이천쌀(추청)10kg,39000,31500,-7500
2018-06-01,990090887,A011010,쌀,[대월농협]임금님표이천쌀(추청)20kg,71000,68300,-2700
2018-06-01,631048652,C012020,원피스,[대구백화점 I관] [탑걸]간절기트렌치코트(TIA1B600F),139000,119540,-19460
2018-06-01,1150484390,C012020,원피스,겨울인기상품코트 7종 택1/ 나이스클랍,159000,129000,-30000
2018-06-01,1693381571,E011050,책상,위드멀티책상세트/컴퓨터책상/학생책상/학생용 책상,77800,77800,0
2018-06-01,990090895,A011010,쌀,[여주군농협]여주햅쌀10kg(추청),37300,32100,-5200
2018-06-01,335401053,L012090,기초화장품,엠도씨 릴리프 수딩 겔,18000,18000,0
2018-06-01,1340386371,C012060,여자내의,[크로커다일레이디스]모던 캐주얼 밴딩팬츠,10900,10360,-540
2018-06-01,620291496,A014030,치즈,파마산치즈 227g 대용량치즈 치즈가루 파마산치즈가루,8300,8200,-100
2018-06-01,1598458437,A012060,햄및베이컨,동원 리챔/런천미트x10개 대용량340g 스팸/햄/소세지,18900,18900,0
2018-06-01,1461234589,A017300,미역,대박특가 광천김 1박스 전장 도시락김 김자반 파래김,23400,19800,-3600
2018-06-01,705155050,A019080,고추장,ⓒ 해찬들 무침요리장(285G),4380,4380,0
2018-06-01,1347596717,D031010,주택수선재료,KCC도로표지페인트 4L백색/황색 /차선 주차선 표시선,24000,24000,0
2018-06-01,479770934,C012040,여자학생복,[헤레이스]옆트임롱베스트CHF18S766,118000,112100,-5900
2018-06-01,1066523241,E011030,거실장,[채우리] 로즈 1200 거실장,91000,91000,0
2018-06-01,2047673056,C013050,운동복,클레이바/낙진제거제/성애제거제/물때제거/도장면세척,6000,2480,-3520
2018-06-01,1066523242,E011030,거실장,[채우리] 라비앙 600 거실장,58000,58000,0
2018-06-01,206745474,C011050,남자내의,마바지 린넨바지 마반바지와이드/남자반바지/남성,17700,17700,0
2018-06-01,1066523240,E011030,거실장,[채우리] 로즈 600 거실장,58000,58000,0
2018-06-01,517106204,D031010,주택수선재료,[예쁜집꾸미기+오늘출발]포인트스티커/벽지/시트지/리폼/레터링/뮤럴/띠벽지/월데코/패,12000,7340,-4660
2018-06-01,8510117,C014010,아동복,아동남방/ 아동셔츠/ 아동 체크셔츠/ 아동 체크남방/ 워싱체크남방/ 워싱체크셔츠/ 국,19800,19800,0
2018-06-01,1197832497,A011170,떡,[떡장인 황대규옹]떡메찰떡 청실홍실 1호 선물세트,20900,20900,0
2018-06-01,519839640,A017090,열무,국내산 레드비트 2kg 내외,8900,8600,-300
2018-06-01,990089894,A014040,발효유,[동원]동원 비피더스명장(복숭아) 150ML*8,3990,2600,-1390
2018-06-01,830485337,I012010,컴퓨터,729000원+추가5%할인! 한컴&마우스증정 NT900X3Y-AD2S,783870,729000,-54870
2018-06-01,1942443066,A017170,풋고추,(맛나)#백오이(특.경매)/소,115600,104040,-11560
2018-06-01,1825040324,C013020,티셔츠,남성 반팔티셔츠 카라티 골프티셔츠 골프웨어 MKST,27900,27900,0
2018-06-01,862066251,C013020,티셔츠,슈나이더 역시즌2탄! 다운/패딩 알차게 준비했어요~,29800,29800,0
2018-06-01,946481659,A011020,현미,두레생협 찹쌀백미(2kg 무농약) 백미 찹쌀백미 가정용,23500,23500,0
2018-06-01,1243851316,C011030,남자학생복,본사정품 오마샤리프 와이셔츠/남자/남성/체크/긴팔,11000,11000,0
2018-06-01,39066121,C021040,실내화,나이키 여성 테니스 클래식(312498-130),113220,104170,-9050
2018-06-01,900962770,A019060,된장,청정원 고깃집 집된장(450G),5750,5750,0
2018-06-01,766580923,A014020,분유,[20%쿠폰]우리아이워터 240ml 24병 루이보스 보리,18900,18900,0
2018-06-01,1044322868,C015020,모자,균일가/마이너스옵션/군모/심플군모/빈티지군모/남녀공용/연예인군모/기본군모/패션군,7000,6900,-100
2018-06-01,852704960,I012060,저장장치,양몰 ABKO HACKER K640 게이밍키보드 청축/갈축/적축,44460,38900,-5560
2018-06-01,407249520,C013010,점퍼,스테판조셉 프린티드 레인코트 로봇A (택1) 레인코트,65290,62680,-2610
2018-06-01,886801829,E061010,세탁세제,애경 퍼펙트 이코노미 10kg 2개 대용량 업소 드럼겸용,23900,23900,0
2018-06-01,438554235,E061020,섬유유연제,다우니 고농축유연제 5.03L x2 에이프릴프레시,34900,34900,0
2018-06-01,342058159,C013040,청바지,[올젠]`18 S/S 슈퍼플렉스 져지 데님 팬츠 2종 택1 (ZAY1DP1301)(강남점),47000,38760,-8240
2018-06-01,596524942,C013020,티셔츠,(남영비비안) 임산부 스타킹/레깅스/타이츠,5600,5500,-100
2018-06-01,586339651,F012020,생리대,위스퍼 보송보송케어 오버 14Px6개 생리대 최근제조,25900,25900,0
2018-06-01,989938124,A022030,생수,롯데 아이시스8.0 (300ML*20),5400,5400,0
2018-06-01,1559979215,A021010,커피,아이수 페루산 카카오닙스500g -카카오닙스 카카오 페,21280,18940,-2340
2018-06-01,1253288727,C013030,스웨터,육군컴뱃셔츠 셔츠 컴뱃셔츠 육군셔츠 군인셔츠 기능,82210,82210,0
2018-06-01,1293959730,A014020,분유,[베비언스] 산양 액상분유 2단계 240ml 20입,42900,42900,0
2018-06-01,2112111838,A011160,빵,천연발효종*빠네빵(210gX4개)/스파게티/빠네파스타/빵,8900,8900,0
2018-06-01,814922530,E031070,에어컨,정품.신일 벽걸이선풍기 SIF-16JWK 16인치선풍기,34600,34600,0
2018-06-01,1375096268,C013040,청바지,남자 스판 청바지 빅사이즈 남성 구제바지 생지 여름,17800,16800,-1000
2018-06-01,1291962800,C011020,남자상의,체스트맨 언컨 수트 스판 남성정장 여름 양복세트,85000,85000,0
2018-06-01,989855319,A011060,땅콩,BottleRice 아이조아10곡 430G,7990,7990,0
2018-06-01,83363211,A011010,쌀,[참쌀닷컴] 나주 마한농협 새로미 쌀 20kg,47900,47900,0
2018-06-01,1064541402,G011070,자전거,시애틀GS20 18년 접이식자전거 7단20인치 초3부터사용,109000,109000,0
2018-06-01,1082188827,C013040,청바지,[요즘에]여름신상/청바지/슬랙스/반바지/빅사이즈,9900,9900,0
2018-06-01,1517106976,A014020,분유,아이배냇 순 산양분유 1단계 800g 3캔,88500,88500,0
2018-06-01,1899999592,A014050,달걀,유기농 계란 방사 유정란 40알 / 동물복지농장,29000,29000,0
2018-06-01,985381957,A013180,젓갈,[속초아바이마을전통젓갈]갈치쌈젓500g,18600,14900,-3700
2018-06-01,479770960,C012040,여자학생복,[헤레이스]바코드롱가디건CHF18S768,68000,64600,-3400
2018-06-01,479770963,C012040,여자학생복,[헤레이스]메이드가디건CHF18S769,68000,64600,-3400
2018-06-01,145838012,C015020,모자,군모 모자 야구모자 스냅백 밀리터리캡 여자 남자,7900,7900,0
2018-06-01,1439879951,G022020,자동차타이어,한국타이어 다이나프로 HL 3 RA45 무료배송 특가모음,90000,74800,-15200
2018-06-01,1236980634,C013020,티셔츠,[크리비아] (4926상)랩스타일 산전산후 수유가능한 면스판 임부상,17370,17370,0
2018-06-01,450994681,C013050,운동복,스트레치 자켓 MK1521-1522 마크 남성점퍼 남성용점퍼,94570,94570,0
2018-06-01,1806420983,L021020,장신구,[바보사랑]귀걸이 611533063_PMMAPC61004,45000,45000,0
2018-06-01,1358752477,A018060,스낵과자,한입참인절미 한박스/인절미 과자/쌀과자/간식/안주,25000,25000,0
2018-06-01,1123318552,A013070,굴,캐나다산 하드쉘 활랍스타 항공직송500gx2마리-2.5kg,40500,40500,0
2018-06-01,1806420982,L021020,장신구,[바보사랑]팔찌 111513002_PMMAPA11003,105000,105000,0
2018-06-01,1669488681,E021010,침구,엔디미온 시원한 여름을 위한 인견이불세트,39000,36000,-3000
2018-06-01,677097858,C012060,여자내의,BYC여성 국내 베이직 압박스타킹(T1550) 스타킹 팬티스타킹 타이즈 BYC 레깅스,4890,4360,-530
2018-06-01,1806420980,L021020,장신구,[바보사랑]팔찌 121543002_PMMWPB12001,125000,125000,0
2018-06-01,375497887,E011010,장롱,[에넥스 ENNEE] 두잉 옷장 외 5종택1,62910,62910,0
2018-06-01,1806420987,L021020,장신구,[바보사랑]귀걸이 611532143_PMMAPC61018,45000,45000,0
2018-06-01,1872306194,C012040,여자학생복,[끌레르뮤]끌레르뮤 클래식 골드 버튼 꽈배기 가디건,46200,38350,-7850
2018-06-01,1806420985,L021020,장신구,[바보사랑]귀걸이 611533143_PMMAPC61019,45000,45000,0
2018-06-01,382287542,A019050,간장,금용어 조미료 중국식품 5L (4/box),15000,15000,0
2018-06-01,2087983526,C013050,운동복,컴팩트 팜 광택기 6인치 3300RPM/울트라파워 9인치,51600,50570,-1030
2018-06-01,1587325615,A017230,마늘,2018년 무안 햇양파 5kg/10kg 출시!,7900,5900,-2000
2018-06-01,1832397543,A016150,아몬드,[무료배송]2017년 켈리포니아 볶은아몬드 400gX2팩,8900,8900,0
2018-06-01,1806420988,L021020,장신구,[바보사랑]귀걸이 281616403_PMNPPC28033,39000,39000,0
2018-06-01,1028514518,C013020,티셔츠,RT6 V트임 티셔츠 BTT0262 남자티셔츠 남자긴팔티,31730,31100,-630
2018-06-01,1340048141,A013090,전복,부경 냉동반가리비 2.1kg(210gx10개),62590,62590,0
2018-06-01,1235811927,C011030,남자학생복,라이프스타일 반소매(2) 레귤러핏 셔츠&남방 9종 택1(선물포장가능)/ 닥스(셔츠),60000,50400,-9600
2018-06-01,2051154434,F012050,의료측정기,VT 휴비딕 혈압계 팔뚝형 HBP-1000 + 사은품,40000,34320,-5680
2018-06-01,1953075902,I031040,생화,[아웃팅]접이식 의자침대/낚시의자/야전침대/캠핑의자,35900,24800,-11100
2018-06-01,1530590476,C012020,원피스,MELODY F106 그레이/코트/여자코트/겨울코디/겨울코트/자켓/점퍼 미국 여성토탈브랜드,84700,84700,0
2018-06-01,2098876653,C013010,점퍼,베이직기본후드집업 ZYD_1804 여성후드집업 후드집업,25220,25220,0
2018-06-01,1117080052,C013040,청바지,[더루비]여아/청바지/롱티셔츠/티셔츠/맨투맨/아동,11800,11800,0
2018-06-01,1773316077,A016150,아몬드,2017년 켈리포니아 볶은아몬드 400gX2 볶은양념아몬드,7900,7900,0
2018-06-01,1126347380,E011050,책상,/코너책상L 화이트 블랙 베칸트 160x110 cm/ 코너책상,383920,341690,-42230
2018-06-01,1861076457,C015040,장갑,애니멀 변신 벙어리 장갑 워머장갑 방한장갑 벙어리장,13020,13020,0
2018-06-01,1886725425,F011150,건강기능식품,이지바울 유산균 30포 60포 70포,47900,47900,0
2018-06-01,622251839,A021010,커피,[쿠폰가 13 520원]프렌치카페 골드라벨 100T/200T,15900,15900,0
2018-06-01,898631560,A017020,상추,아스파라거스 (150G/팩),6990,4990,-2000
2018-06-01,453519629,C012030,여자상의,단추체크배색원피스 PS1710 예쁜원피스 통일자원피스,44060,44060,0
2018-06-01,552522743,L021030,가방,코치 가방 미니베넷 사첼백 F57521,128000,128000,0
2018-06-01,901562430,D031010,주택수선재료,3M윈도우필름 데코필름 윈도우데코 WDG02 1220mm X 1m,36070,36070,0
2018-06-01,1974546506,A011120,두부,켈로그 스페셜K 레드베리즈 1.05KG/시리얼/씨리얼,9990,9990,0
2018-06-01,1604774787,A016040,포도,동원)황도 슬라이스 400g x 12개 사시사철 맛있는,41360,41360,0
2018-06-01,1530589479,C012020,원피스,MELODY F102 아이보리/코트/여자코트/겨울코디/겨울코트/자켓/점퍼 미국 여성토탈브랜,39700,39700,0
2018-06-01,1783208095,L021010,손목시계,[공식  백화점AS] 루루 여성시계(메탈)_W0890L3,176800,176800,0
2018-06-01,1783208094,L021010,손목시계,[공식  백화점AS] ZOEY 여성시계(가죽)_W0736L6,125800,125800,0
2018-06-01,1783208093,L021010,손목시계,[공식  백화점AS] 첼시 여성시계(가죽)_W0993L2,100300,100300,0
2018-06-01,985381994,A013180,젓갈,[속초아바이마을전통젓갈]명태회무침1kg,29800,21500,-8300
2018-06-01,1783208092,L021010,손목시계,[공식  백화점AS] 클로에 여성시계(가죽)_W1012L2,125800,125800,0
2018-06-01,1346187857,A022040,기능성음료,포카리스웨트 245ml x 30캔 500ml 1.5L 모음 이온음료,16910,15900,-1010
2018-06-01,296413614,E011050,책상,학원책상/학생용책걸상/학교용/하이팩의자/학습/교실,28800,28800,0
2018-06-01,534516814,A016160,과일가공품,시아스 미국산 A그레이드 3kg무배 냉동블루베리 특가,19500,19500,0
2018-06-01,519839696,A017090,열무,국내산 레드비트 3kg 내외,11900,11500,-400
2018-06-01,1335728634,E061010,세탁세제,퍼실 컴플리트솔루션 라벤더 2.7L 용기 2개,22900,22900,0
2018-06-01,68920945,A013100,마른멸치,[정품정량] 완도 싱싱 활전복/크기별 판매,37900,37900,0
2018-06-01,71208626,A013010,갈치,초특가/ 제주 은갈치100토막내외/실속갈치,29900,25900,-4000
2018-06-01,722480150,C013020,티셔츠,T2061-여성 데일리 프린세스 퍼프 티셔츠 소매퍼프티,18840,17900,-940
2018-06-01,325509366,I012060,저장장치,스틸시리즈 RIVAL 100 라이벌 게이밍 마우스,34570,32500,-2070
2018-06-01,1783208091,L021010,손목시계,[공식  백화점AS] 프리마 여성시계(메탈)_W1020L3,227800,227800,0
2018-06-01,1783208090,L021010,손목시계,[공식  백화점AS] 마리나 여성시계(실리콘)_W1025L1,142800,142800,0
2018-06-01,526557145,A012040,닭고기,[코스트코 냉장냉동] SUJIS 수지스 그릴드 닭가슴살 1KG / 수지스 닭가슴살,15220,14620,-600
2018-06-01,1124196231,C013040,청바지,100%정품 리바이스청바지/501/511/514/505/527/569,55000,55000,0
2018-06-01,176433393,E031080,선풍기,후지카 원통형히터 FU-2400H,101200,101200,0
2018-06-01,1783208088,L021010,손목시계,[공식  백화점AS] 베니티 여성시계(메탈)_W1030L1,210800,210800,0
2018-06-01,1783208087,L021010,손목시계,[공식  백화점AS] 리젠트 여성시계(가죽)_W1041G3,159800,159800,0
2018-06-01,415870192,C012040,여자학생복,롱 청자켓 로이청롱 NB KD 청자켓 청카바 데님 여자청,31230,30610,-620
2018-06-01,1783208086,L021010,손목시계,[공식  백화점AS] 블러쉬 여성시계(메탈)_W1062L1,142800,142800,0
2018-06-01,1712439980,I031040,생화,휴대용샤워기/캠핑용 야외용 차량용 간이 등산 낚시,21800,20060,-1740
2018-06-01,1545705347,C012040,여자학생복,[써스데이아일랜드] W몰 배색 손자수 디테일 블라우스,79500,77120,-2380
2018-06-01,415039950,C012030,여자상의,입새 원피스 KD 원피스 청원피스 니트원피스 롱원피스,31230,30610,-620
2018-06-01,1783208089,L021010,손목시계,[공식  백화점AS] 마리나 여성시계(실리콘)_W1025L4,159800,159800,0
2018-06-01,1752797247,E011030,거실장,아네트 글라스도어 수납장,218000,218000,0
2018-06-01,1752797246,E011030,거실장,아네트 서랍글라스 수납장,218000,218000,0
2018-06-01,1614035032,A013060,게,[울릉도 총알오징어] 산지직송 동해안 총알오징어 1kg,16700,16700,0
2018-06-01,1752797245,E011030,거실장,아네트 올갤러리 수납장,218000,218000,0
2018-06-01,404819106,C013050,운동복,여성 M~4XL 트레이닝 반바지 5부7부 린넨 츄리닝 세트,10800,10800,0
2018-06-01,414945560,A019040,소금,누룽지(맛나 한도 4.5K) 누룽지 간식 식자재 업소용식,47580,42830,-4750
2018-06-01,885284671,E041060,수저,한샘 수저통 스텐 원목 수저꽂이/수저함/주방/수납,19900,19900,0
2018-06-01,1770237234,C013060,등산복,쿨론반팔티셔츠 여름아웃도어 남자작업등산복 긴팔티,14380,14380,0
2018-06-01,1020878916,C011050,남자내의,[캘빈클라인진] 남성용 베이직 카라 반팔 티셔츠(4ASKJL2),29500,25080,-4420
2018-06-01,1458267304,A013080,조개,국내산 새꼬막 1.5kg (대) 새벽조업후 발송 산지,36330,36330,0
2018-06-01,719057561,I053010,공책,(변리사 감정평가사 공인노무사 세무사)2차시험답안지,2500,2500,0
2018-06-01,1016310040,C013060,등산복,여름 남성 등산바지 등산복 반바지 등산티셔츠 작업복,19800,19800,0
2018-06-01,2119341775,A018050,비스킷,무배/미주라 오곡토스트 1+1/토스트비스켓/과자/간식,8900,8900,0
2018-06-01,864388015,A022030,생수,네슬레 퓨어라이프 2Lx24 생수,17950,17950,0
2018-06-01,50146250,C011030,남자학생복,인터페이스제작가디건 아이스크림포인트 후드집업자,29700,29700,0
2018-06-01,318105358,C013050,운동복,아디다스/나이키/트레이닝/반바지/유니폼/칠부/130종,22000,20800,-1200
2018-06-01,1159134379,L021050,우산,이마이샵 송월우산/장우산2단우산3단/답례품선물용,6400,6400,0
2018-06-01,325595307,C012040,여자학생복,[코코애비뉴]리셀브이넥블라우스_80504,47300,45410,-1890
2018-06-01,603076746,A013040,고등어,[여수고기]노르웨이 저온숙성 순살 고등어 2kg / 3kg,25900,25900,0
2018-06-01,1515603738,C013040,청바지,마르엘라 로사티 퍼펙트슬림 스판데님3종 (with 김혜수),49900,47410,-2490
2018-06-01,659984870,C013020,티셔츠,슈퍼맨 망또티-배트맨 망또티-슈퍼맨 배트맨티-망토,11900,11900,0
2018-06-01,1076962897,I031040,생화,캠핑용 ROTHCO PARACORD BRACELET 파라코드 팔찌 - 스포츠 팔찌,9900,9100,-800
2018-06-01,1547965082,E061080,키친타월,고급 해동지 미트페이퍼 1200매 천연펄프 무형광 참치,32900,32500,-400
2018-06-01,407225620,C013010,점퍼,스테판조셉 프린티드 레인코트 인어공주B (택1) 캐릭,65290,62680,-2610
2018-06-01,103606895,C014020,유아복,[디플랜][디플랜] 줄기꽃나염티셔츠 BLUE,6000,5700,-300
2018-06-01,2092955366,C013010,점퍼,[꾸띠]밀리터리 야상점퍼/잔무늬 밀리터리 프린트/카키색 핑크색/FF(Free)55~66사이즈,120000,115000,-5000
2018-06-01,984488045,A018040,아이스크림,체리마루홈 3개,16500,12000,-4500
2018-06-01,1702665105,A016150,아몬드,캘리포니아산 구운아몬드 1.2Kg / 견과류,13800,13800,0
2018-06-01,1116000907,C013020,티셔츠,[대구백화점 II관] [블루독]NY보이쿨2종티셔츠(28910-670-14),38000,32300,-5700
2018-06-01,1783208061,L021010,손목시계,[공식  백화점AS가능]스타게이저 여성시계(가죽)_W1005L1,142800,142800,0
2018-06-01,1783208060,L021010,손목시계,[공식  백화점AS가능]펀페티 여성시계(실리콘)_W0944L3,193800,193800,0
2018-06-01,1783208064,L021010,손목시계,[공식  백화점AS] 브로커 여성시계(메탈)_W1072G1,125800,125800,0
2018-06-01,1783208063,L021010,손목시계,[공식  백화점AS] 마이크로 미니 여성시계(메탈)_W65022L1,125800,125800,0
2018-06-01,1294822075,A019090,카레,[청정원공식몰] 청정원 카레여왕 4봉 골라담기,10500,10500,0
2018-06-01,1011209793,A016100,수박,[6월 1일 이후 순차배송][참예과] 단단하고 향이 좋은 청매실 왕특품 10kg,46900,35800,-11100
2018-06-01,1553894716,D031010,주택수선재료,[노루페인트]순&수 항균페인트 모음(곰팡이방지/항균),15200,13100,-2100
2018-06-01,2082122231,A011040,보리쌀,1+1 약콩  서리태 500g+500g / 검은콩,16500,16500,0
2018-06-01,1534717684,C021040,실내화,4.5cm 키높이 여성 여름 매쉬 운동화,19900,19900,0
2018-06-01,704485765,I031040,생화,[카르닉 본사직영] 무릎보호대/손목보호대/발목보호대,7900,7900,0
2018-06-01,1656366071,A022040,기능성음료,게토레이 340mlx24캔/이온음료/뚱캔/음료수,13130,12350,-780
2018-06-01,1783208055,L021010,손목시계,[공식  백화점AS가능]이브 여성시계(메탈)_W0912L1,151300,151300,0
2018-06-01,129034658,E041020,컵,모던화이트 커피잔세트 모음 에스프레소잔 라떼잔,2000,1900,-100
2018-06-01,1783208059,L021010,손목시계,[공식  백화점AS가능]펀페티 여성시계(실리콘)_W0944L2,193800,193800,0
2018-06-01,1783208058,L021010,손목시계,[공식  백화점AS가능]스피너 여성시계(메탈)_W0942L3,117300,117300,0
2018-06-01,1626171330,C013020,티셔츠,그렌에코 ges7503w 여성 아쿠아엑스 냉감 언더레이어,19900,17910,-1990
2018-06-01,1437809644,C013030,스웨터,MTSSF18014 크랙 후드 남자후드 남성용후드티셔츠 캐,40580,40580,0
2018-06-01,1783208057,L021010,손목시계,[공식  백화점AS가능]포지 여성시계(메탈)_W0928L4,117300,117300,0
2018-06-01,50148891,C011030,남자학생복,인터페이스 제작 가디건 Mojito 포인트 후드집업자,29700,29700,0
2018-06-01,1783208056,L021010,손목시계,[공식  백화점AS가능]머져 여성시계(가죽)_W0924G3,151300,151300,0
2018-06-01,325597943,C012040,여자학생복,[위쉬몰]HG 아이스슬림가디건(0175H805),30240,25710,-4530
2018-06-01,451027294,A012060,햄및베이컨,청정원 참나무로훈연한 베이컨 1kg2개 베이컨 청정원,76170,68560,-7610
2018-06-01,508998463,C013020,티셔츠,[폴햄][POLHAM][PHY2TT1900]남녀공용 쿨링 솔리드 반팔 피케 티셔츠,14320,14320,0
2018-06-01,1162918801,E011050,책상,[안드로메다책상]접이식좌식/입식/좌식/책상/테이블/탁자/앉은뱅이/학원/교회/아동용/,29800,29800,0
2018-06-01,387456090,C014010,아동복,토미힐피거 아동용 체크 면 남방 4세/신장-104,20000,20000,0
2018-06-01,1461401378,A013070,굴,킹왕짱대게4L급 2.0kg내외/스노우크랩,74900,74900,0
2018-06-01,895743534,A013170,생선통조림,[동원]동원 김치찌개용참치 100g,2300,2300,0
2018-06-01,478248087,E061050,청소용세제,청소혁명 곰팡이샷 1+1 520ml 2개구성 /살균/탈취,9800,9700,-100
2018-06-01,514257623,A018060,스낵과자,농심 포테토칩 60gx20봉 포카칩/감자칩,18500,18500,0
2018-06-01,531311185,C013010,점퍼,남성 스판트러커점퍼(MSJP3101)/ 마인드브릿지,69300,65840,-3460
2018-06-01,1139193815,C013020,티셔츠,[모다아울렛][토토헤로스]모다남양주 레이스뷔스티에티,19500,18530,-970
2018-06-01,1306707990,A019010,고춧가루,해가원 국산 청양고추가루 250g X 36EA_1BOX 고춧가루,491740,491740,0
2018-06-01,1011210785,A013180,젓갈,[함경도식 동해저염젓갈]오징어젓200g,19000,13500,-5500
2018-06-01,1081040013,C012040,여자학생복,[저스트원] 젠틀 썸머 니트조끼,17900,17900,0
2018-06-01,1394715691,C012030,여자상의,뒷지퍼 미디원피스 스커트 치마 DM-3793,39000,37050,-1950
2018-06-01,1969404665,F012010,종이기저귀,[하기스] [2018]하기스 에어솔솔 썸머팬티 5단계 남아 80매,38700,38700,0
2018-06-01,390942752,C013050,운동복,푸조 남여공용 니트 트레이닝 세트(FZ132-4) 긴팔체육,63430,63430,0
2018-06-01,453894806,E031120,믹서,독일 하이드로마 파워멀티믹서기/스텐레스/HDM-2000,23900,23900,0
2018-06-01,1011210791,A013180,젓갈,[함경도식 동해저염젓갈]가자미식해200g,30000,20900,-9100
2018-06-01,662452376,A012060,햄및베이컨,동원 리챔 340g3입+8입/b / 동원에프앤비 /(참고) 햄,127100,111850,-15250
2018-06-01,1011210792,A013180,젓갈,[함경도식 동해저염젓갈]꼴뚜기젓 200g,23000,16100,-6900
2018-06-01,1011161164,L021020,장신구,1부다이아 남성반지/화이트로즈골드/예물/4708,260000,260000,0
2018-06-01,17549710,E011020,침대,인쏘노 항균 매트리스 침대 : 마루 + 라돈테스트 완료,60450,60450,0
2018-06-01,1155838551,C011030,남자학생복,[타미진]남성 라이트웨이트 린넨셔츠 TJMR2HCE02R0,63000,56700,-6300
2018-06-01,347449458,C012060,여자내의,아둘 여자아이 여름 스트라이프 반팔 스마일 세트 103,15900,15900,0
2018-06-01,1029501936,C012060,여자내의,[톰앤래빗] 로이키PT /팬츠/슬랙스/9부/슬림핏/깔끔,19000,17670,-1330
2018-06-01,1490721464,C012020,원피스,[스타일빅걸][스타일빅걸]더블 체크 코트 STM1125,84870,81480,-3390
2018-06-01,1783208033,L021010,손목시계,[공식  백화점AS가능]IRIS 여성시계(메탈)_W0907L2,168300,168300,0
2018-06-01,1410550447,C011030,남자학생복,남자남방/남자셔츠/7부/스판/체크남방/셔츠/와이셔츠,4800,4800,0
2018-06-01,1783208032,L021010,손목시계,[공식  백화점AS가능]IRIS 여성시계(메탈)_W0907L1,151300,151300,0
2018-06-01,2082100870,E031020,가스레인지,엔텍 빌트인 2구쿡탑 NGC-S202S/전화구 안전센서,89000,89000,0
2018-06-01,1783208031,L021010,손목시계,[공식  백화점AS가능]스텔라 여성시계(가죽)_W0888L3,108800,108800,0
2018-06-01,992142161,C011030,남자학생복,[프리미엄]셔츠 남방 린넨/코튼/헨리넥 NEW시리즈 X,34800,34800,0
2018-06-01,1783208030,L021010,손목시계,[공식  백화점AS가능]STELLA 여성시계(메탈)_W0887L1,193800,193800,0
2018-06-01,398942396,A012030,돼지고기,육즙의 풍미! 이베리코 목살/갈비살/항정살/뼈등심,8900,8900,0
2018-06-01,484667018,A021010,커피,트림베버리지1-다이어트커피식품/쾌변숙변가르시니아,15900,15900,0
2018-06-01,808877709,A018030,껌,행사 판촉 번들껌 사탕 해태/오리온/롯데,9900,9900,0
2018-06-01,859679022,E031110,청소기,싹스 로봇 물걸레 청소기 ARW-C100 아이클레보 LG,278000,278000,0
2018-06-01,529733162,C012060,여자내의,라인이 예뻐보이는 네이비주름치마 주름 교복치마 교,49840,48350,-1490
2018-06-01,1031948242,L012040,치약,라끄시안 퍼펙트 올 케어 치약 120g 무불소 천연치약,13500,12500,-1000
2018-06-01,553196712,C013040,청바지,[컨셉원] 쿨 슬림핏 워터클린 슬랙스 118505/10118505,59800,49040,-10760
2018-06-01,1394500946,A016090,참외,당일수확 달콤한 성주 참외 10kg(대용량),15900,15900,0
2018-06-01,1783115807,L021010,손목시계,MARCJACOBS 마크제이콥스 MJ3566 여성용 메탈밴드 패션시계,199000,199000,0
2018-06-01,1783115804,L021010,손목시계,MARCJACOBS 마크제이콥스 MJ1604 여성용 가죽밴드 패션시계,199000,199000,0
2018-06-01,1783208026,L021010,손목시계,[공식  백화점AS가능]스타라이트 여성시계(메탈)_W0846L4,168300,168300,0
2018-06-01,1577478426,E041050,냄비,[특가판매]사각 전골냄비 세라믹 냄비 라면냄비,23000,17250,-5750
2018-06-01,1456490458,C012060,여자내의,시크폭스 메이필 부츠컷밴딩팬츠/ 시크폭스,28600,22310,-6290
2018-06-01,1783208025,L021010,손목시계,[공식  백화점AS가능]스타라이트 여성시계(메탈)_W0846L2,159800,159800,0
2018-06-01,1783208024,L021010,손목시계,[공식  백화점AS가능]파크 에비뉴 사우스 여성시계(가죽)_W0838L6,142800,142800,0
2018-06-01,1251927337,C013010,점퍼,[플라스틱아일랜드]퀼팅 배색 다운점퍼(PH4EZ081),79000,79000,0
2018-06-01,1783115803,L021010,손목시계,MARCJACOBS 마크제이콥스 MJ3579 여성용 메탈밴드 패션시계,179000,179000,0
2018-06-01,1783208029,L021010,손목시계,[공식  백화점AS가능]스텔라 여성시계(가죽)_W0886L2,108800,108800,0
2018-06-01,1783115802,L021010,손목시계,MARCJACOBS 마크제이콥스 MJ3581 여성용 메탈밴드 패션시계,179000,179000,0
2018-06-01,1783208028,L021010,손목시계,[공식  백화점AS가능]스텔라 여성시계(가죽)_W0885L2,100300,100300,0
2018-06-01,1783115801,L021010,손목시계,MARCJACOBS 마크제이콥스 MJ3582 여성용 메탈밴드 패션시계,199000,199000,0
2018-06-01,1783208027,L021010,손목시계,[공식  백화점AS가능]스타라이트 여성시계(메탈)_W0846L7,176800,176800,0
2018-06-01,1065925328,A011090,국수,삼양라면 40+8봉 기획제품 라면/신라면/진라면/스낵면,24900,24900,0
2018-06-01,877882436,L012090,기초화장품,[2018년형] 옴므 마린 에너지/ 얼티밋 선크림 60ml,40000,22000,-18000
2018-06-01,1240362173,E041010,식기,gold ceramic/단/반상기/세트/셋트/금/도금/혼수/예단/기념일/출산/금/도금/선물/세트,1200000,1100000,-100000
2018-06-01,954073354,A013130,오징어채,꾸이킹 오리지날 (소/22G),1090,1090,0
2018-06-01,611780278,C013010,점퍼,앙팡 래쉬가드 집엎 (네이비) 물놀이용품 물놀이옷 어,25310,25310,0
2018-06-01,624826362,C011050,남자내의,[레노마]17S/S 봄 여름 기본 블랙 컬러 허리밴딩 비지니스캐쥬얼 팬츠 (RJIPBP12AGS),52000,39000,-13000
2018-06-01,1617951971,I031040,생화,[마운틴컴퍼니] SOS 긴급 구호세트 안전용품 캠핑안전용품 캠핑공구,23090,21040,-2050
2018-06-01,1709365062,A017200,토마토,가지2kg 통통하고 싱싱,9900,9900,0
2018-06-01,1085554324,C012040,여자학생복,골드 버튼 가디건 LRT092 롱가디건 봄가디건 (YA02004,50660,50660,0
2018-06-01,1346861298,E031110,청소기,국산 진공청소기필터(20매)/청소기필터 먼지봉투/LG-VPF300/대우RCP-34/삼성VP-95시리,7500,7500,0
2018-06-01,713983546,A019040,소금,인산가 인산죽염(9회자죽염) 골드. 고체 240g,75600,75600,0
2018-06-01,676726835,I031040,생화,차량용 간이침대/캠핑침대/접이식침대/야전침대,74900,74900,0
2018-06-01,2073336598,E041020,컵,강화유리6p 유리컵 머그컵 커피잔 물컵 유리잔 맥주잔,8000,7900,-100
2018-06-01,546707979,A014020,분유,[아이배냇] NEW 순 산양분유 1단계~3단계(400gX1캔),16900,16900,0
2018-06-01,932975277,C013050,운동복,차체유리제설기 멀티 분리형 성에제거기 성애제거 차,4290,4190,-100
2018-06-01,936524545,A021010,커피,카카오닙스/페루카카오닙스/원두100/카카오/카카오빈/,18900,18900,0
2018-06-01,450969667,C013040,청바지,[톰보이]셰퍼드 체크 원턱 팬츠 9108231326,954000,810900,-143100
2018-06-01,1398046168,A011020,현미,두레생협 찹쌀백미(2kg 무농약) 주방용백미 주방용찹,23500,23500,0
2018-06-01,386592182,C015020,모자,(컬러:사이즈 : 챠콜:FREE) ACC-CAP101 찡절,19630,19630,0
2018-06-01,632097422,C011030,남자학생복,TAL1910 남자빅사이즈하이넥사파리자켓,87280,84670,-2610
2018-06-01,1257694939,C012040,여자학생복,러블리목선 프릴블라우스(NW8SB212)/ 온앤온,45000,36000,-9000
2018-06-01,954820142,A016060,감,초L프레시)참살이산딸기 250G/팩,12900,12900,0
2018-06-01,530230134,A019170,냉동식품,오늘출발 만두 380g x 2개 / 왕교자 김치만두 비비고,2590,2590,0
2018-06-01,1973907251,A017140,콩나물,길경 도라지즙 도라지 도라지분말 도라지가루효능 도,19090,19090,0
2018-06-01,1237409165,C013060,등산복,여름 등산바지 등산복 바람막이 아웃도어 작업복,8900,8900,0
2018-06-01,872345891,A018010,초콜릿,킨더조이 T3 x 4 (12입)/초콜릿/페레로/누텔라/킨더,9900,9900,0
2018-06-01,291940666,C013010,점퍼,LAP EDITION 뒷판 나염 라벨장식 우비 AJ2WZS50,85790,85790,0
2018-06-01,1068317494,F011130,홍삼,[CJ직배송] 한뿌리진생베리RED100ML*10EA,10900,10900,0
2018-06-01,449712590,C013040,청바지,[난닝구]마리트 7부밴딩팬츠,19000,17480,-1520
2018-06-01,164689904,L012060,샴푸,오가니스트 내추럴 발효초 대용량 샴푸1000ml,9700,9700,0
2018-06-01,58967892,A018100,꿀,[Hnz] 뉴질랜드 마누카꿀 UMF+5/10/15 250g,48000,48000,0
2018-06-01,1068317495,F011130,홍삼,[CJ직배송] 한뿌리진생베리BLACK100ML*10EA,10900,10900,0
2018-06-01,479468731,F012010,종이기저귀,팸퍼스 프리미엄케어 팬티형 기저귀,41800,39800,-2000
2018-06-01,850478752,E061030,전구,SS LIGHT LED투광기 LED투광등 30W 50W USB LED랜턴,24500,22050,-2450
2018-06-01,827726692,A011050,콩,2017년산 햇 캐슈넛1kg(500gX2) 볶음 / 다양한 견과류,17900,17900,0
2018-06-01,829073639,F011150,건강기능식품,로하비 밀크씨슬골드 6개월분 피로회복 간영양제,29000,28700,-300
2018-06-01,163327889,A011140,부침가루,{최저가}삼립 조각케익 6종 /간식/빵/케이크/치즈,1610,1610,0
2018-06-01,1740738410,D031010,주택수선재료,마페플렉스/AC510K/탄성퍼티/크랙/미세균열/300ml,3740,3740,0
2018-06-01,1304000961,A019040,소금,[개암죽염] 3회 치아용 죽염 250g 양치 가글 죽염소금,9000,9000,0
2018-06-01,2085335544,L012040,치약,페리오 토탈7치약 120g x 12개 (택일),19900,13900,-6000
2018-06-01,1462556432,A018100,꿀,잡화꿀 (다드림 2K),30370,27030,-3340
2018-06-01,526799441,C013020,티셔츠,웨건 루즈핏티셔츠 라운드 긴팔티셔츠 & 트레이닝복,14900,13900,-1000
2018-06-01,200672901,L021030,가방,랩 (유니 20Cm),16800,15630,-1170
2018-06-01,1374735573,F012020,생리대,[화이트] 생리대 팬티라이너 애니데이 롱 75개입 x3개,20500,20500,0
2018-06-01,725586950,I031070,애완동물관리비,윌슨 테니스라켓 울트라 100 CV 블랙에디션 (300g/16x,205000,181430,-23570
2018-06-01,2024035034,C012030,여자상의,로로텐 롱/미니/쉬폰/레이스 원피스/빅사이즈,26900,26900,0
2018-06-01,415906563,C013040,청바지,[플러스에스큐] 구제데님팬츠(LU6DP02),49000,47250,-1750
2018-06-01,1281770960,C021040,실내화,[탠디] 온라인 초특가 남성구두 [P18006 BLACK],128000,99840,-28160
2018-06-01,1553965700,A011010,쌀,맛있는 잡곡 모음. 혼합곡. 오곡밥.서리태 현미 귀리,2500,2500,0
2018-06-01,1973899836,C011030,남자학생복,[타미힐피거]남성] 면 혼방 슬림핏 반소매 시어서커 스트라이프 셔츠 TMMS2HCE24A0 R2,138000,114270,-23730
2018-06-01,988931674,E061090,방향제,불스원) 선바이저 방향제_모히또,7500,7500,0
2018-06-01,386484173,C011030,남자학생복,오투아이스_쿨링조끼/지퍼형,66720,62720,-4000
2018-06-01,1109848750,C014010,아동복,아둘 가족티 쥬니어 커플룩 단가라 슬라브 티셔츠 28,9600,9500,-100
2018-06-01,1878986767,E021020,커튼,[에보니아] 솔리드 반원 케노피/반원커튼/공주방,139000,139000,0
2018-06-01,311561050,C013050,운동복,승합차용 차량커버 외장커버 차량용커버 세차 황사,85000,84150,-850
2018-06-01,1981045131,I011030,사진기,S/S[소니정품 DSC-W810(단품)] 공식대리점,105310,105310,0
2018-06-01,1792346795,A014010,우유,파스퇴르 전용목장1급A 멸균우유(200ml 48팩),29900,29900,0
2018-06-01,1493441479,C013010,점퍼,여성바람막이자켓 여름점퍼 후드 빅사이즈 윈드자켓,20800,20800,0
2018-06-01,1770840583,E031070,에어컨,[신일산업] 신일 천장용 선풍기 SIF-16CSH 3엽 국산 40cm,52000,49140,-2860
2018-06-01,1010381414,A013100,마른멸치,[통영멍게수협]멍게혼합세트1호(비빕밥 양념 100g2개씩),36000,29000,-7000
2018-06-01,2069747383,A018080,설탕,유기농 설탕 5kg 황설탕/비정제/매실용/과일청/수제청,14900,14900,0
2018-06-01,1529743191,C013020,티셔츠,바람난신디 패션30%쿠폰 롱티셔츠/박스티/빅사이즈,13900,12900,-1000
2018-06-01,1803388731,A014010,우유,매일유업 멸균우유 흰우유 무지방우유 200ml 24팩,13800,13800,0
2018-06-01,271647745,A019110,드레싱,동원 치킨/꼬치/닭강정/양념소스2.1kg,4950,4950,0
2018-06-01,117866086,I012010,컴퓨터,특가93만+한컴+로지텍Set+무료퀵 삼성 NT900X3I-A38A,1030520,979000,-51520
2018-06-01,527833761,A011010,쌀,2017년산 햅쌀 10Kg 5Kg 선택 백미 고시히카리 무배,25600,25600,0
2018-06-01,1558064792,A011010,쌀,온참 2017 송악농협 당진 해나루쌀_쌀20kg/당진쌀 쌀,56900,56900,0
2018-06-01,2036818990,E061050,청소용세제,연무기 소독기 차량소독기 집소독 집진드기 연무소독,70000,70000,0
2018-06-01,959344652,A018070,파이,[동서]동서 오레오 딸기크림 (100G),1290,990,-300
2018-06-01,449183260,C013020,티셔츠,메르 블라우스 L~3XL/쉬폰/빅사이즈여성의류/여름신상,21900,21900,0
2018-06-01,1062905348,E061080,키친타월,아이편해~ 뽑아쓰는 키친타올 100% 천연펄프,19800,19800,0
2018-06-01,284437289,C013020,티셔츠,롱/트임/레이어드/나시/면티/레이어드티/남녀공용,7900,7900,0
2018-06-01,1717976586,E031010,전기밥솥,쿠쿠고무패킹 CRP-HNXB107FB/CRP-HNXF1020FB,8500,8400,-100
2018-06-01,1755381156,C012040,여자학생복,(772) 레이어드 룩의 망사 조끼,20800,20800,0
2018-06-01,956264585,A018040,아이스크림,라벨리전문모음/캔디바/,16800,16800,0
2018-06-01,274473054,E031070,에어컨,SIF-THP40/정품/신일 타워팬/신일선풍기/리모컨/선물,55900,55900,0
2018-06-01,795692038,A019080,고추장,해찬들 수라상 약고추장(120G),2900,2900,0
2018-06-01,967278800,A013030,조기,[해울림] 영광굴비선물세트/명품굴비/목포참조기/추자도굴비/,219900,219900,0
2018-06-01,987316486,A016050,밤,청도반건시혼합세트2호(반건시18p+세절건시500g),47000,33000,-14000
2018-06-01,606446660,C012060,여자내의,[체리코코][CHERRYKOKO] la flare  skirt,39000,35100,-3900
2018-06-01,214628052,C013050,운동복,맥과이어스 에탄올 워셔액 2L /천연발효/차량용품,6050,6050,0
2018-06-01,1417032088,D031010,주택수선재료,탑스테인 오일스테인 20리터 방부목페인트 우드케어,70000,70000,0
2018-06-01,364652087,C012040,여자학생복,시어한 거즈셔츠/주름시스루셔츠,19900,19900,0
2018-06-01,439989649,C012060,여자내의,[브리스살롱]여성미물씬청순한bs490프라하체크 루즈핏 점프슈트,15800,15010,-790
2018-06-01,895767565,A012060,햄및베이컨,[롯데]롯데 로스팜 엔네이처 200G,3840,2490,-1350
2018-06-01,385474132,C011030,남자학생복,오투아이스_쿨링타올 소형2개,30390,28570,-1820
2018-06-01,320432274,I031070,애완동물관리비,보급형큐/국내 최저가 큐 큐대 당구큐대 당구재료,7900,7000,-900
2018-06-01,1337483272,C013050,운동복,브리카 안전벨트 위치조정기 안전벨트커버 안전용품,23090,20790,-2300
2018-06-01,1433537613,F011150,건강기능식품,까스활 75ml x 20병_소화제_부채표 동화약품,18120,18120,0
2018-06-01,235127635,I031010,장난감,스텝2 2단 디딤대,26100,23490,-2610
2018-06-01,1245562674,F011150,건강기능식품,한미요구르팅파우더10포 요거트 파우더 요구르트 종균,7900,7800,-100
2018-06-01,340726801,C012060,여자내의,기모 밴딩팬츠 레깅스 여성 밴딩 팬츠,18020,18020,0
2018-06-01,1829431765,F012020,생리대,[중문]바디피트 귀애랑 팬티라이너 38P x 12팩 + 중형,33500,33500,0
2018-06-01,1751437801,A017160,오이,노루궁뎅이버섯 분말(270g),59700,59700,0
2018-06-01,1351025180,A016150,아몬드,[가온애]햇아몬드 400g+400g 캐슈넛 호두 견과류 잣,10500,9900,-600
2018-06-01,140314415,L021020,장신구,은팔찌 모음 /13000~39000 / 92.5 은볼 발리실버 팔,13000,13000,0
2018-06-01,990002324,A011040,보리쌀,손안의간편한끼 바나나 40G,2990,2990,0
2018-06-01,895802312,A011120,두부,[동서]동서 콘푸라이트 1/3라이트 슈거(530G),5930,5930,0
2018-06-01,1602343819,I031040,생화,콩맨 초경량침낭 침낭/춘추침낭/하계/여름/미니/캠핑,21600,19880,-1720
2018-06-01,1985580015,C013040,청바지,허니비 기모스판 나팔청바지/여아기모청바지/기모바지,21800,21800,0
2018-06-01,975328118,C013010,점퍼,[모다아울렛][반에이크]스타디움점퍼 VA84JPQ304Z,59800,54420,-5380
2018-06-01,895767562,A012060,햄및베이컨,롯데 런천미트 340G*3입,10920,5990,-4930
2018-06-01,1517951827,I012060,저장장치,[단독특가]앱코 K660 게이밍 기계식키보드 그린라이트,44900,44900,0
2018-06-01,325595342,C012040,여자학생복,[모다아울렛][막스카라]가디건M82QKC363MEB1,69000,62100,-6900
2018-06-01,1085206602,I053010,공책,초등노트 공책 노트 일기장 알림장 한자공책 10권세트,2400,2400,0
2018-06-01,1842554799,A014040,발효유,헬로엔요 180mlx36팩/유산균 음료/오렌지쥬스,14100,14100,0
2018-06-01,1451483335,I031040,생화,풀세트/ 5200루멘/5발 /3발/ 헤드랜턴/고사양/8종,27800,24800,-3000
2018-06-01,1394691072,L012090,기초화장품,싸이닉 티트리 클리어링 솔루션 3총사/토너/로션/오일,10800,10800,0
2018-06-01,798921906,E031080,선풍기,젠텍 소형 가스스토브 로터리히터 GT-P3500 (LPG전용) / 야외.캠핑용,179000,179000,0
2018-06-01,1778020311,C012020,원피스,[쉬즈마담][쉬즈마담]J3599가죽띠 와인체크 차이나롱코트,158700,152360,-6340
2018-06-01,1010200714,A019150,김치,CJ 비비고총각김치 1.5KG,16900,16900,0
2018-06-01,152352362,A011090,국수,[농심] 신라면 멀티팩 40봉,26500,26500,0
2018-06-01,1010200710,A019150,김치,CJ 비비고썰은배추김치(용기형) 300G,4500,4500,0
2018-06-01,889180185,E031130,보온매트,[하이마트] 스판덱스 전기매트 HL-M106S [싱글 / EMF인증 / 무선자계 열선],145000,145000,0
2018-06-01,1753734360,A015020,식용유,보겔 팝콘오일 3kg,22000,22000,0
2018-06-01,277662277,E041010,식기,소담 도자기 그릇세트-공기대접/접시/찬기/식기세트,17500,14500,-3000
2018-06-01,889180183,E031130,보온매트,[하이마트] 전기매트 DWM-M201F [ 더블 / 인공지능 인체감지 시스템 / 알러지 협회 인증서],189000,189000,0
2018-06-01,889180184,E031130,보온매트,[하이마트] 전기매트 DWM-M101F [ 싱글 / 인공지능 인체감지 시스템 / 알러지 협회 인증서],160000,160000,0
2018-06-01,1148363772,A014030,치즈,코리원/zuger 후레쉬 모짜렐라 슬라이스(블럭)400g/치,9000,8900,-100
2018-06-01,774969946,E061030,전구,국산/LED형광등FPL36w55w/조명/LED전구/방등거실등,7300,7300,0
2018-06-01,149691662,C013010,점퍼,걸크러쉬 슬림 가죽 자켓-m1071 (블랙) 여성용자켓 겨,53880,52270,-1610
2018-06-01,255661607,I031040,생화,지아이엘/부채꼴 파라솔 받침대/파라솔/모기장/야외,25000,23000,-2000
2018-06-01,1481162054,C021010,아동화,MJ펀칭슬립온 아동여름운동화 201MJ,27500,27500,0
2018-06-01,529241933,F012020,생리대,위스퍼 보송보송케어 중형 30Px5팩 (총150P),29000,29000,0
2018-06-01,1639130206,C012040,여자학생복,[크로커다일레이디] 이태리 고급 천연앙피 가디건 XC7SLT606,745000,149000,-596000
2018-06-01,515884814,L021020,장신구,14K 정품 Gold 슬림큐빅스틱 반지 오하나 스타일 일자,235900,228830,-7070
2018-06-01,1439576136,A018070,파이,오리온 초코파이1170g(30봉x2개)오예스 카스타드 간식,17400,17400,0
2018-06-01,482178451,C013010,점퍼,[오후] 공용 홑겹 바람막이 OHJA823B02,19900,19900,0
2018-06-01,1509416874,C011030,남자학생복,체크남방 셔츠 여름 반팔 남방 남자 남성 남방 커플,10900,10900,0
2018-06-01,1498323478,A018080,설탕,유기농 비정제 설탕 25kg/20kg/황설탕/매실청/과일청/,54900,54900,0
2018-06-01,118070606,I031040,생화,LR44 수은건전지/AG13 LR1154 357 A76 호환 수은전지,1200,1200,0
2018-06-01,1169484348,C013050,운동복,K-345 스타렉스 2004후사경 차량안전용후사경 자동차,24430,22260,-2170
2018-06-01,997922884,C013050,운동복,[이큐브] 미니샌다기 2_50mm 샌딩작업/광택작업/밸크로방식/샌,89000,89000,0
2018-06-01,1719332035,E041070,밀폐용기,인콕 스텐콕 대용량 핸디형 스텐 밀폐용기 모음,15000,13710,-1290
2018-06-01,318541893,C013050,운동복,LED 손전등 겸용 경광봉 지시봉 신호봉 안전봉 레드,12900,12520,-380
2018-06-01,1477525353,E061020,섬유유연제,샤프란 향기팡팡 고농축 섬유유연제 1600ml x 4개,13900,13900,0
2018-06-01,855167379,E031080,선풍기,컴텔핫썬 인공태양히터(근적외선히터) 스텐드형(다용도용) CTHS-JS2002,200000,200000,0
2018-06-01,855167378,E031080,선풍기,컴텔핫썬 인공태양히터(근적외선히터) 벽걸이형(리모콘) CTHS-JS1800,230000,230000,0
2018-06-01,360441510,I031040,생화,팔걸이 의자 국내/야외/행사/포장마차/간이/플라스틱,14000,12880,-1120
2018-06-01,2121016487,C015040,장갑,란체티 손목퍼시보리 여성 순모장갑 TL-5404 여자장갑,43790,43790,0
2018-06-01,607203605,A013100,마른멸치,산소포장으로 신선! 꼬마전복부터 특대 전복 모음,10900,10900,0
2018-06-01,2063975922,C013010,점퍼,[탑텐]남)윈드브레이커(MSX2JJ1010),15000,12750,-2250
2018-06-01,533868988,C012030,여자상의,미니원피스/레이스원피스/섹시홀복/클럽의상/오프숄더,18900,18900,0
2018-06-01,595536392,C014010,아동복,[블루독] 헨리넥솔리드셔츠 (27375-320-04),49000,40180,-8820
2018-06-01,152521730,A011010,쌀,[거시기장터]2017년 남원농협 춘향골쌀 신동진미 4kg,14700,14700,0
2018-06-01,895767531,A012060,햄및베이컨,롯데 의성마늘김밥속햄 200G,3790,3790,0
2018-06-01,2064961970,C012060,여자내의,SK1274-러블리 A라인 핀턱 스커트 A라인치마 정장스커,22460,22460,0
2018-06-01,1545208020,C013020,티셔츠,MLB 남여 뉴욕 양키즈 로고 반팔티셔츠HM (31TSD1831-8종),33000,26400,-6600
2018-06-01,32754351,A013140,북어채,손질먹태 먹태 황태 노가리 맥주안주,3700,3700,0
2018-06-01,294043690,C012020,원피스,엄마옷 데드라 YY-SW197 파티컬러포인셋트수영복,80300,72590,-7710
2018-06-01,693879893,C011030,남자학생복,여름 7부 리넨 셔츠 남성 편안한 케쥬얼남방 40여종,16700,16700,0
2018-06-01,1154055182,C012060,여자내의,[위쉬몰]RIN 스판데님스커트(0355RH805)/ 위쉬몰,32760,28180,-4580
2018-06-01,808887112,A015010,참기름,오늘출발 옛날 참기름 들기름 고소한 식용유 카놀라유,10900,10900,0
2018-06-01,987196231,A013140,북어채,황태채 300G/봉,13900,13900,0
2018-06-01,675219345,A013150,어묵,[부산어묵공식] 명품 부산어묵 골라담기/분식/야식,1900,1900,0
2018-06-01,1808574601,L021050,우산,[제레보]휴대용우의/EVA고급소재/일회용아님/성인용/우의/우비/비옷/등산우의/낚시우의,3550,3550,0
2018-06-01,984488016,A018040,아이스크림,와 5개,7500,4000,-3500
2018-06-01,153516128,A014020,분유,[20%쿠폰]뉴트리밀크 180ml 24입 플레인 오곡,36900,36900,0
2018-06-01,542941116,F012010,종이기저귀,리베로기저귀 밴드형/팬티형 1팩,17000,17000,0
2018-06-01,718938253,F012010,종이기저귀,[하기스] 하기스 매직핏 팬티 기저귀 5단계 남아용 31px4팩,56900,56900,0
2018-06-01,1290712986,A017020,상추,국내산 믿을수 있는 우리 농산물 청상추 400g,13720,13720,0
2018-06-01,1783115799,L021010,손목시계,MARCJACOBS 마크제이콥스 MJ1571 여성용 가죽밴드 패션시계,159000,159000,0
2018-06-01,180999674,I031040,생화,야전삽/삽/도끼/톱/캠핑용품/캠핑/야삽/접이식삽,23900,21990,-1910
2018-06-01,1857767620,A017220,양파,대파가루(중국산) 1kg,18150,18150,0
2018-06-01,480709247,I031040,생화,특허/국산/사계절 차량겸용 간이침대/야전침대/간이침대/보조침대,109800,109800,0
2018-06-01,1148265117,A013050,오징어,오뚜기 고등어 280g X 24EA 식품 요리재료 음식용재료,68490,68490,0
2018-06-01,1424440801,F012010,종이기저귀,[오늘만 이가격] 보솜이 리얼코튼 썸머기저귀 + 튜브,34900,34900,0
2018-06-01,607406476,F011120,인삼,국내산 산양삼 8년근 5뿌리 한세트 무료배송 싱싱한 산삼 국내 최저가 장뇌삼 산양 산,75000,75000,0
2018-06-01,443758259,C011030,남자학생복,[지오다노]여 포플린셔츠 348505,25000,20500,-4500
2018-06-01,25903085,D031010,주택수선재료,KCC숲으로멀티멜골드0.9L 곰팡이방지 친환경 방문가구,11800,11800,0
2018-06-01,2034942593,I031010,장난감,벤츠 붕붕카 벤틀리붕붕카 유아붕붕카 아기자동차,23400,23400,0
2018-06-01,1308295124,F011150,건강기능식품,어린이비타민 철분제종합비타민영양제칼슘 멀티비타민,18000,18000,0
2018-06-01,1916183728,A013170,생선통조림,유동 번데기캔 130g X 48EA_1BOX 유동번데기통조림 번,67140,67140,0
2018-06-01,264616975,C012060,여자내의,[줄라이24][줄라이24] NP1980A 네이비 스트라이프 점프수트,59000,56050,-2950
2018-06-01,1139010550,I031040,생화,해먹 휴대용침대 그물침대 흔들침대 간이침대 야영용품 바캉스 휴가 캠핑용품 야전침대,4000,3650,-350
2018-06-01,542227099,F012010,종이기저귀,리베로기저귀 밴드형/팬티형 3팩,46400,46400,0
2018-06-01,297665211,E021010,침구,여름 요차렵 침구세트 요커버+베개+이불+솜 세트,29800,29800,0
2018-06-01,2069387981,C011030,남자학생복,[올젠] 남성 크리즈 소재 반소매 체크 셔츠 남방 ZRY2WC1302,30000,24000,-6000
2018-06-01,707662386,A021010,커피,롬바우츠 소프트파드커피 2종혼합4봉(64개)직경60mm/미코파드선택/포드/센세오/라바짜,42800,38000,-4800
2018-06-01,713753191,I012060,저장장치,[수량한정]로지텍Logitech G502 RGB게이밍마우스/병행,63500,62500,-1000
2018-06-01,906072413,A013010,갈치,업소용 절단 갈치 10kg / 살이 도톰하고 부드러워요,84000,84000,0
2018-06-01,538183559,A014030,치즈,[덴마크] 아기치즈(step 1 / step 2) * 5개 ( 40매 ),19900,19900,0
2018-06-01,236874764,C015040,장갑,[프로스펙스] (SIZE : 0SM) 아미드 메이저 2 니트 글러브(,8740,8740,0
2018-06-01,668938901,I031040,생화,현대모비스 크루저 루프백 RV 승용 캠핑백 루프캐리어,209000,190360,-18640
2018-06-01,766482548,F011130,홍삼,GMS 고려홍삼정 파워롱데이 A+ 10ml x 30,70000,70000,0
2018-06-01,428928992,A019080,고추장,청정원 순창 현미쌀로만든 태양초 명품 고추장3kg,15900,15900,0
2018-06-01,1098468726,A013080,조개,국내산 새꼬막 1.5kg (상) 새벽조업후 발송 산지,32970,32970,0
2018-06-01,1253950067,I053010,공책,신학기 과목노트(한문)(10개입)-랜덤 학교노트 과목노,11370,11370,0
2018-06-01,2046881435,E021020,커튼,슈가오완식 바란스 행잉가렌드,24000,21990,-2010
2018-06-01,721034444,C012030,여자상의,[체리빌레]여름신상 인생샷 예쁜 원피스/플라워/쉬폰,25000,19900,-5100
2018-06-01,2121971657,C015040,장갑,애니멀 변신 벙어리 장갑 방한용장갑 장갑 벙어리장갑,12560,12560,0
2018-06-01,1210355306,C013010,점퍼,[브루노바피][BRUNO BAFFI] 남성 홑겹 서커 프린트 점퍼_MAUCLTM3201,100000,95000,-5000
2018-06-01,152156122,A013090,전복,제이에스 냉동백합조개 1kg2개,22420,22420,0
2018-06-01,295897430,C015020,모자,[FNH] 썸머리즈라피아 라피아햇 캉캉모자 페도라 여름,20500,20500,0
2018-06-01,2047071462,I031040,생화,파라솔 테이블 세트 야외/행사/접이식/간이/편의점,130000,110540,-19460
2018-06-01,352254286,C013060,등산복,여름 등산티셔츠 냉감 등산복 반팔티 작업복 단체,9800,9800,0
2018-06-01,1421031448,L012060,샴푸,쿤달 샴푸/트리트먼트/에센스/바디워시 4+1이벤트,7900,7900,0
2018-06-01,792869948,I031010,장난감,경찰특공대 레고호환 피규어 블록 특수부대 swat 히어,5600,5600,0
2018-06-01,508538606,C011050,남자내의,[백화점SAY][티비제이]남성 슬랙스 팬츠(T182PT290P),49900,36280,-13620
2018-06-01,1783115777,L021010,손목시계,MARCJACOBS 마크제이콥스 MJ8677 여성용 가죽밴드 패션시계,199000,199000,0
2018-06-01,1783115776,L021010,손목시계,MARCJACOBS 마크제이콥스 MJ8678 여성용 가죽밴드 패션시계,299000,299000,0
2018-06-01,1337400817,C012030,여자상의,롱니트 여성 V넥 단가라 원피스 KK롱니트여자 롱니트,67620,67620,0
2018-06-01,1333090061,A022050,탄산음료,일화 탑씨 1.5리터 12페트 사이다 펩시 콜라 음료수,11170,10500,-670
2018-06-01,1209403817,C013040,청바지,[Blouson]오피스 린넨 슬림 슬랙스_[B1806PT055B],49800,44270,-5530
2018-06-01,508742324,C012030,여자상의,데일리앤 여름원피스 쉬폰원피스 뷔스티에 롱원피스,23400,23400,0
2018-06-01,1881021843,C012040,여자학생복,[나이스크랍][18여름] 니트배색 가디건 (N182YSL003)[갤러리아],167000,126920,-40080
2018-06-01,1131892946,C013050,운동복,프론트 리어 범퍼 가드 보호대 몰딩 블랙 자동차범퍼,20890,19040,-1850
2018-06-01,984430601,A019140,이유식,[남양]남양 임페리얼 분유XO 2단계 800G,27200,27200,0
2018-06-01,1258256432,A012050,소시지,수제콤보 소세지360gx3팩 독일풍프랑크롱런 소시지3팩,9900,9900,0
2018-06-01,1224945753,A018070,파이,(공식샵) 오리온 초코파이 12입 x 8개 / 무료배송,27500,27500,0
2018-06-01,1320537150,E011020,침대,프리미엄 패밀리침대 Q+Q 밸런스 포켓양면 매트리스,792100,768340,-23760
2018-06-01,984430605,E061020,섬유유연제,다우니 퍼퓸 블랙(1L),6600,6600,0
2018-06-01,984430604,A019140,이유식,[남양]남양 아이엠마더 3단계 800G,37500,30000,-7500
2018-06-01,984430602,A019140,이유식,[남양]남양 아이엠마더 1단계 800G,36900,36900,0
2018-06-01,1218837371,I031040,생화,[코베아] 코베아 아웃도어 미니삽 VA-SH-0701 야전삽,13400,13400,0
2018-06-01,1582599616,E011070,식탁,[동서가구]LV 와이드2인 식탁세트 DF907236,90000,79900,-10100
2018-06-01,1479488198,A014010,우유,멸균우유 200mlX24팩 저지방 무지방우유 매일우유,12500,12500,0
2018-06-01,1156848586,C011050,남자내의,[뱅뱅][뱅뱅] 남성 썸머팬츠_B7I2,12900,12260,-640
2018-06-01,1340073048,E051030,디지털도어록,머큐리UG-325S/카드키/유리문도어락/인체감지/마스타,77000,68080,-8920
2018-06-01,1294765894,C014010,아동복,[아디다스/adidas] S22083 유스보이F50슬리브리스 YB F50 SL TEE,11600,11600,0
2018-06-01,328867555,A011050,콩,[가온애]고소한 햇 볶음땅콩1kg 알땅콩 피땅콩 볶은콩,6900,6900,0
2018-06-01,1024521382,F011150,건강기능식품,[2만원할인]CJ BYO 장유산균 캡슐형 6병_12개월분,79000,79000,0
2018-06-01,1216819857,C011020,남자상의,투버튼 체크 슬림핏슈트 세미정장 여름용 린넨 마정장,89000,88000,-1000
2018-06-01,1928528555,C013020,티셔츠,MRBOB 신상 기모 후드티 후드집업 빅사이즈 M~3XL,24800,24800,0
2018-06-01,264616939,C012060,여자내의,[오빵스타일]와이드점프슈트점프슈트릴라 밴딩 점프슈트,20000,19000,-1000
2018-06-01,1056809050,C014020,유아복,아둘 유아 여름 미키 랍빠 핫팬츠 반팔티 상하세트 12,19100,19100,0
2018-06-01,86225194,D031010,주택수선재료,(정품)유로프리미엄오일스테인20L/신규런칭평붓증정,96000,96000,0
2018-06-01,2098697847,C013010,점퍼,MJS18010 오버핏 베이직 워싱 중청자켓 청자켓 청재킷,76010,76010,0
2018-06-01,1002001377,I031070,애완동물관리비,[아리몰]당구공/큐대/당구대/당구다이/포켓볼/쵸크/4,11900,11900,0
2018-06-01,689638638,E031070,에어컨,[SK매직] SK매직 CPA-C307W 써큘레이터 3구 3단풍속 무선컨트롤,179000,179000,0
2018-06-01,919940668,L021060,유모차,2018 ANYGO A5플러스 프리미엄 휴대용 기내반입유모차,295000,236000,-59000
2018-06-01,446021903,A016070,귤,화남 밀감대3kgX6개 감귤,76000,73720,-2280
2018-06-01,895802284,E061030,전구,[GE삼성]GE삼성)T4 컴팩트 전구 주광색 15W (2입),14900,14900,0
2018-06-01,895802285,E061030,전구,[GE삼성]GE삼성) T4 컴팩트 전구 전구색 20W 2입,17300,17300,0
2018-06-01,895802286,E061030,전구,GE T4 컴팩트 주광색 20W 2입,15900,15900,0
2018-06-01,2037804143,E061060,살충제,연무기 소독기 차량소독기 집소독 집진드기 연무소독,70000,70000,0
2018-06-01,419237899,A017220,양파,[맘스허브]손질대파300g,1950,1950,0
2018-06-01,1284848824,A019140,이유식,엘빈즈 클래식 이유식 아기밥4단계(만 13개월이상)/ 엘빈즈,3380,3080,-300
2018-06-01,1093199352,E031110,청소기,[미친특가] 센스봇 / 아이센스 물걸레 로봇청소기,210000,210000,0
2018-06-01,1042346246,C011030,남자학생복,봄신상 초특가 가디건 남자 남성 집업 숄 후드 롱,30000,16800,-13200
2018-06-01,989167405,E051020,건전지,에너자이저리튬CR2032(4입),5990,5990,0
2018-06-01,1402125927,C013020,티셔츠,[타미힐피거칠드런]티셔츠/셔츠/팬츠外 98종택1,20200,20200,0
2018-06-01,259151925,C012040,여자학생복,[공구우먼] 엘리셀 체크 남방 29416 빅사이즈여성의류 루즈핏,34000,34000,0
2018-06-01,1530565303,C012020,원피스,MELODY F3 모카/코트/여자코트/겨울코디/겨울코트/자켓/점퍼 미국 여성토탈브랜드 멜로,54700,54700,0
2018-06-01,1261859475,C011030,남자학생복,[지오지아][지오지아] 지오지아 ABX2WD1202 기본셔츠 (P000341097),19000,19000,0
2018-06-01,1403857396,L021030,가방,DAHLIA MINI 크로스백 (JHNEHE7AF167BK980)/ 제이에스티나 핸드백,160200,126560,-33640
2018-06-01,2066003406,F012020,생리대,릴리안 순수한면 중형 16P x 5팩 (총80P),13400,13400,0
2018-06-01,899461735,A013050,오징어,제주 생물갈치(특)/마리,13800,13800,0
2018-06-01,488084690,E041010,식기,풍수인테리어/풍수/지리/삼족두꺼비/대박재운/재운발,125600,123090,-2510
2018-06-01,2128246386,F011150,건강기능식품,CJ 헛개 컨디션 파워 75ml x 10병 숙취해소,16900,16900,0
2018-06-01,366722854,E031110,청소기,싹스 6in1 무선청소기 AVL-912LB진공/침구/물걸레,78800,49800,-29000
2018-06-01,1260463384,A019130,스프,(오뚜기)양송이 스프 80g x 20개 A13260 - 즉석 레토,52470,46700,-5770
2018-06-01,1423802836,I012010,컴퓨터,삼성컴퓨터/데스크탑PC/오버워치/피파3/전시렌탈/WIN7,299000,239000,-60000
2018-06-01,1774389664,L021030,가방,WR/타거스 Targus CN514AP/CN515AP 노트북가방 탑로드,50000,49000,-1000
2018-06-01,620291337,A014030,치즈,파마산 블렌드 1kg 파마산치즈 치즈가루 파마산분말,25200,25200,0
2018-06-01,913333955,C013010,점퍼,앙팡 래쉬가드 집엎 (핑크) 아동집업 집업 아동의류,25790,25020,-770
2018-06-01,773003148,I011020,영상음향기기,엡손 EB-W41 사은품2종 X41 해상도 UP 빔프로젝터,850000,791000,-59000
2018-06-01,896550745,A011080,밀가루,[오뚜기]오뚜기 옛날국수 (소면/320G),1050,1050,0
2018-06-01,1588357114,L012060,샴푸,NEW 엘라스틴 대용량 샴푸 린스 5개/ 퍼퓸 실크리페어,21900,21900,0
2018-06-01,1473065757,E061030,전구,오스람 형광등 삼파장전구 모음/FPL36W 55W 32W 24W,1450,1310,-140
2018-06-01,855518656,L021020,장신구,원석sale/gilalite/4.8캐럿/큼직,45000,45000,0
2018-06-01,1674460062,A013140,북어채,용대리 황태 황태포 10미 특왕(44~47Cm) / 산지직송,40900,40900,0
2018-06-01,439072330,E061030,전구,정품 일본 산쿄 살균램프 자외선 4W~15W 칫솔살균램프,4500,4500,0
2018-06-01,784139921,A021010,커피,[남양유업]루카스나인 라떼60T/바닐라/더블샷/그린티,17790,17790,0
2018-06-01,303655920,A013060,게,오징어 특가전 통오징어 손질오징어 오징어채 등,6500,6500,0
2018-06-01,327001416,A013080,조개,두레생협 새우살(300g/국산) 새우살 새우 두레생협새,33630,33630,0
2018-06-01,1949486894,F012020,생리대,[파우치증정]화이트/좋은느낌 생리대 특가 골라담기,6900,6900,0
2018-06-01,989914093,E061060,살충제,홈매트리퀴드플러그훈증기+45일*2,13900,13900,0
2018-06-01,973634971,I011010,TV,상품평5만(공식파트너)삼성 QLED TV QN49Q7FAMFXKR,1730000,1309000,-421000
2018-06-01,1320537183,E011020,침대,프리미엄 패밀리침대 SS+SS 밸런스 20T라텍스매트리스,790600,766890,-23710
2018-06-01,577397697,E011030,거실장,프라하 거실장 티비다이 TV 다이 장 받침대 선반 세트,38800,38800,0
2018-06-01,1245824114,E031070,에어컨,CMF-20WGI 칼맥 대형(20인치) 업소용 벽걸이선풍기,66900,64900,-2000
2018-06-01,700515852,A016040,포도,[KY식품] 단호박차 100포/천마차/단호박차/시리얼/흑미/씨리얼/,26900,26900,0
2018-06-01,1362532263,A011170,떡,벧엘떡집의 찹쌀100％ 쑥/수리취인절미 (1.8kg),28900,28900,0
2018-06-01,1330484878,I031040,생화,아웃팅/야전침대/접이식의자/릴렉스/체어/캠핑의자,35800,32050,-3750
2018-06-01,1374639774,A022050,탄산음료,칠성사이다/탄산음료/업소용/1.25L/500/355/245/190ml,12900,12900,0
2018-06-01,2033051148,C012040,여자학생복,빅사이즈 남성 여성 스티치 라운드 반팔 티셔츠 셔츠,14170,14170,0
2018-06-01,1117600641,F012020,생리대,예지미인 텐셀일반라이너 20p (1+1팩),2500,2500,0
2018-06-01,878854002,C012060,여자내의,밴딩 데님 랩팬츠/청치마/청바지/치마바지/P.1432,21900,21900,0
2018-06-01,391940701,C013060,등산복,경량스판 하이브리드 남성바지/여름 등산바지/작업복,9900,9900,0
2018-06-01,1010224580,A013170,생선통조림,동원 더참치 고소한쌈 90G×3캔,5990,5990,0
2018-06-01,1171597616,C012020,원피스,[라인어디션]스트라이프 벨티드 미니원피스 NWOPHE13(경기점),87000,70550,-16450
2018-06-01,1100283339,A011110,당면,국내산 도토리전분 도토리 묵말랭이 250g,32220,32220,0
2018-06-01,1010224584,A014020,분유,쌩마멧 유기농 사과 190G,4200,4200,0
2018-06-01,1010224583,A014020,분유,쌩마멧 유기농 사과 배 190G,4200,4200,0
2018-06-01,1377934089,E041050,냄비,내열도자기 워머 및 멀티팬세트 / 전골팬 구이판 수육,39600,39600,0
2018-06-01,1010224582,A014030,치즈,에비츄 슈레드모짜렐라치즈 630G,9990,9990,0
2018-06-01,1785595608,E051020,건전지,GP충전용 건전지 Ni-MH 하이브리드충전지 AAA/AA,5000,4900,-100
2018-06-01,949316698,C021040,실내화,니트 스판 키높이운동화 삭스슈즈 스니커즈,35500,35500,0
2018-06-01,940643046,A019080,고추장,CJ 해찬들 태양초 고추장 1.8kg + 450g,9900,9900,0
2018-06-01,1010224585,A014020,분유,쌩마멧 유기농 사과 바나나 190G,4200,4200,0
2018-06-01,1745442588,A022050,탄산음료,[일화] 탑씨190ml/헛개꿀물/맥콜/레쓰비/칠성사이다,5800,5800,0
2018-06-01,2018231214,A011160,빵,삼립 브라운브레드 10개 부시맨빵 호밀빵 식전빵 빵,7900,7900,0
2018-06-01,507609043,E061060,살충제,쌀벌레퇴치제 쌀벌레거제 5개 방충선언,7900,6900,-1000
2018-06-01,2012926084,C013040,청바지,봄신상 [국내생산]일자바지 8부/밑단컷팅/부츠컷,18000,16900,-1100
2018-06-01,418856919,C011030,남자학생복,(남자옷도매) FS-184 브라운버튼 데님셔츠 (M) 진청,56380,56380,0
2018-06-01,117322305,E011030,거실장,[채우리] 한들 애쉬 원목 좌탁 1200,350000,350000,0
2018-06-01,117322306,E011030,거실장,[채우리] 달보 원목 좌탁 1000,410000,410000,0
2018-06-01,117322307,E011030,거실장,[채우리] 라니 원목 좌탁 1450,400000,400000,0
2018-06-01,117322308,E011030,거실장,[채우리] 히라 원목 좌탁 1300,420000,420000,0
2018-06-01,989914070,E061010,세탁세제,[애경]애경)스파크리필(세탁조케어)3.2KG,9900,9900,0
2018-06-01,1953724413,A019170,냉동식품,비비고 새우왕교자 315g x 4봉 외 감자만두/김치만두,16900,16900,0
2018-06-01,989914071,E061060,살충제,홈매트리퀴드코드훈증기+45일*2,15500,15500,0
2018-06-01,866335291,E031080,선풍기,대웅모닝컴 전기히터 석영관 DWM-H2400S [3단계 온도조절 바퀴장착 ],69750,69750,0
2018-06-01,1003133890,A013040,고등어,업소용 자반고등어 24손(48미) 1박스 국내산 간고등어,32900,32900,0
2018-06-01,216325688,E011030,거실장,1 벽걸이 거실장/TV장/벽선반/거실선반/TV장식장,37800,37800,0
2018-06-01,53106693,C014010,아동복,(숲자람) 기능성 키즈 바람막이 어린이바람막이 유아,70270,70270,0
2018-06-01,4578303,A013040,고등어,삼선식품 노르웨이 구운 고등어 110g/130g/150g 10팩,27900,27900,0
2018-06-01,1252940234,F012020,생리대,시크릿데이 생리대 NEW라이너 일반 20PX15팩/ 시크릿데이,11500,10810,-690
2018-06-01,1988371151,A014020,분유,순산양분유 1~3단계 400g x 1캔 특가[6캔+사은품증정],14890,14890,0
2018-06-01,1243273085,F012010,종이기저귀,(공식)백조기저귀120매~300매 산모패드/신생아,12000,11700,-300
2018-06-01,117322309,E011030,거실장,[채우리] 비각 원목 좌탁 1450,360000,360000,0
2018-06-01,1101026198,A012060,햄및베이컨,태림 훈제삼겹살 400g2개,38020,38020,0
2018-06-01,750971600,A021010,커피,모카 율무차 900g 유안 희창 복숭아 레몬 매실 홍차,2500,2350,-150
2018-06-01,1078221210,I031010,장난감,닌자고 마인크래프트 아이언맨 피규어 레고 블럭 호환,15900,15900,0
2018-06-01,1532286240,A012060,햄및베이컨,SPAM 스팸 클래식/마일드 200g 할인특가,15400,15400,0
2018-06-01,1885678629,E041010,식기,코렐 모음/모닝/리틀/백합/베리/엘레강스/장미/데이지,9900,9110,-790
2018-06-01,117322312,E011030,거실장,[채우리] 다이 선반형 테이블 1500,450000,450000,0
2018-06-01,117322313,E011030,거실장,[채우리] 소피 서랍형 테이블 1500,360000,360000,0
2018-06-01,117322314,E011030,거실장,[채우리] 소피 서랍형 테이블 1200,290000,290000,0
2018-06-01,188204614,C013020,티셔츠,[앨빈클로]따뜻한 기모 무지 후드티 맨투맨 후드집업,24900,14900,-10000
2018-06-01,1792478437,E041030,솥,약재주머니 거름망 다시백 육수망 부직포주머니다시망,990,990,0
2018-06-01,372621862,L021060,유모차,이븐플로 휴대용유모차 라이트 이지,28000,28000,0
2018-06-01,359305841,C011020,남자상의,캐주얼세미정장자켓 여름쿨마린넨자켓 남자콤비마이,49800,49800,0
2018-06-01,886267197,L012030,칫솔,이천사 치과용칫솔 교정용 어린이 어금니 미세모 치솔,16900,16900,0
2018-06-01,117322310,E011030,거실장,[채우리] 비각 원목 좌탁 1200,290000,290000,0
2018-06-01,117322311,E011030,거실장,[채우리] 해각 테이블 1500,550000,550000,0
2018-06-01,1171328348,A015020,식용유,동원 카놀라유 4호 선물세트(쇼핑백 포함) A60240 -,21880,19480,-2400
2018-06-01,870818861,I031040,생화,레이맨 UV랜턴 자외선램프 위폐 형광 네일 경화 uvled,9800,8520,-1280
2018-06-01,52287464,C013050,운동복,카비스 순정형 후사경/RV전차종/백밀러/보조미러/후방,19000,17390,-1610
2018-06-01,2042852575,E011060,의자,타이탄 PC방 컴퓨터 책상 편한 학생의자,99600,90500,-9100
2018-06-01,1167223455,C011050,남자내의,[모다아울렛][닉스][남] 샴브레이 뒷밴딩 5부팬츠(NMMCPH151P)-3컬러,29600,28120,-1480
2018-06-01,1614413678,A014020,분유,[아이배냇] NEW 순산양분유 1단계~4단계 800g 3캔,98700,98700,0
2018-06-01,614332891,C013020,티셔츠,헤지스레이디스 HSTS7B608N2 라인 면 혼방 반팔 카라 티셔츠,87570,71810,-15760
2018-06-01,1115144854,L021060,유모차,[도노도노] 휴대용 선풍기색상선택,21900,21900,0
2018-06-01,846248564,A011010,쌀,2017년산 햅쌀 현미10kg/백미10kg/찰현미/찹쌀,18800,18800,0
2018-06-01,25626511,F012050,의료측정기,브라운체온계 IRT-6030 6510 6520 / 필수악세서리선택,75260,70000,-5260
2018-06-01,955915651,A012060,햄및베이컨,샘표 우리엄마 쇠고기 장조림110G,3590,3590,0
2018-06-01,896633548,L012060,샴푸,[아모레퍼시픽]려)자양운모 지성 샴푸(400ML),16000,9900,-6100
2018-06-01,896572104,A019080,고추장,[청정원]청정원 순창 초고추장 170g,1690,1690,0
2018-06-01,505122656,C014010,아동복,단가라프릴원피스,22900,22900,0
2018-06-01,441061190,A018090,잼,오뚜기 후루츠잼300gX15개(1박스)/딸기잼/포도잼/블,70990,70990,0
2018-06-01,1387468675,E061050,청소용세제,백화제거제/돌세척제/건물외벽 청소/백화제로,12900,12900,0
2018-06-01,896572106,A019080,고추장,[청정원]청정원 태양초 현미찰고추장 200g,3700,3700,0
2018-06-01,808515725,E011030,거실장,미니다용도 거실장 TV다이 수납장 서랍장 모음전,29900,24900,-5000
2018-06-01,1656958037,A016120,바나나,[EROOM C&G]고당도 바나나 3kg내외(2손),15200,14690,-510
2018-06-01,2146819442,E021010,침구,천사몽 국내산 포근한 사계절 패딩이불 차렵이불 D Q,16000,14630,-1370
2018-06-01,450693614,C013010,점퍼,빅사이즈 레이스끈자켓 CM1705 빅사이즈 여성의류 미,81030,79410,-1620
2018-06-01,920011107,C021020,구두,[SODA] 남성 보트슈즈 AJM848 2종 택1 (3cm),109000,83930,-25070
2018-06-01,1603857610,C011020,남자상의,봄여름균일가12종/남성정장/정장/남성양복/수트,68900,68900,0
2018-06-01,534781501,A018100,꿀,프랑스 유기농 로얄제리 선물세트 30앰플,180000,148000,-32000
2018-06-01,2145075648,A017110,감자,당근 정품 5kg 9900원/10kg/안전포장,9900,9900,0
2018-06-01,926835471,A014010,우유,[가정배달] 아침의 선물 (930mL) 주3회 4주(월12회),32400,32400,0
2018-06-01,1229078164,F012020,생리대,{무료배송}동아제약 템포 총40p 레귤라10P/슈퍼10P,18800,18800,0
2018-06-01,1897254034,A022020,두유,[베지밀]베지밀 검은콩과 검은참깨 190mlx72팩,29900,29900,0
2018-06-01,372452691,C013020,티셔츠,콜핑 봄 기능성티셔츠 13종 균일가,13000,13000,0
2018-06-01,990089743,A019180,즉석식품,요리하다 방울순대 400G,2980,2980,0
2018-06-01,990089742,A019180,즉석식품,요리하다 찰순대 500G,2980,2980,0
2018-06-01,229022903,E011060,의자,쿠시 체어/책상의자/사무의자/컴퓨터의자/학생의자,26200,26200,0
2018-06-01,579285094,E041010,식기,로하스면기 국수 비빔밥 빙수그릇 블랙 대접 멜라민,3100,2860,-240
2018-06-01,1530589387,C012020,원피스,MELODY F102 그레이/코트/여자코트/겨울코디/겨울코트/자켓/점퍼 미국 여성토탈브랜드,39700,39700,0
2018-06-01,792723494,L021060,유모차,봄맞이 초특가세일~스마트써니 휴대용짱짱유모차,72800,49510,-23290
2018-06-01,180456161,A018060,스낵과자,과자/초콜릿/사탕/파이( 최대60%할인)/1+1이벤트!!!!!,2990,2990,0
2018-06-01,534082617,A016040,포도,동원)황도 슬라이스 400g x 12개 사시사철 맛있는 복,32960,32960,0
2018-06-01,287473944,E041050,냄비,[네오플램] 네오플램 에콜론 2종 냄비세트 냄비,40900,39900,-1000
2018-06-01,594705067,L012090,기초화장품,참존 스킨 에센스(남성용) 수분에센스 세럼 앰플 수분,29470,29470,0
2018-06-01,52999672,A011170,떡,[꾸워먹는 꾸떡] 구워먹는 치즈떡 1kgx2,15500,14290,-1210
2018-06-01,1530590352,C012020,원피스,MELODY F106 블랙/코트/여자코트/겨울코디/겨울코트/자켓/점퍼 미국 여성토탈브랜드 멜,84700,84700,0
2018-06-01,1912619510,C011050,남자내의,[행텐] 남여공용 밴딩 반바지 10120-251-431-41 NC아울렛,19800,9000,-10800
2018-06-01,337121145,A022010,주스,무료배송 태평마트 태국 수입 바라푸드 타스 망고스틴 주스 드링크 310ml 8캔 열대 과,12150,12150,0
2018-06-01,1639881682,C013050,운동복,봄신상 트레이닝복세트 운동복 트레이닝복 츄리닝,29800,29800,0
2018-06-01,60183225,C013050,운동복,남여트레이닝세트/후드세트/반팔세트/커플/빅사이즈,19900,19900,0
2018-06-01,195562972,A014010,우유,남양 DHA 옳은 유기농우유 딸기 바나나 120ml 24팩,19900,19900,0
2018-06-01,570142145,D031010,주택수선재료,원목 조립식 발판/깔판/베란다 마루 발코니 끼움식,7400,7400,0
2018-06-01,450284570,C012040,여자학생복,PTU2075G 커플여자패딩조끼베스트-빅사이즈88까지,19460,19460,0
2018-06-01,691023387,I011020,영상음향기기,(공식인증점) 스마트빔 SSB-10DLFF08 미니 빔프로젝터,349000,349000,0
2018-06-01,456394052,C013050,운동복,자동차 도어가드 4p세트/문콕방지가드 차량용도어가드,3990,3880,-110
2018-06-01,1437048039,F012010,종이기저귀,2018 보솜이 리얼코튼 밴드 남/여 4팩,41900,39810,-2090
2018-06-01,1355103246,L021050,우산,우비/우의/비옷/성인/아동/어린이/여성/일회용/낚시,4900,4900,0
2018-06-01,895889858,A019050,간장,[청정원]청정원 햇살담은 자연숙성 조림간장 (840ml),6500,6500,0
2018-06-01,895889859,A019050,간장,[청정원]청정원 햇살담은 자연숙성 국간장 840ml,6100,6100,0
2018-06-01,130123860,A013170,생선통조림,유동 번데기탕 캔 구수한맛 280g X 24EA_1BOX 유동번,51070,51070,0
2018-06-01,1013988021,C013020,티셔츠,♣특가판매♣기능성코오롱원단 쿨카라티셔츠-쿨라운드(반팔.긴팔)단체티 단체복 작업복,6000,5900,-100
2018-06-01,349810855,A018080,설탕,큐원 하얀설탕 15kg / 3kg x 4개삼양사/백설탕 P,15900,15900,0
2018-06-01,342097668,E011040,소파,[에보니아] 티파니 1인수툴의자/방수패브릭/스툴소파,49000,49000,0
2018-06-01,245794990,E031020,가스레인지,SK매직 GRA-S2084 가스레인지 2구,120000,120000,0
2018-06-01,437787776,I011010,TV,특가! 아도니스81~165cm(32~65)삼성A패널무결점모음,132980,129000,-3980
2018-06-01,313945630,C012030,여자상의,크러쉬 멜빵 데님스커트-M1060,31360,31360,0
2018-06-01,1749532901,L012090,기초화장품,리리코스 마린 콜라겐/UV 워터 쿠션/더블 프로텍션 데일리/엑스퍼트/커버 BB 비비/CC,23600,21500,-2100
2018-06-01,759608634,C012040,여자학생복,[막스까르띠지오]숄카라 샤이닝 루즈가디건,30000,28500,-1500
2018-06-01,89561667,C012040,여자학생복,[MLB]엠엘비 3종택1 남여공용 소매박스로고 MLB 후드집업(31TRS1811),79000,67150,-11850
2018-06-01,1422031431,A022050,탄산음료,트로피카나 스파클링 355ml x 24캔 /웰치스/닥터페퍼,12800,12800,0
2018-06-01,140799411,A011110,당면,라라스팜 저칼로리 고단백 하늘이 내린 쌈두부 80g 5,34360,30590,-3770
2018-06-01,1250073008,C012020,원피스,[데미안][AK구로점][데미안]반차이나 롱 트렌치코트DE41062-200,376200,357390,-18810
2018-06-01,1654792065,C011030,남자학생복,3000원 할인[아메리칸웨스트]TWIST Pabis 남성가디건/정장가디건/남성자켓/니트/울/단,39800,19900,-19900
2018-06-01,454203034,E041070,밀폐용기,ANN 내열유리밀폐용기/유리병/저장병/밀폐용기,4000,3130,-870
2018-06-01,117322250,E011030,거실장,[채우리] 다은 소나무 원목 좌탁 1200,150000,150000,0
2018-06-01,117322251,E011030,거실장,[채우리] 다은 소나무 원목 좌탁 1000,120000,120000,0
2018-06-01,117322252,E011030,거실장,[채우리] 잠비 소나무 원목 좌탁 1200,160000,160000,0
2018-06-01,534285550,A011010,쌀,분도쌀10kg 5분도/7분도/쌀눈쌀/현미/백미 밥선생,26900,26900,0
2018-06-01,425908989,A011040,보리쌀,(전남오픈마켓/강진전통된장)강진고추장용메주가루1kg,18000,18000,0
2018-06-01,820097549,C011050,남자내의,아로미 905/고무꽃 발목 고무밴딩 스프사 9부 파자마,11700,10420,-1280
2018-06-01,377892808,A018100,꿀,잡화꿀 (다드림 500g) X20,131240,116810,-14430
2018-06-01,156549528,I031040,생화,미디어 MPC-10000T 이동식 에어컨 26-33㎡ 일체형,368000,368000,0
2018-06-01,895682032,A011010,쌀,청원생명쌀(포/10KG),32900,26900,-6000
2018-06-01,1510442742,L021020,장신구,라이센스 정품 피어싱 포켓몬 팬콧 디즈니,4800,4800,0
2018-06-01,2034846433,C012040,여자학생복,[꼼빠니아]사이드레이스배색 베스트-IC5U5WVC010,22900,19470,-3430
2018-06-01,1338869842,C013050,운동복,신개념 허브향 에탄올 워셔액(1.8L X 6개)/무료배송,16900,16900,0
2018-06-01,601684687,C013040,청바지,26~32인치 스판 워싱 스트레이트 데님 청바지,21900,21900,0
2018-06-01,1260162385,E031020,가스레인지,린나이 2구 가스렌지 RT-1003J/고화력/고효율/,125800,117000,-8800
2018-06-01,1508766463,I031040,생화,OKG캠핑 접이식 미니삽 야전삽 모종삽 중형 대형,5900,5430,-470
2018-06-01,2005078015,C012060,여자내의,T1765-지젤 나비 자수 티셔츠 브이넥티셔츠 자수티셔,55750,54080,-1670
2018-06-01,452703852,C014020,유아복,아둘 가족티 유아 샌디에고 원피스 롱티셔츠 12,14300,14300,0
2018-06-01,90902594,A012060,햄및베이컨,[롯데햄]런천미트 200gx10/로스팜 340gx6개,17900,17900,0
2018-06-01,776472214,C013050,운동복,올뉴카니발전용 콘솔트레이 올뉴카니발전용트레이 올,24070,21930,-2140
2018-06-01,1271366093,E021020,커튼,롤스크린 그림 암막 1468,54560,54560,0
2018-06-01,440293568,A015020,식용유,해표 카놀라유18L카놀라유 해표 식자재 식용유 콩기름,87400,76920,-10480
2018-06-01,2064623907,L012030,칫솔,2080 센서티브 딥터치 쏙쏙터치 칫솔 18개 택1,10900,10900,0
2018-06-01,73352646,C011050,남자내의,신상 트렌드 카고 바지/남자/밴딩/빅사이즈/면팬츠,19800,19800,0
2018-06-01,256854820,C013010,점퍼,[블루독] 바람막이우븐점퍼 (28325-110-51),110400,90530,-19870
2018-06-01,117322279,E011030,거실장,[채우리] 보담 시다 원목 좌탁 1800,540000,540000,0
2018-06-01,1885113833,C013050,운동복,카테크 무선 광택기 CT-726 광택기 폴리셔 기계왁스,65000,59800,-5200
2018-06-01,1198155770,A017010,배추,곰보배추 발효액 2병x1000ml/곰보배추차/곰보배추즙/곰보배추진액/곰보배추액기스/곰보,70000,70000,0
2018-06-01,1772487560,A016060,감,상주전통곶감 건시1kg24-34과 곶감/상주곶감/건시/반,37600,37600,0
2018-06-01,117322274,E011030,거실장,[채우리] 잠비 소나무 원목 좌탁 1000,130000,130000,0
2018-06-01,117322275,E011030,거실장,[채우리] 다솜 소나무 원목 좌탁 1200,140000,140000,0
2018-06-01,117322276,E011030,거실장,[채우리] 한울 소나무 원목 좌탁 1200,120000,120000,0
2018-06-01,802790502,D031010,주택수선재료,노루페인트 친환경 프리미엄 팬톤페인트 1L 간단세트,20900,20900,0
2018-06-01,115748253,C013050,운동복,+봄신상 밴딩팬츠+ 빅사이즈77-99 조거 배기 면바지,25400,25400,0
2018-06-01,117322280,E011030,거실장,[채우리] 보담 시다 원목 좌탁 1500,380000,380000,0
2018-06-01,117322281,E011030,거실장,[채우리] 보담 시다 원목 좌탁 1200,330000,330000,0
2018-06-01,1596823577,E061020,섬유유연제,샤프란 섬유유연제 시트150매 테크 세탁 세제 피죤,10900,10900,0
2018-06-01,127709359,I011010,TV,초특가 65인치 LED UHD TV/삼성패널/특급설치,535050,519000,-16050
2018-06-01,193696868,E041010,식기,[금도금 장수 수저5벌-종이케이스] 스푼세트 수저세트 숟가락세트 부부수저세트 예쁜수,53700,52600,-1100
2018-06-01,529530513,C012060,여자내의,허리조절 베이지체크 교복치마 교복 예쁜교복 교복쇼,49840,48350,-1490
2018-06-01,1961377114,A011170,떡,떡국 1kg 한양식품 떡국떡 떡볶이 조랭이떡 판매,2100,2100,0
2018-06-01,1684945573,E031070,에어컨,신일 가정용 업소용 벽걸이선풍기 모음 MF-16WHD,40000,28310,-11690
2018-06-01,1577937366,A017100,당근,주문 후 수확 왕방산 열무 2kg,6800,6800,0
2018-06-01,760068158,F012010,종이기저귀,팸퍼스/베이비드라이/밴드/기저귀/4단계(2팩)ampers,56900,56900,0
2018-06-01,855167434,E031080,선풍기,[기본배송비무료][신일금속] 누임형 특대(기본형) SL-130/연탄난로/보일러/장작난로/주물난로/,510200,510200,0
2018-06-01,855167433,E031080,선풍기,[기본배송비무료][기본배송비무료][신일금속] 누임형 대(구이 겸용) SL-120C/연탄난로/보일러/장작난로/주물난로/,595800,595800,0
2018-06-01,855167436,E031080,선풍기,[기본배송비무료][신일금속] 누임형 특대(구이 겸용) SL-130C/연탄난로/보일러/장작난로/주물난로/,746900,746900,0
2018-06-01,1802315211,E011040,소파,보니타빈백/신상품A206상품후기작성100L충전재증정,80900,80900,0
2018-06-01,855167435,E031080,선풍기,[기본배송비무료][신일금속] 누임형 특대(망부착) SL-130M/연탄난로/보일러/장작난로/주물난로/,619000,619000,0
2018-06-01,1778587603,L021020,장신구,[바보사랑]silver rose gold ring earring,34000,34000,0
2018-06-01,1778587601,L021020,장신구,[바보사랑]2컬러 crystal drop ring earring,21000,21000,0
2018-06-01,1698554620,A017080,무,18년 5월말수확중 콜라비 (특) 10kg 적콜라비 산지,23900,23900,0
2018-06-01,1778587600,L021020,장신구,[바보사랑]2컬러 4way nacre earring,30000,30000,0
2018-06-01,1803301099,L021030,가방,타거스 CN418 17인치-18인치 노트북가방/서류가방,46000,44000,-2000
2018-06-01,452703883,C014020,유아복,아둘 가족티 유아 샌디에고 원피스 롱티셔츠 11,14300,14300,0
2018-06-01,458996646,I031040,생화,CAMPro 초경량 알루미늄 야전침대 간이침대 캠핑의자,24500,24500,0
2018-06-01,1869354519,F011150,건강기능식품,자연웰/25곡/미숫가루/블랙미숫가루+쉐이크통+천연당,9900,9900,0
2018-06-01,247993087,C012020,원피스,김발 겉대x20,20160,20160,0
2018-06-01,520108962,A016040,포도,아삭아삭 껍질째 먹는 적포도(크림슨) 2kg이내,19900,19900,0
2018-06-01,1346161198,A014010,우유,엿기름(오곡 10K )/엿질금 고추장재료 시골엿기름,52000,49400,-2600
2018-06-01,549038353,A022010,주스,망고주스(델몬트 롯데 1.5L)/망고 원액 스무디 망고스틴 젤라또 아이스크림 재료 푸딩,6620,6430,-190
2018-06-01,227063844,A019060,된장,옹고집장집 호박보리된장 5kg/ 벌크/ 국산콩 저염된장,80000,80000,0
2018-06-01,859645515,C012060,여자내의,컨택유 페미닌 플리츠 롱 스커트 #5833/ 컨택유,20600,15660,-4940
2018-06-01,50173968,C011030,남자학생복,인터페이스제작 특양면가디건 밤톨이포인트 후드집,29700,29700,0
2018-06-01,1173847748,L021020,장신구,은 볼 5.0mm 무광팔찌,20000,20000,0
2018-06-01,1395401815,C013010,점퍼,블래이즈 니트 여성티셔츠집업 DM-5072,87130,82780,-4350
2018-06-01,1119344606,E031080,선풍기,신일산업 팬히터/석유난로/온풍기 SFH-CBR900,397000,397000,0
2018-06-01,1081454719,A017150,버섯,산채류 선물세트_(건표고버섯 80g + 건고사리80g,58120,58120,0
2018-06-01,108069841,A017040,양배추,(면)(냉동)청학 부추1kg,4820,4820,0
2018-06-01,1119344605,E031080,선풍기,신일산업 팬히터/석유난로/온풍기 SFH-CC910,408500,408500,0
2018-06-01,2050662448,C014010,아동복,여름 특가 신상 러블리 여아원피스 레깅스 아동복,6900,6900,0
2018-06-01,505857442,C012040,여자학생복,니트원피스가디건set/모직원피스/니트스커트/do,34430,34430,0
2018-06-01,497665452,A011110,당면,(무)시골다람쥐도토리묵2kgX2EA(BOX)X2개다람쥐 도토,32200,28340,-3860
2018-06-01,1268017623,E061040,부엌용세제,기름기에 강한주방세제 친환경 메소드1000mlx3개,15900,15900,0
2018-06-01,385476895,C011030,남자학생복,오투아이스_쿨링조끼/애견용/2XL(대형),31170,29300,-1870
2018-06-01,1873908552,F012010,종이기저귀,스웨덴 친환경 네띠 기저귀 밴드형 팬티형 4팩,47600,47600,0
2018-06-01,246684908,E021020,커튼,GT 강아지 고양이 물통 철문 이동장 걸리버 디럭스1 S,82970,82970,0
2018-06-01,1196783016,C012060,여자내의,[플라스틱아일랜드]밑단 언발 주름포인트 스커트(PJ2WS586)(광주신세계),89000,72200,-16800
2018-06-01,1300571268,I012060,저장장치,[무료배송]특가!!!/USB 무소음마우스!!![클릭소리NO]/,6500,6500,0
2018-06-01,1207332746,C013010,점퍼,[데일리스트/앤섬] 히든 버튼 엘레강스 베스트 MDBQCRM4171,24200,22750,-1450
2018-06-01,1890085222,C011020,남자상의,아이보리 체크 밍크털 코트 캐주얼코트 퍼코트 남성털,109100,109100,0
2018-06-01,855167410,E031080,선풍기,[기본배송비무료][신일금속] 누임형 대(기본형) SL-120 /연탄난로/보일러/장작난로/주물난로/,475700,475700,0
2018-06-01,855167411,E031080,선풍기,[기본배송비무료][신일금속] 누임형 대(망부착) SL-120M/연탄난로/보일러/장작난로/주물난로/,532000,532000,0
2018-06-01,571021971,A017200,토마토,[하늘농가]순수국산 건가지 70gX3팩/ 롯데식품관,16900,16900,0
2018-06-01,713995656,E041030,솥,본사직영/PN풍년 압력솥/뉴하이클래드IH/사은품증정!,50900,50900,0
2018-06-01,855167407,E031080,선풍기,[기본배송비무료][신일금속] 누임형 중(기본형) SL-110 /연탄난로/보일러/장작난로/주물난로/,399000,399000,0
2018-06-01,275422034,C013020,티셔츠,신상특가/카라티/카라티셔츠/반팔티셔츠/PK티셔츠,26000,22800,-3200
2018-06-01,855167406,E031080,선풍기,[기본배송비무료][신일금속] 연탄난로 1구 3탄 SL-13/연탄난로/보일러/장작난로/주물난로/,49900,49900,0
2018-06-01,267357032,A022050,탄산음료,오란씨 비타민C 250ml x 30캔 탄산음료 음료수 캔음료,10900,10900,0
2018-06-01,855167409,E031080,선풍기,[기본배송비무료][신일금속] 누임형 중(구이 겸용) SL-110C/연탄난로/보일러/장작난로/주물난로/,553700,553700,0
2018-06-01,855167408,E031080,선풍기,[기본배송비무료][신일금속] 누임형 중(망부착) SL-110M/연탄난로/보일러/장작난로/주물난로/,455200,455200,0
2018-06-01,51131229,A013090,전복,(국보수산)냉동 청정 남해안 키조개관자 1kg,31000,31000,0
2018-06-01,470755201,C013040,청바지,봄신상 남자 청바지/빅사이즈/스판/일자/밴딩,15800,15800,0
2018-06-01,650792672,C014010,아동복,레이스가방원피스/공주드레스/ 여아드레스/쉬폰원피스,28900,18900,-10000
2018-06-01,1286300155,A015020,식용유,청정원 포도씨유 500ml X 15EA 식용유 기름 청정원포,133560,133560,0
2018-06-01,226257807,E041010,식기,예쁜그릇 공기대접 세트 29종 모음전/,9000,8280,-720
2018-06-01,989855198,A013060,게,[기획전]돌문어 1kg(1~2미),37000,24500,-12500
2018-06-01,1729913321,C014010,아동복,뒤리본프릴넥ops/여아원피스/여름신상원피스/외출복,9900,9900,0
2018-06-01,855167402,E031080,선풍기,컴텔핫썬 인공태양히터(근적외선히터) 원통형(가정용) CTHS-J1000,140000,140000,0
2018-06-01,525897253,C011050,남자내의,여름/청바지/밴딩/일자/스판/면/빅사이즈/남자/남성,17800,17800,0
2018-06-01,117322246,E011030,거실장,[채우리] 노아 소나무 원목 좌탁 780,110000,110000,0
2018-06-01,57750484,C012030,여자상의,[이란지]봄 신상/티셔츠/블라우스/원피스/자켓/코트,6800,6800,0
2018-06-01,117322248,E011030,거실장,[채우리] 늘솜 애쉬 원목 좌탁 1000,150000,150000,0
2018-06-01,192578809,C014010,아동복,[에꼴리에]에꼴리에 PNC02 스키니핏 찢청 워싱진 18A1258,24000,23040,-960
2018-06-01,117322249,E011030,거실장,[채우리] 늘솜 애쉬 원목 좌탁 800,130000,130000,0
2018-06-01,209523011,A013020,명태,[마산어시장 이바다몰]절단명태코다리1kg/손질코다리,5300,5300,0
2018-06-01,1219631307,A018030,껌,오리온 더자일리톨껌 리필백 (오리지날/더민트/비타C),2930,2930,0
2018-06-01,2144740373,L012090,기초화장품,하다라보 고쿠쥰 밀크(고보습 모이스쳐라이저) 2개,26900,26900,0
2018-06-01,117322243,E011030,거실장,[채우리] 은솜 소나무 원목 좌탁 확장형 1000,190000,190000,0
2018-06-01,117322244,E011030,거실장,[채우리] 노아 소나무 원목 좌탁 1200,140000,140000,0
2018-06-01,117322245,E011030,거실장,[채우리] 노아 소나무 원목 좌탁 1000,130000,130000,0
2018-06-01,898422060,A017070,부추,흙대파(봉),4990,1490,-3500
2018-06-01,546453231,E031020,가스레인지,RBO-619SM 린나이 빌트인 4구 가스쿡탑/가스오븐렌지/화재예방/황토오븐/자연대류형/마,860000,860000,0
2018-06-01,569270075,A011170,떡,특허받은맛 아리울 떡 공방 굳지않는 쫀득 절편,7800,7800,0
2018-06-01,1319076005,C011030,남자학생복,[지이크][지이크] 블루 스타일리시 드레스 셔츠 (FMBAD5208) (P000329073),17900,17900,0
2018-06-01,1202700020,L012060,샴푸,대용량 샤샤 아르간오일 1500ML 약산성 샴푸 린스 1+1,14800,13800,-1000
2018-06-01,1059483141,E041030,솥,스텐냄비모음 곰솥 국수냄비 들통 찜솥 밀크팬 빨래삶,17000,17000,0
2018-06-01,344732178,L012090,기초화장품,아이오페 모이스트 클렌징 크림 180ml,14900,14900,0
2018-06-01,1323887806,C013050,운동복,[아스토레] (SIZE : 100) 본딩 히트자켓(ABL) - 우븐+,110640,110640,0
2018-06-01,1330722695,I031040,생화,(은성) 여명기 1-53 /1.5-53 2-53 3-53 3-43호,61500,56680,-4820
2018-06-01,2093556364,C013020,티셔츠,1+1 실켓 티셔츠,12900,12900,0
2018-06-01,1312426802,A013020,명태,두레생협 바다마을대구전(500g) 부침개용냉동대구 전,31440,31440,0
2018-06-01,930436598,I031070,애완동물관리비,훼르자 스파이크화 블루/그린 육상화 핀포함,33000,29120,-3880
2018-06-01,1633029246,E061020,섬유유연제,피죤 대용량 20리터/샤프란 20리터/섬유유연제/말통/세탁/세제/빨래/말통 펌프 별매/업,15700,15700,0
2018-06-01,2136976338,C012060,여자내의,[JEIKEI]베이직 5부 바지 JH6PT005Z[갤러리아],10000,8700,-1300
2018-06-01,475160964,C013050,운동복,벨크로 선정리 테이프/배선정리/케이블클립/슈프림카,2600,2030,-570
2018-06-01,1893285108,E061020,섬유유연제,바운스 320매 시트유연제 종이유연제 드라이시트,17190,17190,0
2018-06-01,1004951676,L021020,장신구,로즈 체인 태슬 롱 목걸이 주얼리 로즈목걸이 장미체,33380,33380,0
2018-06-01,2006813928,C012030,여자상의,+여름신상 쉬폰원피스+빅사이즈77-99 플라워/나시,25500,25500,0
2018-06-01,190917698,E011060,의자,무무 체어 북유럽 너드 인테리어 카페 식탁 의자 책상,19900,19900,0
2018-06-01,609137134,A019100,식초,오뚜기 케찹 마요네즈 드레싱 딸기쨈 스파게티 소스,2000,2000,0
2018-06-01,854844199,I031040,생화,[써모스] 진공단열 푸드컨테이너 JBJ-302K (보온죽통),25300,22650,-2650
2018-06-01,1039685464,A019080,고추장,[고스락] 유기농발아현미고추장(1kg),41000,41000,0
2018-06-01,2139547237,C012040,여자학생복,여성 무스탕 조끼_베스트 그레이조끼 브라운조끼 여성,35150,35150,0
2018-06-01,1362123529,E061050,청소용세제,계양산업 곰팡이터치원 곰팡이제거 화장실세제,4400,4400,0
2018-06-01,539817038,L021060,유모차,[해피랜드]에어토리 휴대용유모차 공기청정기/3중필터,84000,84000,0
2018-06-01,906338979,E011050,책상,컴퓨터책상/입식책상/책상/H형/입식,40900,39900,-1000
2018-06-01,1550172013,E041070,밀폐용기,[그린킵스]스텐 김장용 김치통 밀폐용기 반찬통 모음,31900,29350,-2550
2018-06-01,2025745132,A012010,국산쇠고기,[무항생제] 탕갈비 800g 1등급,89900,89900,0
2018-06-01,1966756369,C014010,아동복,[스타일노리터][BIU] 리키 나시 블라우스.bls(마산점),29800,27470,-2330
2018-06-01,350933632,C013050,운동복,제이피플요가복트레이닝/필라테스/휘트니스/헬스복,10000,9900,-100
2018-06-01,409006440,C013010,점퍼,빅사이즈 박스후드티 TD 남성의류 후드티집업 후드 패,65000,64350,-650
2018-06-01,549932662,C013050,운동복,기능성 츄리닝바지/신축스판/반바지/츄리닝/단체복,30800,29000,-1800
2018-06-01,1379909850,I031010,장난감,레고 대용량 2000피스 리필블럭 벌크 클래식호환 블록,12300,12300,0
2018-06-01,1656767472,A013090,전복,살아있는 국내산! 통영 바지락 (조개) 1kg,5900,5900,0
2018-06-01,488084653,E041010,식기,대박/기원/개업선물/집들이/선물/풍수지리/인테리어,90700,88890,-1810
2018-06-01,635974958,A019080,고추장,청정원 태양초 찰고추장 (현미)(1.5KG*2입),16590,16590,0
2018-06-01,1244584168,A016070,귤,[곱들락][제주남원농협] 곱들락 하우스감귤 5kg (47-94과내) / 벌크형(실중량),57900,57900,0
2018-06-01,1308586775,C011020,남자상의,MJ_1132 블루 래글런코트 남성코트 겨울코트 자켓 겨,91580,91580,0
2018-06-01,2047158979,C011050,남자내의,푸마 트레이닝 팬츠 (65382437 ),70960,63160,-7800
2018-06-01,1600562934,E011060,의자,NEW)BLMG사무용의자B100/컴퓨터의자/학생의자/책상,56900,48910,-7990
2018-06-01,1316032052,D031010,주택수선재료,데코타일/바닥재/현관타일/접착식바닥재/장판/베란다,750,750,0
2018-06-01,2143788323,A017100,당근,알타리 5Kg내외×4박스,63920,63920,0
2018-06-01,622648365,L021020,장신구,S.STEEL 귓바퀴 이어커프 귀찌 피어싱 귀걸이 P0796,2000,2000,0
2018-06-01,817734236,A017180,호박,청양고추 상품 10kg땡초,26000,25740,-260
2018-06-01,319577939,C012040,여자학생복,[로엠(ROEM)]베이직 셋업 반팔 블라우스 (1color) RMBL824R01,39900,39900,0
2018-06-01,1341313859,E011070,식탁,삼익가구 화산석 원목 식탁 풀세트(의자2+벤치1 포함),395000,395000,0
2018-06-01,1457630187,F012050,의료측정기,2018년형 써모파인더에스2 비접촉체온계 HFS-710,43000,43000,0
2018-06-01,1040566098,E011050,책상,/11번단독특가/모던라인책상/1인용책상/2인용책상/책상/사무용책상/테이블/책상의자/책,79010,79010,0
2018-06-01,1579307481,A014030,치즈,치즈(파마산 크레프트 227g)X24 뿌리는 가루 파스타,196930,196930,0
2018-06-01,2092749082,C013020,티셔츠,[대백아울렛] [리트머스]여름반팔 오버핏 레이어드 후드티 (LI7TU428),29000,29000,0
2018-06-01,109922493,E031030,전자레인지,삼성 전자레인지 MS23K3535AK / 오늘발송,92000,92000,0
2018-06-01,316736462,C011030,남자학생복,줄지 헨리넥 차이나셔츠스타일 좋은 남성 남방 모음전,17700,17700,0
2018-06-01,467554990,A011090,국수,[당일출고/무료배송]오뚜기 참깨라면 20개,16910,16910,0
2018-06-01,1011209857,E021010,침구,3M오염방지일반베개50*70,34900,25000,-9900
2018-06-01,1011209856,E021010,침구,3M진드기방지경추베개속통50*70,29900,19900,-10000
2018-06-01,364532848,C011050,남자내의,여름신상 반바지 트레이닝 남자 5부 운동복 고무줄 티,8700,8700,0
2018-06-01,1434462128,L021020,장신구,실버 925 엔틱 진주 체인 레이어드 여자 은반지,23000,23000,0
2018-06-01,279815426,I012010,컴퓨터,애플정품 21.5형 New iMac MK142KH/A 아이맥/SG,1453820,1453820,0
2018-06-01,1010138219,A013100,마른멸치,RF)날치알(레드) 100G,4990,4990,0
2018-06-01,1049023468,C013030,스웨터,폴라티 긴팔 MJ7362_7367 마르잔 빅사이즈 반팔티,43180,42320,-860
2018-06-01,1010138220,A013100,마른멸치,RF)피꼬막살 200G,7990,7990,0
2018-06-01,218067088,C013010,점퍼,30%쿠폰!남자봄풀코디/봄자켓/남자바지/셔츠/봄아우터,14800,9800,-5000
2018-06-01,2013855206,C013020,티셔츠,봄신상 오버핏 티셔츠/루즈핏/박스/7부/남자티셔츠,14800,10800,-4000
2018-06-01,1394740586,C013030,스웨터,알렉 브이넥 오버사이즈 롱니트 여성티셔츠DM-4046,40800,38760,-2040
2018-06-01,143493265,C014020,유아복,베이비앙 아기망토 유아망토 유아케이프 망토&장갑,13900,13900,0
2018-06-01,1233814445,A013120,낙지,정화 불고기 통.전기 오징어 50g x 5.,24430,24430,0
2018-06-01,1641747104,D031010,주택수선재료,[노루페인트] DHDC-2520_형광페인트 0.4L 식별용,13000,13000,0
2018-06-01,1891240683,A016020,배,찬바람N(앤) 도라지배즙 (100mg25포),50300,48800,-1500
2018-06-01,2083978893,C013010,점퍼,남자아우터 연카키 후드 롱 패딩 /(참고)롱점퍼 남자,100900,88800,-12100
2018-06-01,1922828591,C013050,운동복,(1+1 EVENT) 16ss 첨이첨이 플라워소녀3부세트 듀퐁 유아동의류 아동의류 공용 상하복,33170,33170,0
2018-06-01,2059494939,C014010,아동복,[MLB키즈]트레이닝 반 바지( 택1) 71SPD2831,39000,33150,-5850
2018-06-01,2081572983,C015040,장갑,[미셀라니]UV 차단 쿨 레이스장갑 모음,13900,13210,-690
2018-06-01,1606782807,A016030,복숭아,황도캔(슬라이스 삼아2.96K)/황도캔 복숭아캔 황도 과,10540,9910,-630
2018-06-01,222935445,C013020,티셔츠,[트루젠] 봄 정장/이너/팬츠 100종,10000,10000,0
2018-06-01,1433070894,I053030,복사용지,직배송 밀크 A4 복사용지(A4용지) 80g 2박스/더블에이,46040,39600,-6440
2018-06-01,1179945297,L021020,장신구,피지 미니 버튼 스터드 귀걸이 SS-EA-FAMS-DIA/ 모니카비나더(주얼리),518000,466200,-51800
2018-06-01,359508414,I031070,애완동물관리비,럭셔리그네의자/안락의자/흔들의자/캠핑용품/펜션/캠핑의자/가든체어/인테리어소품,69800,60010,-9790
2018-06-01,984549795,E061020,섬유유연제,샤프란 핑크 리필1300ML,1990,1990,0
2018-06-01,1854514036,L021010,손목시계,남성 패션시계 메탈밴드 손목 바늘 학생 니트가디건,22500,22500,0
2018-06-01,2114554657,F012020,생리대,엘리스 생리대 순수감촉3+1팩/메가미/고쿠수이/초안심,7900,7900,0
2018-06-01,398217285,C021040,실내화,[리복]유어플렉스 트레인 10 M BS9882,43470,37820,-5650
2018-06-01,1783115769,L021010,손목시계,MARCJACOBS 마크제이콥스 MJ3574 여성용 메탈밴드 패션시계,259000,259000,0
2018-06-01,1048963175,C012040,여자학생복,베하터 청롱 NB 여성 청남방 KD 청남방,78860,77290,-1570
2018-06-01,1783115768,L021010,손목시계,MARCJACOBS 마크제이콥스 MJ3572 여성용 메탈밴드 패션시계,299000,299000,0
2018-06-01,1657608504,A013150,어묵,매콤해물 수제어묵 오뎅 어묵탕,3100,3100,0
2018-06-01,143542672,C013020,티셔츠,a120 여성 브이넥 반팔 티셔츠 무지 면티 여름 슬림핏,14900,14900,0
2018-06-01,1783115770,L021010,손목시계,MARCJACOBS 마크제이콥스 MJ1597 여성용 가죽밴드 패션시계,299000,299000,0
2018-06-01,555997065,C013050,운동복,프론트 리어 범퍼 가드 보호대 몰딩 화이트 차량범퍼,22340,20360,-1980
2018-06-01,1525051315,A012010,국산쇠고기,횡성한우 갈비혼합세트3호 2.8kg 찜갈비세트 고기세트,350700,350700,0
2018-06-01,1207900778,E031120,믹서,퍼스트 다용도 미니믹서기세트 FM-800,23900,23900,0
2018-06-01,1216699730,A016060,감,달콤샤르르 자연그대로 만든 아이스 홍시 18개(컵)/개,30710,27640,-3070
2018-06-01,367710916,A017230,마늘,2018년 햇 양파 5kg,4700,4700,0
2018-06-01,2057989095,C013040,청바지,뱅뱅 남녀공용 테이퍼드 스판 청바지 NQE298,25720,25720,0
2018-06-01,811575336,C012040,여자학생복,[크로커다일레이디] 로고 플레이 번아웃 소재의 집업 가디건 CL7M TS218,49700,46230,-3470
2018-06-01,1488262093,C014010,아동복,[블루독] 린넨6부배기팬츠 (27425-411-02),43000,35260,-7740
2018-06-01,1066513705,A012010,국산쇠고기,축협 1등급 한우 갈비선물세트 3.2kg 한우갈비 찜갈비,260000,257400,-2600
2018-06-01,2001496993,C012020,원피스,김발(속대 에브리홈)X2,2290,2290,0
2018-06-01,1933356173,E021010,침구,[천사몽] 여름 홑요커버 침구세트 요커버+베개+이불+솜 세트,29800,29800,0
2018-06-01,1806828023,C013010,점퍼,[흄] [흄]fhmecuv701p유니) 나일론100 코치자켓형점퍼,69900,19900,-50000
2018-06-01,1366924300,I011030,사진기,정품 소니 A6000+16-50 새상품 색상보유 명품마을,596010,596010,0
2018-06-01,875644898,E021010,침구,11st X 아르페지오 봄신상 차렵이불/베개/패드 모음,24900,22910,-1990
2018-06-01,1039685490,A019060,된장,[고스락] 유기농된장(350g),9100,9100,0
2018-06-01,456115320,C012030,여자상의,단배색플리츠원피스 MN1710 예쁜원피스 배색패턴원피,41550,41550,0
2018-06-01,1039685488,A019060,된장,[고스락] 유기농된장(950g),29000,29000,0
2018-06-01,1039685489,A019060,된장,[고스락] 유기농된장(500g),17000,17000,0
2018-06-01,1039685486,A019080,고추장,[고스락] 유기농발아현미고추장(500g),23000,23000,0
2018-06-01,1039685487,A019080,고추장,[고스락] 유기농발아현미고추장(350g),16000,16000,0
2018-06-01,1224629751,F012010,종이기저귀,[군] 군(GOO.N)슬림앤드라이 밴드 기저귀 대형(L) 32Px4팩,34900,34900,0
2018-06-01,259378958,E031020,가스레인지,자동 개폐 환풍기 (ESV-250GA)/ 공기정화기 욕실환풍,36500,35400,-1100
2018-06-01,2094629740,C015020,모자,군모 모자 밀리터리모자 여성모자 남성모자 빈티지,4900,4900,0
2018-06-01,2032234575,C012060,여자내의,[모다아울렛][나인스텝]무드밴딩니트미디SK슬림H라인스커트(A18SK8205그린),29000,26680,-2320
2018-06-01,2086310738,L021050,우산,일회용우의 비옷 우비 우의 레인코트 우천대비 행사용,450,450,0
2018-06-01,2119015866,A017150,버섯,[홈플러스]대상_무농약콩나물_340G,2190,2090,-100
2018-06-01,2104418741,C013010,점퍼,가죽자켓 라이더자켓 가죽점퍼 P173가죽가죽점퍼가죽,95390,95390,0
2018-06-01,479055169,I031040,생화,1+1 낚시의자 캠핑의자 간이 보조 미니의자 등산,5900,5900,0
2018-06-01,58086270,A012010,국산쇠고기,팔도 호두기름세트 2호(고품격 웰빙 선물세트)사은품,114410,114410,0
2018-06-01,1999012759,A018100,꿀,잡화꿀 (다드림 2K),30360,27030,-3330
2018-06-01,1284391867,E031020,가스레인지,(사은품) 2018년형 2구 가스렌지 GRA-806SR 에코버너,159570,150000,-9570
2018-06-01,367538499,A019110,드레싱,다빈치소스/기라델리소스/포모나소스/모닝소스/토라니,15000,15000,0
2018-06-01,274282989,F012020,생리대,고급형 면생리대 5장/사은품/순면 생리대/팬티라이너,15000,15000,0
2018-06-01,1679018747,I012060,저장장치,ROCCAT KONE PURE OWL-EYE 제이웍스 (정품) 마우스,102000,79000,-23000
2018-06-01,164579604,A016020,배,나주배 끝판왕 달콤아삭한 나주 추황배 5kg,9900,9900,0
2018-06-01,1866308022,E011070,식탁,아일랜드식탁/2~4인식탁/접이식테이블/이동식테이블,95000,89900,-5100
2018-06-01,1065551220,G011070,자전거,시애틀레이디7 18년 페밀리자전거 7단26인치,129000,129000,0
2018-06-01,459487571,C015040,장갑,프리미엄 무스탕 장갑 무스탕장갑 스마트폰터지장갑,26900,26900,0
2018-06-01,1553314961,C013050,운동복,패션요가바지 요가복 트레이닝복휘트니스복 요가바지,14900,14900,0
2018-06-01,373415679,E041030,솥,풍년/주물/업소/영업용/압력밥솥50인용/40C/세원통상,222000,222000,0
2018-06-01,315965069,C011030,남자학생복,남성남방 남자남방 체크남방 롱남방 롱셔츠 체크셔츠,42500,42500,0
2018-06-01,1266599775,C011030,남자학생복,라벨 옥스포드셔츠 BTT005 셔츠 남자셔츠(YA02004) 남,26160,26160,0
2018-06-01,911406185,A016150,아몬드,[서래푸드]캘리포니아 아몬드(500gX2팩) 무,10900,10900,0
2018-06-01,1976721144,A013130,오징어채,진미 오징어채1kg / 진명종합유통(Hanworld),57600,50690,-6910
2018-06-01,546005099,C013020,티셔츠,박스티반팔티모음/미키티/롱티/빅사이즈티/루즈핏박스,6900,6900,0
2018-06-01,2030478559,C012040,여자학생복,44~88/국산 기본 긴팔 반팔 여자 셔츠 남방,12800,12800,0
2018-06-01,1120840258,A013070,굴,[해저도시]살아있는 캐나다 활랍스터,24900,24900,0
2018-06-01,1741485888,A017090,열무,동수농원 시래기(건무청) 100g * (5봉/10봉) 자연건조,17500,17500,0
2018-06-01,829144691,A022020,두유,매일유업 매일두유 190ml 24팩 99.89 무설탕 식이섬유,11500,11500,0
2018-06-01,525800480,C013020,티셔츠,하라 HARA 여름신상입고 아동복/원피스/플라워/롱티,16900,16900,0
2018-06-01,796211883,E031130,보온매트,[기본설치비+배송비무료][대성셀틱가스보일러] S라인 콘덴싱 20 000kcal,669000,669000,0
2018-06-01,1102785286,A011130,시리얼,켄터키치킨용파우다 1kg 홈메이드 치킨 업그레이드,4300,4300,0
2018-06-01,1951355941,G022020,자동차타이어,넥센타이어 N7000 플러스 225/45R18 정품 무료배송,79200,66900,-12300
2018-06-01,1742603890,A013170,생선통조림,유동 번데기캔 130g X 48EA_1BOX 번데기통조림 맛있는,64740,64740,0
2018-06-01,2147411960,A016160,과일가공품,블루베리(건조 한끼 350g),20130,20130,0
2018-06-01,718953995,E011050,책상,e엘리트 입식 좌식 원목책상 컴퓨터책상 테이블,49000,47000,-2000
2018-06-01,1168320957,A012030,돼지고기,삼겹살 500g/목살/대패삼겹살/오겹살/보쌈 [꾼고기]m1,3900,3900,0
2018-06-01,131456307,A011160,빵,코리원/씬크러스트도우10인치12인치(15장)씬도우/피자,10000,9900,-100
2018-06-01,515664194,F012020,생리대,[1box] 순수한면 생리대 x 12팩 / 오버나이트,25900,25900,0
2018-06-01,907818692,A011120,두부,포스트 씨리얼 대용량 1100g/ 코코볼 /콘푸라이트,6900,6900,0
2018-06-01,190854055,A021010,커피,유기농 카카오닙스 카카오원두 미국 카테킨 식이섬유,16900,16900,0
2018-06-01,2079520202,D031010,주택수선재료,블라썸 접착식벽지/붙이는풀바른셀프시트지스티커벽지,31310,31310,0
2018-06-01,180310206,C013050,운동복,[3M] 3M 공업용수세미 7440 1박스/30장/수세미/다목적수세,161410,161410,0
2018-06-01,184316119,A022010,주스,KT푸드 비타민나무열매가루/사차인치/바오밥/풋사과,12800,12800,0
2018-06-01,485173371,A016090,참외,[하루특가]아삭달콤한 성주꿀참외5kg,7500,7500,0
2018-06-01,840474338,C015020,모자,미키/마블디즈니정품/아이언맨/심슨/캡틴/볼캡/스냅백,16800,16800,0
2018-06-01,1939821826,A018040,아이스크림,해태 아이스크림 탱크보이 누가바 폴라포 6개 특가,4900,4900,0
2018-06-01,1691035948,E061010,세탁세제,뉴페트라 미니제품 3종 핸들형 3종선물세트350mlx3ea,36000,36000,0
2018-06-01,954940205,A019050,간장,샘표 진간장 금S(1800ML),8950,5490,-3460
2018-06-01,954940204,L012030,칫솔,[애경]애경 2080 딥터치 칫솔(3입+3입),6990,6990,0
2018-06-01,1348350050,A011040,보리쌀,17년산 강원도 백태2kg/메주콩/흰콩/왕태,14500,14500,0
2018-06-01,725932198,A017230,마늘,2018년 국산 합천 양파 - 특가 - 10kg/5kg,5900,5900,0
2018-06-01,899436874,L012070,바디워시,아모레 해피바스내츄럴순한바디워시 500ML,9990,3490,-6500
2018-06-01,1433439305,A011090,국수,오뚜기 진라면대컵 12개/육개장사발면/신라면/불닭,9890,9890,0
2018-06-01,176254800,E031130,보온매트,EMF 삼원온스파 양모항균 전기매트(반스)/전자파차단/사이즈선택,74000,74000,0
2018-06-01,899436873,L012070,바디워시,아모레 해피바스내츄럴촉촉바디워시 500ML,9990,3490,-6500
2018-06-01,176254801,E031130,보온매트,EMF 삼원온스파 양모항균 전기매트(로엠)/전자파차단/사이즈선택,74000,74000,0
2018-06-01,456396717,C013050,운동복,차량용 도어가드 12p/문콕방지가드 자동차 도어가드,3310,3220,-90
2018-06-01,200016008,E061060,살충제,달팽이킬러 [50g]- 민달팽이제거 달팽이약 퇴치,2200,2170,-30
2018-06-01,1714462698,A019090,카레,오뚜기 카레 1kg/순한맛/약간매운맛/매운맛/카레,4700,4700,0
2018-06-01,149412956,E011030,거실장,(아이잠)해피 600 본체서랍통,118000,118000,0
2018-06-01,1328623464,C013020,티셔츠,베이직 후드티 LLTT003 여성티셔츠 후드티,23510,23040,-470
2018-06-01,149412954,E011030,거실장,(아이잠)해피 600 본체형,83000,83000,0
2018-06-01,891110858,C013020,티셔츠,긴팔티셔츠/긴팔티/티셔츠/기본티/면티/티/남자티셔츠,7900,7900,0
2018-06-01,674508119,A011160,빵,샌드위치 재료모음/토스트소스 치즈 햄 피클 포장지,8900,8900,0
2018-06-01,866350542,I011030,사진기,명품마을 소니 A7S II 정품 새상품 보호필름,2662490,2662490,0
2018-06-01,1258677111,F012030,안경,티타늄안경테/초경량티타늄안경/동글이안경/국산안경,24900,24900,0
2018-06-01,1902488749,E061020,섬유유연제,[다우니]향기지속제 데오도라이저 480g 1+1,21900,21900,0
2018-06-01,10028102,A016020,배,가정용 정품배7.5kg9~14과17900원15kg15-35과28900원,17900,17900,0
2018-06-01,1208728610,C013040,청바지,[까르뜨블랑슈]18년 여름 신상 솔리드 스판 팬츠 CMM8WP87DE-D,89000,72980,-16020
2018-06-01,525569091,C011020,남자상의,핏감좋은 남성슬랙스 정장팬츠 면바지 반바지 46종,12900,12900,0
2018-06-01,1096351483,E011060,의자,[위드퍼니처][식탁의자모음 26 800원~]목재의자/원목의자/식탁의자/카페의자/식당의자,29900,26910,-2990
2018-06-01,110528928,A013170,생선통조림,동원참치 살코기 150g 10개+요리용기 2개/추가금無,19900,19900,0
2018-06-01,205638414,C012040,여자학생복,[세인트마리]카라 랩 가디건골지니트리본벨트오피스룩데일리,40700,36630,-4070
2018-06-01,440786087,E011060,의자,[오디엔즈] 다용도 예쁜보조의자 - 화장대의자 식탁보조의자 사무용의자 간이의자 업소,35000,35000,0
2018-06-01,2122450523,C013010,점퍼,[TBJ]점퍼 여성 캐주얼 점퍼(T162JP610P),29000,23490,-5510
2018-06-01,731351659,C012020,원피스,[쉬즈미스]블루라벨 신상 핸드메이드 오버 핏 코트_SWHHCH42010,119000,95200,-23800
2018-06-01,176278820,E031130,보온매트,기능성매트 MES-2000 [전자파안심 / 황토ㆍ항균 / 전기매트(더블)],149000,149000,0
2018-06-01,731424725,E011050,책상,[리센트]케빈 집중력책상 /독서실책상,64900,64900,0
2018-06-01,1623415756,I031040,생화,버팔로 포시즌 침낭/극세사/덴보/3계절침낭/겨울침낭,25800,22080,-3720
2018-06-01,1761355524,A017250,고사리,냉동 브로콜리 1kg/냉동야채/브로컬리,3000,3000,0
2018-06-01,194442981,C013020,티셔츠,[아메리칸트위스트] Twist Tristan 터틀넥티셔츠/긴팔티/목폴라티/캐주얼티/남성티셔츠,39800,19900,-19900
2018-06-01,648788490,F011150,건강기능식품,[본사공식몰]드시모네 베이비 드롭/캡슐,38000,38000,0
2018-06-01,199446960,C013040,청바지,[게스]남성 D톤 슈퍼 스키니(MI1D1091),124740,106030,-18710
2018-06-01,545176290,C013020,티셔츠,여성 쉬폰 양면 롱 반팔셔츠 여름특가,17900,17900,0
2018-06-01,538450888,A012030,돼지고기,듀팜 친환경 암돼지 1등급이상 냉장육 부위별 500g,13500,13500,0
2018-06-01,176278818,E031130,보온매트,기능성매트(싱글) MES-1500 [9단계온도조절 / 8중안전장치 ],129000,129000,0
2018-06-01,176278819,E031130,보온매트,기능성매트(더블) MES-2500 [9단계온도조절 / 8중안전장치],139000,139000,0
2018-06-01,149412979,E011030,거실장,(아이잠)해피 800 본체형,101000,101000,0
2018-06-01,149412978,E011030,거실장,(아이잠)해피 600 본체 + 3단서랍통,145000,145000,0
2018-06-01,1017623761,C021020,구두,[루플랫] 1335743 (해외) 18SS 이티스 엔젤로 레더 러더 플랫폼 로퍼,343400,296070,-47330
2018-06-01,509355219,C012040,여자학생복,[미씨엘라]시니컬 스트라이프 린넨 가디건,48000,45600,-2400
2018-06-01,1317624630,E061010,세탁세제,비트 20kg 특가 스파크 35kg 수퍼타이 액츠 리큐 비트,18900,18900,0
2018-06-01,574846167,A012050,소시지,렉커 화이트소시지 바이스 부어스트(300g)/국산돈육/손으로만든독일전통수제햄소시지/,5300,5300,0
2018-06-01,77563833,C012060,여자내의,민트딜 캐서린 쉬폰바지 SD-6288,12660,12660,0
2018-06-01,75795858,F012030,안경,국산100여종/금테/은테/뿔테/무테/반무테/컬러메탈테,11500,11300,-200
2018-06-01,48241554,C011050,남자내의,여름바지/린넨마팬츠/9부밴딩바지/남자면바지/반바지,9800,9800,0
2018-06-01,162293138,E031010,전기밥솥,CRP-M112FD/쿠쿠/압력/10인용/음성/GH,170000,156130,-13870
2018-06-01,440352156,A013160,맛살,(냉동)태공식품 꽃맛살(2kg)X4개식품 식자재 반찬 꽃,130600,114930,-15670
2018-06-01,149412983,E011030,거실장,(아이잠)해피 600 3단서랍통 + 다리,128000,128000,0
2018-06-01,149412980,E011030,거실장,(아이잠)해피 800 본체서랍통,137000,137000,0
2018-06-01,77815608,L021020,장신구,예쁨주의 인기 데일리 피어싱/러블리/큐빅/유니크,7000,6000,-1000
2018-06-01,747475191,L021010,손목시계,CoolBoss 스포츠 손목시계/전자시계/스포츠시계/알람/,4800,4800,0
2018-06-01,1704941350,C013020,티셔츠,[레티노] 디즈니 반팔티/ 박스티/롱티/원피스,8900,8900,0
2018-06-01,535126518,C012060,여자내의,[오빵스타일]트임스커트밴딩스커트리즈 미디 니트스커트,17000,16150,-850
2018-06-01,1198554863,L012060,샴푸,려 탈모케어 자양윤모샴푸400mlx3개/함빛모/려샴푸/려,14900,14900,0
2018-06-01,448199999,C013020,티셔츠,[무료배송]레노바폴라티1 레이어드폴라티 긴팔폴라티,10890,10890,0
2018-06-01,2005249967,C012060,여자내의,[케네스레이디]엠비 스커트(EGSKHE95),26000,21320,-4680
2018-06-01,495428961,C012040,여자학생복,(더틸버리) 배색 스트라이프 니트 TI3M1KT03/ 더틸버리,39200,35280,-3920
2018-06-01,1749520640,L021010,손목시계,엠콜로 시계 전자시계 군인시계 학생시계 손목시계,9900,9800,-100
2018-06-01,457587723,C013040,청바지,남자바지 클래식 체크 핀턱 와이드 팬츠 남자팬츠 와,58910,57150,-1760
2018-06-01,1977253967,I031040,생화,국산 스티로폼아이스박스 소중대특대 레저 낚시 업소,28500,23100,-5400
2018-06-01,1658328482,E061020,섬유유연제,드라이시트 500매 빨래 의류 건조기 유연제 코스트코,15480,15480,0
2018-06-01,374845017,E011020,침대,소파형 평상형침대/일반형침대/더블침대프레임,159000,143100,-15900
2018-06-01,559813919,C013010,점퍼,동물 캐릭터 케이프 후드 망토 아기 외출복 유아 용품,56900,51210,-5690
2018-06-01,104084166,I053010,공책,플립북 애니메이션 노트 ver2 기능성노트,3500,2980,-520
2018-06-01,1313108061,A013020,명태,두레생협 대구전부침용(400g 러시아산) 부침용냉동대,28620,28620,0
2018-06-01,66645231,C021040,실내화,정품 나이키운동화 80종 파격가/당일무료배송/농구화/,89000,89000,0
2018-06-01,1403630991,L021060,유모차,NEW 2017 엘레니어 키즈슬레드S 에스 유모차 라이더,142000,142000,0
2018-06-01,2059805608,E011010,장롱,소르니드레스룸/옷장 이불장 투서랍장 거울장 틈새장,59000,59000,0
2018-06-01,1709441853,C013020,티셔츠,여름 여아원피스 아동복 유아복 반팔 티셔츠 치마,12700,12700,0
2018-06-01,1030649549,C011050,남자내의,벤티브 M~4XL 남성 반바지 7부5부트레이닝 조거 린넨,11900,11900,0
2018-06-01,624606014,F012020,생리대,3팩 묶음 위스퍼 슈퍼롱 오버나이트/좋은느낌/화이트,13400,13400,0
2018-06-01,385547860,E011040,소파,3인용 쇼파 할인+쿠션 2EA증정-체스소파/쟈스민소파,159000,149000,-10000
2018-06-01,905751770,A013020,명태,명태역거리(중)(10마리) 코다리 조림 생산자직판,20550,20550,0
2018-06-01,787676010,I011010,TV,[상품평5만]인증점 삼성커브드 UHD TV UN49MU6500FXKR,831000,719000,-112000
2018-06-01,1010403518,F011130,홍삼,[정관장] 굿베이스 홍삼담은 흑마늘 (50ml*30포),57000,43970,-13030
2018-06-01,558658973,C014010,아동복,남아 여아 상하 트레이닝 어린이집 유치원 아동복 옷,11900,11900,0
2018-06-01,323367289,C012060,여자내의,빅사이즈/제이스타일 바오드 플레어 롱스커트/ 제이스타일,45800,35270,-10530
2018-06-01,1175132898,C012060,여자내의,패션풀 BSK17544굿모닝 뒷 밴딩 테니스 스커트/ 패션풀,21400,18190,-3210
2018-06-01,89632439,C013020,티셔츠,더다다/빅사이즈/신상/롱/루즈핏/박시/원피스/데일리,9900,6900,-3000
2018-06-01,1581781843,C012030,여자상의,로즈셔링랩원피스/나시원피스/미니원피스/섹시홀복,9900,9900,0
2018-06-01,1257907307,A012010,국산쇠고기,[명절선물 Best][프리미엄 한우선물세트 5호 4.8kg] 1,450000,445500,-4500
2018-06-01,2062735855,C013020,티셔츠,[컨셉원]남성 우븐 슬릿 넥 카라 저지 티셔츠 10028501[갤러리아],29800,22950,-6850
2018-06-01,1997293721,E011020,침대,[골든잼]원목 천연생황토 싱글 돌침대(물망초)/흙침대,1397100,1355190,-41910
2018-06-01,1280393066,E011060,의자,[에몬스]베스트&신제품 메쉬/요추의자 11종 특별전,59900,59900,0
2018-06-01,550740292,A014030,치즈,아담스 프리미엄 파마산 1kg,15100,15100,0
2018-06-01,1062122671,L021010,손목시계,SEIKO ALBA 세이코알바 AH7M37X1 여성 가죽밴드 패션시계,137000,137000,0
2018-06-01,1062122672,L021010,손목시계,SEIKO ALBA 세이코알바 AH7M35X1 여성 메탈밴드 패션시계,143000,143000,0
2018-06-01,1062122673,L021010,손목시계,SEIKO ALBA 세이코알바 AH7M33X1 여성 메탈밴드 패션시계,143000,143000,0
2018-06-01,249495024,E061040,부엌용세제,레몬 주방세제 1Lx10개 트리오/퐁퐁/베이킹소다/순샘,11900,11900,0
2018-06-01,1871056912,E041050,냄비,쿡에버 라면 냄비 14/18 사이즈 선택,15900,15900,0
2018-06-01,451027454,A012060,햄및베이컨,쉐프솔루션 베이컨 1kg2개 베이컨 쉐프솔루션베이컨,70090,63090,-7000
2018-06-01,693299438,E061010,세탁세제,[흔들기만해도되는]그린잇 운동화세제+비닐세탁기,6900,6800,-100
2018-06-01,1575641830,A013070,굴,소라게발 1kg내외 게발 냉동 꽃게,16900,16900,0
2018-06-01,567769556,C014010,아동복,아동 긴팔남방/ 아동 긴팔셔츠/ 아동 체크남방/ 아동 체크셔츠/ 아동 고급체크셔츠/ 클,19800,19800,0
2018-06-01,985354124,A011170,떡,풀무원 올바른 또띠아 8인치(우유),3100,3100,0
2018-06-01,988098618,E041070,밀폐용기,초L) 스마트 스텐락 직사각 1.1L,11900,11900,0
2018-06-01,1293464576,F011150,건강기능식품,#TV홈쇼핑정품# 건강기능식품/장기능관리/장이튼튼 생 유산균 1개월/ 프로바이오틱스,29510,29510,0
2018-06-01,246537881,C011030,남자학생복,BM자수 후디 집업가디건 sj174-001 남성캐쥬얼.캐쥬얼,37750,37000,-750
2018-06-01,1327060468,E021010,침구,무독성 PE놀이방매트 잉글리쉬파크 200×180 모서리보호대/ 어린이집놀이방매트 놀이방,58700,53000,-5700
2018-06-01,1438773964,A016070,귤,[신세계몰]제주도 카라향 3kg 23-30과 (벌크),29800,29800,0
2018-06-01,985354125,A011170,떡,올바른 또띠아 통밀 (15cm  6개입),3500,3500,0
2018-06-01,1548352558,C011030,남자학생복,[제이반스][Jbans Classic] 알파와플 저지 트임베스트 조끼 (C1801-TS905_BK),26000,22100,-3900
2018-06-01,985440584,F012010,종이기저귀,하기스 물놀이 팬츠 5단계 남아용_3P,6400,6400,0
2018-06-01,709730387,A022050,탄산음료,캐나다 토닉워터 클럽소다 진저엘 250mlx30can,17600,17600,0
2018-06-01,938365397,A019180,즉석식품,사조 버팔로윙 1kg 버팔로봉 1kg/치킨너겟/치킨/안주,9800,9800,0
2018-06-01,1322718885,A011040,보리쌀,국산 서리태 1kg 약콩 쥐눈이콩 흑태 백태 팥 강낭콩,12900,12900,0
2018-06-01,2071134379,C012040,여자학생복,빅사이즈/캉캉/요루/블라우스 / 참고 캉캉요루블라우,61600,54210,-7390
2018-06-01,1037484871,A016070,귤,[제철에만난]베트남 용과 2개(개당/500g내외),13500,13040,-460
2018-06-01,1145295356,A013060,게,마른오징어 파품500g 반건조 오징어,16900,16900,0
2018-06-01,981637294,E011050,책상,대나무 좌식테이블/ 식탁/ 침대책상/ 사이드테이블,42480,42480,0
2018-06-01,1120465016,C015020,모자,야구모자 볼캡 캡모자 남성/여성/남자/여자 여름모자,9900,9900,0
2018-06-01,798980531,E031080,선풍기,[태서전기] Alpaca 석유히터 TS-757/석유히터/석유난로/석유곤로/,106500,106500,0
2018-06-01,1711743882,C015020,모자,모자/야구모자/볼캡/롱스트랩/스냅백/캡모자/군모/캡,3300,3300,0
2018-06-01,1406768417,A017180,호박,(맛나)참맛청결고추가루(국산한식)3kg/고추나라,132300,119070,-13230
2018-06-01,1495282681,A012010,국산쇠고기,무조청 1kg,30430,30430,0
2018-06-01,1207031577,A013090,전복,신일수산 싱싱한 활 생합(백합)1kg/생합구이/생합탕,9900,9900,0
2018-06-01,1648833425,C011030,남자학생복,따뜻한 방한 나시 / 남자 겨울 정장 이너,13950,13950,0
2018-06-01,1674809634,C013010,점퍼,[나이스크랍] 슬림핏 누빔항공점퍼 a181psg801 [NC중계점],299000,179400,-119600
2018-06-01,537317704,C013040,청바지,[부루앤쥬디][18년 여름] 밴딩 데님 반바지B1KD4SP001[갤러리아],24900,22410,-2490
2018-06-01,1419668003,C013050,운동복,빵꾸닥터 끈끈이 자동차 타이어 수리 공구 휠 펑크 지,3600,3400,-200
2018-06-01,791735373,A018010,초콜릿,{무배}미니초코바대용량/트윅스/자유시간핫브레이크,7400,7400,0
2018-06-01,1047847809,C012030,여자상의,디자이너 롱 빅사이즈 린넨원피스 캉캉 프릴 면,15800,15800,0
2018-06-01,830788951,C012040,여자학생복,하얀비3000원쿠폰/나시/정장롱베스트/체크/린넨롱조끼,13800,10800,-3000
2018-06-01,858780677,C012060,여자내의,트리키 린넨마통바지 SD-5546 마통바지 통팬츠 와이드,14810,13330,-1480
2018-06-01,2023231860,C013050,운동복,4기능 LED 경광봉 차량부착 가능 차량용고휘도 LED 경광봉 비상용품 멀티 안전봉 점멸,12800,12800,0
2018-06-01,300223373,F012020,생리대,순 슈퍼롱 오버나이트 10매 x5팩 +샘플4p/ 예지미인,11900,11900,0
2018-06-01,971084827,A012040,닭고기,국내산100% IQF[닭가슴살 10kg]체리부로/CSK/신선,44500,44500,0
2018-06-01,1010320747,A013110,마른오징어,초L프)건홍합살 80G/봉,6990,6990,0
2018-06-01,1948628039,C013050,운동복,L.LAMO정품 트레이닝바지/S~4XL/체육복/운독복/츄리닝,19900,19900,0
2018-06-01,1993489123,E061040,부엌용세제,순샘 베리/라임 주방세제 3L x2개/대용량세제,11900,8900,-3000
2018-06-01,296317585,C013020,티셔츠,반폴라 스튜디오 티셔츠 긴팔목폴라 남아폴라티 여아,10400,10400,0
2018-06-01,413331511,C011030,남자학생복,[제이브로스]알리 썸머 니트 가디건,30800,29260,-1540
2018-06-01,310071677,A012030,돼지고기,바베큐용으로 딱 좋은 두께_삼겹살 500g,6500,6500,0
2018-06-01,901165689,L012080,화장지,초이스L 여행용 티슈 (70매*3),1290,1290,0
2018-06-01,467782761,C012040,여자학생복,단독!전상품무료배송! 드넬&모리스커밍홈특가!,11800,11800,0
2018-06-01,1319739119,E061060,살충제,강력한 킬파프 초파리트랩 15ml 바퀴벌레약 바퀴벌레,13950,13950,0
2018-06-01,2091005329,A011090,국수,오뚜기 컵누들 6입x3종선택(총18개입) 컵라면/박스,16800,16800,0
2018-06-01,548801893,C011050,남자내의,(남자옷도매) DP-250 린넨마 ST팬츠 (S-XL) 진소라 일,32430,31460,-970
2018-06-01,1818949402,C011050,남자내의,아디다스 나이키 푸마 트레이닝 바지 트레이닝복 팬츠,39000,39000,0
2018-06-01,2105524263,C011030,남자학생복,[코디갤러리]by STCO 네이비 퓨어 소프트 린넨 셔츠1_CDSFA85TSN,16800,15960,-840
2018-06-01,340665180,C013010,점퍼,이중포인트자켓 LS1610 예쁜빅사이즈자켓 큰옷자켓 빅,65480,65480,0
2018-06-01,1367815947,A019090,카레,에스앤비 토로케루카레 1kg/업소용 일본고형카레/일본카레,11500,11500,0
2018-06-01,506071052,C012060,여자내의,[카라]KARRA 핀턱하이웨이스트린넨롱스커트_KBI6SK201A,49800,47310,-2490
2018-06-01,1288297074,E061010,세탁세제,토니네추럴 친환경 유기농 천연 가루 세제 표백제,25900,25900,0
2018-06-01,1597060148,F011130,홍삼,정관장 홍천웅 12년(70ML*30입),200000,200000,0
2018-06-01,1010320751,A013110,마른오징어,초이스엘프레시))밥새우&멸치80G/봉,4990,4990,0
2018-06-01,961610446,C011050,남자내의,[모다아울렛][리바이스][LEVIS] 501 스트레이트 레그 버튼 플라이 청반바지_빈티지블루,41500,39430,-2070
2018-06-01,1363194555,E011050,책상,자이너스 원목가구 BEST 컬렉션,27900,26900,-1000
2018-06-01,510189111,E021020,커튼,[까르데코] 작은창/긴창암막커튼+커튼끈/인테리어효과,9900,9900,0
2018-06-01,2124300026,C012040,여자학생복,수지네 빈티지 아디다스 옐로우 다운 패딩조끼 여성 S,36000,35640,-360
2018-06-01,1225351597,C015040,장갑,밍크 방울 모직 장갑 패션장갑 방울모직장갑 여성장갑,21540,21540,0
2018-06-01,290844431,C013060,등산복,1+1이벤트/여름 아웃도어팬츠/등산복바지/기능성스판,21800,19520,-2280
2018-06-01,1108401110,A011050,콩,머거본 40여가지 간식 술안주 칼몬드,1000,1000,0
2018-06-01,1806275426,A021010,커피,그린커피빈 베트남 커피 생두 원두 가루 콩 차 추출물,92900,92900,0
2018-06-01,1361198920,E011070,식탁,리안 아일랜드식탁/홈바주방가구/주방수납장/전자렌지,85000,84000,-1000
2018-06-01,561329031,C012040,여자학생복,[1위]교복셔츠/생활복/둥근카라/여자블라우스/남자셔,19600,19600,0
2018-06-01,1660018673,L012090,기초화장품,오휘 에이지 리커버리 스킨/크림/미라클/2종/4종기획,68900,67800,-1100
2018-06-01,481516706,C012040,여자학생복,[클라비스]솔리드 스퀘어필 블라우스 CVBW82517Q,39900,34720,-5180
2018-06-01,529708394,C012060,여자내의,라인이 예뻐보이는 레드체크주름치마 주름 교복치마,49840,48350,-1490
2018-06-01,1027010587,A012030,돼지고기,국내산 냉장 돼지고기 삼겹살 목살 갈비 1등급 부위별,5900,5900,0
2018-06-01,1237688731,A011130,시리얼,혼합감자맛전분(화미 1k)X20 식자재용 파우더 업소 뚜,56130,56130,0
2018-06-01,562582083,E061100,습기제거제,[소다스쿨] 제습제 물먹을래용 24개,18900,18340,-560
2018-06-01,795092580,A013030,조기,제주 해바라기 참조기 4호500g이상 x 5줄 깨끗한 해역,194400,194400,0
2018-06-01,1332922062,A012050,소시지,[진주햄 천하장사] 100개 특가 더블링 치즈 소세지,6900,6900,0
2018-06-01,334672615,A019180,즉석식품,숯불향쭈꾸미볶음 /볶음/반찬/술안주/캠핑/음식/해담,6900,6900,0
2018-06-01,1169596872,C011050,남자내의,DON 1846 린넨9부밴딩슬렉스남자바지 린넨슬랙스 남성,27320,27320,0
2018-06-01,572633546,C014020,유아복,[트윈키즈]헨리넥린넨피그셔츠 (M7MB9Y01),12900,8390,-4510
2018-06-01,983598158,F012010,종이기저귀,하기스 매직기저귀 3단계 여아용 72P,31000,22900,-8100
2018-06-01,1813268273,E011050,책상,엘리트 와이드 독서실책상 930 /LED스탠드 포함/ 이스마트,164000,145960,-18040
2018-06-01,1316311237,L021020,장신구,슈가 별 목걸이 WG 20대 기념일 30대 악세사리 주얼리,15370,15370,0
2018-06-01,983598160,F012010,종이기저귀,하기스 매직기저귀 4단계 여아용 60P,31000,22900,-8100
2018-06-01,1010320657,A016160,과일가공품,레몬(미국산)/특대,1490,1490,0
2018-06-01,895767718,A022060,혼합음료,롯데 델몬트 종합세트(180ML*12입),12500,12500,0
2018-06-01,1440735264,I012010,컴퓨터,Mac mini [MGEN2KH/A] 2.6듀얼코어 8GB 1TB,822000,780900,-41100
2018-06-01,1450424110,F011150,건강기능식품,[동화약품] 까스활 70ml 40병{황사마스크증정}소화제/까스활명수,27000,27000,0
2018-06-01,1915592003,A015020,식용유,오뚜기 프레스코 카놀라유 900ml X 20EA(Oneworld2),116000,102080,-13920
2018-06-01,895767717,A022010,주스,[롯데]롯데제주감귤180ML*12입,9600,9600,0
2018-06-01,624694505,E041050,냄비,판다 경질 편수냄비-18cm/20cm/라면냄비/경질냄비,7800,7800,0
2018-06-01,975037036,C013050,운동복,쏘렌토-미르웨이 후사경/4WD/RV용품/사각지대/후진주차/현대/기아/대우/쌍용,27000,24600,-2400
2018-06-01,1422997825,A016040,포도,[농협6번]칠레산 거봉포도 적포도 3kg,17500,17500,0
2018-06-01,2064067152,C012040,여자학생복,[30%쿠폰][비지트인뉴욕]신상원피스/린넨/블라우스外,9900,9900,0
2018-06-01,169572555,C014010,아동복,[로엠걸즈]로엠걸즈 PNC02 허리고무줄스판 5부청바지 rgtj82304c,19900,19510,-390
2018-06-01,733276792,E011020,침대,[필우드가구]퀸침대/패브릭침대/원목침대/침대프레임,169000,169000,0
2018-06-01,441895429,A015020,식용유,(그리스 직수입)아노스켈리 압착 유기농 올리브오일,29180,29180,0
2018-06-01,1846090062,L012090,기초화장품,[BLANCNATURE]블랑흔적크림/트러블흔적/블랑수분크림,40000,34900,-5100
2018-06-01,498097276,F012020,생리대,에리에르 엘리스 생리대 순수감촉 4팩+4팩,15900,15900,0
2018-06-01,985439522,A011110,당면,초L프레시)옛날방식 도토리묵 기획 320G*2,3490,3490,0
2018-06-01,889180303,E031080,선풍기,[하이마트] 스탠드형 세라믹히터 SEH-A91 [원적외선 / 무연 / 무소음 / 좌우회전],43000,43000,0
2018-06-01,889180304,E031080,선풍기,신일 전기 히터 스토브 SEH-2200CTK [이동형 손잡이 / 전도 안전스위치],30600,30600,0
2018-06-01,889180301,E031080,선풍기,[하이마트] 카본히터 SEH-900JCM [2단온도조절 / 무소음 / 저전력 / 버튼식 ],49000,49000,0
2018-06-01,889180302,E031130,보온매트,[하이마트] 폴프랭크 극세사 전기요 SEB-S130PF [더블사이즈 / 분리형 조절기],49000,49000,0
2018-06-01,895743757,A022010,주스,농심 카프리썬 아이스티 200ML,590,370,-220
2018-06-01,1383450109,E021010,침구,굿몽 국산 알러지 먼지없는 마이크로 사계절 차렵이불,36900,33950,-2950
2018-06-01,91417633,C013040,청바지,28~42 빅사이즈 남자 청바지/면바지/카고/밴딩,19800,19800,0
2018-06-01,1298154089,C012040,여자학생복,[모다아울렛][막스카라]시스루 롱 가디건 82qkc363 블랙,69000,62100,-6900
2018-06-01,895743759,A022010,주스,농심 카프리썬 오렌지 200ML,590,370,-220
2018-06-01,1241579925,I053010,공책,근영사)아이디얼 양장노트(라인_블루)박스(24개입) 미,125470,125470,0
2018-06-01,889180305,E031080,선풍기,[하이마트] 라디에이터 SHR-3015BT [ 과열방지 센서 / 이동식 / 24시간 타이머 ],99000,99000,0
2018-06-01,631195882,A017120,고구마,하루한끼 맥반석으로 구운 아이스 군고구마 450g(3-4,94400,83080,-11320
2018-06-01,889180306,E031130,보온매트,[하이마트] 전기장판 SY-171 [싱글 / PVC원단 / 2중안전장치 / 생활방수],42000,42000,0
2018-06-01,1541892068,C013040,청바지,아둘 패밀리룩 조던 민소매 메쉬 상하의 나시세트 64,15900,15900,0
2018-06-01,823404187,C013050,운동복,벤츠 엠블럼 선글라스 카드클립 홀더 거치대 악세사리,19000,16720,-2280
2018-06-01,901515800,C013010,점퍼,사파리 옷 수선 접착 테이프 패치 간절기 야상 점펴,9000,9000,0
2018-06-01,2069265448,C013020,티셔츠,베이직 후드티 LTT0033 여성티셔츠 여성후드티(YA0200,32100,28250,-3850
2018-06-01,370841357,C013010,점퍼,(냉동)양념숙성소막창2kg,131380,131380,0
2018-06-01,483969041,C013030,스웨터,밀란시아 빅사이즈 골지 단가라 폴라티 bom12-2 빅사,51710,50680,-1030
2018-06-01,2000652340,A021010,커피,[당일출고]카누 아이스100T+아이스머그/스텐텀블러,19900,19900,0
2018-06-01,1236279338,C013030,스웨터,후드집업 MJ5002_5009 후드티 후드점퍼 후드자켓 후드,56080,56080,0
2018-06-01,1903604199,E011020,침대,[안전한 베디스]SB467 스마트수납침대 서랍형침대,99000,99000,0
2018-06-01,395403509,L012090,기초화장품,뉴트로지나 딥 클렌징오일 200ml 2개,19000,19000,0
2018-06-01,423466839,C015020,모자,(컬러:사이즈 : 베이지:FREE) ACC-CAP102 베,19630,19630,0
2018-06-01,1345366037,F012020,생리대,위스퍼 리프레쉬 슈퍼롱 오버나이트 10Px1팩,3800,3800,0
2018-06-01,1483041677,I011010,TV,SHE-430P / 43인치LEDTV 무결점 LG정품패널 2년무상AS,269800,259000,-10800
2018-06-01,441871435,A015020,식용유,에버코코 엑스트라버진 코코넛오일485ml 3개,57240,57240,0
2018-06-01,1494078783,C012020,원피스,[나이스크랍] 양모&캐시미어 핸드메이드코트 n171msg402 [nc중계점],599000,299500,-299500
2018-06-01,1900306119,F011150,건강기능식품,삼성제약 까스명수GOLD 건강음료 소화제 75mlx50병,56860,39810,-17050
2018-06-01,1184422029,A018060,스낵과자,게메즈 에낙 30개입 1통 라면과자 라면땅 간식,5900,5900,0
2018-06-01,199072662,A018060,스낵과자,심심풀이 영양간식 단호박칩 카사바칩 과자12종 모음,3700,3700,0
2018-06-01,296195013,C012020,원피스,[나이스클랍]스테일 코트 (N174XSG403)(광주신세계),139000,110400,-28600
2018-06-01,150401173,A013090,전복,부경 냉동반가리비 2.1kg(210gx10),62580,62580,0
2018-06-01,1086831482,E041050,냄비,네오플램 레트로 2종 세트(22cm양수+22cm전골),90000,72900,-17100
2018-06-01,1344502741,L021020,장신구,무료배송 14K 정품 Gold 슬림큐빅스틱 반지 오하나 스,228400,228400,0
2018-06-01,989050901,A011120,두부,[정기배송]동서 포스트 고소한아몬드후레이크 620G*2개,15160,10780,-4380
2018-06-01,1696172377,C013040,청바지,갭키즈 아동 8 사이즈 스판 청바지 미사용 택제품/F02,19000,18810,-190
2018-06-01,443866292,C011020,남자상의,MT-215 신사스트라이프 싱글수트 남성정장 남자정장,49000,49000,0
2018-06-01,1027829476,C013040,청바지,[5%복수구매할인]헤이올리진 히든밴딩 데님팬츠~2XL,11900,11900,0
2018-06-01,1068354674,A022050,탄산음료,[오플]이롬 황성주 국내산100 검은콩 고칼슘 두유 [80입],40900,40900,0
2018-06-01,1916484779,E031020,가스레인지,동우환풍기 150mm/ 가정용환풍기 일반환풍기 화장실환,18500,17400,-1100
2018-06-01,898667835,C012060,여자내의,[로엠(ROEM)]비비드 컬러 3부 린넨 반바지 RMTW737GQ1,19000,19000,0
2018-06-01,497293624,E041020,컵,모던머그 3P세트/머그컵/커피잔/찻잔/도자기컵,8420,8420,0
2018-06-01,1653290638,C013020,티셔츠,후드티/후드티셔츠/반팔티/반팔티셔츠/여름티/티/후드,10000,9900,-100
2018-06-01,1499431239,L021030,가방,[엘사베로니]소가죽+스팽글 오스카 숄더백 EL700-70,29900,29900,0
2018-06-01,1681154644,C013060,등산복,[빈폴아웃도어]핑크 여성 BREEZE 싱글 재킷 (BO8339C01X),179000,141410,-37590
2018-06-01,918097837,A012040,닭고기,맛있닭 닭가슴살 BEST 37종 골라담기 특가,14900,14900,0
2018-06-01,1964713997,E041010,식기,el. 면기/우동그릇/소면기/냉면그릇/라멘/떡국/그릇,10000,9900,-100
2018-06-01,1616133803,E011020,침대,후지히노끼 편백나무 침대 선반형 2구콘센트 장착,398000,398000,0
2018-06-01,723345283,L021030,가방,XOXO BLU 바니 미니 크로스백 UKFH007 A/ 엑소엑소,45000,36900,-8100
2018-06-01,1410141619,C012060,여자내의,[atti.k] 에띠케이 워셔블 쿨 썸머 팬츠 3종,69900,61100,-8800
2018-06-01,868264920,C013010,점퍼,JPM2018 겨울신상 롱패딩 야상 항공점퍼 밀리터리자켓,50000,48000,-2000
2018-06-01,393369340,A017050,미나리,믿을수 있는 우리 농산물 양배추 반통(1/2),4570,4570,0
2018-06-01,1989951603,E061030,전구,국내산 HEB LED형광등 LG칩 삼파장FPL호환형 LED전구,11000,7590,-3410
2018-06-01,1899035691,I031040,생화,캠핑테이블/접이식테이블/캠핑의자/캠핑용품/가판대,22800,17730,-5070
2018-06-01,889180336,E031130,보온매트,[하이마트] 2인용 찜질매트 BKM-5141D [9단계 온도조절],139000,139000,0
2018-06-01,889182999,E031080,선풍기,후지카 초절전형 슬림 판넬 히터 FU-1800CH [15㎡ / 벽걸이겸용 / 리모컨 / 온도조절 5단계],109000,109000,0
2018-06-01,889180337,E031130,보온매트,[하이마트] 전자파 안심 안티 알러지 전기요 BKB-5202D [더블 / 마이크로화이바 재질],109000,109000,0
2018-06-01,889182998,E031080,선풍기,후지카 라디에이터 FU-1300R [3단계조절 / 24시간 타이머 / 이동가능],135000,135000,0
2018-06-01,889180334,E031130,보온매트,[하이마트] 미니매트 BK-M3761SM [전자파안심 / 쟈가드원단 / 전기매트(미니)],89000,89000,0
2018-06-01,1599756298,L012110,색조화장품,베리떼 더블컷 선스틱 더블이펙트 SPF50+/PA+++,8700,8700,0
2018-06-01,889180335,E031130,보온매트,[하이마트] 인테리어 러그 전기매트 BK-M4275SD [3중 안전장치 / 전자파 억제 / 15시간 타이머],149000,149000,0
2018-06-01,889180332,E031130,보온매트,[하이마트] 전자파 안심 전기요 BKB-6662Q [더블 / 과열 화재 방지 / 전자파안심],89000,89000,0
2018-06-01,1608259612,L021020,장신구,실버)Luminous 목걸이(White)20대 30대 여자 여성 예,16730,16730,0
2018-06-01,1593081852,A018010,초콜릿,초콜릿/사탕/젤리/특별기획전!!,7800,7800,0
2018-06-01,889180333,E031130,보온매트,[하이마트] 고급 전기장판 BKF-6131D [더블 / 과열방지 / 전자파안심 / 생활방수],79900,79900,0
2018-06-01,2056581074,A022010,주스,봉봉 238ML 24캔 과즙음료 캔음료 과일주스 음료수 음,25090,24340,-750
2018-06-01,2109905839,F012020,생리대,화이트 입는 오버나이트생리대 중형/대형 생리대 8px4팩/화이트오버나이트생리대/화이,39900,39900,0
2018-06-01,524559080,C013020,티셔츠,챔피온 정품 반팔티 반바지 나그랑 티셔츠,13800,13800,0
2018-06-01,2018328248,I012010,컴퓨터,특가 114만원/2018 삼성노트북9 NT900X3V-A58A/30시간,1262100,1199000,-63100
2018-06-01,889180331,E031130,보온매트,[하이마트] 기능성 황토매트 BK-M4287S 싱글 [온도조절 9단 / 타이머기능],199000,199000,0
2018-06-01,1681333271,C013060,등산복,[빈폴아웃도어]네이비 남성 에어홀릭 바람막이 (BO8339B01R),111300,87930,-23370
2018-06-01,889180338,E031130,보온매트,[하이마트] 미니전기요 BKB-5286M [ 50*170cm / 55W / 폴리에스테르재질 / 자기장 감소기능 ],59000,59000,0
2018-06-01,308515945,I012060,저장장치,YK 커세어 K68 기계식키보드 한글판 정품 청축 적축,138610,129000,-9610
2018-06-01,889180339,E031130,보온매트,[하이마트] 전자파 안심 안티 알러지 전기요 BKB-5202S [싱글 / 마이크로화이바 재질 ],99000,99000,0
2018-06-01,532949159,A018010,초콜릿,롯데 가나초콜릿 34g 15개,19680,19680,0
2018-06-01,1067958440,A018010,초콜릿,해태 자유시간 36g x 24개/초콜릿/초코바 세트 모음,14900,14900,0
2018-06-01,1346714342,A011120,두부,특대용량 시리얼 1100g~콘푸라이트/코코볼/아몬드,6900,6900,0
2018-06-01,1678093,C013050,운동복,7각 락너트 휠너트소켓/스페셜키 도난방지용 휠너트용 호일복스알 복수알(타이어 휠/7,8500,8500,0
2018-06-01,1653674175,C013040,청바지,2018 알마니아 봄여름용 4050 기본일자 스판 청바지,49800,49800,0
2018-06-01,1825701361,E021010,침구,폭풍인기 누비지오 피치스킨 차렵이불/패드,12800,12800,0
2018-06-01,582925760,C013050,운동복,여름트레이닝복팬츠/7부바지/배기/반바지/빅사이즈,8900,8900,0
2018-06-01,1730434606,A011040,보리쌀,흰강낭콩 4kg 흰강남콩 흰콩 네이비빈 화이트빈,9900,9900,0
2018-06-01,467757832,E021020,커튼,하겐 펫보이져 고양이 이동장 블루 소 고양이이동케이,42190,42190,0
2018-06-01,1213352592,F011150,건강기능식품,[베이비락] 베이비락 19종 생유산균 프로바이오틱스 어린이유산균,22690,22690,0
2018-06-01,1911536146,C012060,여자내의,기모바지/보온성/기모밴딩팬츠/신축성/여성기모일바지,16850,16850,0
2018-06-01,1806963499,G022020,자동차타이어,[타이어플러스]피렐리 피제로 올시즌+ 245/45R17,190000,153430,-36570
2018-06-01,431291571,L021020,장신구,동은쥬얼리 실버반지 은반지 포인트반지 레이어링반지,5000,5000,0
2018-06-01,366999376,C012020,원피스,체크대형숄 겨울체크 목도리 남여성목도리 겨울목도,29880,29880,0
2018-06-01,2056896583,A011170,떡,명미당 45년전통 왕호두 찹쌀떡 1호,29620,29620,0
2018-06-01,1102690411,A019080,고추장,청정원 쇠고기볶음고추장 180g(60gx3ea)x4개,15900,15900,0
2018-06-01,71426853,E011070,식탁,신제품특가 일주일간만 솔로미니홈바/식탁/렌지대,34900,31320,-3580
2018-06-01,406709493,E061030,전구,KS안전인증 /LED T5/LED형광등/T5램프/간접등/LED바,4800,4800,0
2018-06-01,1154263701,C013060,등산복,[블랙야크]여름 남성용 기능성 등산 아웃도어 팬츠[B4XS4팬츠]1(김해점),86600,71410,-15190
2018-06-01,270143855,A017080,무,아루이팜 친환경 유기농 야채 스프 수프 수 한달분6봉,46000,46000,0
2018-06-01,982466098,A017280,김,일미 열줄 김밥용 우엉(120G),2350,2350,0
2018-06-01,797595596,A019080,고추장,해찬들 수라상 약고추장(500G),5700,5700,0
2018-06-01,1074504137,F012020,생리대,예지미인 특가 순한순면/숲속이야기 증정/ 생리대 1+1,14900,14900,0
2018-06-01,2078508398,C012040,여자학생복,kk34 헨리넥st 하프버튼 데님셔츠_블루청 데님셔츠 셔,16620,16620,0
2018-06-01,1004951549,C013040,청바지,여름용 청바지/일자형 남자청바지/데님스판 국내생산,40800,37800,-3000
2018-06-01,1885076520,F012020,생리대,바디피트 오버나이트 슈퍼롱 40P+2P/생리대/한결/순면,12900,12900,0
2018-06-01,418648350,C015020,모자,(COLOR : 그레이) AF-23 브루클린 스냅백 스,12740,12740,0
2018-06-01,311949726,C011030,남자학생복,[레노마셔츠] COOL MAX 여름 반소매셔츠 31종 택1,30000,23700,-6300
2018-06-01,1899505764,C013050,운동복,에탄올워셔액/불스원프리미엄워셔액/현대모비스워셔액,2900,2650,-250
2018-06-01,844794020,C012040,여자학생복,베러댓걸 / 6612-리본고양이 간절기베스트,23500,23500,0
2018-06-01,902165963,L012060,샴푸,천연 한방샴푸/비듬/약산성/지성두피/지루성/유아샴푸,24160,24160,0
2018-06-01,438001511,C013020,티셔츠,임산부 면스판 망고캡롱나시/롱임부나시/브라런닝,9900,9900,0
2018-06-01,1098069379,C013010,점퍼,가죽/패딩점퍼/패딩무스탕/무스탕/가죽자켓/가죽점퍼,127900,127900,0
2018-06-01,1392719632,C013010,점퍼,폭스퍼 장식 후드 다운점퍼 ATJU7DZ04/ 앳코너,249500,212080,-37420
2018-06-01,1093875950,C011030,남자학생복,[루이까또즈셔츠]매니저추천 비지니스셔츠&케주얼셔츠22종,35000,28000,-7000
2018-06-01,437340392,C021010,아동화,아동화/주니어/초등/중/고등학생/런닝화/아동운동화,15800,15800,0
2018-06-01,87817772,A013030,조기,국내산 참 조기 20미 / 5미 x 4팩,11900,11900,0
2018-06-01,122030020,A015010,참기름,다인 청정들 맛기름 모음 참기름 고추기름 업소용,7700,7700,0
2018-06-01,664677583,I031070,애완동물관리비,나이키 빅 마우스 스포츠 물병 650ml(AC2342)/물통,5200,4150,-1050
2018-06-01,1286300282,A015020,식용유,청정원 포도씨유 900ml X 12EA 청정원 스페인산오일,180810,180810,0
2018-06-01,653615182,A022050,탄산음료,[롯데칠성] 트레비 (라임/레몬) 355ml x 24캔,12000,12000,0
2018-06-01,1673546561,C013010,점퍼,파타고니아 남 아동 11 12 세 거위털 구스 패딩 점퍼,45450,45450,0
2018-06-01,235695849,G011070,자전거,GIFT 2018 삼천리 26 루시아 여성용 시티 자전거,306000,306000,0
2018-06-01,1777384629,C013040,청바지,게스 [기획신상] ICE 구제 보이프렌드 YI2D9089,66300,51720,-14580
2018-06-01,552556230,L021030,가방,마크제이콥스 가방 바이커 백팩 라지 M0012700,148000,148000,0
2018-06-01,258643124,L021020,장신구,은팔찌 은발찌 기획특가모음전 925실버 순은,10900,7800,-3100
2018-06-01,1967225657,G011070,자전거,삼천리클래식 여성용자전거 베네치아22인치 7단,126500,112590,-13910
2018-06-01,1175757094,C012060,여자내의,SK1621-티라미슈 플레어 미디스커트 FREE(44~66) 플레,40720,38690,-2030
2018-06-01,1128191755,C012060,여자내의,[나인] 셋업 언발란스 페플럼 니트 스커트 (SK-2868),46090,46090,0
2018-06-01,439637138,A019100,식초,(무)오뚜기 토마토케찹1kgX12개(1박스)마요네즈 식자,77800,66130,-11670
2018-06-01,552064814,C012040,여자학생복,[나인(NAIN)](OP-3709)스트라이프 탑 스커트 니트 세트S(센텀시티점),59000,54370,-4630
2018-06-01,389468762,I011010,TV,(공식파트너)삼성 125cm UHD TV UN50MU6300FXKR,982000,799000,-183000
2018-06-01,440945999,C012040,여자학생복,[더미니][2color]마리나 니트/배색/캡소매/여름니트,42550,38950,-3600
2018-06-01,1154766039,C013010,점퍼,엄마옷 후드롤업 바람막이 사파리_MO6152/ 마담센스,38700,32900,-5800
2018-06-01,1083750010,C013020,티셔츠,[타미힐피거] 반팔 커스텀핏/슬림핏 카라티 2종 특가,39900,39900,0
2018-06-01,1545392198,L021020,장신구,실버- 홀리데이 진주 목걸이 실버 봄 세트 30대 10대,27570,27570,0
2018-06-01,294165837,C012040,여자학생복,[코코애비뉴]웬디나염로브_80504_gn,53350,48830,-4520
2018-06-01,472344647,F011150,건강기능식품,17곡 미숫가루1kg x 3봉/신선함가득/검은콩,14900,13900,-1000
2018-06-01,600540630,C021040,실내화,여성 삭스운동화 스니커즈 키높이 조깅화 런닝화 여자,24000,23700,-300
2018-06-01,2006428950,C011030,남자학생복,[지이크파렌하이트] 2017년S/S플라워포인트케주얼셔츠(FQBAD5042),99000,29000,-70000
2018-06-01,1267441523,C013020,티셔츠,아스토레 JSG-LSTW10006 골프 캐주얼 카라티셔츠(ORG),68190,68190,0
2018-06-01,176254798,E031130,보온매트,EMF 삼원온스파 양모항균 전기매트(캘빈)/전자파차단/사이즈선택,74000,74000,0
2018-06-01,176254799,E031130,보온매트,EMF 삼원온스파 양모항균 전기매트(웨이브)/전자파차단/사이즈선택,74000,74000,0
2018-06-01,1032526688,A014030,치즈,치즈(파마산 아담스 1K)/ 식자재 전문,12900,12900,0
2018-06-01,2026780222,C011020,남자상의,여름 남성 밴딩 신사바지 노턱 스판정장바지 w027,20000,19800,-200
2018-06-01,1792190125,A016030,복숭아,청정 문경/상주산 야생 개복숭아 10kg/5kg 자연산100%,24500,24500,0
2018-06-01,409126572,C013010,점퍼,가죽점퍼 레쟈점퍼 라이더자켓 PU16 WS 남성라이더점,145020,145020,0
2018-06-01,1777166289,C013020,티셔츠,모이모이깜피 오가닉 슬러브 가오리 긴팔티,5900,5900,0
2018-06-01,989074957,A019120,혼합조미료,초L 쇠고기다시 300G,3750,3750,0
2018-06-01,988001588,A019170,냉동식품,요리하다 동그랑땡 400G*2,6980,6980,0
2018-06-01,484704695,L012110,색조화장품,랑콤 UV 엑스퍼트 톤업 50ml/자외선차단제/썬크림,57900,57900,0
2018-06-01,942763701,C012060,여자내의,버드월 3버튼 기모 가죽바지 SD-5059,19100,19100,0
2018-06-01,294165829,C012040,여자학생복,아이우먼 루즈 오픈 가디건 BG2051M805 빅사이즈,46500,40950,-5550
2018-06-01,989050961,A015010,참기름,[오뚜기][정기배송]오뚜기 고소한참기름 320ML*2병,14500,14500,0
2018-06-01,1200753715,I011030,사진기,소니 A7III 바디 본체 + 상품권 3만원 증정 정품 명품,2668270,2668270,0
2018-06-01,1866878726,C013010,점퍼,아디다스 유소년 콘디보16 스타디움자켓(AN9871),137010,121940,-15070
2018-06-01,1451133009,I012010,컴퓨터,특가129만)2종사은품-삼성노트북9 NT900X5N-K58A,1466310,1393000,-73310
2018-06-01,1854470757,A021010,커피,페루산/카카오닙스/100%/카카오립스/카카오콩/씨앗,18900,18900,0
2018-06-01,279840532,I012010,컴퓨터,애플정품 16년형 New iMac MK482KH/A 5K 레티나/아이맥신형/SG,2967900,2967900,0
2018-06-01,1778587539,L021020,장신구,[바보사랑]foil pendant drop earring,33000,33000,0
2018-06-01,1842613370,C013040,청바지,{16C2_18S0467}7부스키니/ 더데이걸,9900,9510,-390
2018-06-01,1384535974,C011050,남자내의,여름 면바지 남자 남성 슬랙스 스판 밴딩 팬츠 기모,15800,15800,0
2018-06-01,1024763673,C013020,티셔츠,강력한 시원함 반목 아이스목티 쿨티셔츠 골프 목폴라,5900,5900,0
2018-06-01,1778587538,L021020,장신구,[바보사랑]rose velvet pink drop earring,34000,34000,0
2018-06-01,141204096,C012040,여자학생복,[포에버21]드레이프 후드 가디건/FOREVER21/가디건/후드 가디건,33900,10170,-23730
2018-06-01,1778587537,L021020,장신구,[바보사랑]oval hoop earring,27000,27000,0
2018-06-01,1783208218,L021010,손목시계,[공식 백화점AS가능] Diver Chic 여성시계(메탈)(Swiss made)_X35015L4S,448800,448800,0
2018-06-01,644879647,L012090,기초화장품,해피바스 솝베리 클렌징 크림 300ml x 2개/클렌징폼,11900,11900,0
2018-06-01,1778587536,L021020,장신구,[바보사랑]bold shape earring,34000,34000,0
2018-06-01,1259411466,C013020,티셔츠,아동쿨론티/20수/30수라운드/흰색면티/단체티/반티,4600,4300,-300
2018-06-01,1444370456,C013050,운동복,오토컴 랠리 튜닝 범퍼가드 2개한셋트 자동차 범퍼보호대 리어범퍼 도어가드 알루미늄,3500,2760,-740
2018-06-01,985474029,A019060,된장,샘표 토장 900G,9990,6490,-3500
2018-06-01,886862991,A011170,떡,현미떡국떡600g 유기농현미로 재래식으로 만듬,6000,6000,0
2018-06-01,1047241037,I031010,장난감,(물놀이용) 네오프랜 라켓세트 라켓2개+소프트볼2개,10900,10900,0
2018-06-01,234101050,C013020,티셔츠,MNC 긴팔티/면티/무지/라운드/단가라/남자/여자/커플,11000,9900,-1100
2018-06-01,895767784,A022010,주스,[롯데]롯데 델몬트 프리미엄 오렌지(병/180ML*12입),13200,13200,0
2018-06-01,985474028,A019060,된장,샘표 백일 된장_900G,8900,8900,0
2018-06-01,209863698,I031070,애완동물관리비,232g 풀카본 헤드 Ti.S6 테니스라켓/용품/테니스화/공,139000,137610,-1390
2018-06-01,1333212861,A017150,버섯,들기름(B급들깨 정도 1.8K)X12,116530,116530,0
2018-06-01,989074929,A017300,미역,초이스엘프레시))구운김밥김10매,1990,1990,0
2018-06-01,385679723,C012020,원피스,히든 밴딩 사부 팬츠 RIN0364RM805 빅사이즈,51290,48220,-3070
2018-06-01,418600330,E061020,섬유유연제,샤프란 꽃담초 섬유유연제 리필 1.3L x 4개 외,13900,13900,0
2018-06-01,1783208213,L021010,손목시계,[공식 백화점AS가능] Gc LadyChic 여성시계(메탈)_Y07002L1,287300,287300,0
2018-06-01,1969404815,C014010,아동복,블랙야크키즈 경량 구스 다운자켓 BK로컬다운자켓,65190,65190,0
2018-06-01,1783208212,L021010,손목시계,[공식 백화점AS가능] Gc LadyChic 여성시계(메탈)_Y07004L1,338300,338300,0
2018-06-01,1783208211,L021010,손목시계,[공식 백화점AS가능] Gc LadyChic 여성시계(가죽)_Y10002L1,295800,295800,0
2018-06-01,989050992,A013170,생선통조림,샘표 바로바로요리하는우렁이 140G,3990,3990,0
2018-06-01,1783208210,L021010,손목시계,[공식 백화점AS가능] Gc LadyChic 여성시계(가죽)_Y11001L1,270300,270300,0
2018-06-01,1783208217,L021010,손목시계,[공식 백화점AS가능] Gc ClassicChic 여성시계(메탈)(Swiss made)_X98003L1S,414800,414800,0
2018-06-01,868781392,A013130,오징어채,정화 맥반석 진미오징어 ( 채 ) 30g x 5,21580,19210,-2370
2018-06-01,1783208216,L021010,손목시계,[공식 백화점AS가능] Gc LadyChic 여성시계(가죽)_Y05011M3,414800,414800,0
2018-06-01,2038319073,C012030,여자상의,로로텐 롱/미니/쉬폰/레이스 원피스/빅사이즈,26900,26900,0
2018-06-01,1783208215,L021010,손목시계,[공식 백화점AS가능] Gc LadyChic 여성시계(메탈)_Y06003L1,363800,363800,0
2018-06-01,1783208214,L021010,손목시계,[공식 백화점AS가능] Gc LadyChic 여성시계(메탈)_Y06009L7,389300,389300,0
2018-06-01,989050995,A013170,생선통조림,[동원][정기배송]동원 꽁치400G*2캔*2묶음,11980,11980,0
2018-06-01,1569971877,A011090,국수,라면 70종 최다구성 신라면 진라면 삼양라면 봉지,2700,2590,-110
2018-06-01,1175289623,C013050,운동복,현대가 만든 프리미엄 친환경 에탄올 워셔액 1개입,3300,3160,-140
2018-06-01,1778587545,L021020,장신구,[바보사랑]flower crystal hook earring,27000,27000,0
2018-06-01,1778587544,L021020,장신구,[바보사랑]crystal pearl hook earring,23000,23000,0
2018-06-01,1778587543,L021020,장신구,[바보사랑]crystal ball circle earring,18000,18000,0
2018-06-01,1778587542,L021020,장신구,[바보사랑]circle small crystal earring,26000,26000,0
2018-06-01,1778587541,L021020,장신구,[바보사랑]beige crystal blossom earring,25000,25000,0
2018-06-01,2023774845,C012030,여자상의,로드#로즐리 스토어15%+원피스외 신상,19600,19600,0
2018-06-01,1778587540,L021020,장신구,[바보사랑]brown texture oval earring,31000,31000,0
2018-06-01,575462726,C013040,청바지,[끌리네]끌리네 히든밴딩 페이스 슬림핏 일자 청바지,22900,21760,-1140
2018-06-01,1806300954,L021020,장신구,[바보사랑]코인 더블 초커 목걸이 (2colors),10000,10000,0
2018-06-01,889180367,E031130,보온매트,클라우드 전기요 MFB203 [싱글 / 화재 방진 열선 / 전자파 차단 / 면혼방],69000,69000,0
2018-06-01,1806300952,L021020,장신구,[바보사랑]화려한 십자가귀걸이 (화이트),9520,9520,0
2018-06-01,1806300953,L021020,장신구,[바보사랑]타원형 엔틱 큐빅귀걸이,10320,10320,0
2018-06-01,93836508,A011010,쌀,2017년 햅쌀[지리산메뚜기쌀]20Kg/백미/현미,46900,46900,0
2018-06-01,889180365,E031130,보온매트,[하이마트] 전기매트 MES-S900 (싱글) [황토금사매트 / EMI 인증 / 9단계온도조절기능],89000,89000,0
2018-06-01,467564438,C012040,여자학생복,이프네 청스모크블라우스 DI4WBL36,34000,34000,0
2018-06-01,889180366,E031130,보온매트,[하이마트] 클라우드 전기요 MFB303 [더블 / 화재 방진 열선 / 전자파 차단 / 면혼방],75000,75000,0
2018-06-01,1772005802,C013010,점퍼,[비키]더블 포켓 사파리 자켓 (TMJAD2140)_R4M7,29900,28410,-1490
2018-06-01,889180363,E031080,선풍기,[하이마트] 전기 라디에이터 MO-15T [자연대류형 난방 ],99000,99000,0
2018-06-01,889180364,E031130,보온매트,[하이마트] 전기매트 MES-D900 (더블) [황토금사매트 / EMI 인증 / 9단계온도조절기능],99000,99000,0
2018-06-01,2104418677,C013010,점퍼,가죽자켓 라이더자켓 가죽점퍼 P171가죽가죽점퍼가죽,95390,95390,0
2018-06-01,795004044,A013030,조기,제주 해바라기 참조기 6호700g이상 x 5줄 깨끗한 해역,182300,182300,0
2018-06-01,1122835027,E011030,거실장,메탈 화분선반 2단,34900,34900,0
2018-06-01,899461766,A014040,발효유,푸르밀 비타요구르트 65ML*15입,1470,1470,0
2018-06-01,364870647,C012040,여자학생복,[앤드스타일]카이아 발레리나 시스루 가디건_236056,21900,20810,-1090
2018-06-01,1122835026,E011030,거실장,메탈 화분선반 3단,44900,44900,0
2018-06-01,989074932,A017300,미역,초이스엘프레시))간장쌈 구운파래김15매,2990,2990,0
2018-06-01,1943976833,L012040,치약,[Dr.Whitiss]치아미백 닥터 화이티스 4주분 (1세트),29800,29300,-500
2018-06-01,519673635,A013070,굴,캐나다산 프리미엄 활랍스터 1kg 2kg 2.3kg 캠핑 모임,56800,54800,-2000
2018-06-01,1010138347,E041040,프라이팬,자이글심플(블랙),149000,149000,0
2018-06-01,12136931,I031040,생화,GERBER /거버 오리지널 인증 홀로씰 부착/멀티툴/맥가이버칼/다용도칼/주머니칼/도끼/,34900,34900,0
2018-06-01,1010165931,A022030,생수,아워홈 지리산수 500ML,360,300,-60
2018-06-01,437315337,C013020,티셔츠,브이넥트임티(RMD_1606) 빅사이즈티셔츠 큰티 여성브,15700,15700,0
2018-06-01,1010165930,A022030,생수,아워홈 지리산수 2L,860,600,-260
2018-06-01,1280442457,L012090,기초화장품,설화수 자음수 125ml / 설화수 자음유액 125ml 택1,39950,39950,0
2018-06-01,947466929,C013010,점퍼,[폴햄키즈] 후드 집업(PKY2TC1010),17400,15660,-1740
2018-06-01,750887497,C012060,여자내의,푸조 여성 워테레깅스 ( S26-1 ),28540,26550,-1990
2018-06-01,1424858070,I011010,TV,(전국무료배송) LG 슈퍼울트라HDTV 65UJ7250 TV UHD,1978120,1899000,-79120
2018-06-01,347682790,C013050,운동복,미국 존슨 타이어 펑크복구제 응급 펑크액 실펑크,4600,4600,0
2018-06-01,1373354979,C013020,티셔츠,[필골드] MD789 기획모티브 기모 폴라 티셔츠,22800,22800,0
2018-06-01,474653175,A011110,당면,시골다람쥐동부묵2kgX2개(BOX),14700,14700,0
2018-06-01,399203182,C013020,티셔츠,콜핑 기능성 긴팔티셔츠 17종 균일가전,16900,16900,0
2018-06-01,1305937456,C013010,점퍼,야상 YSM01 WS야상바람막이점퍼남자 바람막이남성 바,109520,109520,0
2018-06-01,847767930,A011130,시리얼,오뚜기 부침가루 1kg X 10EA 찹쌀부침가루 찹쌀부침분,33370,33370,0
2018-06-01,21149018,C012040,여자학생복,[다니엘 에스떼]DANIEL HECHTER 다니엘에스떼 밀라노립 코튼 니트 3종 + 스카프 S,39000,35100,-3900
2018-06-01,984464271,A021010,커피,[동서]동서 카누 미니 마일드 30T*3입+1입,18150,18150,0
2018-06-01,246356554,C012060,여자내의,버드월 3버튼 기모 가죽바지 SD-5059 기모가죽바지 래더팬츠 가죽바지 가죽반바지 가죽,25360,22580,-2780
2018-06-01,306168662,C013020,티셔츠,[앨빈클로]양털 후드집업/패딩점퍼/커플후드티/기모,32900,24900,-8000
2018-06-01,895743783,A022010,주스,농심 카프리썬 오렌지망고 200ML,590,370,-220
2018-06-01,14133860,G011070,자전거,자전거 백팩/블루투스 스피커/방향등/후미등/안전용품,177900,177900,0
2018-06-01,892734437,F012020,생리대,엘리스 순수감촉 4팩/메가미/고쿠수이/생리대,7900,7900,0
2018-06-01,1068293044,L021010,손목시계,Paop-u 스포츠시계 (색상선택) 패션시계 시계 스포츠,12350,12350,0
2018-06-01,629938244,A018080,설탕,백설 하얀설탕 15kg/CJ설탕/갈색설탕/흰설탕/큐원,12000,12000,0
2018-06-01,1387289757,C013040,청바지,똥글이 여름신상 19호까지 아동복 바지 청바지 반바지,21600,21600,0
2018-06-01,1316071321,I011010,TV,SHE-400B / 40인치LEDTV / 100%무결점 패널2년무상AS,238550,229000,-9550
2018-06-01,1204829117,A017180,호박,국내 청피망(상) 10kg 두리반농산,21000,21000,0
2018-06-01,503605493,L021010,손목시계,남성 포스트 모더니즘 손목 시계 패션아이템 캐주얼손,68500,68500,0
2018-06-01,176278796,E031130,보온매트,기능성매트 MES-1000 [전자파안심 / 황토ㆍ항균 / 전기매트(싱글)],139000,139000,0
2018-06-01,1778587569,L021020,장신구,[바보사랑]beige half moon earring,24000,24000,0
2018-06-01,1735091806,A013080,조개,왕중왕 해물나라 900g2개 해물나라 해물모듬 냉동식품,32570,30300,-2270
2018-06-01,984961909,C011050,남자내의,[필골드] CHP04 기모디자인 클라이밍팬츠,29800,29800,0
2018-06-01,1778587568,L021020,장신구,[바보사랑]beige crystal ball earring,19000,19000,0
2018-06-01,1949447398,A017110,감자,[초특가] 싱싱한 세척당근 5kg 10kg 선택구매,9900,9500,-400
2018-06-01,1778587567,L021020,장신구,[바보사랑]half moon small crystal earring,29000,29000,0
2018-06-01,1297917809,C011030,남자학생복,MCD-905 믹스매치 컬러배색 브이넥 가디건 브이넥가디,23670,23670,0
2018-06-01,625777750,C013040,청바지,레깅스 투버튼 벨트 기모 가죽 치마레깅스 레깅스 치,46070,46070,0
2018-06-01,1444827544,I031070,애완동물관리비,[슬레진저] 연습용 엑소더스 테니스라켓 레슨용 교재용 학과수업,21000,20790,-210
2018-06-01,895743782,A022010,주스,농심 카프리썬 오렌지망고 200ML*10입,5900,3700,-2200
2018-06-01,1983535249,E031120,믹서,필립스 미니 믹서기 핸드블렌더 6종 HR2874/HR2860,59900,59900,0
2018-06-01,853219622,E041050,냄비,러브쿡 경질냄비/업소/식당/가정/전골/양수/유리뚜껑,6900,6900,0
2018-06-01,1305937425,C015040,장갑,커피색 북극곰 장갑 털장갑 귀여운장갑 북극곰끈장갑,16390,16390,0
2018-06-01,1318840523,A019020,참깨,해정원 검정깨 1kg 깨 식자재 가공식품 식품 볶음깨,25580,25580,0
2018-06-01,1195714578,C021040,실내화,[컨버스] 기본코어 척테일러 컨버스로우 M9166C,42900,42900,0
2018-06-01,571744799,C011020,남자상의,레드 체크 밍크털 코트 캐쥬얼코트 남성용코트 남자코,114550,114550,0
2018-06-01,2100605660,C012040,여자학생복,카라넥 아웃 포켓 모던 베스트 (SF8XVT104)/ 스테파넬,45000,38250,-6750
2018-06-01,487447512,C014020,유아복,[아가방] 로니상하 01K353093 NC아울렛,15000,10500,-4500
2018-06-01,572439313,C013050,운동복,[마운틴리서치] 에어 크로스 웜팬츠/아동 주니어 트레이닝팬츠,7900,7900,0
2018-06-01,986218096,A016050,밤,청도 아이스홍시(100g*24개/미탈피),22000,13900,-8100
2018-06-01,895767748,A022010,주스,롯데 콜드오렌지 950ML,2630,2630,0
2018-06-01,862414114,A022010,주스,식자재 양념 음료 차 음료 파낙스 매실 1.5L 1BOX 8EA,82000,81180,-820
2018-06-01,895767746,A022010,주스,롯데 콜드오렌지 1.89L,4300,4300,0
2018-06-01,1414308,C013040,청바지,제이로드 명품급1 라이더 카고 남자청바지 밴딩 빅사,36900,36900,0
2018-06-01,544154216,C012060,여자내의,[플라스틱아일랜드][18여름]슬림일자팬츠(PJ2DP482)[갤러리아],69000,55200,-13800
2018-06-01,51856696,A019110,드레싱,● ♣ 오뚜기 햄샌드위치 스프레드(245G),2000,2000,0
2018-06-01,859246382,A011010,쌀,17년산 갓밥분도쌀 10kg/쌀/하이아미/고시히카리,28500,28500,0
2018-06-01,1778587576,L021020,장신구,[바보사랑]white crystal blossom earring,25000,25000,0
2018-06-01,133105724,C014010,아동복,멋쟁이세상 남아정장 코디세트 아동턱시도 결혼식화동,39800,39800,0
2018-06-01,1778587575,L021020,장신구,[바보사랑]pink half moon earring,24000,24000,0
2018-06-01,1778587574,L021020,장신구,[바보사랑]peach pink crystal blossom earring,25000,25000,0
2018-06-01,1778587573,L021020,장신구,[바보사랑]peach moonstone line earring,31000,31000,0
2018-06-01,258704596,C013010,점퍼,후드티/후드집업/맨투맨/점퍼/커플티/단체티/빅사이즈,18900,18900,0
2018-06-01,1778587572,L021020,장신구,[바보사랑]lemon quartz line earring,28000,28000,0
2018-06-01,1778587571,L021020,장신구,[바보사랑]lemon quartz ball earring,26000,26000,0
2018-06-01,1778587570,L021020,장신구,[바보사랑]hexagon objet nacre earring,30000,30000,0
2018-06-01,318952914,A011040,보리쌀,2017년산 국내산 햇 백태 2kg 메주콩/청국장/두유,12300,12300,0
2018-06-01,2055052441,E011070,식탁,아일랜드식탁 홈바 렌지대 광파오븐 인조대리석 수납,269000,242100,-26900
2018-06-01,1890482065,I031010,장난감,(둥근 지붕차) 햇빛차단 자동차 선물 유아 안전 승용,187020,187020,0
2018-06-01,2115924256,E061030,전구,국산 FPL LED형광등 LED전구 36W 55W 대체형 조명,9990,7650,-2340
2018-06-01,1014927111,C012030,여자상의,미나비 홀복 섹시원피스 파티복 드레스 클럽의상 미니,35800,35800,0
2018-06-01,1258738724,I012010,컴퓨터,[가온씨앤씨] 2015 NEW iMac 5K 디스플레이 MK472KH/A 27형 6세대 코어i5/8GB램/1TB퓨,2670000,2670000,0
2018-06-01,1618706453,L021020,장신구,실버/은/팔찌/발찌/악세사리모음/은팔찌/은발찌세트,19900,19900,0
2018-06-01,895682126,A012040,닭고기,냉동 닭가슴살 600g이상/봉(점포마다 브랜드가 상이할수 있습니다),29980,6980,-23000
2018-06-01,895682125,A012040,닭고기,하림 냉동 닭다리 800g이상/봉,7980,7980,0
2018-06-01,1180804610,C013050,운동복,43_고구마베이비 아기옷-무형광 카스 자카드 민소매,10910,10590,-320
2018-06-01,14663364,E041050,냄비,[TV홈쇼핑]에코라믹 통주물 스톤 냄비세트3+3사은품,59900,59900,0
2018-06-01,984307535,A013130,오징어채,문경새재 황태채 150G/봉,7990,5990,-2000
2018-06-01,433153103,C013050,운동복,차량 도어가드세트4P 자동차 문콕방지 범퍼가드,3990,3680,-310
2018-06-01,1195051512,C012060,여자내의,[로로텐]카딜리 구제데님,32700,31410,-1290
2018-06-01,604001380,I031040,생화,폴스타 2인용 캠핑의자 / 롱릴렉스체어 /벤치체어,19800,19800,0
2018-06-01,1344454807,A017010,배추,[Organicgarden] 양배추 야채수 즙 위양배추 엑기스 쥬스속쓰림 위보호,25900,25900,0
2018-06-01,187179125,A021010,커피,맥심병커피 8종/모카골드/오리지날/아라비카,5700,5700,0
2018-06-01,227181062,C013010,점퍼,[2001 OUTLET]LANZI (란찌) 런던 스트라이프 셔츠 (LAYS18AS2),19900,19310,-590
2018-06-01,415473636,F012050,의료측정기,VT 케어센스 혈당시험지 50매 /당뇨측정지/검사지,13970,13000,-970
2018-06-01,1399612459,C013050,운동복,4P 차량용 도어가드/ 도어가드 자동차도어가드 자동차,4300,3200,-1100
2018-06-01,1536266018,C012040,여자학생복,[무배] 심플 데일리 롱베스트 롱조끼 [지센]/ 아티젠,33800,27380,-6420
2018-06-01,1949832004,I031010,장난감,레고호환 쥬라기 월드 공룡 모음 티라노 랩터 듀랑고,28000,28000,0
2018-06-01,1230759902,A015020,식용유,카놀라유 라이트 (백설 0.9L) X12,124000,110360,-13640
2018-06-01,1749410221,I031040,생화,REDUX 생존팔찌/나침반/나이프/호각/파이어스틱,9700,8930,-770
2018-06-01,419720707,C011030,남자학생복,일반핏 반팔 줄지 와이셔츠 IS-1073,17900,17900,0
2018-06-01,1217372755,C014010,아동복,한국생산 블랙 스트라이프 5종세트(3-24개월)203536,64100,62180,-1920
2018-06-01,1507105946,C013050,운동복,한글 CAREUD U903CW-i TPMS (외장형 미니센서),132000,132000,0
2018-06-01,1160945778,C012060,여자내의,[탑걸] (TIZ4PT724F) 마 소재 여름 와이드팬츠,39000,31980,-7020
2018-06-01,1823837479,L021020,장신구,곡선라인반지/14K핑크골드/큐빅/OPR819,237000,237000,0
2018-06-01,1941641741,C014010,아동복,넥프릴블라우스/여아/주니어/유아 긴팔블라우스,9900,9900,0
2018-06-01,1778587599,L021020,장신구,[바보사랑]silver circle clutch pearl earring,26000,26000,0
2018-06-01,1899615944,C013020,티셔츠,[필골드] DB005 맨투맨 배색 목폴라 티셔츠,25800,25800,0
2018-06-01,1778587598,L021020,장신구,[바보사랑][액세서리키친] 925실버 별자리+운석 팔찌,25900,25900,0
2018-06-01,1238096458,A013150,어묵,(냉장)풍조 부산어묵(손중)2.8kgx6개,94330,94330,0
2018-06-01,975678455,A018100,꿀,꿀판매1위[가야농산 국내산 벌꿀2kg]꿀 사양꿀,13300,13300,0
2018-06-01,1049035769,C013010,점퍼,안감양털 박시 오버사이즈 코트 DM-4043-이쁜코트 오,75020,66770,-8250
2018-06-01,988243846,A016100,수박,리얼허니)고당도수박6호,15900,15900,0
2018-06-01,107055031,A017040,양배추,(면)(냉동)청학 부추1kg,4820,4820,0
2018-06-01,337808186,C011030,남자학생복,2018 COOL SUMMER반소매 일반핏&슬림핏 30종 모음전/ 예작(셔츠),30000,25500,-4500
2018-06-01,321900110,C012040,여자학생복,DCR1729 달콤 체크 남방 804S 남방 여성남방 패션셔츠,46610,46610,0
2018-06-01,1348929703,A012060,햄및베이컨,[동원]리챔120gx10캔or리챔200gx7캔+식탁김8봉증정,17600,17600,0
2018-06-01,2105029264,A013070,굴,해물탕700g알탕700g외 탕15종,5900,5900,0
2018-06-01,990090921,A011010,쌀,[서천군농협]청풍명월쌀20kg,57000,54300,-2700
2018-06-01,1178935754,C012030,여자상의,[쉬블림로브] 북유럽풍 빅사이즈 루즈핏 롱원피스~,7900,7900,0
2018-06-01,1471464461,A019180,즉석식품,대림선 약속 부산종합어묵 1kg/선종합/오뎅/오뎅국,4800,4800,0
2018-06-01,641221874,E031070,에어컨,((너무~시원해/COOL~!!))신일/보국/홍진/유파~선풍기,39900,33900,-6000
2018-06-01,1010403490,F011150,건강기능식품,[정관장] 굿베이스 홍삼담은 블루베리 (50ml*30포),59000,42610,-16390
2018-06-01,1314652454,C012040,여자학생복,조스라운지 팝콘 순면 긴팔 원피스 여성 잠옷 홈웨어,41170,39120,-2050
2018-06-01,28672741,E061020,섬유유연제,[출시특가!] 피죤 건조기 섬유유연제 시트 40매x2개,9900,9900,0
2018-06-01,355154374,C021040,실내화,[MNX15] 5~10센티 UP 국산 남여공용/커플키높이운동화,36900,36900,0
2018-06-01,1023256319,C012030,여자상의,애프리콧 봄신상~! 니트/가디건/원피스/조끼,11900,8900,-3000
2018-06-01,826258846,A012010,국산쇠고기,[무항생제 한우선물세트] 한우 명절 2호 2kg,149200,149200,0
2018-06-01,2059480204,C013020,티셔츠,반폴라 스튜디오 티셔츠 어린이목폴라티 긴팔목폴라,10500,10290,-210
2018-06-01,1526433080,E031010,전기밥솥,당일출고 CRP-JHR1020FD/쿠쿠/IH압력/10인용/음성/GH,477000,424180,-52820
2018-06-01,1111354379,F012020,생리대,위스퍼 리프레쉬 케어 소형 18p 생리대 1입 리플레쉬,3690,3690,0
2018-06-01,555262097,L012110,색조화장품,5%추가쿠폰! 닥터지선크림/선스틱/필링젤 외~40%,12600,12600,0
2018-06-01,1608260478,L021020,장신구,실버)라운드 플랫 체인 목걸이 20대 30대 여친선물 추,23950,23950,0
2018-06-01,990090918,A011010,쌀,[동철원농협]철원오대쌀20kg,67000,64500,-2500
2018-06-01,990090919,A011010,쌀,[동철원농협]철원오대쌀10kg,37000,32500,-4500
2018-06-01,1583438485,G011070,자전거,[시애틀레이디7+무료조립배송] 삼천리 여성용 7단,159000,143100,-15900
2018-06-01,600975917,L021010,손목시계,패션시계/스포츠시계/알람시계/전자시계/군용시계/xj1,6000,6000,0
2018-06-01,632927503,A012010,국산쇠고기,(목우촌 선물세트)제주생고기 돔베팸 2호 고급 쇼핑백,83700,73660,-10040
2018-06-01,723707793,A022020,두유,삼육 고소A 달콤B 950ml 12팩/190ml 48팩/본사배송,19900,19900,0
2018-06-01,1900416458,A011130,시리얼,오뚜기 부침가루 1kg X 10EA 찹쌀부침가루 부침분말가,33720,33720,0
2018-06-01,1274977506,E061080,키친타월,깨끗한나라 아낌이 키친타올 130매x4+2롤x4팩,12000,12000,0
2018-06-01,504652145,C012040,여자학생복,[모다아울렛][반에이크]반에이크 뒷목셔링블라우스 VA86BLM204Z-PU,39800,36220,-3580
2018-06-01,253146934,C013040,청바지,[플레이팝][플레이팝]블루 스트링밴딩데님팬츠 4219,13900,12790,-1110
2018-06-01,222490008,C012040,여자학생복,무료배송 170244C_고급스런 볼레로/미니 가디건,14000,12900,-1100
2018-06-01,987049293,F012020,생리대,[P&G]위스퍼 리프레쉬 울트라 날개 대형_32P,9300,9300,0
2018-06-01,1930832240,F012010,종이기저귀,군기저귀 팬티형 여아 XL 3팩 / XXL 3팩 (+수영장 3P),43900,43900,0
2018-06-01,370287678,C013010,점퍼,[모다아울렛][레코브]양피라이더자켓(LZ2183JK001X),238400,219330,-19070
2018-06-01,1351436702,E021020,커튼,암막커튼1+1/화이트사암막/DTP/북유럽풍/가,8500,8500,0
2018-06-01,896550930,A018060,스낵과자,크라운 빅파이 딸기 324G,3990,3990,0
2018-06-01,1098853137,C013020,티셔츠,섹시블링~ 스팽글 나시티 콜렉션 클럽의상 방송댄스복,25800,25800,0
2018-06-01,1644828848,A019140,이유식,(10+1) 후기 이유식 24종/ 팜투베이비,3990,3800,-190
2018-06-01,154866207,E031020,가스레인지,(사은품) SK매직 GRA-C2100R 2구렌지+그릴/블랙색상,275000,258000,-17000
2018-06-01,324791882,C013040,청바지,{17G2_18S0005}스키니데님/ 행텐주니어,5000,4700,-300
2018-06-01,1198889078,L021020,장신구,실버 은팔찌 모음/정품925실버팔찌 12900원부터,12900,12900,0
2018-06-01,424584163,A013140,북어채,진부령 황태포 10미(소/중/대/특) 황태/황태채/명태,25000,25000,0
2018-06-01,2127383724,A013100,마른멸치,살아서도착 완도 전복 활전복 특대전복 전복회,2500,2400,-100
2018-06-01,1553300408,C012020,원피스,[베네통] 베네통 심플 가벼운 백팩BCBGA3811[NC중계점],131400,131400,0
2018-06-01,988243876,E061100,습기제거제,암앤해머 프리즈앤프리저 (탈취제) 396.8G,3000,3000,0
2018-06-01,489515408,C013020,티셔츠,[탐나나]크러스꼬임 크롭티셔츠/ 탐나나,14400,14400,0
2018-06-01,416979963,E011050,책상,ET101-S 전동식 높이 조절 워크스테이션 높이조절책,1171800,1171800,0
2018-06-01,1011089456,A019180,즉석식품,[CJ직배송] 비비고 한입떡갈비 140g X5개,13400,13400,0
2018-06-01,1306742030,C013030,스웨터,폴라폴리스 자켓 JK430W등산자켓패딩점퍼패딩점퍼패딩,54700,54700,0
2018-06-01,175326469,E031130,보온매트,한일 편백 자가드 이불전기매트 1인용,59000,59000,0
2018-06-01,175326468,E031130,보온매트,한일 편백 자가드 이불전기매트 2인용,69000,69000,0
2018-06-01,1876167189,A012060,햄및베이컨,[롯데햄] 롯데 의성마늘햄480g(160x3),5900,5900,0
2018-06-01,1426855058,C013010,점퍼,아디다스 니트 AK 3S 트랙탑(AJ3645) 져지 체육복 패,68870,66810,-2060
2018-06-01,482347942,C013040,청바지,지오다노 01108220 코튼 버뮤다 [웨빙벨트증정] 108220 [2018년 S/S],19800,16440,-3360
2018-06-01,1443286288,A017110,감자,제주 구좌 향당근 세척당근 5kg,14900,14900,0
2018-06-01,108478747,C011030,남자학생복,빅사이즈 베이직 가디건UN921-001 라운드넥니트 빅사,35100,35100,0
2018-06-01,1384244616,C013050,운동복,S-4XL여름신상 트레이닝복세트/반바지반팔/커플츄리닝,27800,25800,-2000
2018-06-01,1228974470,A021020,차,[동서식품]프리마 1kg 자판기용,3600,3600,0
2018-06-01,1222247692,C012040,여자학생복,[에스티아]55-120/프리미엄 디테일 원피스형 롱티셔츠,12900,12900,0
2018-06-01,1023065821,E021020,커튼,목각발(물결)/문발/창문발/햇빛가리개/원목발/장식발,22900,22900,0
2018-06-01,239566529,C012060,여자내의,여성 슬랙스/정장바지/스키니/밴딩팬츠/빅사이즈바지,19800,19800,0
2018-06-01,175326470,E031130,보온매트,한일의료기 한화 그림명가 카페트 좌우분리난방(183x230cm),186000,186000,0
2018-06-01,1954722540,C012060,여자내의,편안하고 시원한 고품질 냉감통바지 SD-5668,8810,8810,0
2018-06-01,65383790,I011030,사진기,올림푸스터프 TG-5 방수카메라 5월사은품 6%할인쿠폰,520000,446060,-73940
2018-06-01,2083146606,L021020,장신구,사은품 판촉용 진주모양 귀걸이 100쌍 /(참고)플라스,40900,36000,-4900
2018-06-01,1805566414,L021020,장신구,초특가/13mm천연양식담수진주반지3/땡처리,188000,188000,0
2018-06-01,1362666764,C013020,티셔츠,빈폴남방/빈폴카라티셔츠/반팔/니트/가디건/후드티/폴로 카라티/헤지스/정품==사랑채,53000,53000,0
2018-06-01,651125620,C014020,유아복,[대구백화점 I관] [치크]매쉬안감바람막이(CKJA82300G),19900,18510,-1390
2018-06-01,1982430640,A019080,고추장,태양초 햅쌀고추장 800g 전통의 재래식 장담그는 방법,11000,11000,0
2018-06-01,575219813,F012020,생리대,애터미 허브데이 팬티라이너/중형/대형/생리대 [클릭],11300,11300,0
2018-06-01,1011089486,A019180,즉석식품,[CJ직배송] 비비고 한입떡갈비 140g X10개,26800,26800,0
2018-06-01,1041928999,A016150,아몬드,2017년 햇 아몬드 800g/1Kg/ 캐슈넛/피스타치오/호두,9000,8900,-100
2018-06-01,1779512304,L021020,장신구,[바보사랑]SQUARE RING,26000,26000,0
2018-06-01,1779512303,L021020,장신구,[바보사랑]BAND RING,22000,22000,0
2018-06-01,1779512305,L021020,장신구,[바보사랑]CIRCLE RNG,24000,24000,0
2018-06-01,912636864,I053040,기타문구,3M/포스트잇모음/메모지/알뜰팩/플래그/리필용,1150,1150,0
2018-06-01,1129864758,C015020,모자,빈티지한 느낌의 워싱처리가 된 군모시크캡 커플군모,17290,17290,0
2018-06-01,954038879,A017300,미역,초L프레시)광천 재래 도시락김 24봉,8990,6490,-2500
2018-06-01,989074986,A019010,고춧가루,초L 중국산 고춧가루 1KG,13500,13500,0
2018-06-01,592757215,F012020,생리대,((이베이비샵))생리대1+1/사은품/이벤트/허밍스 단오,9400,9400,0
2018-06-01,1200618361,A013050,오징어,오뚜기 고등어 280g X 24EA,74800,66580,-8220
2018-06-01,2029328220,A015020,식용유,라온 현미유 900ml,14590,14590,0
2018-06-01,707686539,L021060,유모차,리안 그램 플러스 휴대용유모차 2018 +3종 사은품,198000,198000,0
2018-06-01,1791420398,A018070,파이,버터와플/초코하임/빈츠/오예스/아이비/참잉/국희,33000,33000,0
2018-06-01,509331107,C012040,여자학생복,보풀방지 네이비 교복조끼 남자 교복 교복쇼핑몰 교복,23160,22470,-690
2018-06-01,900394032,A013100,마른멸치,초이스엘 홍합살 (350G/팩),6900,6900,0
2018-06-01,1326603667,F012020,생리대,좋은순면 울트라 날개 중형생리대 36p/대형32px3팩,28900,28900,0
2018-06-01,1010403456,A016130,키위,[참예과] 가정용 알뜰 실속배 5kg 8-10과 (중과),14900,9900,-5000
2018-06-01,1010403457,A016130,키위,[참예과] 가정용 알뜰 실속배 5kg 11-12과 (중소과),13900,9300,-4600
2018-06-01,1918264913,C013050,운동복,[경동산업] K-345 스타렉스 2004후사경 자동차실외용품 실외용후,24380,22210,-2170
2018-06-01,887025361,E061020,섬유유연제,다우니 퍼퓸 1Lx3개/고농축섬유유연제/미스티크/블룸,15900,15900,0
2018-06-01,402392771,I031040,생화,2단팔각파라솔 초대형파라솔 꺽임파라솔 비치파라솔,17000,15550,-1450
2018-06-01,440945966,C012040,여자학생복,[화이트폭스]루즈핏그물니트가디건,16500,15110,-1390
2018-06-01,989855414,A011060,땅콩,BottleRice 영양12곡 900G,8990,8990,0
2018-06-01,1207562555,C012030,여자상의,봄신상 정장원피스/레이스/쉬폰/나시/결혼식/하객,29800,29800,0
2018-06-01,2083337173,A011020,현미,햇사래 농부의 정성을 가득담은 찹쌀 3kgX2봉 포대찹,56770,56770,0
2018-06-01,986160217,A019170,냉동식품,CJ 비비고 곤드레나물밥 433G,6980,5990,-990
2018-06-01,1498913002,C015040,장갑,파스텔 곰돌이 벙어리 장갑 방한장갑 겨울용품 장갑,10500,10500,0
2018-06-01,1763810776,I031040,생화,빈슨메시프 웨어 침낭-셀크백 옷처럼 입는 캠핑 침낭,59800,59800,0
2018-06-01,1011089482,A019180,즉석식품,[CJ직배송] 비비고 한입떡갈비 140g X8개,21440,21440,0
2018-06-01,1146932538,A017010,배추,[강원도 정선]냉동곤드레 4kg/건곤드레 500g/곤드레밥,21000,20790,-210
2018-06-01,884838531,C013010,점퍼,후리스 집업 폴라폴리스자켓 기모목폴라티셔츠 단체티,13900,13900,0
2018-06-01,1706540311,E051030,디지털도어록,게이트맨 WG-100 무타공 도어락 디지털도어록 카드키,80500,72450,-8050
2018-06-01,894468992,L021010,손목시계,갤럭시기어S3 호환 메탈 디버클 가죽시계줄 22mm,25000,25000,0
2018-06-01,184270390,E041070,밀폐용기,글라스 유리 밀폐용기 오븐용기 주방용품 선물세트,55000,50600,-4400
2018-06-01,127073488,C013010,점퍼,DMO5UTUJ923_남여공용 533 WINDBREAK JK/ 디키즈,29000,26100,-2900
2018-06-01,1242707278,C012040,여자학생복,[무료배송]빅사이즈 DHG1197 엉클 체크 남방 802S 블,62080,62080,0
2018-06-01,258065414,C015040,장갑,남성용 양가죽 장갑 남자가죽장갑 양가죽장갑 양가죽,23910,23910,0
2018-06-01,389647100,E021010,침구,캐리보우100%순면이불 두툼한이불 차렵이불 봄이불,29900,29900,0
2018-06-01,1364216678,A016120,바나나,[거북농산]달콤하고 부드러운 멕시코바나나 3봉지,11900,11900,0
2018-06-01,1248797416,C012060,여자내의,[ab.f.z][17S/S]허리밴딩A라인반팬츠(AFR3GP59F)[갤러리아],29000,24650,-4350
2018-06-01,1479863828,E011060,의자,[레이싱코리아]게이밍 컴퓨터 책상 사무실 pc방의자,71800,64620,-7180
2018-06-01,1107779913,C013050,운동복,차량용 다용도 후크 /옷걸이행거/후크행거/카후크,4560,4560,0
2018-06-01,395655071,C013020,티셔츠,데일리걸 끈나시 롱나시 캡나시 나시티 홀터넥 튜브탑,8900,8900,0
2018-06-01,1027952988,C012060,여자내의,팝플라워/홈웨어/원피스/여성/가정/잠옷/홈원피스/쇼핑몰/여자/미니원피스/꽃무늬/여름,34800,34800,0
2018-06-01,1005963855,L021030,가방,유앤미샵/닥스여성가방/헤지스가방/닥스가방/가방,280000,280000,0
2018-06-01,351365361,C012020,원피스,빅사이즈/지브라/롱/가디건 지브라롱가디건 빅사이즈,33950,33950,0
2018-06-01,117011762,A021010,커피,2만원 무배/돌체구스토 캡슐 대용량 매그넘팩(30입),16880,16880,0
2018-06-01,1592527823,E031050,냉장고,공식파트너]삼성 김치냉장고 RQ51N92D07Z,2299000,1730970,-568030
2018-06-01,476615664,A017120,고구마,2018년 햇감자10kg중-12900원외 등급별엄선판매/양파,9900,9900,0
2018-06-01,1321371898,A021010,커피,MD추천특가! 맥심모카골드1kg/자판기용커피믹스 /동서,7340,6900,-440
2018-06-01,1762244506,C011050,남자내의,[헤리토리(HERITORY)](남성)베이직캐주얼5부팬츠_MHCDSQM4221_33/ 인디안,9000,8550,-450
2018-06-01,1157535862,C012060,여자내의,슬릿H라인스커트 (J11NSK344)/ 매그제이(MAGJAY),39900,35910,-3990
2018-06-01,483209030,C013050,운동복,콜라보배색집업 MS1710 트레이닝집업 운동복집업 여자,49060,49060,0
2018-06-01,612890853,E031130,보온매트,★TV홈쇼핑정품!!★뉴 일월 숯 황토매트 고급형 더블 일월매트/전기매트/보료매트/옥매,168000,166320,-1680
2018-06-01,487026958,C012040,여자학생복,수지네 구제 k2 그린 조끼 여성 S 16-18,17430,17430,0
2018-06-01,1496014658,C013010,점퍼,아이엠파인 봄여름신상 린네자켓/코트/야상,25900,25900,0
2018-06-01,289397836,A017180,호박,늘푸른 특 청양고추가루 2.4kg,40900,39680,-1220
2018-06-01,1203325364,E061020,섬유유연제,샤프란 3100 4개 2000 6개 피죤 3100 4개 섬유유연제,11800,11800,0
2018-06-01,193647735,C012040,여자학생복,[로렌하이] 셔츠/블라우스 모음/반팔/셔츠/스트라이프,19900,19900,0
2018-06-01,1390467098,F012010,종이기저귀,리베로 기저귀/밴드형3단계 68매x3팩+턱받이,52000,52000,0
2018-06-01,1248471390,A018080,설탕,대상 청정원 함수결정포도당 20kg,24700,24700,0
2018-06-01,905462936,C013050,운동복,나이키 아디다스 푸마 트레이닝복 세트 단체 츄리닝,49800,47800,-2000
2018-06-01,1619826468,C013060,등산복,봄 여름 가을 노벨라 원턱 등산바지/등산복/작업복,9900,8870,-1030
2018-06-01,1434185097,I053010,공책,줄없는 종합장NO. 14501 76837 초등생종합장 무선연습,6770,6770,0
2018-06-01,1415649046,A016100,수박,달콤달콤 맛잇는 수박 5kg,8900,8900,0
2018-06-01,2042850188,F012020,생리대,릴리안 순수한면 대형 14P x 5팩 (총70P),13800,13800,0
2018-06-01,853883467,C013020,티셔츠,[폴햄 (POLHAM)][남여공용]브이넥 무지 슬러브 반팔티셔츠(PHY2TR1840B)[갤러리아],9900,7920,-1980
2018-06-01,1291044180,C012030,여자상의,nn66 스트랩 베이직 린넨원피스 - 소라 원피스 여성원,33640,33640,0
2018-06-01,1078115746,E041050,냄비,클리나 싱글즈 냄비후라이팬 3종세트/혼밥세트,29900,29900,0
2018-06-01,239059446,A019040,소금,히말라야 소금/핑크소금/ 고품질 미네랄 1kg,11800,11800,0
2018-06-01,467672241,A019040,소금,신송메주된장50(14kg) 신송 메주된장 식품 식료품 식,59820,53840,-5980
2018-06-01,478371343,C013010,점퍼,OMJ-004 백패치 빈티지야상-카키 남성청코트 데님청코,76000,75240,-760
2018-06-01,1380250329,A018020,사탕,[캔디마을]롯데청포도캔디/1445g/1020g/128g/대용량/왕사탕/청포도/사탕/캔디/청포도사,9700,9700,0
2018-06-01,1180128555,C011020,남자상의,남자정장바지/여름정장바지/일자정장바지/남자바지,17800,17800,0
2018-06-01,73374184,L012090,기초화장품,[더페이스샵] 허브데이 클렌징 크림 4종中-3개(1+1+1),9900,8900,-1000
2018-06-01,1056956015,C014010,아동복,아둘 패밀리룩 가족티 쥬니어 포티아노 반팔티 28,9600,9500,-100
2018-06-01,776085111,A011130,시리얼,백설 부침가루 1kgx10개,31490,28030,-3460
2018-06-01,542579411,C011030,남자학생복,빅사이즈 95-130 여름 반팔 셔츠 와이셔츠 남자 남방,9900,9900,0
2018-06-01,1743591981,E031110,청소기,LG판매점(JS) LG K83RGY 슈퍼싸이킹 진공청소기,251610,234000,-17610
2018-06-01,2024581932,C011050,남자내의,[올진]JB페인팅데미지-진청 스티치 남자 청반바지,29900,28410,-1490
2018-06-01,1904978669,C014020,유아복,배냇베이비 허리라인이 들어간 순면 아동 티셔츠,10780,10780,0
2018-06-01,784548342,A019060,된장,청정원 안심 생된장 (봉)(500G),2000,2000,0
2018-06-01,514039489,A011160,빵,프랑스 프리미엄 미니 크로아상 25gx25개 냉동빵 생지,13900,13900,0
2018-06-01,1597084044,F011130,홍삼,정관장 홍백작(50ML*30입),200000,200000,0
2018-06-01,75541683,C012020,원피스,정장 결혼식하객원피스 레이스 오피스룩 비치원피스,93000,46500,-46500
2018-06-01,1183702480,I011020,영상음향기기,미니 빔 프로젝터 미니빔프로젝트 스마트빔,81000,77990,-3010
2018-06-01,1505335291,C012060,여자내의,[레이디플러스](2XL-5XL)캐슈넛 데님팬츠-3645,36900,33210,-3690
2018-06-01,922156808,A019080,고추장,해찬들 태양초 알찬고추장 4.5kg /고추장/된장,13800,13800,0
2018-06-01,1269497195,C012020,원피스,보헤미안룩 여성 여름신상 빅사이즈 롱 가디건,44100,44100,0
2018-06-01,1268642043,I031040,생화,더온발열도시락 발열전투식량 발열식품 간편식 즉석밥,5900,5290,-610
2018-06-01,1119332910,C013010,점퍼,[스타일썸] 걸크러쉬 슬림 가죽 자켓-m1071 (블랙) 겨울자켓 여성,53020,53020,0
2018-06-01,1775760337,L021010,손목시계,[Ange odor]앙쥬오도르 여성용 가죽밴드 패션시계 SAGE no.01,223000,223000,0
2018-06-01,1775760336,L021010,손목시계,[Ange odor]앙쥬오도르 여성용 가죽밴드 패션시계 SAGE no.02,233000,233000,0
2018-06-01,696766892,C013020,티셔츠,[하프클럽/타미힐피거]타미힐피거 반팔 슬림핏 폴로티셔츠,37500,37500,0
2018-06-01,784548370,A019060,된장,청정원 안심 생된장(1KG),4410,4410,0
2018-06-01,228239339,E031010,전기밥솥,CRP-CHS1010FS/쿠쿠/10인용/IH압력//GH,404000,371590,-32410
2018-06-01,119635790,C021010,아동화,남아신발 운동화 아동화 여름샌들 남아샌들 여아신발,10000,9900,-100
2018-06-01,447983693,C013020,티셔츠,언더레이어티셔츠(사계절_기본형_여성용_화이트) 레져,58730,58730,0
2018-06-01,73868239,C012030,여자상의,미키정품/냉장고/원피스/여름바지/나시/미시,7900,7900,0
2018-06-01,1693838313,A014020,분유,[유통기한8/24까지][베비언스]킨더밀쉬유 200ML(24입),38500,26950,-11550
2018-06-01,1990543553,C015020,모자,세일7900원~정품 스냅백 캠프캡 볼캡 힙합모자 뉴에라,9900,9900,0
2018-06-01,954038880,A017300,미역,초이스L 광천재래전장김 (20g*3봉),3990,2990,-1000
2018-06-01,761151309,A013160,맛살,올리브녹차 돌자반 70gx20개 입안에서 살살녹는 고,57540,57540,0
2018-06-01,975245669,I031040,생화,차량용 3D 루프백 루프박스 캠핑 자동차 캐리어,98600,89700,-8900
2018-06-01,201535295,E041020,컵,el. 스마일 머그컵4p / 커피잔 컵 머그잔 찻잔 물컵,9000,8910,-90
2018-06-01,1087022722,L012090,기초화장품,헤라선크림/선메이트레포츠/선메이트프로텍터/선스틱,18900,18900,0
2018-06-01,43249982,A021010,커피,카카오닙스/카카오/카카오원두/카카오닙/카카오분말/카카오열매/초콜릿/로스팅/가루/요,16900,16900,0
2018-06-01,900480305,A011070,혼식곡,큐원 중력 밀가루 (1KG),1490,1490,0
2018-06-01,1211414231,C013010,점퍼,주니어 초등학생 아동 의류 여름 바람막이 점퍼,34500,34500,0
2018-06-01,1666143881,C011050,남자내의,리바이스 반바지 23251-0008 55328-0091/카고반바지,47500,47500,0
2018-06-01,1644828823,A019140,이유식,(10+1) 중기 이유식 18종/ 팜투베이비,3690,3510,-180
2018-06-01,1644828826,A019140,이유식,(10+1) 전환기 이유식 18종/ 팜투베이비,3790,3610,-180
2018-06-01,830558727,E011010,장롱,레이나 옷장 장롱 붙박이장 틈새장 서랍장 800,85000,60000,-25000
2018-06-01,1346161360,A014010,우유,엿기름(오곡 15K)/가루 식혜재료 엿질금 보리가루,53700,51020,-2680
2018-06-01,111199186,C013050,운동복,세련된 디자인의 국기모양 유러피안 도어가드,4300,3960,-340
2018-06-01,2093341572,C012060,여자내의,피오나 블리플레어 skirt/m6514/스커트/ 피오나,19400,14940,-4460
2018-06-01,956071595,C021010,아동화,월드컵 유아 남아 여아운동화 아동화 샌들 슬립온신발,10000,9900,-100
2018-06-01,1603990043,C013040,청바지,주니어반바지/여름바지/청반바지/주니어바지/5부/7부,25900,12900,-13000
2018-06-01,768057709,A017150,버섯,[엉클팜]유기농 알로에 베라 생잎 3.3gk 특 / 무료배송,19500,18530,-970
2018-06-01,1961451361,L021010,손목시계,MITZVAH 미츠바 보석시계/ 미츠바시계/ 메탈 금시계,59800,59800,0
2018-06-01,1025700523,A011010,쌀,ORGA 쌀가루 고운입자(유기농 18g * 10EA) x 3개,10800,10800,0
2018-06-01,286461748,E061060,살충제,피톤치드원액/천연편백나무추출액/산림욕/살균/탈취,29800,19600,-10200
2018-06-01,1209437418,C013040,청바지,[Blouson]쿨 스트라이프 허리리본 와이드 팬츠_[B1806PT065B],16000,14230,-1770
2018-06-01,1411221009,C014010,아동복,어린이 방한 마스크 FR0012 겨울왕국프릴마스크,9310,9310,0
2018-06-01,1925064572,C012040,여자학생복,[대구백화점 I관] [베이직코데즈]배색자켓가디건(CZA-CD112M1),50000,46000,-4000
2018-06-01,896574991,A014030,치즈,남양 유기농 아기치즈 1단계 (180G),5300,5300,0
2018-06-01,1541869749,C014020,유아복,아둘 패밀리룩 메쉬 조던 나시세트 민소매 상하의 18,15900,15900,0
2018-06-01,896574992,A014030,치즈,남양 유기농 아기치즈 2단계 (180G),5300,5300,0
2018-06-01,896574993,A014030,치즈,남양 유기농 아기치즈 3단계 (180G),5300,5300,0
2018-06-01,1392911289,F012020,생리대,좋은느낌 라네이처 유기농 순면 4팩 구성 립밤증정!,18800,18800,0
2018-06-01,27551105,C021020,구두,[토리버치]토리버치 웨지 플립플랍 조리 18SS 50008673 009,129000,107070,-21930
2018-06-01,1378307355,C013020,티셔츠,[나인스텝]주문폭주(18 S/S) 파리 스팽글 티셔츠 N18NT8609[갤러리아],10000,8400,-1600
2018-06-01,324426290,L021030,가방,[리바케이스] 독일 리바케이스7860/17.3인치 노트북가방/케이밍/RCN,129000,126420,-2580
2018-06-01,425835377,L012010,면도기,카이 크로스핏면도기2개+날총12입,11400,11400,0
2018-06-01,731434277,C011030,남자학생복,팬콧 보아 다운 베스트_PPOEIDV01C,49000,44100,-4900
2018-06-01,971527401,C013050,운동복,투싼-미르웨이 후사경/4WD/RV용품/사각지대/후진주차/현대/기아/대우/쌍용,27000,24600,-2400
2018-06-01,1644828821,A019140,이유식,(10+1) 초기 이유식 12종/ 팜투베이비,2490,2370,-120
2018-06-01,687325126,A017160,오이,[지리산 표고버섯] 자연햇살에말린 표고버섯/건표고,16930,16930,0
2018-06-01,1946789261,A011160,빵,삼립빵 1000빵 10봉 랜덤 단팥빵 간식빵 슈퍼빵 샤니,8400,8400,0
2018-06-01,254504415,L021060,유모차,[정품]치코 어반플러스 디럭스유모차/시트분리형,298000,298000,0
2018-06-01,492276541,C012060,여자내의,빅사이즈/제이스타일 텔리나 래쉬가드 스커트,25200,22680,-2520
2018-06-01,985381899,A013180,젓갈,[속초아바이마을전통젓갈]명란젓(골드)500g,25900,17900,-8000
2018-06-01,1407754241,E031010,전기밥솥,쿠쿠고무패킹/10인용 8인용 6인용 쿠쿠압력밥솥패킹,4700,4700,0
2018-06-01,1658715572,I053020,스케치북,흑캔트지 검정도화지 8절 180g 125장 -31445 캔트지,15730,15730,0
2018-06-01,1916000508,F012010,종이기저귀,18년 군 수영장 기저귀 3매/방수 기저귀/하기스,4900,4900,0
2018-06-01,1225688224,C012060,여자내의,난닝구 에이르 린넨밴딩팬츠/ 난닝구,22900,22220,-680
2018-06-01,1212353264,C014010,아동복,[레노마키즈]여아쿨메쉬레이어드주름원피스(R1825O565),31500,28500,-3000
2018-06-01,1524488988,L021020,장신구,로즈골드 반지/큐빅/인기/OPR879,165000,165000,0
2018-06-01,369850405,C012060,여자내의,[이프네(IFNE)]뀨뀨 스커트 (DI4WSK25)(센텀시티점),35000,31240,-3760
2018-06-01,212512443,C012040,여자학생복,여성 여자 목폴라/목폴라티/목티/폴라티/폴라/골지/티,6100,6000,-100
2018-06-01,586268504,I031040,생화,바낙스 CM 군도 plus 1호 2호 3호대 바다낚시대,57310,48150,-9160
2018-06-01,1305046641,C015040,장갑,ELH핫템 발열장갑 ( M ) 충전식발열기 보온기 열선장,279210,279210,0
2018-06-01,2025892744,L021020,장신구,스타샵 EGS1543 재고보유 당일발송 엠포리오 알마니 EMPORIO ARMANI 엠포리오 아르마니,180000,160120,-19880
2018-06-01,263629775,E021020,커튼,침대 캐노피 모기장 예쁜캐노피 공주캐노피 캐노피장,34390,33360,-1030
2018-06-01,696076057,A018010,초콜릿,토블론 스위스 밀크초콜릿 100g /다크/화이트,1890,1890,0
2018-06-01,1278849187,I012010,컴퓨터,114만원!!5월 특가!! 8세대 삼성노트북 NT900X3V-A58A,1262100,1199000,-63100
2018-06-01,1478657252,E031020,가스레인지,하츠빌트인가스렌지 GC-2303/3605SDSH 2/3구 가스쿡탑,108000,108000,0
2018-06-01,515027797,F012020,생리대,동아제약 템포 슈퍼 20매 1팩,6000,6000,0
2018-06-01,1608260418,L021020,장신구,실버)디데이 초커 목걸이 크리스탈 물방울 20대 30대,11560,11560,0
2018-06-01,996572295,D031010,주택수선재료,걸레받이 방수몰딩시트지 미색 WBMDIT-902-15-5 15cm x 5m 헤라증정,7000,7000,0
2018-06-01,2132523503,E061050,청소용세제,맥스크린 살균소독제 500ml 차아염소산수 가정집 병원 어린이집 장난감소독 테이블소독,8000,7900,-100
2018-06-01,1340075828,C013040,청바지,[리바이스]여성 LVC 1950 701 rigid 스트레이트 핏 데님 팬츠_ 다크 인디고 (50701-00,259000,226110,-32890
2018-06-01,2125023621,C012040,여자학생복,[모다아울렛][레코브]진주별가디건(L9217YKC542X),39900,36710,-3190
2018-06-01,1775760314,L021010,손목시계,[Ange odor]앙쥬오도르 여성용 가죽밴드 패션시계 SAGE no.03,233000,233000,0
2018-06-01,575401994,C013050,운동복,상하세트 유아상하세트 핑크상하세트,36360,36360,0
2018-06-01,959586800,A017280,김,[한성]한성 실속김밥세트(505G),6590,5790,-800
2018-06-01,1285626124,A019140,이유식,엘빈즈 클래식 이유식 미음1단계(만 4~6개월)/ 엘빈즈,3180,2900,-280
2018-06-01,1722683461,A017050,미나리,무농약 양배추 5kg,17500,14000,-3500
2018-06-01,1290600237,E061050,청소용세제,한번애 곰팡이제거/벽지/욕실곰팡이제거제/방지제,19800,19800,0
2018-06-01,48821976,E011020,침대,린디베드S/철제침대/침대프레임/슈퍼싱글/베드/침대,89900,89900,0
2018-06-01,64335580,E021020,커튼,레이스커튼/국내산망사/속커튼 거실 안방 주방 문입구/여름커텐/기본가로300부터 대형,39600,36440,-3160
2018-06-01,988035090,A012050,소시지,초L)탱글탱글 비엔나 (400G*2),7280,5990,-1290
2018-06-01,1375963195,I031070,애완동물관리비,4구프로컵/당구공/당구큐대/4구공/3구공/당구장갑,109000,96470,-12530
2018-06-01,586293518,C011020,남자상의,레이어드자켓 WS 패딩자켓 PD21,102170,102170,0
2018-06-01,2068821451,C011050,남자내의,냉장고바지 무료배송! 2018년최신상/아이스/쿨팬츠,5900,5900,0
2018-06-01,1267619214,C013040,청바지,[쿠기(KOOGI)]오프숄더스모크롱점프수트_KL1PT183A,20800,20800,0
2018-06-01,1383476843,A018040,아이스크림,[2+1]하겐다즈파인트2개+파인트1개증정,22600,22600,0
2018-06-01,1200751025,L021010,손목시계,메탈시계 남자 남성 실용적 패션 가죽 손목시계,22900,22900,0
2018-06-01,1890107326,C011020,남자상의,레드 체크 밍크털 코트 캐주얼코트 남성털코트 털코트,109100,109100,0
2018-06-01,2124771116,C011050,남자내의,남성 슬림 스키니 블랙 팬츠 남자청바지 편한청바지,70200,70200,0
2018-06-01,723372988,C013040,청바지,[올젠] [ZPY2PP1502-MNV/MGR/MBL] 쾌적한 비즈니스 캐주얼 팬츠,49000,39200,-9800
2018-06-01,1825438896,C013010,점퍼,야상점퍼 남성가을점퍼 남성야상점퍼 기본야상점퍼,109900,109900,0
2018-06-01,988035095,A013170,생선통조림,[동원]동원 고소한꽁치 기획 (300G*2),7390,7390,0
2018-06-01,370841485,E021010,침구,[보리보리/데코뷰]베이직 스트라이프 3D매쉬 쿨매트,35100,35100,0
2018-06-01,954820208,A019030,생강,깐양파 2입 팩,2990,2990,0
2018-06-01,155853443,I031040,생화,[콜럼버스]자이언트 다운백 사계절 침낭 오리털 100%,39800,36620,-3180
2018-06-01,959523311,E061040,부엌용세제,트리오 홍초설거지 리필 1200ML,4990,4990,0
2018-06-01,1783208183,L021010,손목시계,[공식 백화점AS가능] Gc CableChic 여성시계(실리콘)_Y16006L5,295800,295800,0
2018-06-01,1398010386,A012010,국산쇠고기,두레생협 닭봉(2kg/무항/국산),76660,75130,-1530
2018-06-01,1783208182,L021010,손목시계,[공식 백화점AS가능] B1-Class 여성시계(가죽)_Y17013L1,244800,244800,0
2018-06-01,895743634,A014040,발효유,남양 요구르트 (65ML*5입),650,650,0
2018-06-01,603040424,A015020,식용유,만토바 엑스트라버진 올리브유 스프레이 250ml,12600,12600,0
2018-06-01,1783208181,L021010,손목시계,[공식 백화점AS가능] Gc CableChic 여성시계(실리콘)_Y18004L1,253300,253300,0
2018-06-01,895743635,A014040,발효유,남양 이오 요구르트(80ML*5입),2300,2300,0
2018-06-01,1783208180,L021010,손목시계,[공식 백화점AS가능] Gc CableChic 여성시계(실리콘)_Y18005L7,278800,278800,0
2018-06-01,1067452591,E031080,선풍기,한일 캠프파이어 로터리 히터 OHG-19800FT,459420,459420,0
2018-06-01,1783208187,L021010,손목시계,[공식 백화점AS가능] Gc LadyChic 여성시계(가죽)_Y11003L1,270300,270300,0
2018-06-01,1783208186,L021010,손목시계,[공식 백화점AS가능] Gc Twist 여성시계(가죽)_Y13006L1,244800,244800,0
2018-06-01,1783208185,L021010,손목시계,[공식 백화점AS가능] Gc Twist 여성시계(가죽)_Y13007L1,270300,270300,0
2018-06-01,2091113270,C013040,청바지,2018신상 BEST 청바지/밴딩/워싱/생지/일자/데님/남자,14900,14900,0
2018-06-01,1523679144,A019100,식초,청정원 고소한 마요네즈 3.7KG / 코스트코 대용량,13150,13150,0
2018-06-01,1783208184,L021010,손목시계,[공식 백화점AS가능] Gc CableChic 여성시계(실리콘)_Y16004L1,295800,295800,0
2018-06-01,2098068678,C013050,운동복,아디다스 여성 스타디움 후드자켓(BP7066) 후드자켓,106440,106440,0
2018-06-01,1869994371,A011010,쌀,17년 햅쌀 임실농협 행복드림 쌀 20kg / 당일도정,47900,47900,0
2018-06-01,28070899,C014010,아동복,초등학생여아상하복 주니어여아세트복 트레이닝복,14900,14900,0
2018-06-01,1783208188,L021010,손목시계,[공식 백화점AS가능] Gc LadyChic 여성시계(가죽)_Y11002L1,270300,270300,0
2018-06-01,1671490667,C013020,티셔츠,맨투맨티 라운드티 기본티 베이직 남녀공용 쮸리티,13800,13800,0
2018-06-01,783768738,C015040,장갑,등산 장갑 모음/터치장갑/자전거/헬스/스포츠/레저,3300,3040,-260
2018-06-01,1544646423,A013170,생선통조림,유동 번데기탕 캔 구수한맛 280g X 24EA_1BOX 맛있는,50490,50490,0
2018-06-01,2069265328,C013020,티셔츠,베이직 후드티 LTT0032 여성티셔츠 여성후드티(YA0200,32100,28250,-3850
2018-06-01,1228827173,E031070,에어컨,한일선풍기 천장선풍기 FC-62LB-S/천정형선풍기/선풍기/벽걸이선풍기/천장형선풍기/업,63800,63800,0
2018-06-01,1982922059,E031090,공기청정기,[일우]공기청정기/헤파필터공기청정기/냄세제거,59000,57000,-2000
2018-06-01,1347122297,A021010,커피,동서식품 맥심 아이스커피믹스 110T(100T+10T),15900,15900,0
2018-06-01,1179945421,L021020,장신구,피지 밴드 반지 SS-RG-FARB-NON/ 모니카비나더(주얼리),168000,151200,-16800
2018-06-01,989880340,L012030,칫솔,[LG]LG)리치컴플리트오리지널(미디엄)3입,5900,5490,-410
2018-06-01,1392492821,F012020,생리대,1000원할인)귀애랑생리대중형20Px5팩 100P 대형90매,12900,11900,-1000
2018-06-01,1783208179,L021010,손목시계,[공식 백화점AS가능] Gc CableChic 여성시계(실리콘)_Y18006L5,253300,253300,0
2018-06-01,1043200417,E061020,섬유유연제,울트라 다우니 에이프릴프레쉬 5.03L 2개 유연제 퍼퓸,34900,34900,0
2018-06-01,1324740810,C013050,운동복,겨울기모 패션트레이닝복세트/빅사이즈/패딩/커플,31800,31800,0
2018-06-01,1038384355,C013020,티셔츠,남성 슬럽헨리넥7부티(MSX2TR1003)/ 탑텐,9900,8910,-990
2018-06-01,1639925156,A017220,양파,영창]알루미늄용팁쏘 12인치 305mm 60-100날/국산,39800,39800,0
2018-06-01,989880336,A016150,아몬드,초L프레시)꿀땅콩 130G,2990,2990,0
2018-06-01,549991281,C013010,점퍼,[Wilson]투습방풍발수/윈드자켓/바람막이/단체복/팀복,42500,39000,-3500
2018-06-01,989880338,L012060,샴푸,[애경]애경) 케라시스퍼퓸 샴푸(그레이스핑크)400ML,8900,3490,-5410
2018-06-01,1615409462,A021010,커피,[그린어쓰 커피1kg Micro당일로스팅/판매우수상품특가,12000,12000,0
2018-06-01,1746039049,A014020,분유,일동후디스 트루맘 슈퍼프리미엄 퀸 1~4단계 800g,34000,34000,0
2018-06-01,300599697,A013150,어묵,지엠푸드 꼬치어묵 700g2개 어묵 꼬치어묵 냉동식품,19750,17780,-1970
2018-06-01,1640170044,A021010,커피,(2주절식) 봄들산야초 1100ml + 섬유질 생식 30포,77000,70840,-6160
2018-06-01,341787899,C011050,남자내의,[I.M.Z PREMIUM]S/S 애시매트리 슬림 카고팬츠 65PC404 92(워싱그레이),99000,89100,-9900
2018-06-01,2078508243,C012030,여자상의,nn66 스트랩 베이직 린넨원피스 - 네이비 스트랩원피,36390,36390,0
2018-06-01,1451520457,A013090,전복,[유진수산] 그린홍합/특대사이즈 녹색홍합 뉴질랜드,13770,13770,0
2018-06-01,1871211304,E011040,소파,플로바움 프린스 4인용쇼파/카우치/스툴,369900,369900,0
2018-06-01,1796966037,A014010,우유,[파스퇴르] 아기우유 파스퇴르 무항생제 유산균우유 200ml 20개,23200,23200,0
2018-06-01,350101499,C014010,아동복,로하스 한지 키즈 여 런닝 NO1 닥나무 원료의 한지를,18020,18020,0
2018-06-01,368815753,C021020,구두,남성구두 MA92 천연가죽 3cm 슬립 남성정장 신사화 구,53390,53390,0
2018-06-01,1783208150,L021010,손목시계,[공식 백화점AS가능] Gc PureChic 여성시계(메탈)_Y31003L1,278800,278800,0
2018-06-01,889180213,E031080,선풍기,한일 원적외선 세라믹히터 EHB-1470C [안전스위치 / 최대4000시간사용 / 화력조절2단],85000,85000,0
2018-06-01,2111522815,I031040,생화,콘츠 컴포트 침낭/포시즌/내외부 퀄팅처리/지퍼풀오픈,30000,25320,-4680
2018-06-01,889180211,E031080,선풍기,[하이마트] 한일 전기스토브 EH-600 [석영관히터 / 스탠드형 / 화력조절 2단 / 상하 각도 조절],39990,39990,0
2018-06-01,1783208154,L021010,손목시계,[공식 백화점AS가능] Gc LadyChic 여성시계(메탈)_Y21002L3,346800,346800,0
2018-06-01,889180212,E031080,선풍기,[하이마트] 근적외선 전기히터 EH-1820R [근적외선 히터 / 스탠드형(리모컨) / 건강난방],209000,209000,0
2018-06-01,1783208153,L021010,손목시계,[공식 백화점AS가능] Gc Structura 여성시계(메탈)_Y29001L1,338300,338300,0
2018-06-01,1783208152,L021010,손목시계,[공식 백화점AS가능] Gc PureChic 여성시계(메탈)_Y31001L7,253300,253300,0
2018-06-01,1943096673,A017170,풋고추,(맛나)백오이(국내산)5개,11300,10170,-1130
2018-06-01,889180210,E031080,선풍기,PTC히터 DHJY-3970 [ 3시간 타이머 / 상하 각도 조절 ],159000,159000,0
2018-06-01,1783208151,L021010,손목시계,[공식 백화점AS가능] Gc PureChic 여성시계(메탈)_Y31002L1,304300,304300,0
2018-06-01,1834029222,E061020,섬유유연제,[지금 최저가] 대용량 섬유유연제 피죤 20L 샤프란,17000,17000,0
2018-06-01,1783208157,L021010,손목시계,[공식 백화점AS가능] Gc LadyBelle 여성시계(메탈)_Y19001L1,312800,312800,0
2018-06-01,1963884828,F012050,의료측정기,케어센스N 보이스/N혈당측정기+시험지110+솜100+침210,42000,38500,-3500
2018-06-01,1783208156,L021010,손목시계,[공식 백화점AS가능] Gc LadyBelle 여성시계(메탈)_Y19002L1,346800,346800,0
2018-06-01,1920975285,A022010,주스,[롯데칠성]델몬트드링크팩190ml오렌지/포도/망고/파인,5800,5800,0
2018-06-01,1783208155,L021010,손목시계,[공식 백화점AS가능] Gc LadyBelle 여성시계(메탈)_Y19003L1,346800,346800,0
2018-06-01,2133547864,I031040,생화,카즈미 감성캠핑 캠핑의자 캠핑체어 BBQ체어 캠핑용품,14900,12640,-2260
2018-06-01,53987898,C013010,점퍼,남아 메쉬 배색 바람막이 점퍼(JBF0L301BS)/ 제이씨비,17100,13680,-3420
2018-06-01,1179945450,L021020,장신구,피지 버드 반지 SS-RG-FARA-NON/ 모니카비나더(주얼리),168000,151200,-16800
2018-06-01,1777105474,C011050,남자내의,[쇼타임] DG포인트보카시밴딩 남자 남성 마바지 린넨 빅사이즈,21800,21800,0
2018-06-01,983116488,C013050,운동복,TNR 차량용 문콕방지 도어가드 4P 영국기,2480,2480,0
2018-06-01,1656371962,A022050,탄산음료,[택일 웰치스 355mlx24캔 3종/탄산음료/캔음료/음료수,14400,14400,0
2018-06-01,1192344347,C013040,청바지,[메이비베이비] Sounds (pt),30000,30000,0
2018-06-01,909743416,C013050,운동복,여성트레이닝셋트/후드집업/5부7부팬츠/배기밴딩바지,25000,24000,-1000
2018-06-01,467757714,E021020,커튼,하겐 펫보이져 고양이 이동장 핑크 소 고양이이동케이,42190,42190,0
2018-06-01,994901685,L021030,가방,[명품LIFE]수제 명품 EREDL/ITALY Calf 가죽 서류가방,428000,428000,0
2018-06-01,1783208149,L021010,손목시계,(공식  백화점AS) 타임 투 기브 여성시계(가죽)_W0023L7,185300,185300,0
2018-06-01,1783208148,L021010,손목시계,[공식  백화점AS] 오버드라이브 여성시계(실리콘)_W0149L6,185300,185300,0
2018-06-01,839664335,A016030,복숭아,[국내산]씨없는포도 델라웨어 1kg 4-5송이,30500,29470,-1030
2018-06-01,422552656,E061010,세탁세제,테크 베이킹소다+구연산 액체세제 리필 2L x 6개,19900,19900,0
2018-06-01,155180896,A011170,떡,정남농협 디딜향 떡국떡 5종,2500,2500,0
2018-06-01,325186729,C013040,청바지,신상 시크블랙진/코팅진/스키니/반하이/데님/청바지,18000,16900,-1100
2018-06-01,798980554,E031080,선풍기,[태서전기] Alpaca 석유히터 TS-231(아이보리)/석유히터/석유난로/석유곤로/,82600,82600,0
2018-06-01,1559133093,E061020,섬유유연제,샤프란 20L 대용량 섬유유연제 표백제 액체세제 세제,17700,17700,0
2018-06-01,144128399,C014010,아동복,한국생산 노랑 베스트 5종세트 (3-24개월)800016,61090,59870,-1220
2018-06-01,798980557,E031080,선풍기,[태서전기] Alpaca 석유히터 TS-2000 /석유히터/석유난로/석유곤로/,138700,138700,0
2018-06-01,1350353547,A022010,주스,웰치스캔 포도맛 355ml 24ea,27800,27800,0
2018-06-01,1890543540,I031010,장난감,경찰 전동 오토바이 유아 스쿠터 바이크 사이클 선물,87900,83510,-4390
2018-06-01,178394215,C013020,티셔츠,진달래박스티/프린팅티/롱원피스티/루즈핏반팔/오버핏,9900,9900,0
2018-06-01,117756030,A017110,감자,(맛나)#흙당근(특.국산)20kg,108730,108730,0
2018-06-01,2146411632,C012040,여자학생복,패션풀 OCJ17524라이프 린넨 로브 가디건/ 패션풀,31000,26350,-4650
2018-06-01,330301176,G022020,자동차타이어,넥센타이어 엔페라 NFERA RU5 235/55R19 정품,108400,91720,-16680
2018-06-01,553446206,A013070,굴,랍스타테일 4oz~5oz 1kg 7~8마리 바다가재 꼬리,68000,68000,0
2018-06-01,1415011286,E011070,식탁,10종 아일랜드식탁 서랍장 렌지대 밥솥 선반수납장,107000,96300,-10700
2018-06-01,1361811596,C011050,남자내의,[키작은남자]여름/남자/반바지/청바지/슬랙스/면바지,10000,9500,-500
2018-06-01,308417692,E031110,청소기,LG 공식인증점 코드제로 R9 로봇청소기 R958RA,1402170,1290000,-112170
2018-06-01,1825436260,C021040,실내화,윌슨 엠플리필 amplifeel 테니스화 ( WRS322840 ) 차,218160,194170,-23990
2018-06-01,242422648,C012020,원피스,노카라 포켓 바바리 (LI5BY603)/ 르샵,79000,67150,-11850
2018-06-01,440317749,A019100,식초,오뚜기케찹 1kgX12개오뚜기 식품 식자재 케첩 케찹(Ha,75600,66530,-9070
2018-06-01,322115184,E061020,섬유유연제,아우라 명품 고농축 섬유유연제 1L x 3개 (택일),11900,11900,0
2018-06-01,1534210339,A017170,풋고추,동서 리치스 피클 슬라이스 오이피클 3kg,8020,8020,0
2018-06-01,282755426,E011050,책상,테이블[고정테이블]흔들림없는작업대/회의용테이블/공장/공장가구/간이/매대/진열대/책,98900,98900,0
2018-06-01,415218486,E041050,냄비,퐁듀 도자기 중 도자기편수퐁듀 편한퐁듀도자기 예쁜,49700,49700,0
2018-06-01,171394614,C011030,남자학생복,남여공용 라운드 울트라 다운 베스트 _ PHX4VP1020,59900,37400,-22500
2018-06-01,475628511,C013050,운동복,이아이A 앵글포유 LED 삼각대 경광봉형 (2952),53000,53000,0
2018-06-01,1209462467,C012030,여자상의,독보적 빅사이즈 베니코코 여름신상 원피스/린넨,9900,9900,0
2018-06-01,1120009990,C012060,여자내의,다미엔 밴딩 후레아 청롱스커트-청치마 DM-5038 청치,21770,21120,-650
2018-06-01,39610228,F012020,생리대,릴리안 초흡수 중형 16P x 12팩,27900,27900,0
2018-06-01,978591598,C013010,점퍼,행텐남성 아노락 바람막이점퍼10120-010-402-58,15770,15770,0
2018-06-01,1783208121,L021010,손목시계,[공식  백화점AS] 콘페티 여성시계(메탈)_W0774L4,295800,295800,0
2018-06-01,843062817,A019180,즉석식품,[진주햄] 진주 포차 옛날김말이1kg+1kg,13900,13900,0
2018-06-01,1809716548,I031010,장난감,[레고 디즈니]41154 신데렐라의 드림 캐슬,113900,113900,0
2018-06-01,1783208120,L021010,손목시계,[공식  백화점AS] 라임라이트 여성시계(가죽)_W0775L6,210800,210800,0
2018-06-01,1783208125,L021010,손목시계,[공식  백화점AS] 미니 에섹 여성시계(메탈)_W0403L2,219300,219300,0
2018-06-01,1783208124,L021010,손목시계,[공식  백화점AS] 미니 선라이즈 여성시계(메탈)_W0448L9,227800,227800,0
2018-06-01,1783208123,L021010,손목시계,[공식  백화점AS] 카탈리나 여성시계(실리콘)_W0562L1,202300,202300,0
2018-06-01,1783208122,L021010,손목시계,[공식  백화점AS] 서펜타인 여성시계(메탈)_W0624L3,278800,278800,0
2018-06-01,889180208,E031130,보온매트,[하이마트] 스판덱스 전기매트 HL-M106D [더블 / EMF인증 / 무선자계 열선],160000,160000,0
2018-06-01,1297119315,A014050,달걀,두레생협 올레길깐볼(700g/제주),27000,26190,-810
2018-06-01,1354308199,C013020,티셔츠,심플 후드집업 LLTT004 후드집업 트레이닝복,24820,24330,-490
2018-06-01,889180207,E031130,보온매트,[하이마트] 참숯 황토 전기매트 EPH-M7312W [좌우분리난방 / EMF인증],230000,230000,0
2018-06-01,1783208126,L021010,손목시계,[공식  백화점AS] 크로커 글램 여성시계(메탈)_W0236L2,219300,219300,0
2018-06-01,1043356164,C014020,유아복,줄무늬묶음셔츠/나시묶음티/여름신상/유아나시/여아티,9900,9900,0
2018-06-01,1783208119,L021010,손목시계,[공식  백화점AS] 사우스 햄튼 여성시계(메탈)_W0831L2,2227800,2227800,0
2018-06-01,690182121,C011050,남자내의,어트랙션 8부 트랙 밴딩 팬츠,40000,27900,-12100
2018-06-01,356140199,C012060,여자내의,숏팬츠 핫팬츠 PT1355-피쉬 패턴 밴딩 숏 팬츠 밴딩팬,9950,9950,0
2018-06-01,1053867930,E041010,식기,광명유기 4인 반상기세트 31pcs,490000,441600,-48400
2018-06-01,469512524,C013020,티셔츠,(남자옷도매)MTS-164 캔디보이 맨투맨티 (M-L) 4COLOR,36160,36160,0
2018-06-01,1673546685,C013010,점퍼,잭울프스킨 남아 아동 152 폴라폴리스 자켓 겨울 짱,29610,29610,0
2018-06-01,895802402,E061030,전구,[GE삼성]GE 컴팩트 형광램프(24W/주광색),5200,5200,0
2018-06-01,1334210517,E031070,에어컨,한일선풍기 24인치 벽결이선풍기 FW-2416 대형선풍기,110000,103460,-6540
2018-06-01,259449545,G011070,자전거,700C 레브 7 자전거용품 여성용자전거 커플하이브리드,278960,254090,-24870
2018-06-01,1083064572,E061010,세탁세제,신형 슈퍼타이 22kg 초특가! 스파크 비트 수퍼타이,24900,24900,0
2018-06-01,1686012373,I012060,저장장치,큐센 ARES Q120S 레인보우 LED 무접점 광축[블랙/USB],47500,39900,-7600
2018-06-01,895802405,A012050,소시지,[CJ]CJ 햄스빌베이컨 320G,8980,6290,-2690
2018-06-01,1762244478,C011050,남자내의,[헤리토리(HERITORY)](남성)베이직5부팬츠_MHCDSQM4211_04/ 인디안,9000,8550,-450
2018-06-01,399736950,A014050,달걀,이른아침애 무항생제 구운계란 훈제란 반숙란 모음전,5900,5900,0
2018-06-01,1146101975,C013050,운동복,[무료배송]카멜 아동 우유바지/배기/간절기/봄/가을,7900,7900,0
2018-06-01,1783208118,L021010,손목시계,[공식  백화점AS] 딕시 여성시계(가죽)_W0854L2,219300,219300,0
2018-06-01,433180812,C013050,운동복,자동차 파워핸들봉 파워봉 핸들손잡이 차량보조핸들,6440,5930,-510
2018-06-01,323863426,C013040,청바지,MDD5059 캣블랙슬림일자스판남자청바지 (~38) 빅사이,32470,32470,0
2018-06-01,1783208117,L021010,손목시계,[공식  백화점AS] 스텔라 여성시계(가죽)_W0885L4,108800,108800,0
2018-06-01,987979515,F012020,생리대,초L)슬림핏팬티라이너롱20P,1000,1000,0
2018-06-01,2070065841,C012020,원피스,빅사이즈/이중/레이스/가디건 / 참고 미시옷 임부복,45000,38250,-6750
2018-06-01,710360259,A017110,감자,신선한 국내산 당근 3kg/5kg(상품/특품)-6900원,6900,6900,0
2018-06-01,1597267724,F011130,홍삼,정관장 홍삼정진 에브리타임(10ML*20포),41600,41600,0
2018-06-01,29800050,I012010,컴퓨터,-P200 인텔 클락데일540/DDR3-4G/SSD120G/DVD/WIN10,229000,229000,0
2018-06-01,1789987923,A019180,즉석식품,하동 섬진강 자연산 재첩진국 500g 10개 재첩국,50000,50000,0
2018-06-01,1061232694,E041070,밀폐용기,스텐통 39종류/수저통/소스통/양념통/뼈통/집게통/11,7000,6440,-560
2018-06-01,731196999,L021060,유모차,휴대용유모차/초경량/디럭스/접이식,39000,39000,0
2018-06-01,959439577,A016060,감,씨없는 청도아이스홍시(탈피/60g/6개),14000,7900,-6100
2018-06-01,586352302,A013050,오징어,오뚜기 고등어 280g X 24EA 통조림 식자재 캔고등어,66050,66050,0
2018-06-01,1011124263,E061090,방향제,Kakao플레이키링(KAPKR-A),5900,5900,0
2018-06-01,889180269,E031130,보온매트,[하이마트] 전기요 EK-B7711 [싱글 / 3중 안전장치 / 절전형 조절기],39000,39000,0
2018-06-01,124392655,C011050,남자내의,남성 슬랙스 28~40 스판/일자/밴드/면/팬츠/정장바지,19800,19800,0
2018-06-01,1833202952,A016150,아몬드,[무료배송]2017년 켈리포니아 볶은아몬드 400gX2팩,8900,8900,0
2018-06-01,654845808,F012020,생리대,예지미인 울트라슬림 날개 대형 16개입 x 40,177240,177240,0
2018-06-01,1176987738,E061010,세탁세제,강력세척 파워팡팡10kgx2개 총20kg 대용량 세탁세제,9900,9900,0
2018-06-01,959439582,A016060,감,청도 아이스홍시(60g*24개/껍질벗기고),23900,16000,-7900
2018-06-01,693880944,C011030,남자학생복,여름신상 체크 남방 7부 솔리드남방 반팔셔츠 남자 스,14700,14700,0
2018-06-01,1319850474,C021020,구두,남성구두 M6452 에나멜 키높이구두 7cm 슬림디자인 구,55870,55870,0
2018-06-01,954820298,A016050,밤,[밤톨이약단밤][1+1 기획]영양간식 약단밤1kg+1kg 무료배송,25900,21000,-4900
2018-06-01,1034343845,A012060,햄및베이컨,쉐프솔루션 베이컨 1kg 냉동식품 가공육제품 베이컨,42280,42280,0
2018-06-01,889180274,E031080,선풍기,[하이마트] 웰로하스 전기히터 WDS-1500 [벽걸이형 / 카본히터 / 회전기능 / 화력조절 2단],52000,52000,0
2018-06-01,889180271,E031080,선풍기,[하이마트] 할로겐 히터 EHF-16HA [6.8㎡ / 화력조절3단 / 전도안전장치],57000,57000,0
2018-06-01,889180270,E031130,보온매트,[하이마트] 인체감지 전기 카페트 EKM-80NPS [싱글 / 5중 안전장치 / 자동꺼짐],99000,99000,0
2018-06-01,337833082,C013040,청바지,[2001 OUTLET]LANZI (란찌) 가을 NC 스판 팬츠 (LATA6903),10000,9700,-300
2018-06-01,1708523041,E011050,책상,[동서가구] 유주얼 멀바우 책상 시리즈,38900,38900,0
2018-06-01,1982430582,C013010,점퍼,[헌트키즈(아동)]앵커 경량 바람막이_JA184B2,15900,15900,0
2018-06-01,1356247564,C011020,남자상의,하일 코트 BDT081 남자코트 남자롱코트 / 참고 코트,144300,126990,-17310
2018-06-01,1082993121,A015020,식용유,해표식용유 2개 900ml 1.5L 1.8L 카놀라유 포도씨유 올리브유 백설콩기름,8800,8800,0
2018-06-01,880363645,C011050,남자내의,링클프리 물세탁 봄/여름 남성 면바지 캐주얼바지,19800,19800,0
2018-06-01,78126684,A018060,스낵과자,삼진 미니프레첼 85g 10봉 맥주안주/간식/수입과자,9900,8900,-1000
2018-06-01,889180239,E031080,선풍기,[하이마트] 3면발열 전기히터 스토브 EHVW-1280 [벽걸이형 / 화력2단],35000,35000,0
2018-06-01,1121538811,F012020,생리대,엘리스 생리대 순수감촉 날개형 소형22Px2팩 + 순수날개 대형2팩/ 엘리스,8500,8080,-420
2018-06-01,21487049,C013050,운동복,불스원 레인OK 에탄올 워셔액 1800ml x 12개,27900,27900,0
2018-06-01,733709768,A011010,쌀,강화섬 고시히카리쌀10kg 강화군농협 밥선생,35900,35900,0
2018-06-01,296210930,A019140,이유식,[짱죽] 바른이유식 10팩/배달이유식/죽 아기반찬 미음,30900,30900,0
2018-06-01,497665200,A011110,당면,(무)시골도토리묵400gX10EA(BOX)X2개시골 도토리묵 식,31900,28080,-3820
2018-06-01,889180240,E031080,선풍기,PTC히터 HEF-3320 [편리한 로터리 스위치 / 안전난방 / 상하수동조절],129000,129000,0
2018-06-01,170853604,I031070,애완동물관리비,울트라원반/소프트/우레탄/플라잉디스크/원반던지기,7500,6500,-1000
2018-06-01,889180241,E031080,선풍기,[하이마트] 전기히터 EHW-1800NR [벽걸이형 /리모콘],169000,169000,0
2018-06-01,910301746,A019080,고추장,초이스엘 우리쌀 태양초고추장(170G),2000,2000,0
2018-06-01,286302394,C013050,운동복,키스포/무배/여름주니어팬츠/아동트레이닝/단체복,6900,6900,0
2018-06-01,575462847,C012040,여자학생복,[에이인]risa v-neck cardigan,19000,18050,-950
2018-06-01,335790313,C013050,운동복,카본 범퍼윙 가드 대 중 소 중 택1 차량용가드 범퍼윙,20670,18840,-1830
2018-06-01,1225231631,C012030,여자상의,절개나시벨벳원피스 PG1710 컬러롱원피스 여성나시벨,73920,73920,0
2018-06-01,1113484218,C012040,여자학생복,[올리비에스클로젯][올리비에스클로젯]썸머 카사리 7부소매 가디건_[O1805CD012B],14800,12580,-2220
2018-06-01,889180247,E031130,보온매트,유파 전기요 EK-B7712 [더블 3중 안전장치 절전형 조절기],39000,39000,0
2018-06-01,889180244,E031080,선풍기,[하이마트] 석유난로 PFH-5K [파세코 팬히터/ 실내용 등유/ 적은 산화가스/ 가정용에 적합],349000,349000,0
2018-06-01,889180242,E031080,선풍기,[하이마트] 일렉시온 석영관히터 HM-1800S [3단계 조절가능 / 이동용손잡이],45900,45900,0
2018-06-01,1778707665,L021020,장신구,[바보사랑]도자기 팔찌 전통도자기 무지개팔찌,6000,6000,0
2018-06-01,889180243,E031130,보온매트,포러스 전기요 WEB-12JE [면혼방 물세탁 3중 안전장치 싱글],35000,35000,0
2018-06-01,1778707666,L021020,장신구,[바보사랑]도자기 목걸이 전통도자기 무지개목걸이,8400,8400,0
2018-06-01,1678705144,A014020,분유,트루맘 프리미엄후레쉬 1 - 4 단계 - 3 캔 x 800g,65000,65000,0
2018-06-01,2124650085,C013040,청바지,[BRENTWOOD] 포인트 배색 트레져 팬츠 BRPAM17915GYL,39000,33150,-5850
2018-06-01,188179439,C013020,티셔츠,[앨빈클로]공용 무지 맨투맨 후드티 목폴라 커플 집업,24900,14900,-10000
2018-06-01,2133329735,A013130,오징어채,일미 진미 오징어채 쥐포채 가문어 양태채,9900,9900,0
2018-06-01,1969490867,C015020,모자,크로스 린넨 메쉬 군모 / 여름 남자 여자 커플 모자,15000,14500,-500
2018-06-01,409102479,C013010,점퍼,빅사이즈 가디건 니트짚업 주머니 블루종 남성용점퍼,54020,54020,0
2018-06-01,651039234,A014010,우유,아인슈타인 플러스 천연 DHA원유 120ml 24팩/멸균우유,15900,15900,0
2018-06-01,895767683,A012050,소시지,[롯데]롯데 알뜰 소세지 (500G),2500,2190,-310
2018-06-01,1778707670,L021020,장신구,[바보사랑]CTB-50045,75000,75000,0
2018-06-01,320733099,C013020,티셔츠,면티 교복티 반팔티 쿨론티 여성티 긴팔 민소매 흰티,3500,3500,0
2018-06-01,1398227483,C013010,점퍼,[쉬즈미스][쉬즈미스] 버튼사파리점퍼-SWJPF61040_KH,28900,25440,-3460
2018-06-01,1948435008,C011030,남자학생복,교복몰 기본 후드집업 다양한 컬러(남자) 교복 교복바,19610,19030,-580
2018-06-01,1396531100,E031030,전자레인지,삼성 삼성 전자레인지 MS23J5133AM (23L/미러),110540,108330,-2210
2018-06-01,1893332170,A017090,열무,[e-fresh] 아삭아삭 콜라비 10kg / 개당 500g 내외,35900,34690,-1210
2018-06-01,1017621096,C021020,구두,[루플랫] 1298773 (해외) 18SS 생로랑파리 스터드 엠벨리쉬 레더 더비 슈즈,749300,646070,-103230
2018-06-01,316073454,C015040,장갑,양가죽 무스탕 벙어리 여성장갑 겨울장갑 겨울용장갑,26080,26080,0
2018-06-01,1233454958,C021040,실내화,벤시몽 BENSIMON 18SS HTSO8G402_엘리 ELLY_11종 1택,40180,40180,0
2018-06-01,224150491,E041070,밀폐용기,식품용기/단지/협구/광구/젓갈용기/젓갈통/페트병/참기름병/간장병/저장용기/패트병/플,330,310,-20
2018-06-01,1322909477,C015040,장갑,(옵션 : M) 아디다스 COND 니트장갑(BR9919),32970,32970,0
2018-06-01,1234726086,C011030,남자학생복,[레노마셔츠] 프리미엄 신상 퀄리티셔츠 38종택1 RHFSL0-500,30000,23700,-6300
2018-06-01,1689492666,F012030,안경,국내제작 고급 메탈 안경테 무테 반테 안경 30종 모음,15000,14800,-200
2018-06-01,1778707667,L021020,장신구,[바보사랑]CTB-30181-W,65000,65000,0
2018-06-01,1778707668,L021020,장신구,[바보사랑]CTB-30242-B,85000,85000,0
2018-06-01,1778707669,L021020,장신구,[바보사랑]CTB-50008,75000,75000,0
2018-06-01,1962039428,I031040,생화,레텍트레블 침낭 써모라이트 고급솜 충전 캠핑침낭,48800,48800,0
2018-06-01,265506895,A019140,이유식,우리애들밥상 이유식외 22종 반값 특가 [3만+사은품],990,990,0
2018-06-01,980846946,A017040,양배추,[오창농협] 무농약 대파 300g,9100,7760,-1340
2018-06-01,1203291576,C021020,구두,[단골쿠폰 15%] 남여 봄신상부터 샌들까지!!,39000,39000,0
2018-06-01,986184174,F011150,건강기능식품,[풍기][풍기인삼농협][황풍정] 홍삼분말300g (지함),75000,75000,0
2018-06-01,1312715569,A018090,잼,[복음자리]과일잼 1+1_사은품증정,7800,7800,0
2018-06-01,1076323705,C013020,티셔츠,[크루클린] 맨투맨/후드티/집업/오버핏/터틀넥/반지퍼,19800,13800,-6000
2018-06-01,1118645399,E011050,책상,강화유리 컴퓨터책상/ 키보드 드로우 테이블/입식책상,42480,42480,0
2018-06-01,523696737,C011030,남자학생복,꽃남방/리조트유니폼/하와이안셔츠/커플룩/레시가드,23200,23200,0
2018-06-01,1597267752,F011130,홍삼,정관장 홍삼정(진) 에브리타임(10ML*30입),75000,75000,0
2018-06-01,270466243,C014010,아동복,[대디오대디]겨울세일/아동복/티셔츠/팬츠/레깅스,10000,9900,-100
2018-06-01,1778707692,L021020,장신구,[바보사랑]CTB-30311-1,90000,90000,0
2018-06-01,895743688,A021010,커피,[네슬레]네슬레 초이스 모카(리필/170g),8700,8700,0
2018-06-01,1778707693,L021020,장신구,[바보사랑]CTN-10284-B,100000,100000,0
2018-06-01,1778707694,L021020,장신구,[바보사랑]CTN-10522-1,90000,90000,0
2018-06-01,1778707695,L021020,장신구,[바보사랑]CTN-10380,60000,60000,0
2018-06-01,1778707696,L021020,장신구,[바보사랑]CTN-10348-2,90000,90000,0
2018-06-01,1011124236,L021050,우산,Kakao슬림텀블러(KASLIM-A),19800,19800,0
2018-06-01,889180275,E031080,선풍기,[하이마트] 콘솔히터 WHCH1202 [ 2단계 온도조절 / 1080분 타이머 / 리모컨 기능 ],83610,83610,0
2018-06-01,1011124237,G022010,자동차용품,Kakao고무키링(KAKR-R2),5000,5000,0
2018-06-01,889180276,E031130,보온매트,[하이마트] 방적사 전기요 MSP-Y170ND [더블 / 9단계 온도조절 / 국내 제조생산 제품],76000,76000,0
2018-06-01,1123078970,C021040,실내화,푸마 TSUGI JUN 365489 남성 런닝화,116220,116220,0
2018-06-01,384606253,G011070,자전거,SKY20 폴딩 미니벨로/20인치 여성용 접이식자전거/7단,100000,99000,-1000
2018-06-01,2015793558,I031040,생화,물병/락스타 스포츠물병/생수/쉐이크/냉장고물통,1000,920,-80
2018-06-01,1024822541,C011050,남자내의,올젠 1st 시원한 여름바지 6종 택 1 ZPY2PP,40670,40670,0
2018-06-01,94076568,E061040,부엌용세제,팜올리브 고농축주방세제591ml/트리오,5700,5700,0
2018-06-01,1973571348,A021020,차,백설표 롱슈가(100개입)/커피/설탕/백설탕/황설탕,1430,1430,0
2018-06-01,1686845601,A018090,잼,[복음자리]햇딸기잼 기획전 사은품 증정,9600,9600,0
2018-06-01,1426519807,C013050,운동복,빅사이즈 트레이닝바지~4XL~48신축성 밴딩[더블온스],30900,29900,-1000
2018-06-01,1176734913,A014040,발효유,대상 요거트파우더1kg/스무디/에이드/녹차라떼/초코파우더/코코아/과일베이스/와플/잼,6900,6900,0
2018-06-01,1419259529,E061050,청소용세제,{락스알뜰구매}유한락스/맑은락스/락스세제/펑크린/,13800,13800,0
2018-06-01,898485422,A018040,아이스크림,바밤바 (10개),12000,4500,-7500
2018-06-01,1455646349,C013010,점퍼,특가세일전/등산자켓/골프웨어/윈드자켓/바람막이/아웃도어자켓/방풍자켓/등산복/단체,40800,39800,-1000
2018-06-01,898485421,A018040,아이스크림,누가바 (10개),12000,4500,-7500
2018-06-01,828376807,D031010,주택수선재료,10+1(풀바른소폭벽지_폭53cm)/포인트/아이방,490,490,0
2018-06-01,898485426,A018040,아이스크림,옥동자 (10개),10000,4500,-5500
2018-06-01,1572354456,C021040,실내화,아디다스/나이키 아동/키즈 샌들/운동화/신발,25900,25900,0
2018-06-01,898485424,A018040,아이스크림,비비빅 (10개),12000,4500,-7500
2018-06-01,1318152421,L021020,장신구,로즈 체인 태슬 롱 목걸이 예쁜목걸이 장미목걸이 롱,33380,33380,0
2018-06-01,1367587905,C013060,등산복,여름 쿨론티 쿨냉감 남성등산티 라운드티 기능성w025,8100,8100,0
2018-06-01,1900370617,A019160,밑반찬,[소보꼬]홈밥 블랙앵거스 소고기볶음 고추장 250g,11900,11400,-500
2018-06-01,1064891467,E031130,보온매트,한일의료기 황토매트/투난방/2인용,82500,82500,0
2018-06-01,1064891468,E031130,보온매트,한일의료기 전기요 극세사-대,40500,40500,0
2018-06-01,1064891469,E031130,보온매트,한일의료기 전기요 극세사-중,35500,35500,0
2018-06-01,1893332136,A017090,열무,[e-fresh] 산지직송 무 3개 / 개당 1.5kg 내외,14900,14400,-500
2018-06-01,503786099,C012040,여자학생복,[루시다]H45 BL4712루칸 태슬 블라우스,31800,28310,-3490
2018-06-01,895743692,A021010,커피,[네슬레]네슬레 초이스(리필/170g),8900,8900,0
2018-06-01,206867752,A012010,국산쇠고기,축협1등급 한우등심 2.4kg 한우선물세트 등심선물세트,260000,257400,-2600
2018-06-01,255225261,A017210,파,정품 완숙토마토10kg 100박스 특가행사 - 15900원,15900,15900,0
2018-06-01,2104359965,C012030,여자상의,롱니트 여성 V넥 단가라 원피스 KK롱니트여자 롱니트,67620,67620,0
2018-06-01,1307575856,F012010,종이기저귀,18년 신제품 마미포코 에어핏팬티/보송허그밴드,49900,49900,0
2018-06-01,1319856178,C011050,남자내의,남자바지 밴딩 조거 슬랙스 P0716012 남자청바지 카고,30560,30560,0
2018-06-01,1978322643,A021010,커피,루카스나인 콜드브류 아이스라떼 30T/아이스커피/커피,12000,12000,0
2018-06-01,1091675528,E031080,선풍기,한솔일렉트로닉스 원적외선 이동형 카본히터 HSH-C300SL,178000,178000,0
2018-06-01,1091675525,E031080,선풍기,후지카_ 나노카본 18 탁상용 히터 FU-4819,48000,48000,0
2018-06-01,1117467618,E011030,거실장,명품 심우 TV AV 홈씨어터 누드 거실장 600II 우레탄 도장 고급제품,638000,638000,0
2018-06-01,1890477295,I031010,장난감,경찰 전동 오토바이 유아 스쿠터 바이크 사이클 선물,79800,79800,0
2018-06-01,171155292,C013020,티셔츠,[씨샵인더룸]스토어15%단독특가+무배 여름 스페셜!,14900,14900,0
2018-06-01,1117467619,E011030,거실장,명품 심우 홈씨어터 AT-900 스피커 스탠드 2개 1세트 우레탄 무광 도장제품,174000,174000,0
2018-06-01,136420143,A011110,당면,시골다람쥐동부묵2kgX2개(BOX),14700,14700,0
2018-06-01,1803311022,C012030,여자상의,[앙투] 여름신상 원피스44~110빅사이즈 루즈핏 마 롱,19800,19800,0
2018-06-01,492364656,C013050,운동복,[모비스] 모비스 크루저 루프백 자동차루프백 캠핑가방 루프백,267510,243660,-23850
2018-06-01,870922003,I031040,생화,[콜럼버스]사계절 침낭 오리털 거위털 100% 국산,38900,34820,-4080
2018-06-01,1008357838,I053020,스케치북,스케치북 모음 드로잉 크로키북 캘리노트 크라프트,2000,2000,0
2018-06-01,529787303,A017080,무,[가족사랑] 비트즙 100ml X 30포 제주비트원액100%,27900,27900,0
2018-06-01,982062119,I011010,TV,정품패널 더함 코스모 C551UHD 55인치 UHD TV,411340,399000,-12340
2018-06-01,1094206311,E011050,책상,컴퓨터책상/ 책꽂이 책장 겸용 테이블/ 수납선반,26640,26640,0
2018-06-01,7611478,C011030,남자학생복,[인디안][인디안리더스(INDIAN LEADERS)]절개배색정장베스트_MARGCPS2111_56,18000,17100,-900
2018-06-01,121221969,F012050,의료측정기,마이크로라이프 혈압계 BP3BM1-3,41500,38600,-2900
2018-06-01,1352266420,C013010,점퍼,봄아우터/항공점퍼/자켓/롱항공점퍼/봄코트,24000,12800,-11200
2018-06-01,898485363,A018040,아이스크림,쿠앤크 바 10개,12000,4500,-7500
2018-06-01,250667311,A017080,무,[이조식품] 이조된장 소고기 양념된장 500g*4팩/6팩,33000,33000,0
2018-06-01,1011059906,E041030,솥,[CUAN] 쿠앤 바일레 냄비 3종세트,117000,70000,-47000
2018-06-01,898485368,A018040,아이스크림,보석바 (10개),12000,4500,-7500
2018-06-01,898485365,A018040,아이스크림,돼지바 10개,12000,4500,-7500
2018-06-01,938096873,A016020,배,자연농부 달콤시원 나주배 선물세트 4호 7.5kg(7-9과),71990,69840,-2150
2018-06-01,1117467621,E011030,거실장,명품 심우 홈씨어터 AT-400 스피커 스탠드 2개 1세트 무광 도장제품,142000,142000,0
2018-06-01,1117467622,E011030,거실장,명품 심우 천연 대리석 상판 홈씨어터 AV 800 오디오 거실장 장식장 무광 도장제품,530000,530000,0
2018-06-01,475989460,C013010,점퍼,[무료배송]봄 후드 가죽자켓 PU03 A WS 남성재킷 가죽,115770,115770,0
2018-06-01,1117467620,E011030,거실장,명품 심우 홈씨어터 AT-650 스피커 스탠드 2개 1세트 무광 도장제품,158000,158000,0
2018-06-01,1091675533,E031080,선풍기,닥터훅_고구마 전기스토브(영업용/가정용) NS-9293 (1.4KW)/히터/전기스토브/난로,78000,78000,0
2018-06-01,395212595,L021030,가방,[엘사베로니]염소가죽+스팽글 샤이니 숄더백 EL900-30,35900,35900,0
2018-06-01,1349337975,A013170,생선통조림,유동 꽁치캔 (400g) x24,72090,72090,0
2018-06-01,1091675530,E031080,선풍기,닥터훅_고구마 전기스토브(영업용) NS-9292 (3.1KW)/히터/전기스토브/난로,89000,89000,0
2018-06-01,599592154,E031120,믹서,다용도믹서기/멀티믹서기/분쇄기/쥬서기/KMX-2548WK,33000,33000,0
2018-06-01,1051012719,I011010,TV,SHE-320XQ 풀HD 32인치LEDTV 무결점 LG패널 무상2년AS,186460,179000,-7460
2018-06-01,989969744,A011040,보리쌀,햄프씨드 800G,17900,17900,0
2018-06-01,1117467623,E011030,거실장,명품 심우 천연대리석 상판 홈씨어터 1993 TV AV 거실장 우레탄 도장제품,1238000,1238000,0
2018-06-01,591707604,A011090,국수,[당일출고/무료배송]삼양 까르보불닭볶음면 10개(4+1),9900,9900,0
2018-06-01,1088277829,C013060,등산복,남성 등산복 방풍자켓 점퍼 작업복 남자자켓 바람막이,39800,39800,0
2018-06-01,204482485,A017020,상추,몬 뉴월남쌈300g(16cm) 2개,9150,8880,-270
2018-06-01,1315303983,C012040,여자학생복,조스라운지 팝콘 순면 여성 잠옷 긴팔 상하세트,44670,42440,-2230
2018-06-01,989918159,C012040,여자학생복,[루시다][루시다]C97 KN4724에슐리 백레이스 가디건,39000,34710,-4290
2018-06-01,1010382346,F011150,건강기능식품,[종근당] 프리바이오틱스 프락토올리고당 FOS (5gX30포) - 2박스,40000,23900,-16100
2018-06-01,1440135689,E021010,침구,지베딩 피치스킨 보들보들 간절기/사계절 침구 이불,17900,16470,-1430
2018-06-01,985327151,A022050,탄산음료,롯데 칠성사이다 190ML*6입캔,4380,2300,-2080
2018-06-01,578228108,A019060,된장,[사조해표] 사조해표 순창궁 재래식된장 14kg [무료배송],19900,19900,0
2018-06-01,1091675501,E031080,선풍기,후지카_ 나노카본 12 탁상용 히터 FU-4818,38000,38000,0
2018-06-01,1760207125,E041050,냄비,키친아트 슈미트 파티팬 32cm 스텐 찜냄비 양수냄비,16400,16400,0
2018-06-01,797273783,C012030,여자상의,[여름신상]빅사이즈/정장원피스/하객룩원피스/오피스,14700,14700,0
2018-06-01,1256958849,C012030,여자상의,스칼렛 베이직 H원피스,59900,59900,0
2018-06-01,895772400,A019090,카레,[오뚜기]오뚜기 바몬드 카레 골드 약간매운맛 100g,2650,2390,-260
2018-06-01,895772401,A019090,카레,[오뚜기]오뚜기 백세카레 약간매운맛 100g,3590,3590,0
2018-06-01,1367950799,A014010,우유,초콕 초코렛30T(10Tx3개)스트로우/미떼/코코아/핫초코,11900,11900,0
2018-06-01,1784188251,L021020,장신구,[바보사랑]klug 메탈볼드드롭이어링,12250,12250,0
2018-06-01,1784188250,L021020,장신구,[바보사랑]zenE 포인트샹들리에파티이어링,13650,13650,0
2018-06-01,1999239661,C013020,티셔츠,빅사이즈민짱/심쿵 신상티모음/루즈핏/롱/박시,9900,9900,0
2018-06-01,1575142575,C014010,아동복,[빈]BS27TS11NV/BS27PT02NV 네이비 티셔츠 다이마루팬츠 세트,39000,32370,-6630
2018-06-01,1784188248,L021020,장신구,[바보사랑]calin 메탈볼드드롭이어링,17150,17150,0
2018-06-01,1010382316,F011150,건강기능식품,[종근당] 하이업 쏘팔메토 아연 전립선 (30캡슐 x 3EA) - 1박스,30000,22900,-7100
2018-06-01,1784188247,L021020,장신구,[바보사랑]bacher 메탈볼드드롭이어링,12250,12250,0
2018-06-01,744275854,C012040,여자학생복,[키첼]단독 여름신상 쇼핑특보!! 원피스외 50종,13900,13900,0
2018-06-01,1405365686,C013050,운동복,P 운동 반바지 조깅 런닝 헬스반바지 마라톤팬츠,6900,6900,0
2018-06-01,866177754,E011020,침대,닐스퍼니 편백나무 히노끼 침대(매트리스포함),269000,257000,-12000
2018-06-01,594195972,A011110,당면,국내산 도토리전분 도토리 묵말랭이250g 2개,65720,65720,0
2018-06-01,1010382314,F011150,건강기능식품,[종근당] 루테인 오메가3 (눈건강 혈행관리 30캡슐) - 3박스,45000,19900,-25100
2018-06-01,1784188249,L021020,장신구,[바보사랑]din 그레이앤틱파티이어링,13650,13650,0
2018-06-01,1010382313,F011150,건강기능식품,[종근당] 루테인 오메가3 (눈건강 혈행관리 30캡슐) - 2박스,30000,14500,-15500
2018-06-01,1623646729,F012020,생리대,바디피트 생리대 볼록맞춤 중형/대형 128매,16900,16900,0
2018-06-01,246110096,A013120,낙지,굽지않고 바로 먹는 누드 오징어채(몸통) 150g,16900,16330,-570
2018-06-01,530752364,I031010,장난감,조립판/블럭조립판/블럭판/블럭/레고판/레고/듀폴로,1600,1600,0
2018-06-01,1617210981,A021010,커피,맥심 아이스 커피믹스 220T,29900,29900,0
2018-06-01,1392713730,C013020,티셔츠,엠엘비키즈 캐릭터 썬캡72CPVH831,31200,31200,0
2018-06-01,747263304,A016110,딸기,세미원 냉동 딸기 1kg 2개,22560,22560,0
2018-06-01,1864688190,A014030,치즈,코리원/모짜렐라치즈 1kg/치즈/피자/피자치즈/간식,10500,10500,0
2018-06-01,231401105,E061010,세탁세제,애경 울샴푸 (리필) 캡1.3L x 9개,36510,36510,0
2018-06-01,1610311131,A013070,굴,선주가 직접 자연건조한 해각포 대게 다리살 게살,12000,12000,0
2018-06-01,1886257146,E061080,키친타월,키친타올 150매 x 16롤 초특가/총2400매 화장지 휴지,11800,11800,0
2018-06-01,1784188253,L021020,장신구,[바보사랑]yaki 메탈볼드드롭이어링,12250,12250,0
2018-06-01,1181040500,C013060,등산복,[빈폴아웃도어]블루 남성 서플렉스 자켓 (BO6139D51P),71200,56250,-14950
2018-06-01,1784188252,L021020,장신구,[바보사랑]taki 메탈볼드드롭이어링,9450,9450,0
2018-06-01,62489289,C014020,유아복,HelloGeeks Onepoint top패션 여성의류 티셔츠 프린트,18300,18300,0
2018-06-01,898485335,A018040,아이스크림,메로나 (10개),12000,4500,-7500
2018-06-01,362035666,C013040,청바지,업타운홀릭 테이크 pants [반하이팬츠/일자청바지/크롭팬츠/밑단컷팅진/기본청바지/ 업,29000,26100,-2900
2018-06-01,321007433,C013040,청바지,빈티지 데미지 청반바지 스타일청반바지 남성청반바지,15730,15730,0
2018-06-01,895951178,A016090,참외,지금이 딱! 아삭아삭 꿀달달 성주 꿀 참외 2kg/3kg,9900,9900,0
2018-06-01,701522515,E041010,식기,백청아 면기 라면그릇 우동기 공기 대접 멜라민그릇,1000,880,-120
2018-06-01,938094245,A016020,배,자연농부 달콤시원 나주배 선물세트8호 15kg(20과내),131530,127590,-3940
2018-06-01,910304504,A019060,된장,초이스엘 재래식 집된장(1KG),4500,4500,0
2018-06-01,1434553920,A019170,냉동식품,[동원] 개성왕교자만두 304g*4 + 군만두잡채 600+300g,13410,13410,0
2018-06-01,1806301139,E011030,거실장,로딘 몬테 원목4인 식탁세트,605000,605000,0
2018-06-01,412289902,C013020,티셔츠,빅사이즈 브이단추티 BG1705 빅사이즈 여성의류 미시,29840,29250,-590
2018-06-01,989945722,A013130,오징어채,한끼진미채볶음50G,2490,2490,0
2018-06-01,632990070,C011030,남자학생복,밀리터리 빅사이즈 후드패딩 빅사이즈,53480,51350,-2130
2018-06-01,440234737,E021020,커튼,GT 퍼셀 강아지 고양이 이동가방 펫 배낭 블루 소 배,57890,57890,0
2018-06-01,2139456433,F012010,종이기저귀,[보솜이] 디오가닉 밴드 XL 특대형 공용 32매 4팩,41900,41900,0
2018-06-01,656849548,F012020,생리대,예지미인 울트라슬림 날개 중형 16개입 x 40,177240,177240,0
2018-06-01,1924155549,A021010,커피,네스카페 수프리모 아메리카노 100T 크레마/블랙커피,11650,10960,-690
2018-06-01,404762123,A018100,꿀,아카시아꿀 (청림 500g) X30,106730,94990,-11740
2018-06-01,2143963104,L021020,장신구,[패션플러스][호림쥬얼리]실버92.5정품)히트)순은(HR)실버 만자 반지(여)(卍),29000,27550,-1450
2018-06-01,1806301137,E011030,거실장,로딘 발렌시아 원목6인 식탁세트,715000,715000,0
2018-06-01,1806301138,E011030,거실장,로딘 발렌시아 원목4인 식탁세트,565000,565000,0
2018-06-01,1692980608,E041020,컵,모던도자기 카페 머그컵 머그잔 80종 모음,1600,1520,-80
2018-06-01,387529054,E041050,냄비,[키친아트] 인덕션 쿠커냄비 18편수 인덕션겸용 이유식 곰솥 전골,25500,25500,0
2018-06-01,210473214,C014010,아동복,똥글이 여름신상 17호까지 아동복 상하복 상하세트,25600,25600,0
2018-06-01,1328420906,C013020,티셔츠,타이틀리스트 카라티 반팔티 반팔 팬츠 바지  S/S신상,69000,61410,-7590
2018-06-01,1010201516,A014050,달걀,[풀무원]풀무원 동물복지목초란 15구,5990,5990,0
2018-06-01,1806301140,E011030,거실장,로딘 쏠하임 원목6인 식탁세트,775000,775000,0
2018-06-01,1806301141,E011030,거실장,로딘 몬테 원목6인 식탁세트,765000,765000,0
2018-06-01,898485397,A018040,아이스크림,죠스바 (10개),12000,4500,-7500
2018-06-01,450384277,A018080,설탕,비정제설탕/원당(천연당)15kg/과일청/사탕수수/매실,19900,19900,0
2018-06-01,1137588520,C013020,티셔츠,수아 여름 신상 여성 롱 티셔츠/프린팅 티셔츠/반팔티,4900,4900,0
2018-06-01,761081469,C012060,여자내의,#NAME?,26490,25700,-790
2018-06-01,1209280936,C013040,청바지,[세컨플로어] [여성] 솔리드 밴딩 와이드 팬츠 SWMS2WP51100044,156000,149940,-6060
2018-06-01,1806301142,E011030,거실장,로딘 쏠하임 원목4인 식탁세트,620000,620000,0
2018-06-01,898485398,A018040,아이스크림,호두마루 바 (10개),12000,4500,-7500
2018-06-01,898485399,A018040,아이스크림,쌍쌍바 (10개),10000,4500,-5500
2018-06-01,1177527022,E041030,솥,PN풍년 가정용압력솥/신제품/정품AS/100%사은품증정,53500,53500,0
2018-06-01,1416021082,C013050,운동복,차량용다용도걸이/차량용옷걸이행거/자동차거치대..,2500,2300,-200
2018-06-01,838662285,E061020,섬유유연제,(FC 베이비전용 섬유유연제 refill) 유아세탁세제 아,14910,14910,0
2018-06-01,245735290,C013010,점퍼,빅사이즈 레미롱자켓 MN1703 빅사이즈 여성의류 미시,69390,68010,-1380
2018-06-01,761331047,A013160,맛살,(냉장)한성통통맛살H(1kg)x5개,35000,34650,-350
2018-06-01,384757292,C012060,여자내의,사선 플레어 데님 스커트(AJ2DS560)/ 랩,59000,50150,-8850
2018-06-01,1130932526,C013010,점퍼,[모다아울렛][YK]쉬폰 레이스샤링 점퍼Y182c114,49900,44910,-4990
2018-06-01,117167046,A022030,생수,페리에 탄산수 500ml 24개/플레인/라임/스파클링/음료,29900,29900,0
2018-06-01,1556201522,L012090,기초화장품,SK-II/SK2 페이셜 리프트 에멀젼 100ml/로션/이멀젼,95900,95900,0
2018-06-01,1696704585,C011030,남자학생복,MCD-917 빈티지 스타일 롱가디건 남자후드가디건 빈티,49940,49940,0
2018-06-01,1475531882,C013020,티셔츠,[티탁]복수구매할인이벤트/루즈핏/롱티셔츠/빅사이즈,16900,12900,-4000
2018-06-01,1225252408,A019020,참깨,고운 들깨가루 (한1K) X10,98520,87690,-10830
2018-06-01,141113835,A013080,조개,바다해 냉동굴 손질완료 굴 1kg 통영굴 손질완료,8500,8500,0
2018-06-01,1920585358,A014030,치즈,코리원/본가드 슬라이스치즈120매/160매/200매/무색소,22900,22900,0
2018-06-01,1509639532,F012010,종이기저귀,2018 보솜이 리얼코튼 밴드 남/여 2단계 소형 50매3팩/ 보솜이,30900,29980,-920
2018-06-01,1339557311,E031070,에어컨,프리미엄 타워팬모음 플래티늄360도타워팬WINDPIA-360,66900,63560,-3340
2018-06-01,112887472,C013020,티셔츠,빅사이즈 기본매치30수V긴팔티 WW03509 여성의류 미시,14960,14960,0
2018-06-01,815563265,A012010,국산쇠고기,함평농협:농협 안심한우/1등급 한우 등심 안심 소고기,20900,20900,0
2018-06-01,2066921229,C014010,아동복,탑텐키즈 아동 저지 후드집업MKY2TC1001,17010,17010,0
2018-06-01,890290710,L012110,색조화장품,셀트리온 포피네 데일리 선스틱1+1/썬스틱/썬크림,19900,19900,0
2018-06-01,1327500081,C013010,점퍼,인조이 롱 점퍼 블랙 여성점퍼 롱점퍼 여성잠바 여자,25450,25450,0
2018-06-01,1029346733,C011030,남자학생복,여름/빅사이즈/셔츠/남방/체크/남자/남성/헨리넥/린넨,14900,14900,0
2018-06-01,1814441682,D031010,주택수선재료,[노루] 유성페인트 슈퍼에나멜 페인트 - 18L 기본컬러,108000,108000,0
2018-06-01,722993411,C013040,청바지,리바이스레이디/여성용청바지/여성용반팔티/당일발송/레깅스진/스키니진/부츠컷진,67000,67000,0
2018-06-01,425513946,A019020,참깨,볶음참깨 (삼진 1k) X10,106250,94570,-11680
2018-06-01,530536626,C012040,여자학생복,보풀방지 네이비 롱조끼 여자 교복 예쁜교복 교복쇼핑,24430,23700,-730
2018-06-01,988932637,L012040,치약,[페리오] 키즈 스테이지2 치약(쿠키런) 75GX2x3개,7800,7800,0
2018-06-01,948330778,E061040,부엌용세제,커피머신세정제 어넥스카피자 전문가용커피머신세정제,36920,36920,0
2018-06-01,895772465,A011090,국수,[오뚜기]오뚜기 스낵면 108G*5입,3050,3050,0
2018-06-01,895772462,A019130,스프,[오뚜기]오뚜기 쇠고기스프 80g,1690,1490,-200
2018-06-01,621274318,L012040,치약,죽염 네추럴 프레쉬허브 치약 160g x 9개 (택일),9900,9900,0
2018-06-01,895772463,A019130,스프,[오뚜기]오뚜기 쇠고기죽 85g,1450,1450,0
2018-06-01,592322120,A011030,찹쌀,국내산 보리쌀 4kg/찰보리/쌀보리/검정찰보리/압맥,10800,10800,0
2018-06-01,1890477205,I031010,장난감,전동 오토바이 에버바이크 선물 유아 스쿠터 사이클,116400,112910,-3490
2018-06-01,417662158,C012040,여자학생복,빅사이즈/제이스타일 루메린 스카시 니트 로브 가디건/ 제이스타일,41200,31730,-9470
2018-06-01,1735312358,I012060,저장장치,커세어 K70 LUX/LUX RGB/RAPIDFIRE 기계식 키보드,186170,175000,-11170
2018-06-01,1425774482,C012040,여자학생복,부루앤쥬디 캣츠카라 니트 WGKE2PO001 3컬러,24900,22410,-2490
2018-06-01,1294070746,L012090,기초화장품,안나홀츠 관리실 대용량 리바이탈 로션 300ml  1000ml,18000,18000,0
2018-06-01,1162025062,C013050,운동복,툴마트 다목적WOOL폴리싱콘패드 광택 연마 청소,8900,8100,-800
2018-06-01,417662157,C012060,여자내의,빅사이즈/제이스타일 델로프 린넨 3부 팬츠/ 제이스타일,39100,30110,-8990
2018-06-01,580652280,I031040,생화,[국산]몬스터파라솔/테이블/의자/파라솔받침대[국산],39000,39000,0
2018-06-01,135528453,A012010,국산쇠고기,해인 진국사골분말500g 2개,53000,51410,-1590
2018-06-01,1607069221,E041060,수저,[마호커트러리] 수저세트/숟가락 젓가락,2000,2000,0
2018-06-01,1001123438,C011030,남자학생복,봄여름 단추가디건B 1개 가디건 남자가디건 남성가디,45760,45760,0
2018-06-01,440916081,C012040,여자학생복,[블루종]다이아 짜임 포켓 가디건_[B1806CD034B],35000,27690,-7310
2018-06-01,2836353,A019140,이유식,남양 맘스쿠킹 영양쌀죽 10팩 골라담기/간식,17900,17900,0
2018-06-01,496775677,I031010,장난감,레고책상 듀플로테이블 레고놀이판 레고판 이케아,29500,29500,0
2018-06-01,2142939623,C011030,남자학생복,와이셔츠/긴팔/반팔/남방/교복/정장/체크/빅사이즈,15900,15900,0
2018-06-01,1011153125,F012010,종이기저귀,[유한킴벌리]2018년 하기스매직핏팬티 4단계여76P,39900,26900,-13000
2018-06-01,1011153126,F012010,종이기저귀,[유한킴벌리]2018년 하기스매직핏팬티 5단계남62P,39900,26900,-13000
2018-06-01,489096169,C013020,티셔츠,실크실켓인견면롱슬립캡나시 쉬폰프릴레이스롱원피스,7900,7900,0
2018-06-01,1915533421,A018100,꿀,오뚜기 벌꿀 잡화 1kg X 6EA(Hanworld2),207000,182160,-24840
2018-06-01,959347351,A022030,생수,풀무원 네슬레 퓨어라이프 (500ml),400,300,-100
2018-06-01,959347350,A022030,생수,풀무원 네슬레 퓨어라이프 (2L*6입),4980,3600,-1380
2018-06-01,1823376992,A022010,주스,Dole 돌 1000ml 주스 4팩 2종 파인 망고,12900,12900,0
2018-06-01,764420984,I053040,기타문구,3M 포스트잇 2000장 알뜰팩 오피스팩 대용량팩,7900,7900,0
2018-06-01,1359077101,L021050,우산,[카르닉] 완벽방수/판초우의/등산/골프/낚시우의/우비,13900,13900,0
2018-06-01,1385611347,A013070,굴,[e수산물][절단꽃게3L] /손질꽃게/절단꽃게살이꽉차고큰3L사이즈/킹크랩/꽃게탕 맛있는,4300,4300,0
2018-06-01,651161255,A018060,스낵과자,인기과자 반값행사 /간식/캔디/쿠키/득템/모음전,1000,1000,0
2018-06-01,1829989031,L021030,가방,타거스 CN317 17인치-18.4인치 노트북가방/서류가방,46000,44000,-2000
2018-06-01,442401132,C013050,운동복,후드트레이닝복세트 후드트레이닝복 요가복 운동복 츄리닝 트레이닝복,61000,60390,-610
2018-06-01,870118542,A017250,고사리,랜시 냉동 콜리플라워 3kg(1kgx3ea)/냉동야채,23000,19550,-3450
2018-06-01,1011214636,F011130,홍삼,천호엔케어 천심본 홍삼여감 75 mL X 60개입,168000,168000,0
2018-06-01,1011214635,F011130,홍삼,천호엔케어 천심본 홍삼백가 70 mL × 30팩,128000,128000,0
2018-06-01,1011214634,F011130,홍삼,천호엔케어 천심본 홍삼보감 80 mL X 60개입,106000,106000,0
2018-06-01,1487344211,E061010,세탁세제,브라이트 세탁세제10Kg 2개/가루세제/테크/분말세제,18900,18900,0
2018-06-01,455364631,F012020,생리대,화이트/좋은느낌 입는오버나이트 팬티형 중형 대형 8P,9700,9700,0
2018-06-01,751409479,C012040,여자학생복,클리어런스SALE홀리스터HOLL008여자가디건 브이넥니트,48900,48900,0
2018-06-01,957589902,E061010,세탁세제,파워 브라이트 (업소용/10KG),12900,12900,0
2018-06-01,58367678,A018060,스낵과자,응답하라 꾀돌이 벌크1kg 추억과자 간식,6500,6500,0
2018-06-01,749253682,A011140,부침가루,[삼립] 삼립 케이크 소프트 고구마 치즈케익 50g,600,600,0
2018-06-01,482154943,C013010,점퍼,새로운봄가을이온다/루즈핏후드뉴컬러야상트렌치코트,39900,39900,0
2018-06-01,1457818602,I031010,장난감,PlayStation Move 무브 충전 거치대 PS3 PS4,48000,48000,0
2018-06-01,154578656,A012060,햄및베이컨,코스트코 커클랜드 슬라이스 베이컨 일반/저염 중 택,24800,24800,0
2018-06-01,475158098,C013050,운동복,[인앤테크] (색상 : 레드) 도어가드원4M ㅣ 문콕방지,23770,21660,-2110
2018-06-01,893206926,C013010,점퍼,[크록스키즈]듀크솔리드래쉬가드세트 CBH2SS401S,39900,34720,-5180
2018-06-01,60739177,L021030,가방,[러브캣] 핸드백 한정수량 최저가 SALE! UP TO ~68%,81440,81440,0
2018-06-01,259022009,A021010,커피,프렌치카페 카페믹스 아이스 110T 커피믹스,19800,19800,0
2018-06-01,1580014930,A019030,생강,편강진저빈 (국산 250gX2통) 선물세트,32450,32450,0
2018-06-01,64418566,C012040,여자학생복,[포에버21]스플릿 백 가디건/FOREVER21/가디건/쉬폰 가디건,21900,13140,-8760
2018-06-01,36894496,A019110,드레싱,코리원/오뚜기 오쉐프 양파드레싱 2kg/대용량/샐러드,8000,7900,-100
2018-06-01,771473865,C014010,아동복,MLB 카봇 파워레인저 다이노코어 스파이더맨 또봇/티,16900,16900,0
2018-06-01,995395174,A021010,커피,유쾌통쾌 90ml x 12포/과채음료/장청소/알로에,17800,17800,0
2018-06-01,1692424196,L021030,가방,드라마협찬 여성가방 크로스백 가성비 갑 퀄리티보장,15900,15900,0
2018-06-01,350376585,C012040,여자학생복,[공구우먼] 키키 스카시 투피스 29713 여성 빅사이즈 뷔스티에,52000,52000,0
2018-06-01,55233683,C013040,청바지,리얼타임/반값세일 프리미엄 반바지 면 데님 빅사이즈,29800,29800,0
2018-06-01,895772426,A011130,시리얼,[오뚜기]오뚜기 부침가루 500g,1390,1390,0
2018-06-01,224158659,C015020,모자,당일출고[ADIDAS]아디다스 오리지날 카모 매쉬 스냅백,45000,45000,0
2018-06-01,895772425,A011130,시리얼,[오뚜기]오뚜기 부침가루 1KG,2790,2790,0
2018-06-01,410465089,C013050,운동복,차량시트간 간이 콘솔수납포켓 2개 차량포켓 휴지통,9570,8630,-940
2018-06-01,631293319,C012040,여자학생복,백프릴 스커트 (J11PSK106)/ 매그제이(MAGJAY),48900,44010,-4890
2018-06-01,2039412681,L021010,손목시계,패션시계/제네바시계/예쁜시계/꽃시계/손목시계,9500,7900,-1600
2018-06-01,1453600751,F012010,종이기저귀,2018 마미포코 보송허그 전라인 1팩 한정특가,7900,7900,0
2018-06-01,1977188183,A011010,쌀,[거시기장터]2017년 남원농협 춘향골쌀 신동진미 10kg,27500,27500,0
2018-06-01,895857959,E061060,살충제,[애경]홈즈 방충선언 (쌀벌레/1입),5600,5600,0
2018-06-01,1110028226,C012020,원피스,여성의류 캐주얼원피스 로맨틱 정장원피스 허밍퍼플,32000,29800,-2200
2018-06-01,1011214661,F011130,홍삼,천호엔케어 천심본 홍삼정 240 g,178000,178000,0
2018-06-01,1011214662,F011130,홍삼,천호엔케어 천심본 어린이 홍삼 40 mL x 30개입,88000,88000,0
2018-06-01,1348816797,E021020,커튼,세진아트 쫀드기 비닐 문발/쭉쭉찢어사용/커튼발/투명발/현관문발/대나무발/비즈발/목,61700,61700,0
2018-06-01,1888054079,E011020,침대,[안전한 베디스]베디스 플라워침대 SS/Q 침대프레임,215000,215000,0
2018-06-01,123463908,F012020,생리대,엘리스 생리대 순수감촉 4팩/메가미/고쿠수이/초안심,7900,7900,0
2018-06-01,1557096993,A011110,당면,[(주)자연촌]부드럽고 고소한맛 연두부 300g×10개,6130,6130,0
2018-06-01,453879605,A018020,사탕,수제 달고나 30g x 10봉,10900,9600,-1300
2018-06-01,1962347367,C021040,실내화,[푸마] DUPLEX EVO 듀플렉스 에보 런닝화 화이트 361383 03,99000,49500,-49500
2018-06-01,1453298058,C012060,여자내의,PT1342-베이직 밴딩 면 숏팬츠 숏바지 예쁜바지 여성,23820,19300,-4520
2018-06-01,989017264,A011120,두부,초L 스위트콘 시리얼 400G,3590,3590,0
2018-06-01,989017265,A016060,감,산딸기(500G/박스),12900,12900,0
2018-06-01,529523693,C012040,여자학생복,보풀방지 와인 교복조끼여자 교복 예쁜교복 교복쇼핑,23160,22470,-690
2018-06-01,936273320,E041010,식기,[고급산삼티타늄수저4P-우단케이스] 스푼세트 수저세트 숟가락세트 부부수저세트 예쁜,71800,71800,0
2018-06-01,1942156962,A018040,아이스크림,업소용/아이스크림/라벨리/프리미엄10리터/무료배송,42000,42000,0
2018-06-01,1751959196,L021010,손목시계,MARCJACOBS MJ1450 마크제이콥스 여성용 가죽밴드 패션시계,189000,189000,0
2018-06-01,1422953638,A013010,갈치,제주 옥돔 프리미엄 3kg 마리당450g내외 선물포장,236140,236140,0
2018-06-01,895857963,A018080,설탕,[삼양]삼양 큐원 하얀 설탕 1kg,1750,1750,0
2018-06-01,1751959194,L021010,손목시계,MARCJACOBS MJ3461 마크제이콥스 여성용 메탈밴드 패션시계,229000,229000,0
2018-06-01,1751959193,L021010,손목시계,MARCJACOBS MJ3474 마크제이콥스 여성용 메탈밴드 패션시계,229000,229000,0
2018-06-01,1068202522,C013010,점퍼,[모다아울렛][쉬즈미스]캐쥬얼점퍼야구점퍼(SWWJPI10040-LB),109000,103550,-5450
2018-06-01,104979936,C013050,운동복,타이어 공기주입기 에어게이지 컴프레셔 에어 자동차,6900,6900,0
2018-06-01,1644334464,C015030,넥타이,턱시도벨트 커머번드 넥타이 웨딩촬영 결혼식 예복,15000,15000,0
2018-06-01,366313464,L021020,장신구,[골드리아:실버은반지 모음] 싱글링/우정링/여자반지,25000,25000,0
2018-06-01,502925298,L021010,손목시계,BELCARINO 라운드 금장 남녀공용 손목시계 MV203018,61620,61620,0
2018-06-01,1751959192,L021010,손목시계,MARCJACOBS MJ1523 마크제이콥스 여성용 가죽밴드 패션시계,229000,229000,0
2018-06-01,1500635872,A017220,양파,[우리가락]깐쪽파 한단,19200,19200,0
2018-06-01,1751959191,L021010,손목시계,MARCJACOBS MJ1437 마크제이콥스 여성용 가죽밴드 패션시계,239000,239000,0
2018-06-01,1278850024,D031010,주택수선재료,본크리트 투명 기초방수재 18L (기초  발수),70000,70000,0
2018-06-01,845174248,A011180,파스타면,펠리체티 유기농 통밀 스파게티500g/파스타,3900,3900,0
2018-06-01,952703377,C012030,여자상의,나봉월드 44~110 빅사이즈 쉬폰 플라워 롱원피스,9900,9900,0
2018-06-01,2061318703,E041070,밀폐용기,스텐밧드 밧드 바트 소스통 업소용 주방용품 반찬통,5700,5150,-550
2018-06-01,1678511160,C013040,청바지,[크로커다일] 블루 뱀부 쿨킨 팬츠 CDAA3PT2542_VIP,39000,31200,-7800
2018-06-01,1948292646,A021010,커피,깜짝폭풍특가! 맥스웰하우스 아로마900g/마일드/마일,3070,2890,-180
2018-06-01,918104452,C014020,유아복,두툼한 유아 패딩점퍼_유아동패딩_안나 여아 패딩점퍼,39900,39110,-790
2018-06-01,293179600,C012040,여자학생복,DRM0130R 브이넥 언발 조끼 803 여자조끼 여성브이넥,40790,40790,0
2018-06-01,534923613,A021010,커피,테이스터스 초이스500g(자판기용)/맥심모카/오리지날,10850,10200,-650
2018-06-01,945786994,A018060,스낵과자,새우깡 90g x 20봉 매운새우깡/쌀새우깡,16900,16900,0
2018-06-01,118795570,A017170,풋고추,오이 취청오이 10kg 1박스,26900,26900,0
2018-06-01,1597144590,F011130,홍삼,정관장 홍삼분리미티드(90G),85000,85000,0
2018-06-01,459342612,C015040,장갑,핫팩 방한방수 벙어리 여성장갑 방수장갑 핫팩 겨울장,19600,19600,0
2018-06-01,459198565,A017230,마늘,2018 햇양파 상/대품 4kg/8900원,8900,8900,0
2018-06-01,690871055,C015030,넥타이,검정넥타이/블랙타이/조문용타이/조문/장례/장례식타이/경조사타이/경조사/수동넥타이,3900,3900,0
2018-06-01,1752708582,C013040,청바지,남자 7부청바지 스키니진 청반바지 9부바지 데님바지,19000,19000,0
2018-06-01,887969122,A022020,두유,연세두유 유기농 무첨가 검은콩 두유 190ml x 48팩,24910,24910,0
2018-06-01,1806242303,L021020,장신구,[바보사랑][은침] 프레디 리본 귀걸이,11000,11000,0
2018-06-01,989017241,A011120,두부,초L 아몬드 시리얼 400G,5990,5990,0
2018-06-01,1705776860,A013150,어묵,부산어묵 지역명물 수제 오뎅 36종/어묵/제조사직송,2000,2000,0
2018-06-01,1806242301,L021020,장신구,[바보사랑]프리토 진주 귀걸이,7000,7000,0
2018-06-01,1757857895,L012110,색조화장품,시세이도 퍼펙트 UV 프로텍터 파란자차 50ml/하늘자차,42900,42900,0
2018-06-01,2550817,C013050,운동복,JBROS 자체제작! The 착한 냉동고 시리즈 7종,10000,10000,0
2018-06-01,319536847,C013050,운동복,360도 관절형 보조미러 - 차량용품,28590,23420,-5170
2018-06-01,895833995,E061030,전구,GE 프리미엄 2관 36주광,11900,11900,0
2018-06-01,1983495742,E041070,밀폐용기,락스타 햇밥 전자렌지용기 밥용기 밀폐용기 냉동밥,6000,5900,-100
2018-06-01,895772432,A011130,시리얼,[오뚜기]오뚜기 빵가루 500g,2990,2990,0
2018-06-01,656994385,A013120,낙지,맛있게 구운 오징어채 250g/마른오징어 건어물 안주,23990,23990,0
2018-06-01,1890477266,I031010,장난감,전동 오토바이 에버바이크 선물 유아 스쿠터 사이클,116100,110300,-5800
2018-06-01,1285423531,C013020,티셔츠,SET276-레임 가죽 뷔스티에 티셔츠 SET 라운드티셔츠,21040,19990,-1050
2018-06-01,636898725,A021010,커피,갓볶은 원두커피 500g+500g/무배/당일로스팅/홀릭커피,12900,12900,0
2018-06-01,2084814702,E031120,믹서,[매직쉐프] 믹서기 텀블러 미니믹서기 블렌더 MEB-F450G 그레이,54000,49000,-5000
2018-06-01,508042834,C013040,청바지,[시크헤라] 피노데님팬츠.A,32900,32900,0
2018-06-01,895833992,A017280,김,일미 우엉플러스단무지 (250G),3280,3280,0
2018-06-01,1328224012,A021010,커피,프렌치카페 카페믹스 160Tx2개 총320T,30900,30900,0
2018-06-01,112417410,A016040,포도,동원)황도 슬라이스 400g x 12개 사시사철 맛있는,38450,38450,0
2018-06-01,959406193,A012060,햄및베이컨,CJ 스팸200G*6입기획,17300,12990,-4310
2018-06-01,1060272899,L021010,손목시계,DW 다니엘웰링턴 0505DW 여성 나토밴드 패션시계,135000,135000,0
2018-06-01,1060272897,L021010,손목시계,DW 다니엘웰링턴 0506DW 여성 나토밴드 패션시계,135000,135000,0
2018-06-01,2001761534,C012040,여자학생복,[화이트폭스] 여름신상 셔츠/무지/체크/스트라이프,14500,14500,0
2018-06-01,1169477684,C013010,점퍼,남성자켓/블레이져/트렌치코트/봄코트/캐주얼자켓,30000,22800,-7200
2018-06-01,1094365816,C013020,티셔츠,여성 사이드 SHARK 빅로고 반팔 티셔츠DWRT9D731/ 디스커버리,35400,30090,-5310
2018-06-01,941925500,A018100,꿀,단호박고구마차 호박고구마차 고구마차 호박차 국산차,10300,10300,0
2018-06-01,1932197515,A017090,열무,(yk식자재) 삶은 무청 시래기/국내산/1kgX10 1BOX,26000,25740,-260
2018-06-01,1056496587,E031020,가스레인지,[SK매직] 무연 무수 그릴 최고급형 가스오븐레인지 GORS7700,1026670,975340,-51330
2018-06-01,1459894873,C013010,점퍼,화이트폭스 여름신상 토탈룩! 예쁨가득! 멀티코디룩!,11900,11900,0
2018-06-01,754196403,L021030,가방,[타거스 정품]Targus TCG460 15.6인치 서류형/일반형 노트북 가방 탑로드[Targus TCG,80000,79000,-1000
2018-06-01,240660084,C015030,넥타이,(색상 : 네이비) BTIE_093 장미 패턴 보타이,13420,13420,0
2018-06-01,1568054857,E021020,커튼,집들이선물 인테리어 패브릭포스터 예쁜그림 커튼,25900,25900,0
2018-06-01,441896515,A015020,식용유,해표고추맛기름1.8L 고추유 고추맛기름 고추기름 요,15020,15020,0
2018-06-01,468587148,I053010,공책,묶음상품 플라스틱링(32mm)백색 50개입x3개 제본용플,58160,58160,0
2018-06-01,377429890,L012090,기초화장품,빌리프 프라블럼 솔루션 모이스춰라이저 125ml/로션,29900,29900,0
2018-06-01,1268857706,A011040,보리쌀,병아리콩4kg 흰강낭콩 (네이비빈) 렌틸콩 / 슈퍼푸드,6500,6500,0
2018-06-01,256309485,A022050,탄산음료,일화 맥콜 업소용 160ml x 30캔 / 캔음료 탄산 음료수,7500,7500,0
2018-06-01,631917618,C011030,남자학생복,패딩점퍼 겨울패딩 JK543W 빅사이즈,82750,80270,-2480
2018-06-01,1741582429,E031120,믹서,[이누스] 초고속 진공 블렌더 V38,398000,398000,0
2018-06-01,416892579,E031070,에어컨,특가] 제이닉스 벽걸이선풍기 리모콘선풍기,19800,19800,0
2018-06-01,345792059,C013010,점퍼,[테이트]남성 쿨매쉬 블럭배색 블루종(KA8U4-MGJ030/410)[갤러리아],69500,53520,-15980
2018-06-01,1482932768,A019070,양념소스,매기 씨즈닝 1000g /미극장,12000,12000,0
2018-06-01,508691539,C013020,티셔츠,[MLB] 남여공용 와펜로고 반팔 티셔츠 (31TSD1831),33000,28050,-4950
2018-06-01,2147136376,A013170,생선통조림,유동 자연산 골뱅이 230g / 140g / 입수량(1박스),107800,107800,0
2018-06-01,895831234,A022020,두유,[정식품]정식품 검은콩과 검은참깨 190ML*24입,23390,10980,-12410
2018-06-01,1714191108,I031040,생화,SOS 생존용품 재난 생존 도구 용품 서바이벌키트 캠핑,8000,7900,-100
2018-06-01,474557896,A022010,주스,코카콜라 미닛메이드 스파클링 사과 350ml 24개 캔음,28000,27160,-840
2018-06-01,618415317,E021020,커튼,창안애 실커튼 커텐/가리개/창문거실/비즈발/인테리어,4700,4700,0
2018-06-01,902252580,E011050,책상,스틸 사무실 인테리어 강화유리책상 사무용컴퓨터책상,104000,100880,-3120
2018-06-01,2060449398,L021010,손목시계,스포츠 전자시계 방수시계 패션시계 손목시계 군인시계,8900,8900,0
2018-06-01,336342385,E011070,식탁,#NAME?,124900,99900,-25000
2018-06-01,1060272873,L021010,손목시계,DW 다니엘웰링턴 0601DW 여성 나토밴드 패션시계,143000,143000,0
2018-06-01,1060272872,L021010,손목시계,DW 다니엘웰링턴 0900DW 여성 가죽밴드 패션시계,135000,135000,0
2018-06-01,1687374390,E011070,식탁,오스틴 빈스 6인식탁세트/의자/벤치/원목식탁,319000,319000,0
2018-06-01,879364361,A019080,고추장,[CJ직배송] 알찬고추장 6.5kg,18760,18760,0
2018-06-01,1060272870,L021010,손목시계,DW 다니엘웰링턴 0509DW 여성 나토밴드 패션시계,137000,137000,0
2018-06-01,1744632711,L012030,칫솔,부광 안티프라그 초극세모 칫솔 20개/탄력모칫솔/치약,7900,6900,-1000
2018-06-01,1806242334,L021020,장신구,[바보사랑]시크 롱 드롭 은침귀걸이,11120,11120,0
2018-06-01,1042304054,A017230,마늘,창녕 순수양파즙 50포 우포바이오푸드,15900,15900,0
2018-06-01,1800432674,A017140,콩나물,도라지가루 200g 도라지가루효능 약도라지 도라지효능,18660,18660,0
2018-06-01,1498089830,C012060,여자내의,빅사이즈/페미닌/레이스/스커트 페미닌레이스스커트,56200,56200,0
2018-06-01,879364362,A019060,된장,[CJ직배송] 구수한집된장 14kg,50150,50150,0
2018-06-01,1203742371,A013070,굴,선주직송 포항 영덕대게/고급 박달대게 당일조업발송,54900,54900,0
2018-06-01,943553119,E061040,부엌용세제,메소드 주방세제 800mlx3 세이프 퐁퐁 트리오 참그린,9000,8900,-100
2018-06-01,332519572,C012040,여자학생복,[디어제인][디어제인]리프레이스로브가디건M4550,9900,9410,-490
2018-06-01,1721462790,C012030,여자상의,봄 타이트미니원피스/나시/슬림/랩/섹시/클럽/홀복,26800,26800,0
2018-06-01,1806242331,L021020,장신구,[바보사랑]My Bloom Gray and Blue Flower Earrings,19500,19500,0
2018-06-01,1720160542,E041070,밀폐용기,인콕 스텐콕 직사각형 납작이형 스텐 밀폐용기 모음전,6000,5430,-570
2018-06-01,1060272869,L021010,손목시계,DW 다니엘웰링턴 0604DW 여성 나토밴드 패션시계,139000,139000,0
2018-06-01,177628635,A011080,밀가루,봉평 메밀국수 400g / 국내산 메밀 100% / 봉평 산지직배송,12900,12900,0
2018-06-01,2120709981,C014020,유아복,아둘 가족티 유아 콜라 나그랑 레글런 반팔티 12,11100,11100,0
2018-06-01,928603265,C015040,장갑,포인트 여성 등산장갑 여자 등산 장갑 여름등산장갑,11000,10020,-980
2018-06-01,631942604,C012020,원피스,빅사이즈/옆/트임/루즈/롱/가디건 빅사이즈,41100,39870,-1230
2018-06-01,881930203,F011130,홍삼,[천제명] 홍삼 세트 모음,37000,37000,0
2018-06-01,2120709977,C014020,유아복,아둘 가족티 유아 콜라 나그랑 레글런 반팔티 11,11100,11100,0
2018-06-01,1842998091,I011010,TV,월드컵 티비 대우루컴즈 T5502TU 55인치 HDR UHD TV,589000,589000,0
2018-06-01,1619246560,E031050,냉장고,[상품평5만]인증점 삼성 김치냉장고 RQ51N92D07Z 505L,2299000,1730970,-568030
2018-06-01,2023016391,C011050,남자내의,남자면바지 밴딩팬츠 9부10부 슬랙스 치노 린넨마바지,17800,14800,-3000
2018-06-01,380913929,A015020,식용유,[올리타리아] 포도씨유500ml 2병 (선물세트),14500,14500,0
2018-06-01,440055985,C012040,여자학생복,[구제]시스템 니트/여성S/반팔/카라넥/스웨터/NG5255,17900,17900,0
2018-06-01,455988398,C013040,청바지,[컨셉원] 118503 라이트 웨이트 TR 테이퍼드 핏 슬랙스 (10118503),59800,47840,-11960
2018-06-01,2094473676,F012010,종이기저귀,킨도 독일 프리미엄 기저귀 밴드형 3팩 (2/3/4/5단계),39900,39900,0
2018-06-01,160208642,A013120,낙지,국산오징어 오다리 1kg 백족 반건조오징어다리,35900,35900,0
2018-06-01,1230217109,C012060,여자내의,빅사이즈/엔젤/쉬폰/스커트 엔젤쉬폰스커트 빅사이즈,36870,35770,-1100
2018-06-01,814299590,C014010,아동복,[키키제제]여아 맨투맨/반팔티/롱티/블라우스/원피스,10900,10900,0
2018-06-01,1415588626,C013010,점퍼,아디다스 티로17 트레이닝자켓(BJ9294) 추리닝자켓 트,75320,75320,0
2018-06-01,849224452,A019080,고추장,ⓒ 해찬들 태양초 고추장 (봉)(500G),5700,5700,0
2018-06-01,316028597,C013050,운동복,(518677)(마이툴) 칼라콘 안전칼라콘 차량안전대 자동,18810,18810,0
2018-06-01,622733912,F012020,생리대,[좋은느낌] 좋은느낌 팬티라이너 오가닉 순면커버 롱 36pX6개,27900,27900,0
2018-06-01,1250342818,C015030,넥타이,나비 넥타이 초특가/보타이/보우타이/리본타이,2700,2700,0
2018-06-01,1469453306,C012020,원피스,[파프리카]트위드배색미니원피스_N81OP101(대구신세계),39200,34990,-4210
2018-06-01,436532895,C013010,점퍼,윈드 에디션 지퍼 점퍼 (아이보리) 봄가을용 패션점퍼,20370,20370,0
2018-06-01,1806242359,L021020,장신구,[바보사랑]티타늄 물방울 하객 웨딩 드롭귀걸이,13520,13520,0
2018-06-01,982676528,A019060,된장,풀무원 찬마루시골강된장3입기획,3650,3650,0
2018-06-01,1011948916,I031040,생화,CH1[버드몰]60년 전통의 캠핑도끼/크롬해머/팩망치/캠핑망치/손도끼/도끼/휴대용도끼/,10000,9110,-890
2018-06-01,468587180,C013020,티셔츠,T1434-셔링 무지 티셔츠 캐주얼티셔츠 여성캐주얼티셔,12620,12620,0
2018-06-01,169802421,C012040,여자학생복,머플러 숄 가디건 보온 패션 여성 디자인 겨울 담요,9920,9920,0
2018-06-01,2144665672,E011020,침대,[동서가구]LV 평상형 편백 원목침대 SS/Q 단독특가,244000,219000,-25000
2018-06-01,657056229,A011130,시리얼,오뚜기 바삭하고 고소한 부침가루 1kg X 10EA 튀김분,37990,37990,0
2018-06-01,1989820147,E021010,침구,겨울왕국 면기모 패드 - 뷰티선샤인 (064187) 까는이,63290,57650,-5640
2018-06-01,140806083,A012010,국산쇠고기,정남진 장흥한牛 장흥한우 꽃등심 1kg 500g 2팩 한우,181880,161880,-20000
2018-06-01,137913258,L012110,색조화장품,랑콤 UV 엑스퍼트 유스 쉴드 BB 컴플리트01 30ml/50ml,52500,52500,0
2018-06-01,1470660535,A017040,양배추,(맛나)#쑥갓(국산.단),5700,5130,-570
2018-06-01,820818324,C013020,티셔츠,롱티/원피스 반팔 빅사이즈 루즈핏 여름 박스 쁘니걸,15900,12900,-3000
2018-06-01,1055147790,C011030,남자학생복,밀란시아 빅사이즈 꽈배기 브이조끼 bom11-2 빅사이즈,34650,33960,-690
2018-06-01,330325209,C013060,등산복,모든상사/4300원부터/여름신상/등산바지등산복티,8900,7790,-1110
2018-06-01,2117011947,C012060,여자내의,밸리걸 매쉬 플레어 스커트 (592501),29900,25420,-4480
2018-06-01,267499792,C021010,아동화,잠뜰운동화 캐릭터 신발 아동화 아동신발 학생 어린이,40500,39290,-1210
2018-06-01,633978166,L021030,가방,투카노 COMPATTO 콤빠또 초경량/여행 백팩/파우치,35000,28000,-7000
2018-06-01,1342068699,A013070,굴,캐나다산 최상급 살아있는 랍스타 1~3kg 수입직송,49700,49700,0
2018-06-01,1329322211,E061030,전구,국산 LED직부등 욕실등 직부등 LED센서등 LED조명,4950,4950,0
2018-06-01,1914172274,C011030,남자학생복,[에디션 앤드지(EDITION ANDZ)]18 S/S 린넨소재 캐주얼셔츠 12종 택1(BEY2WC1501 외)(,45000,37110,-7890
2018-06-01,895772495,A019130,스프,[오뚜기]오뚜기 야채스프 80g,1690,1690,0
2018-06-01,895772493,A015020,식용유,오뚜기 식용유 1.8L,7310,7310,0
2018-06-01,895772494,A015020,식용유,[오뚜기]오뚜기 식용유 (900ml),4500,4500,0
2018-06-01,578049349,A017120,고구마,감자 1kg 깐감자 껍질제거 휴게소 알감자 야채 채소,4900,4900,0
2018-06-01,895772492,A011090,국수,[오뚜기]오뚜기 프레스코 스파게티면 (500G),2790,2390,-400
2018-06-01,1232281256,I031040,생화,K4CAMP 캠핑 LED 2in1 휴대용 해충킬러 랜턴 모기,19800,18800,-1000
2018-06-01,958576523,I031040,생화,정품 DATREX / Made in U.S.A 미국명품 조난 및 비상 체온유지 은박 담요 조난 담요,9980,9020,-960
2018-06-01,1806242365,L021020,장신구,[바보사랑]데일리 귀걸이 6종 세트 23번,6320,6320,0
2018-06-01,1806242362,L021020,장신구,[바보사랑]써클 드롭 티타늄 귀걸이,11920,11920,0
2018-06-01,1879601338,C011030,남자학생복,여름신상 남자셔츠/빅사이즈/반팔/와이셔츠/남방/체크,15800,15800,0
2018-06-01,996840133,C013050,운동복,아디다스 키즈 에스르마 반팔 반바지 세트_총 4컬러,26900,26900,0
2018-06-01,265568363,I053010,공책,클래식 양장노트 무선 클래식무선노트 무선노트 예쁜,10500,10500,0
2018-06-01,1694016132,I011030,사진기,소니코리아정품 DSC-RX10 IV / RX10M4 디카셀러,2250000,2159040,-90960
2018-06-01,918611859,A011160,빵,신라명과 선물세트(카스테라/마드레느/첫눈애바나나),8900,8900,0
2018-06-01,258973459,E041070,밀폐용기,스텐 바트 밧드 드레인 물받이 보관 저장 용기 반찬통,5900,5430,-470
2018-06-01,584296700,C012040,여자학생복,[꾸즈]롱니트중심라인CF2TF11,39000,32760,-6240
2018-06-01,1296635828,C012040,여자학생복,[로엠] [로엠]베이직민소매블라우스(RMBN725R01),29900,9000,-20900
2018-06-01,482886419,C012060,여자내의,국내산 여름시원한 리넨 멜빵 와이드 슬랙스 앵클팬츠,13900,13900,0
2018-06-01,2071143058,C012040,여자학생복,라엘 가디건 LBR0672 여성가디건 가디건 / 참고 여성,97500,82880,-14620
2018-06-01,1511989192,C014010,아동복,[트윈키즈(TWINKIDS)] 남아 헨리넥 린넨 반팔 셔츠/ 트윈키즈,12500,11130,-1370
2018-06-01,1233509733,C013030,스웨터,폴라티 반팔 MJ7202_7209 마르잔 빅사이즈 반팔티,28130,27570,-560
2018-06-01,400112835,A011170,떡,쫄깃한 순 쌀떡 칠갑 500g X 15,28520,28520,0
2018-06-01,906133427,A019080,고추장,청매실고추장/잘되는맛집된장/태양초고추장/된장/진미,14900,14900,0
2018-06-01,1574716286,E011060,의자,카페의자 베스트모음 카페의자 빈티지 인테리어의자,29900,29900,0
2018-06-01,1754421403,C011050,남자내의,엠포르스 여름/린넨바지/슬랙스/청바지/반팔티/7부티,12800,12800,0
2018-06-01,411718421,C013010,점퍼,[시에로]블루종 플라워 점퍼 (SC2JPF081),104900,86020,-18880
2018-06-01,2033022099,C012060,여자내의,오프라 맥시 롱스커트 DM-3800,13690,13150,-540
2018-06-01,1462066793,A012010,국산쇠고기,[무항생제] 불고기 300g 1+등급,18700,18700,0
2018-06-01,461655285,A017120,고구마,18년도 햇 감자 3kg/5kg/10kg,10900,10900,0
2018-06-01,893231877,C011050,남자내의,컨셉원 107501 워시드 코튼 버뮤다 팬츠 (10107501)/ 컨셉원,25000,20250,-4750
2018-06-01,1320558538,E011020,침대,프리미엄 패밀리침대 SS+SS 가드형 20T라텍스매트리스,790600,766890,-23710
2018-06-01,1352580516,C013050,운동복,에어워크 스판츄리닝/기능성트레이닝/운동복/츄리닝,49800,48800,-1000
2018-06-01,748734958,I031040,생화,고캠 랜턴스탠드S/탑앤탑L사이즈/양방향캠핑랜턴걸이,32000,29440,-2560
2018-06-01,415132212,C013020,티셔츠,빅사이즈 썸머브이넥티 BM1706 빅사이즈 여성의류 미,16500,16170,-330
2018-06-01,86709716,C012060,여자내의,허리끈 양털 반바지 겨울 핫팬츠 숏팬츠 여성 캐주얼,11220,11220,0
2018-06-01,50172940,C011030,남자학생복,인터페이스 제작 특양면가디건 Shut up자수 후드집,29700,29700,0
2018-06-01,670197105,C013030,스웨터,스토어15%![멋남]베스트! 티셔츠 셔츠 슬랙스 반팔,8900,8900,0
2018-06-01,1205744590,C013020,티셔츠,키즈 와펜 카라 티셔츠 _ PHV2TT4150,34800,17400,-17400
2018-06-01,524626122,F012020,생리대,뉴 템포 슈퍼 10P x 5팩 (총50P),15900,15900,0
2018-06-01,548727542,C013010,점퍼,신상 고급스런 퍼배색무스탕/양털자켓/연말모임/파티룩/뽀글이퍼,70900,69900,-1000
2018-06-01,1871875702,C013010,점퍼,퍼카라프릴무스탕,87900,87900,0
2018-06-01,1907503366,I031070,애완동물관리비,테니스/라켓/용품/초보/가방/엘보/추천/헤드/프린스,37000,35000,-2000
2018-06-01,1324080330,E021020,커튼,에쿠스 암막 콤비블라인드 소형 1 플러스 1 암막커튼,114660,111230,-3430
2018-06-01,1402615702,C012040,여자학생복,국산 여자 체크 남방/44~88까지/기본/롱/루즈핏 셔츠,15800,15800,0
2018-06-01,2010621264,E031120,믹서,필립스 HR2876/00 미니믹서 (빠른배송),52850,52850,0
2018-06-01,1647046111,A018070,파이,화이트하임/참잉/쿠크다스/칙촉/아이비/국희/산도,2000,2000,0
2018-06-01,1706929093,A018080,설탕,캐인슈가 비정제원당 유기농설탕 20kg-10kg/갈색설탕,30900,25600,-5300
2018-06-01,1687171600,A017010,배추,삶은 무청시래기10kg 시래기 단무지무청 다래순 나물,69000,69000,0
2018-06-01,1430153561,A017110,감자,[거시기장터]산지직송! 건강한 2018년 햇당근 3kg(상),5900,5900,0
2018-06-01,1361621797,C011050,남자내의,남자마바지/밴딩/반바지/린넨팬츠/슬랙스/린넨/마팬츠,12800,9800,-3000
2018-06-01,2076989595,A016020,배,나주 신고배 특가~가정용/선물용8kg(9900원),9900,9900,0
2018-06-01,1091675498,E031080,선풍기,후지카_ 벽걸이 할로겐 히터 FU-4817,38000,38000,0
2018-06-01,1091675493,E031080,선풍기,후지카_ 좌석용 할로겐 히터 FU-4811,43000,43000,0
2018-06-01,1311635319,I031040,생화,부산가자낚시-파도기-엡솔루트-청파기 갯바위릴낚시대,46000,38640,-7360
2018-06-01,1091675495,E031080,선풍기,후지카_ 벽걸이 세라믹 히터 FU-4816,36000,36000,0
2018-06-01,256179638,C013020,티셔츠,봄 여름 남자 냉감 티셔츠 등산 아이스 쿨 티 작업복,7400,7400,0
2018-06-01,1429896118,A019030,생강,편강진저빈 (국산 250gX2통) 선물세트,32800,29200,-3600
2018-06-01,883956405,A019160,밑반찬,차그림 과일원액 9종 모음/오렌지 키위 자몽 딸기 등,2800,2800,0
2018-06-01,1180173802,I011030,사진기,(주)거성카메라 200D/Body/정품/화이트/블랙,560810,515950,-44860
2018-06-01,1139963911,A018100,꿀,담터 벌꿀 1kg+1kg/대용량/아카시아꿀/다농원/국산꿀,15000,14700,-300
2018-06-01,374969873,L021030,가방,백팩/소가죽/여성/여행/책가방/가방/기저귀가방/CW01,67800,67800,0
2018-06-01,1477037203,E031120,믹서,리큅 공식인증점 RPM Quattro BS7 블렌더/국내생산,428050,394800,-33250
2018-06-01,1912014457,E031120,믹서,월풀정품/백화점모델/스탠드블랜더 믹서기ACB150IX/DN,79000,79000,0
2018-06-01,238816786,C015020,모자,(COLOR : 카키) MC-019 투버튼 포인트 군모,12740,12740,0
2018-06-01,340045570,A017280,김,단무지 쌈무 무쌈 반달 김밥 꼬들 압축단무지 일식,3500,3500,0
2018-06-01,614210668,A012060,햄및베이컨,[CJ]스팸클래식/마일드340gX6(카놀라유/햇반/스팸)택1,21900,21900,0
2018-06-01,1546157048,I031040,생화,캠핑 베터리 파워스테이션 파워뱅크/차량용/인버터,298000,274160,-23840
2018-06-01,1091675462,E031080,선풍기,유니맥스_ 미니 석영관히터 2단 UMH-2078,18500,18500,0
2018-06-01,318486160,C012040,여자학생복,수지네 빈티지 베이지 면혼방 조끼 여성 S 16-47,12680,12680,0
2018-06-01,789578325,A019080,고추장,해찬들 새콤달콤초고추장 1050g,2870,2870,0
2018-06-01,1969736465,C013020,티셔츠,남성 블럭 반팔 카라티셔츠 EPY2TT1103/ 엠폴햄,25000,21250,-3750
2018-06-01,1462776941,A012010,국산쇠고기,[무항생제] 불고기 300g 2등급,15300,15300,0
2018-06-01,59643257,C013040,청바지,리바이스 유아 아동 2 3세 청바지 정품 미사용/F02,20000,19800,-200
2018-06-01,1065765349,E041070,밀폐용기,스텐밧트 /PC밧드/반찬/냉장고/바트/양념통/밀폐/11,11500,10580,-920
2018-06-01,1892263480,C012040,여자학생복,모자이크 라운드 넥 반팔 니트 티 티셔츠 여성 스웨터,10420,10420,0
2018-06-01,2083921421,C012030,여자상의,키섬 라운드 원피스 니트세트 SD-6520 /(참고)니트원,55700,47350,-8350
2018-06-01,960540046,A018010,초콜릿,해태 글리코 포키 극세 44G,1200,1200,0
2018-06-01,1375568101,I011010,TV,[아이엠티비]/55인치TV/LG패널/UHDTV/무료스탠드설치,399000,379000,-20000
2018-06-01,192614646,L021010,손목시계,(국내당일발송)알마니시계 인기모델80여종풀세트발송,97000,97000,0
2018-06-01,1656077172,I031010,장난감,도티잠뜰 플레이블럭 6종피규어 도티 샌드박스 장난감,24900,24900,0
2018-06-01,1739460428,I011010,TV,공식파트너 삼성 80cm LED TV UN32M4010AFXKR,314000,299000,-15000
2018-06-01,24104566,D031010,주택수선재료,순앤수 항균페인트 DIY 멀티3.8L 방문/목재/벽지/벽면,38000,38000,0
2018-06-01,1811632884,C012020,원피스,[미스티에이치][미스티에이치] 양모 안감 집업코트,15000,13350,-1650
2018-06-01,986295723,A018050,비스킷,사과맛쿠키 75gx20개 1박스/ 딸기맛쿠키 20개 1박스,7900,7900,0
2018-06-01,2104204369,C013010,점퍼,봄 후드 가죽자켓 PU03 A WS가죽점퍼가죽자켓라이다자,140720,140720,0
2018-06-01,1609588393,F012020,생리대,바디피트 볼록맞춤 중형220P/생리대/오버나이트,35000,35000,0
2018-06-01,1975898730,C011050,남자내의,여름신상 고탄력 밴딩슬랙스 스판면바지 남성바지,17700,17700,0
2018-06-01,1210388721,C013040,청바지,[쿠키세븐]P6547 언발 컷팅 슬림 스트레이트진(S.M.L),39800,37810,-1990
2018-06-01,1295176078,C012020,원피스,[더아이잗][더아이잗] 더아이잗 하이넥 알파카 코트 IGCA0CT59 (P000363416),79000,71100,-7900
2018-06-01,1365071595,I031010,장난감,(Step2)병아리차 (2016.4.1 소비자가 인상) 자동차완,195940,195940,0
2018-06-01,1724918531,E021010,침구,[코튼렛]호텔콜렉션 광폭순면80수 이불커버세트(Q/SS),89900,89900,0
2018-06-01,1779137531,A015020,식용유,해표 식용유 / 백설 식용유 1.8L 콩기름 대두유,3300,3300,0
2018-06-01,918958388,L021060,유모차,리안 트윈 쌍둥이 절충형 유모차,418000,418000,0
2018-06-01,1323919367,C013050,운동복,[아스토레] (SIZE : 090) 본딩 히트자켓(ABL) - 우븐+,110640,110640,0
2018-06-01,1978910413,C011030,남자학생복,[써스데이아일랜드][18년 여름]등판 메탈자카드 루즈핏 가디건(T184MCD231W),139000,125100,-13900
2018-06-01,336089241,C014010,아동복,어린이 방한 마스크 WH0171 쿠루몬마스크 M,8720,8720,0
2018-06-01,1819333081,C011050,남자내의,슬림핏 바지 남자 면바지 롤업팬츠 배기바지 조거팬츠,14900,14900,0
2018-06-01,383134942,I011010,TV,NEX 55인치 UHD TV/ 삼성패널/ 스탠드 무료설치,530300,509000,-21300
2018-06-01,2076341719,E011010,장롱,레인 틈새장/옷장/투서랍/장농/이불장/장롱/수납,69000,62100,-6900
2018-06-01,448502417,C011050,남자내의,1+1봄신상/남자청바지/스판/일자/카고/롤업/빅사이즈,12800,12800,0
2018-06-01,1187271104,C013040,청바지,여성 구제 청바지 리바이스  디젤  CK  게스 등 다수,8900,8900,0
2018-06-01,1664036913,C011020,남자상의,남자 정장/블레이져/자켓/수트/캐주얼/남성/세트/마이,62000,57800,-4200
2018-06-01,786336451,A013090,전복,태안 자연산 바지락 10Kg / 칼국수용 산지직송,58000,58000,0
2018-06-01,1720184530,A019180,즉석식품,사조튀김모음/소세지/만두/햄/분식/떡볶이/튀김간식,6500,6500,0
2018-06-01,1050287392,E021010,침구,자연미학 어반 링클피그먼트 워싱이불3장 세트 퀸(Q),69900,69900,0
2018-06-01,750891319,C012060,여자내의,푸조 여성 워테레깅스 ( S26-2 ),28550,26560,-1990
2018-06-01,1431068266,A014040,발효유,(선인)슈크림라떼믹스1kgx10개(7000),70000,70000,0
2018-06-01,948305824,E061040,부엌용세제,닥터큐 우유분해 세정제 전문가용우유분해세척제 커피,44800,44800,0
2018-06-01,346675826,C014020,유아복,아둘 패밀리룩 커플룩 바캉스룩 별 롱원피스 티셔츠11,14300,14300,0
2018-06-01,503348104,L012010,면도기,질레트 퓨전 파워/퓨전프로글라이드면도기,6900,6900,0
2018-06-01,2006102740,E051030,디지털도어록,[빠른배송] 밀레 디지털 도어락 파인/카드키4개,53900,53900,0
2018-06-01,608708173,C013010,점퍼,[지이크] (PQF4212F4236) 봄 여름 남자 슬렉스 쿨팬츠 6종 택1,49000,39200,-9800
2018-06-01,900297003,L012080,화장지,크리넥스 콤비 (250매*3),7500,6400,-1100
2018-06-01,1324079362,E021020,커튼,루베스 콤비 블라인드 특대형 1 플러스 1 암막커튼 블,93080,90290,-2790
2018-06-01,729706278,F012010,종이기저귀,신제품론칭 팸퍼스 베이비드라이 기저귀 할인전,43900,41900,-2000
2018-06-01,2141818517,A016150,아몬드,[무료배송]본사직영하루견과인기모음/하루견과50낱봉,22900,22900,0
2018-06-01,229220208,L021020,장신구,[로로스피어싱] 9800원 무료배송!! 예쁜피어싱/써지컬,500,500,0
2018-06-01,32171696,A022010,주스,포도원액(참존 835ml)/ 식자재 전문,5100,5000,-100
2018-06-01,346675858,C014020,유아복,아둘 패밀리룩 커플룩 바캉스룩 별 롱원피스 티셔츠12,14300,14300,0
2018-06-01,172374734,C012020,원피스,원피스 투피스 청원피스 롱원피스 니트 봄 겨울 가을,24600,24600,0
2018-06-01,322875582,L012010,면도기,페리오키즈 양치세트 어린이/칫솔치약/칫솔/치약/세트,4500,4500,0
2018-06-01,744248184,C012060,여자내의,[나이스크랍] 뒷트임 기본 니트스커트 a182ksd201 [nc중계점],79000,47400,-31600
2018-06-01,2144472293,A018010,초콜릿,푸른농장 미니가나6000/밀크/마일드/크런키/ABC초콜릿,3250,3250,0
2018-06-01,1516742861,A021010,커피,[쿠폰가29 900원/당일출고]화이트골드 320T/모카 340T,32900,32900,0
2018-06-01,1045475144,E041070,밀폐용기,스텐 소스통 뼈통 BMP 양념통 휴지통 업소용 식당용,6000,5520,-480
2018-06-01,1933630763,C015040,장갑,버튼예식장갑 M 10개입 일반장갑 예식장갑 남자장갑,18110,18110,0
2018-06-01,1376219144,I031040,생화,코스모스 아이스박스/추천/낚시용/레저용/캠핑용/바퀴,96800,96800,0
2018-06-01,1795423370,A016120,바나나,필리핀산 고당도 바나나 13kg 1박스,28900,28900,0
2018-06-01,543691992,C012040,여자학생복,[악녀일기]라올가디건(4col),26880,23120,-3760
2018-06-01,426969581,E031020,가스레인지,린나이 스마트플러스센서 펄크리스탈 4구그릴 가스오븐레인지 RSF-BM82C,850000,775000,-75000
2018-06-01,1301787604,C013030,스웨터,(사이즈 : 105) MNT_123 배색 니트 라운드,45090,45090,0
2018-06-01,504592570,L021010,손목시계,시크스퀘어 화이트 손목 시계 MV201034BL 패션손목시,119020,119020,0
2018-06-01,387365916,C015030,넥타이,(색상 : 네이비) BTIE_066 타올 텍스쳐 보타,12740,12740,0
2018-06-01,1788563218,L012060,샴푸,사이오스 실리콘프리 리페어 샴푸 2개,16500,16500,0
2018-06-01,279817529,I012010,컴퓨터,애플정품 16년형 21.5형 New iMac MK452KH/A 4K레티나 아이맥신형/SG,2002900,2002900,0
2018-06-01,1897087995,E031020,가스레인지,린나이 가스레인지 RT-1003J 가스렌지2구 스마트센서,127000,127000,0
2018-06-01,2121841390,L021020,장신구,무료배송 925 실버 팔찌 은팔찌 발찌,20000,20000,0
2018-06-01,632896913,A011170,떡,전북고창 울어매 모시잎송편(2팩) 복분자송편(2팩)/10,84000,73920,-10080
2018-06-01,1292754983,C011030,남자학생복,[주노클럽]구스다운 울트라 라이트 경량 베스트,33800,29750,-4050
2018-06-01,2046020566,C012060,여자내의,[반에이크]플라워쯔글SK(VA85SKM318Z),25110,25110,0
2018-06-01,1336472366,A019180,즉석식품,사보레_럭셔리혼밥 7종구성 스테이크/코코뱅/불고기,6400,5120,-1280
2018-06-01,246450794,C012060,여자내의,타이거워싱 기모 청레깅스 JE-2905 레깅스 면레깅스 기본레깅스 치마레깅스 반바지레깅,5860,5220,-640
2018-06-01,1011059910,E041030,솥,[CUAN] 쿠앤 바일레 냄비 4종세트,180000,108000,-72000
2018-06-01,1997323761,E011020,침대,[골든잼]잣나무 천연 생황토 슈퍼싱글 돌침대/흙침대,2387100,2315490,-71610
2018-06-01,1997286252,E011020,침대,[골든잼]카우치보료/돌침대 흙침대 카우치소파 보료,722900,701220,-21680
2018-06-01,1091675406,E031080,선풍기,유니맥스_ 파티오 스탠드형 히터 UMH-6707S,60500,60500,0
2018-06-01,19929314,E011050,책상,해피클래스 1인용책상 2인용책상/서랍장/수납장,98900,98900,0
2018-06-01,985293391,A017180,호박,(친환경)오이맛고추 (봉),2990,2990,0
2018-06-01,636454988,A017250,고사리,청홍고추 봉 채소 파프리카 고추 열매채소,3280,3280,0
2018-06-01,1778736359,E031130,보온매트,일월 뉴숯 황토방 매트/전기장판/일월매트/전기요,59300,56240,-3060
2018-06-01,532152156,F012050,의료측정기,케어센스N 혈당시험지 2박스 100매+솜100매+침100개,31000,31000,0
2018-06-01,367519857,A017110,감자,제주 구좌 흙 당근 산지직송 3kg/5kg,25400,12700,-12700
2018-06-01,386483245,C012030,여자상의,포인트 라인 원피스 HM2216M805 빅사이즈,66570,62580,-3990
2018-06-01,529523786,C012060,여자내의,허리조절 스판 차콜 교복치마 교복 예쁜교복 교복쇼핑,43580,42280,-1300
2018-06-01,508595616,C013050,운동복,포워드 320L 대용량 루프백+논슬립패드/루프박스,101900,89070,-12830
2018-06-01,389039334,E061040,부엌용세제,무료배송/국산 백설공주 행주비누10개/세탁 세척 표백,12000,10500,-1500
2018-06-01,108005423,A016110,딸기,(냉동)국내산 딸기1kg,9820,9820,0
2018-06-01,610760250,C013040,청바지,[게스키즈] G76KDP911게스키즈데미지그레이스키니진,79000,55300,-23700
2018-06-01,2069973704,C012040,여자학생복,빅사이즈/밴딩/프릴/블라우스 / 참고 미시옷 임부복,54300,47790,-6510
2018-06-01,418761842,C012020,원피스,[BCBG] B8M4P335 체코니 린넨 팬츠,249000,224100,-24900
2018-06-01,1920500289,F011150,건강기능식품,독일산 발포비타민 20정x3통/비타하임/에너하임/특가,9700,9700,0
2018-06-01,741524702,I031010,장난감,에디카 뉴 클래식 붕붕카/장난감/승용완구/자동차/,29600,29600,0
2018-06-01,530475276,C012060,여자내의,백합주름치마 그레이 전체 주름 교복치마 교복 예쁜교,55060,53410,-1650
2018-06-01,801412970,A013020,명태,절단코다리 10kg-1box 코다리찜 조림 강정 손징 명태,48500,48500,0
2018-06-01,421412318,C011030,남자학생복,[동네방네]피에르 가르뎅 조끼 남성95,1500,1500,0
2018-06-01,996278917,C013050,운동복,갤로퍼-미르웨이 후사경/4WD/RV용품/사각지대/후진주차/현대/기아/대우/쌍용/겔로퍼,27000,24600,-2400
2018-06-01,896543156,A019100,식초,[오뚜기]오뚜기 과일과 야채 케찹 280g,1990,1990,0
2018-06-01,1697847039,C013020,티셔츠,(아띠벗) 봄신상/M~2XL/후드티/빅사이즈여성의류,17800,11800,-6000
2018-06-01,326622090,C012030,여자상의,심플골지이너원피스/섹시원피스/민소매원피스/롱나시,9900,9900,0
2018-06-01,1273245062,C012040,여자학생복,[구제]엘르 집업니트/여성M/울/가디건/골프/NG5243,25000,25000,0
2018-06-01,609832969,C012020,원피스,[플리츠미] 컬러 8부 통팬츠,39000,31200,-7800
2018-06-01,1326633299,C021040,실내화,[푸마] (SIZE : 270) 플레어 2(18951701) 신발 러닝,85190,85190,0
2018-06-01,1888970755,C011020,남자상의,[빅클로] 빅사이즈 슬랙스 정장바지 밴딩 신상,27900,27900,0
2018-06-01,293358496,C013010,점퍼,시크폭스 잇티드 후드집업/ 시크폭스,30500,23790,-6710
2018-06-01,428308316,C015040,장갑,남녀공용 패션 프리미엄 털장갑 AG1716019 남녀공용장,17720,17720,0
2018-06-01,23908472,E011040,소파,천연가죽소파 32종 모음전 3인/4인용/카우치 쇼파,788000,788000,0
2018-06-01,195938105,E011060,의자,야외등벤치모음 벤치의자 야외의자 정원벤치,123000,123000,0
2018-06-01,1707306407,A011080,밀가루,[백제물산]즉석쌀국수 24개+2개(추가)/30개+2개(추가),23500,23500,0
2018-06-01,1010382221,A011090,국수,삼양 짜장불닭볶음면 140G*4입,4980,3990,-990
2018-06-01,746396578,A016110,딸기,세미원 냉동 딸기 1kg 2개,25480,25480,0
2018-06-01,736111477,C011030,남자학생복,[포에버21]헤링본 베스트/FOREVER21/조끼/베스트/니트,58900,29450,-29450
2018-06-01,1203886031,A014040,발효유,청춘목장 수제요거트 순수 요거트 170ml 450ml 750ml,2200,2200,0
2018-06-01,479655421,C011020,남자상의,DIB1573 레오 트렌치 코트 803S 여성코트 버버리트렌,146980,146980,0
2018-06-01,1258862248,A011020,현미,삼원농산 2017년 찹쌀 10kg 100% 국내산,29300,29300,0
2018-06-01,1439939602,A016090,참외,달콤한 성주 꿀참외8kg,9500,9500,0
2018-06-01,989945624,E061020,섬유유연제,[AURA] 스파클링에메랄드 용기(1L),8900,4450,-4450
2018-06-01,416975373,E011050,책상,MT101W-M 높이조절 워크스테이션 화이트 높이조절책,630150,630150,0
2018-06-01,418761812,C012020,원피스,[BCBG]B8M5P340 레인보우 S/T 숏PT,159000,143100,-15900
2018-06-01,795042367,D031010,주택수선재료,계단미끄럼방지 논슬립 계단논슬립 미끄럼방지테이프,2500,2200,-300
2018-06-01,407344441,F012050,의료측정기,Spirit CK-110 메타혈압계+30A단면청진기증정,31180,29000,-2180
2018-06-01,1432322764,A022010,주스,[무료배송]웅진)자연은 포도100 180ml12개입 주스 포,14840,14840,0
2018-06-01,955887691,A018040,아이스크림,까페오레 10개,10000,4500,-5500
2018-06-01,1131896083,F012020,생리대,화이트 울트라/슬림(소/중/대/오버/수퍼롱)5팩/10팩,24500,24500,0
2018-06-01,812287790,C013060,등산복,여름 등산바지 남성 등산복 작업복 남자 아웃도어 7부,15700,14060,-1640
2018-06-01,1406533631,F012010,종이기저귀,(공식) 18년 군기저귀 오리지널 밴드 M (64매)X3팩,43900,43900,0
2018-06-01,34805021,E041010,식기,1+1 스마트 전자렌지용기/푸드커버/라면기 찜기 계란,7900,7270,-630
2018-06-01,1438059175,F012050,의료측정기,브라운 귀체온계 IRT-6520/6510+필터21p포함,80000,80000,0
2018-06-01,843617609,A013060,게,다인 냉동오징어 오징어채/무라사키/업소용/대용량,29000,29000,0
2018-06-01,1424906891,C013010,점퍼,걸크러쉬 슬림 가죽 자켓-m1071 (블랙) 여성용자켓 여,54020,54020,0
2018-06-01,1279309480,C013040,청바지,[패션24시30%쿠폰]플레이팝 여름신상 청바지/반바지,9900,9900,0
2018-06-01,1855781614,A013020,명태,곱게 다진 국산 순 대구살(120g 냉동),13900,13900,0
2018-06-01,635368685,E011040,소파,동서가구 북유럽풍 구스다운 3인용 가죽소파/쇼파,224100,224100,0
2018-06-01,1489900773,E041070,밀폐용기,신상품 라팔 더블 푸드박스/찬통/찬합/반찬통/도시락,3000,2490,-510
2018-06-01,1426606856,I031040,생화,손도끼 캠핑 휴대용 만능 미니 비상 망치 모종 야전삽,10800,10800,0
2018-06-01,895686099,A019030,생강,깐마늘 (200G/봉),3990,3990,0
2018-06-01,1689569806,F012050,의료측정기,휴비딕 써모파인더/비접촉 방식 체온계/HFS-900/,35800,33110,-2690
2018-06-01,433927925,D031010,주택수선재료,[슁글박사]옥상방수/지붕방수/슁글방수재/슁글방수제,39000,39000,0
2018-06-01,1946975719,A017280,김,[홈플러스][행사상품]한성_프리미엄김밥세트_440g,7590,7220,-370
2018-06-01,1291163379,C012030,여자상의,oo01 7부소매 스트랩 단가라 ops - 오렌지 원피스 여,18810,18810,0
2018-06-01,1407583526,A022050,탄산음료,펩시콜라245mlX24캔/칠성사이다/코카콜라/음료수,9460,8900,-560
2018-06-01,2090038978,C013020,티셔츠,[대구백화점 I관] [비지트인뉴욕]레터링박시티셔츠(VU5ST75),19000,16340,-2660
2018-06-01,706164163,A014010,우유,소화가잘되는우유 190mlx24팩 락토프리 멸균 소화우유,17500,17500,0
2018-06-01,453422484,A022030,생수,광동 힘찬하루 헛개차 1.5L 12개 야왕 옥수수수염차,18000,18000,0
2018-06-01,1076964040,I031040,생화,오토캠핑 ROTHCO PARACORD BRACELET 파라코드 팔찌 - 스포츠 팔찌,9900,9100,-800
2018-06-01,1292791896,C013020,티셔츠,정품 챔피온 맨투맨 후드집업 후드티 반팔티 빅사이즈,29900,29900,0
2018-06-01,1898483555,F011150,건강기능식품,[삼성제약공업] 까스명수 골드 75ml x 20개 소화제 까스활명수,12000,12000,0
2018-06-01,1487224248,E011050,책상,집중력 독서실 우등생 책상,48000,48000,0
2018-06-01,88194435,G011070,자전거,삼천리자전거 하로GS26/접이식자전거 MTB자전거,108890,98000,-10890
2018-06-01,25813238,C021040,실내화,[American Eagle][아메리칸이글][여성] 피프 토 플랫샌들 AFMS1KB9571A 001(센텀시티점,47920,44170,-3750
2018-06-01,1870441696,A021010,커피,맥스웰 아로마 마일드 커피믹스 900g 자판기용,4000,4000,0
2018-06-01,123654539,A011120,두부,[당일출고/무료배송]포스트크런치쉘350gx3개+증정,10900,10900,0
2018-06-01,2068311892,C013030,스웨터,남자니트 헨리넥 폴라 니트 / 참고 남자니트 남자스웨,53600,45560,-8040
2018-06-01,447069581,I053040,기타문구,더블에이 컬러 미니박스메모지 600매 (81x61) 혼합5색,2200,2200,0
2018-06-01,490422401,C013010,점퍼,[시에로](남녀공용) 시에로 오버핏 REAL 무스탕 라이더 자켓 (SA4LTU016),1140000,1090000,-50000
2018-06-01,323659631,C014020,유아복,한국 해피 마린 유아정장 3종 레드 (3-24개월)800014,74760,74760,0
2018-06-01,466060833,C012040,여자학생복,FREE 시원오버핏 롱긴팔여자니트가디건 하프가디건 여,22550,20300,-2250
2018-06-01,1293897232,C012060,여자내의,허리밴딩 치마같은 큐롯팬츠 숏팬츠 치마바지,8100,7700,-400
2018-06-01,1279346482,C011020,남자상의,CT02 남성 봄신상 트렌치코트 맥코트 오버핏 코트모음,24800,24800,0
2018-06-01,1579047406,I053030,복사용지,직배송 HP A4 복사용지(A4용지) 75g 2박스/더블에이,35930,30900,-5030
2018-06-01,1003640110,A017220,양파,꼬레촌조미 파(깐대파)최상품 1kg/5단,22700,22700,0
2018-06-01,96584347,L012090,기초화장품,헤라 옴므 CC크림 / 헤라 옴므 레포츠 선크림,20200,20200,0
2018-06-01,151826055,F012010,종이기저귀,메리즈 기저귀 일본내수용 팬티형3팩/밴드4팩,49900,49900,0
2018-06-01,1784188309,L021020,장신구,[바보사랑]두산 베어스 양의지 멀티실 팔찌,15000,15000,0
2018-06-01,1010382255,F011150,건강기능식품,[종근당] 글루코사민 프리미어큐 (관절건강 120정x2케이스) - 1박스,50000,24900,-25100
2018-06-01,988932727,L012030,칫솔,[페리오] 키즈 1단계(4개월-24개월) 2입x3개,11400,11400,0
2018-06-01,1784188308,L021020,장신구,[바보사랑]두산베어스 두산 베어스 박건우 멀티실 팔찌,15000,15000,0
2018-06-01,820207877,C011050,남자내의,905/레이스자수호피 허리 고무밴딩 스프사 9부 파자마,12640,11250,-1390
2018-06-01,1784188307,L021020,장신구,[바보사랑]두산베어스 양의지 클래식 열쇠고리,15000,15000,0
2018-06-01,1784188306,L021020,장신구,[바보사랑]두산베어스 김재환 클래식 열쇠고리,15000,15000,0
2018-06-01,1056927311,C014020,유아복,아둘 패밀리룩 가족티 유아 포티아노 반팔티 11,9600,9500,-100
2018-06-01,1514186399,A021010,커피,프렌치카페 120T+160T+맛쿡4P/커피/믹스커피,26600,26600,0
2018-06-01,1945636404,C013040,청바지,[젤리스푼]스트라이프해지데님팬츠,15900,14310,-1590
2018-06-01,64428063,L021060,유모차,킨즈무브2 유아웨건 디럭스 쌍둥이 유모차 매트증정,395000,395000,0
2018-06-01,866922786,C013060,등산복,몬태뉴 2018 NEW 드라이테크 라이트 쿨스킨 티셔츠,19800,19800,0
2018-06-01,1784188311,L021020,장신구,[바보사랑]두산 베어스 함덕주 팔찌,15000,15000,0
2018-06-01,182847417,A017090,열무,청정 자연건조 삶은 무우청 500gx3개 양구시래기 나물,29700,29700,0
2018-06-01,1784188310,L021020,장신구,[바보사랑]두산 베어스 김재환 멀티실 팔찌,15000,15000,0
2018-06-01,240635130,C021040,실내화,[푸마] (SIZE : 250) 플레어 2(18951703) 신발 러닝,85190,85190,0
2018-06-01,974756849,E061020,섬유유연제,다우니 드라이시트형 섬유유연제 40매/april fresh,3900,3900,0
2018-06-01,2124204147,C021040,실내화,가죽 키높이 통굽 슬립온 스니커즈 6cm 속굽 운동화,24900,23900,-1000
2018-06-01,1625298208,C011030,남자학생복,[레노마셔츠] 2018년 레노마 여름 반팔셔츠 29종중 택1 슬림핏19종/일반핏10종,24000,24000,0
2018-06-01,1803264054,L012030,칫솔,(덴티메이트 초미세모 칫솔 20개/30개)마이브러쉬 외,8900,8900,0
2018-06-01,961398347,A018050,비스킷,해태 에이스 436G,4700,3490,-1210
2018-06-01,1251255037,A019070,양념소스,(참소당 매운탕소스2kg) 동태탕양념 해물탕 알탕양념,16500,16500,0
2018-06-01,1010140107,A019060,된장,CJ 해찬들 그대로된장찌개 쇠고기 450G,5980,5980,0
2018-06-01,1010140108,A019060,된장,CJ 해찬들 그대로된장찌개 청양초 450G,5980,5980,0
2018-06-01,1066177227,D031010,주택수선재료,미앤미 편백나무 원목 조립식마루 18p 24p 베란다마루,39500,37530,-1970
2018-06-01,988114466,A018100,꿀,스페인 비폴렌 먹는 화분 꽃화분 미네랄 비타민 400g/,29900,29900,0
2018-06-01,464863840,E011060,의자,리클라인 베드체어 침대 사무용 책상 컴퓨터의자,143000,129580,-13420
2018-06-01,1749372777,C021040,실내화,아디다스 운동화 어드벤티지 외 17종택1 런닝화 신발,35000,30800,-4200
2018-06-01,151395104,A011020,현미,찹쌀(산들샘 1k)X10 식자재 업소용식자재 대량구매,75790,72010,-3780
2018-06-01,1091675439,E031080,선풍기,유니맥스_ 글라스 전기 컨벡터히터 UMH-2416CR,82000,82000,0
2018-06-01,986161331,L012030,칫솔,[LG]페리오 트리플액션 부드러운모3+3,6900,3990,-2910
2018-06-01,986161332,L012030,칫솔,페리오 트리플액션 미세모3+3,6900,3990,-2910
2018-06-01,1091675437,E031080,선풍기,유니맥스_ 벽걸이형 세라믹히터 UMH-6703WC,27100,27100,0
2018-06-01,1662744713,C011030,남자학생복,[ELLE] 최고급 스판 발수 교복 와이셔츠/블라우스 1+1,39900,39900,0
2018-06-01,488085555,E041010,식기,수정구/수정구슬/투명/구슬/풍수지리/인테리어소품,75400,73900,-1500
2018-06-01,808955244,I053030,복사용지,라인프렌즈 한솔 80g A4용지 2박스 5000매,39600,33520,-6080
2018-06-01,1782466989,L021010,손목시계,카파 손목시계 DS116UA 카파 손목시계 전자시계 스포,29630,29630,0
2018-06-01,1619151865,C013010,점퍼,메덱스 아웃도어 등산자켓 JK150 바람막이 빅사이즈점퍼 아웃도어 등산자켓 등산점퍼,90160,80250,-9910
2018-06-01,985293361,A017070,부추,(친환경)쌈모음 (200G/봉),2990,2990,0
2018-06-01,1152983412,A018070,파이,파이류 3곽 골라담기(11종)/초코파이/오예스/몽쉘,10500,10500,0
2018-06-01,268222653,I031040,생화,차량용 간이침대/캠핑침대/접이식침대/야전침대,74800,74800,0
2018-06-01,293179572,C021010,아동화,깜찍 딸기 슬립온 유아신발 (130-180mm) 900034 베이,31620,31620,0
2018-06-01,1238005097,E011050,책상,스마일 코너h형 본체서랍 책상세트,280000,277200,-2800
2018-06-01,2070719409,C013020,티셔츠,[인디안][인디안(INDIAN)]스포티엠보집업티셔츠_MIGASPM3461_01,19400,18430,-970
2018-06-01,85698660,A013090,전복,국내산 새꼬막 1.5kg (상) 새벽조업후 발송 산지,32960,32960,0
2018-06-01,1803805474,C013010,점퍼,앙팡 래쉬가드 집엎 (핑크) 래쉬가드 물놀이옷 어린이,21590,21590,0
2018-06-01,1784188338,L021020,장신구,[바보사랑]Moon and Star Cubic Zirconia Necklace,29000,29000,0
2018-06-01,1355806106,A012050,소시지,[롯데푸드] 롯데 키스틱 60gX78개/한박스/어린이간식/소시지/빅팜,36000,36000,0
2018-06-01,1569993970,A011120,두부,켈로그 에너지바x24개/크런치넛/레드베리/간식/과자,15000,15000,0
2018-06-01,442077129,C013050,운동복,F1-WJK007 우븐 자켓(YE) 트레이닝자켓 자켓 트레이닝,59570,59570,0
2018-06-01,40272458,C012040,여자학생복,폴로정품Big세일POLO004여자니트티 카라니트 반팔니트,38900,38900,0
2018-06-01,1784188339,L021020,장신구,[바보사랑]Cream Moon 천연 바로크 진주 Ring (6월 탄생석),95000,95000,0
2018-06-01,215512614,A018030,껌,웅진 졸음 확 깨는껌 108gx3통/자일리톨/졸음껌,9900,9900,0
2018-06-01,465323941,C013020,티셔츠,/쿨티/쿨티셔츠/쿨론티/단체티/헬스반바지/기능성티/,3000,3000,0
2018-06-01,675645555,E041030,솥,풍년 하이클래드 압력밥솥 15인 20인 25인용 세원,115000,115000,0
2018-06-01,175385002,A019060,된장,[1+1]청정원 순창 재래식生된장 500g+500g(사각),5800,5800,0
2018-06-01,290371925,A019110,드레싱,스키야키소스/일본식불고기양념/캠핑소스양념,7500,7500,0
2018-06-01,2082741748,C012020,원피스,[CC콜렉트]캐시미어 폭스퍼 멋스런코트(C174MSG009),339000,264420,-74580
2018-06-01,895772341,A019100,식초,[오뚜기]오뚜기 골드 마요네즈 800g,6500,6500,0
2018-06-01,1317917872,L021020,장신구,듀얼 큐빅 초커 목걸이 네크리스 화사한 엘레강스 초,24080,24080,0
2018-06-01,799550725,C012040,여자학생복,신상 반팔 최저가 국산 긴팔 스판 남방 블라우스,9800,9800,0
2018-06-01,2079750258,C011030,남자학생복,[리바이스] 리바이스/긴팔셔츠/청남방 658160006 [중청],48000,48000,0
2018-06-01,895772340,A019100,식초,[오뚜기]오뚜기 골드 마요네즈 500g,4300,4300,0
2018-06-01,1639511463,E011070,식탁,[아리아퍼니쳐]zodax 인기 식탁/4인 식탁세트/테이블,179000,179000,0
2018-06-01,687581393,C014010,아동복,[에꼴리에]에꼴리에 PNC02 5부슬림핏블루워싱진 18B0212,29800,28610,-1190
2018-06-01,175385000,A019060,된장,[1+1]청정원 순창 재래식生된장 1kg+1kg(사각),10800,10800,0
2018-06-01,1695127791,E021010,침구,주노베딩 시~원~한 시어서커 여름이불 S/Q 침구세트,59800,59800,0
2018-06-01,269114420,C013010,점퍼,빅사이즈 오버핏 야상 mir1711-001 빅사이즈 남성캐쥬,129660,129660,0
2018-06-01,2123279861,A012010,국산쇠고기,[무항생제] 찜갈비 800g 1+등급,93000,93000,0
2018-06-01,764780523,E031130,보온매트,토황토 온열매트(더블) 황토자연염색패드 세트,271900,271900,0
2018-06-01,1011060871,E041080,부엌용용구,[포트마이오] 스파이럴 그레이터,99000,49900,-49100
2018-06-01,1507049698,C013030,스웨터,[공구우먼] 펀칭 러블리 니트 28602 빅사이즈여성의류 루즈핏,27000,27000,0
2018-06-01,1311348596,C012030,여자상의,셔츠배색체크원피스 PE1710 여성간절기원피스 원피스,75090,75090,0
2018-06-01,895772339,A019100,식초,[오뚜기]오뚜기 골드 마요네즈 (300g),2800,2800,0
2018-06-01,764780522,E031130,보온매트,토황토 온열매트(싱글) 황토자연염색패드 세트,244700,244700,0
2018-06-01,1822385354,C014010,아동복,펑키 로봇 후드 티셔츠 (3-24개월) 201965,18200,16200,-2000
2018-06-01,895772337,A013170,생선통조림,[오뚜기]오뚜기 고추참치 150g*3,8390,8390,0
2018-06-01,15675199,C011050,남자내의,체크9부/주머니 착용감 좋은 체크 9부 주머니파자마,13900,12380,-1520
2018-06-01,895772334,A015010,참기름,[오뚜기]오뚜기 고추맛 기름 80ml,2150,2150,0
2018-06-01,448791269,C015030,넥타이,나비넥타이 보타이 니트 리본타이 셀프웨딩 파티용품,1900,1900,0
2018-06-01,895772333,A019050,간장,오뚜기 가쓰오장국 360ML,3150,3150,0
2018-06-01,890277811,E011020,침대,[동서가구]LV 호텔식 투매트리스 침대 4종 DF909810,239000,239000,0
2018-06-01,894496856,C013010,점퍼,[인터페이스]보온성까지 갖춘 봄자켓 항공점퍼/바람막,23700,23700,0
2018-06-01,1011060874,E041080,부엌용용구,[포트마이오] 애플필러,142000,85000,-57000
2018-06-01,763058893,F011150,건강기능식품,국산헛개차 CJ 헛개수 2L x 6팻 컨디션 헛개수,9800,9120,-680
2018-06-01,496930421,C011020,남자상의,블랙 체크 밍크털 코트 캐주얼코트 남성용코트 털코트,107100,107100,0
2018-06-01,988067770,F011130,홍삼,정관장 아이키커 오렌지맛 10팩,15900,9900,-6000
2018-06-01,1325259273,C011030,남자학생복,스타일리쉬 남자 여름 가디건 루즈핏 린넨 롱가디건,24800,21800,-3000
2018-06-01,1252895575,D031010,주택수선재료,히노끼편백 조립식마루/조립마루/벽체/루바패널바닥재,43900,39510,-4390
2018-06-01,1213845387,E031130,보온매트,#TV홈쇼핑정품# 황토매트/참숯매트/온열매트/온돌매트/싱글매트/더블매트/건강매트//일,129000,127710,-1290
2018-06-01,2026992210,A013170,생선통조림,[동원]자연산골뱅이 230g 원터치,3590,3590,0
2018-06-01,1217753770,F012020,생리대,좋은느낌 생리대 모음(소/중/대/오버/수퍼롱)5팩/10팩,33500,33500,0
2018-06-01,1611204563,E041020,컵,벌집진공 스텐 이중컵 보온보냉컵 모음,6140,6140,0
2018-06-01,1084083962,L012060,샴푸,올뉴 TS샴푸2개(500mlx2)티에스샴푸 뉴프리미엄샴푸,40800,40800,0
2018-06-01,1622862769,A017170,풋고추,국산100% 건 여주 1kg 여주열매 여주차 여주환 900g,32900,32900,0
2018-06-01,1719830237,I031040,생화,해먹스텐드+해먹(1+1세트)/캠핑용품/야전침대,49800,49800,0
2018-06-01,1546926210,A014050,달걀,[아침란]껍질이 잘 벗겨지는 무항생제 찐계란 30구,19800,19800,0
2018-06-01,1285593896,A014040,발효유,[아가프라]요구르트빨대60p/야구르트빨대/개별포장60,1000,1000,0
2018-06-01,716099547,A022030,생수,소다스트림 탄산수시럽 탄산에이드시럽 유기농시럽,14000,13500,-500
2018-06-01,1010382280,F011150,건강기능식품,[종근당] 칼슘 앤 마그네슘 비타민D 아연 (180정) - 2박스(총6개월분),60000,19900,-40100
2018-06-01,1944839329,E021010,침구,겨울왕국 면기모 패드 - 뷰티선샤인 (064187) 침구 요,65560,59720,-5840
2018-06-01,619896066,A013020,명태,동태16-18미 10.5kg 러시아산동태 두리반농산,40000,40000,0
2018-06-01,1096112398,I011010,TV,LG패널 이노스 32인치 LED TV E3200HC 2년무상AS,145000,135000,-10000
2018-06-01,407248558,C013010,점퍼,스테판조셉 프린티드 레인코트 프린세스A (택1) 우비,65290,62680,-2610
2018-06-01,383891485,C012020,원피스,마르엘라 로사티 SAGA 폭스카라 롱 밍크코트,598000,598000,0
2018-06-01,1452877952,E011050,책상,주)프리마/101/105입식독서실책상/DIY/가정용/,42800,41180,-1620
2018-06-01,1457664842,C013010,점퍼,시보리 배색 소매롤업 점퍼 MG2WZ562 MG2WZ562/ 매긴,43800,43800,0
2018-06-01,895772369,A018090,잼,[오뚜기]오뚜기 딸기잼(500g),4800,3490,-1310
2018-06-01,828896179,E031040,전기레인지,고급형 케익쇼케이스/제과쇼케이스 SCW-130L/SCW-160L,788000,788000,0
2018-06-01,1088816503,C011020,남자상의,봄정장자켓/여름정장자켓/정장콤비/캐주얼자켓/정장,68800,68800,0
2018-06-01,1010382281,F011150,건강기능식품,[종근당] 칼슘 앤 마그네슘 비타민D 아연 (180정) - 3박스(총9개월분),90000,31900,-58100
2018-06-01,895772368,A019070,양념소스,[오뚜기]오뚜기 중화 두반장 358g,4990,4490,-500
2018-06-01,423499353,A011100,라면,옛날국수(소면)10kg(1박스)/국수/소면/중면/칼국수/,36590,36590,0
2018-06-01,895772364,A011130,시리얼,[오뚜기]오뚜기 녹두 빈대떡 가루 (500g),6600,6600,0
2018-06-01,1313348429,C011030,남자학생복,밀란시아 비지니스캐쥬얼 원버튼 베스트 sh171-001 남,45500,44590,-910
2018-06-01,2110148277,C013020,티셔츠,데일리앤 여성나시 골지 롱나시 기본나시 끈나시,6800,6800,0
2018-06-01,1393508633,F012010,종이기저귀,리베로 기저귀/밴드형5단계 56매x4팩,69900,69900,0
2018-06-01,1271283658,A011100,라면,(식자재 박스판매)봉평 메밀 부침가루 골드플러스(메,158480,142640,-15840
2018-06-01,407224598,C013010,점퍼,스테판조셉 프린티드 레인코트 트럭B (택1) 레인코트,65290,62680,-2610
2018-06-01,726009879,A019090,카레,하우스카레 치킨/포크/보노스프 모음/햇반/컵밥/죽,1690,1690,0
2018-06-01,1469970044,C011050,남자내의,여양면파자마 면100 부드러운 소재 여성양면9부파자마,8260,7360,-900
2018-06-01,1010382279,F011150,건강기능식품,[종근당] 칼슘 앤 마그네슘 비타민D 아연 (180정) - 1박스(총3개월분),30000,11500,-18500
2018-06-01,1010382278,F011150,건강기능식품,[종근당] 글루코사민 프리미어큐 (관절건강 120정x2케이스) - 2박스,100000,49900,-50100
2018-06-01,827427848,F011150,건강기능식품,콘플레이크 천마차/흑미차/율무차/간식/선식/씨리얼,20000,18900,-1100
2018-06-01,549344519,I031010,장난감,소니 PS4 플스4 프로 + PS VR (신형 2세대) 3번세트,1105000,1105000,0
2018-06-01,1265868743,L021010,손목시계,로제타 여성 손목시계 FW-16 시계 손목시계 팔찌 팔찌,12960,12960,0
2018-06-01,818877147,C012040,여자학생복,이사벨 여성 100 울 후드 집업 니트 롱 자켓 가디건,34560,34560,0
2018-06-01,561148912,C012030,여자상의,원피스/봄원피스/스판원피스/플레어/나시 미니원피스,9900,9900,0
2018-06-01,1769213024,A018030,껌,껌모음/자일리톨/왓따/후라보노/쥬시/스피아/커피껌,6200,6200,0
2018-06-01,123666574,E011010,장롱,[라자가구]기획 옷장/장롱/장농/드레스룸,99000,88900,-10100
2018-06-01,1739303465,C013020,티셔츠,탐나나 여름신상! 린넨 반팔 긴팔 티셔츠 나시 남방,9900,9900,0
2018-06-01,988212906,A011010,쌀,Lgrow 찰진쌀 10KG/포,33900,33900,0
2018-06-01,415073500,C013040,청바지,EX 88 2 밴드 청반바지 청반바지 청5부 청 반바지 남,54190,53110,-1080
2018-06-01,591815375,E041010,식기,방짜/방짜유기/그릇/부부/반상기/놋그릇/세트/민자,620000,600000,-20000
2018-06-01,2090036396,A022010,주스,무료배송 태평마트 필리핀 수입 망고 퓨레 스위트 1kg 20개 농축 망고 쥬스 주스 과즙,320300,320300,0
2018-06-01,273011942,E031050,냉장고,T 위니아 딤채 쁘띠 소형김치냉장고 WDS10BPACP 100L,619000,589000,-30000
2018-06-01,1247663318,C013050,운동복,여름 쿨링베이직세트/츄리닝/트레인이복/냉장고바지,12500,12500,0
2018-06-01,78716632,C013020,티셔츠,빅사이즈/반팔/빅사이즈반팔티/빅사이즈반팔/L~XXX,5800,5800,0
2018-06-01,231822247,F011120,인삼,(장생농산장수산삼 7년근 7주(7뿌리) 산양산삼 선물용,285030,276480,-8550
2018-06-01,858951059,I011030,사진기,소니 세계 최소형 카메라 DSC-RX0 /RX0/공식대리점e,1018000,936560,-81440
2018-06-01,570322810,I031040,생화,버팔로 산토리니 와이드 캠핑의자 세트/캠핑 낚시의자,45000,39160,-5840
2018-06-01,119050369,E011030,거실장,[채우리] 시아 스틸 4단 선반,70000,70000,0
2018-06-01,384216490,E011070,식탁,베스트30종 홈바형 아일랜드식탁 조리대 식탁 테이블,89900,89900,0
2018-06-01,2136704061,F011150,건강기능식품,종근당 장을위한 생유산균 19 락토핏 180포/코스트코,34390,34390,0
2018-06-01,340405841,A019070,양념소스,이시봉족발 냉채소스 2kg 해파리냉채 부산냉채족발,12900,12900,0
2018-06-01,1430909866,E061050,청소용세제,1+1 곰팡이클린샷/제거+방지/500ml 2개/항균 99.9%,9900,9900,0
2018-06-01,576349566,C011050,남자내의,여름면바지 남자골프웨어쿨스판 바지 작업복 린넨바지,19800,19800,0
2018-06-01,378321374,C012040,여자학생복,[오빵스타일]린넨가디건여름가디건로이나 린넨 브이넥가디건,26000,24700,-1300
2018-06-01,1010201493,A014050,달걀,[풀무원]풀무원 동물복지목초란 10구,5490,5490,0
2018-06-01,115563022,A019040,소금,9회죽염 알갱이 250g/개암죽염 전통죽염 미네랄 죽염소금 고체 생활 대나무 황토 구회,60000,60000,0
2018-06-01,288190877,C012060,여자내의,[바비앤펌킨]몽글도트 롱스커트,61100,54990,-6110
2018-06-01,1612901210,E011070,식탁,규수방가구 로얄 4인 6인 용 회전 의자 원목 식탁,287770,259000,-28770
2018-06-01,198162793,F012020,생리대,화이트 생리대 시크릿홀 울트라 슬림 대형 32+10개입,10900,10900,0
2018-06-01,2069322120,C012040,여자학생복,빅사이즈/루즈/셔링/블라우스 / 참고 루즈셔링블라우,58700,49900,-8800
2018-06-01,168634437,A017220,양파,[맘스허브]국산 손질대파500g,3250,3250,0
2018-06-01,2091086668,F011120,인삼,(장생농산장수산삼 7년근 3주(3뿌리) 명절선물 선물세,136180,132100,-4080
2018-06-01,1764331148,C021010,아동화,레전드 하트리본아동 털하이탑운동화 /(참고) 레전드,51600,45410,-6190
2018-06-01,119050370,E011030,거실장,[채우리] 시아 스틸 3단 선반,50000,50000,0
2018-06-01,119050371,E011030,거실장,[채우리] 시아 스틸 테이블 세트,80000,80000,0
2018-06-01,119050372,E011030,거실장,[채우리] 시아 스틸 사이드 테이블,40000,40000,0
2018-06-01,1290186420,C011050,남자내의,아스토레 와이드 디렉션 팬츠(GRY)-기모 남자바지 남,54690,54690,0
2018-06-01,119050373,E011030,거실장,[채우리] 시아 스틸 소파 테이블,50000,50000,0
2018-06-01,1696415221,A011140,부침가루,[달콤한상상] 달상반점 치즈 케익 4입 / 수제디저트,14900,14900,0
2018-06-01,1476709558,A015020,식용유,백설 콩기름 1.8L / 바삭요리유 옥수수유 식용유 1.8L,3800,3800,0
2018-06-01,901167510,A016100,수박,SF)하우스밀감 900G/봉,9900,9900,0
2018-06-01,183560368,C014010,아동복,뿌찌 아동복 남아 여아 상하복 세트 복 트레이닝복 옷,14400,14400,0
2018-06-01,1464882022,E041070,밀폐용기,락앤락 파스타디쉬 1+1 오븐용기 파스타볼,7900,7270,-630
2018-06-01,141400325,E011020,침대,와이드 베드트레이 ver3 베드테이블 노트북트레이 노,72790,72790,0
2018-06-01,431828727,E011020,침대,홈잡스 칼렌 철제침대 (슈퍼싱글/퀸),260000,248000,-12000
2018-06-01,2055383,L021020,장신구,(실버) 니트 스틱 목걸이 (Gold Rose Gold) 골드목걸,23220,23220,0
2018-06-01,1783874787,A017180,호박,국산 햇 아삭이고추4kg 할라피뇨 탈라피뇨 퍼팩토,34900,34900,0
2018-06-01,858808835,C013020,티셔츠,브리치X트로디 신상 53종 특가!,18900,18900,0
2018-06-01,1977406836,A018010,초콜릿,무배) ABC 초콜릿 200gx3봉 크런키/가나/크리미츄,11900,11900,0
2018-06-01,1251928023,C013010,점퍼,[플라스틱아일랜드]폼폼이 롱 다운 점퍼(PH4EZ161),109000,85020,-23980
2018-06-01,1329576741,C014010,아동복,스텐레스 고급형 참빗,6260,5950,-310
2018-06-01,1010139177,A011010,쌀,농부의미소 20KG/포,69900,69900,0
2018-06-01,1885187675,L021020,장신구,도금)캐리 열쇠 목걸이(RG)주얼리 악세사리 기념일 기,15690,15690,0
2018-06-01,739247856,A019060,된장,[농협] 우리땅우리콩 전통식 재래된장 800g,12900,11900,-1000
2018-06-01,1387555924,C013010,점퍼,AG 후드 집업점퍼 BOX 올웨이즈 오픈 CC 집업 잠바 집,52100,52100,0
2018-06-01,1142581654,C012030,여자상의,지금살옷 원피스/44-110/빅사이즈/정장/플라워 패턴,25800,9800,-16000
2018-06-01,277662820,A017020,상추,모듬쌈채소 1kg/2kg싱싱야채 최상품(온새미로푸드),11600,11600,0
2018-06-01,1771132335,A018010,초콜릿,누텔라 210gx2병 / 370gx2병 초콜릿/누텔라 앤고 T1,8900,8900,0
2018-06-01,240228754,C013020,티셔츠,[키키제제]남아 티셔츠/반팔티/맨투맨/남방/가디건,10900,10900,0
2018-06-01,989103852,E041080,부엌용용구,초L)옻칠뒤집개,6500,6500,0
2018-06-01,169094129,A019060,된장,CJ에서 보장합니다!,5750,5750,0
2018-06-01,696768877,A014020,분유,[일동후디스]트루맘 프리미엄 3단계 800g 3캔,66000,66000,0
2018-06-01,119050346,E011030,거실장,[채우리] 시아 원목 3단 분리형 수납선반,100000,100000,0
2018-06-01,1929784548,C013020,티셔츠,데일리앤 민소매티셔츠 여름티셔츠 반팔티 해외여행,7800,7800,0
2018-06-01,119050347,E011030,거실장,[채우리] 시아 스틸 행거 선반,120000,120000,0
2018-06-01,1272199494,C011030,남자학생복,오버 스트라이프 버튼다운 셔츠 스트라이프셔츠 남성,29440,29440,0
2018-06-01,2058004913,C013010,점퍼,MNC 봄신상/블레이저/블레이져/마이/자켓/정장/수트,18000,16800,-1200
2018-06-01,989103853,E041080,부엌용용구,초L)옻칠미니조리스푼,5900,5900,0
2018-06-01,948689209,E041050,냄비,[키친아트] 줄리엣 세라믹냄비3종&후라이팬 기획전,32900,32900,0
2018-06-01,536731126,L021020,장신구,실버 후프 이어링 TU0064/ 뚜아후아,135000,114750,-20250
2018-06-01,319441898,C012020,원피스,(해외직배송)세미정장 원피스자켓 세트 정장자켓 원피,142820,125690,-17130
2018-06-01,1138720574,C021040,실내화,스티유 18 S S 81364ny-81365pk 타임 스포티 샌들,43870,43870,0
2018-06-01,581171081,C011050,남자내의,트레이닝바지 반바지 헬스복 운동복 밴딩바지 츄리닝,12900,12900,0
2018-06-01,693379067,E061010,세탁세제,세제 아기사랑3p선물세트 액체세제 유아세제 액상세제,53100,53100,0
2018-06-01,1144953309,E041050,냄비,[ELO] 독일ELO프리미엄/통삼중올스텐/인덕션냄비-20cm편수,57000,54150,-2850
2018-06-01,427332183,A019020,참깨,볶음참깨 (정도 1K) X10,113800,101290,-12510
2018-06-01,244663141,A013090,전복,통영 홍합 5kg~10kg /굴/장어/학교급식납품/식당추천/당일작업발송,12800,12800,0
2018-06-01,1453526347,A011180,파스타면,판타넬라 5호 스파게티 스파게티면 500g,1300,1300,0
2018-06-01,437883956,E011070,식탁,율키친H 1200아일랜드홈바 (오픈형),99800,99800,0
2018-06-01,1319053776,C011030,남자학생복,[지이크][지이크] 블루 내추럴 반팔 체크 셔츠 (FMBAE5526) (P000329060),15900,15900,0
2018-06-01,313580355,C013040,청바지,워싱청치마바지 [9호~19호] 키즈 여아 아동 치마바지,19800,19800,0
2018-06-01,1822877225,C012060,여자내의,[하늘바라기]눈꽃 후레아 스커트,9900,9410,-490
2018-06-01,1166328021,C012030,여자상의,퍼플스완 너에게 하객 스퀘어넥 체크 미니원피스,34800,34800,0
2018-06-01,465935655,C013050,운동복,아스토레 JSG-JKW30002 골프 캐주얼 우븐자켓(PP) 우,175530,175530,0
2018-06-01,1509593796,A022050,탄산음료,코카콜라 185ml (x30캔) 음료수 칠성사이다 콜라,13610,12800,-810
2018-06-01,1307994176,A015020,식용유,p 냉압착 유기농 엑스트라버진 올리브오일 올리브유,13000,13000,0
2018-06-01,566136,C013020,티셔츠,[SIWY]LOS ANGELES WHITE(A044VCJ9 WHT),90000,72000,-18000
2018-06-01,1292931150,C015030,넥타이,나비넥타이/보우타이/아동/아이/돌잔치/단체제작/교회,2800,2800,0
2018-06-01,1597120754,A011160,빵,[황둔찐빵마을]황둔 모듬 쌀찐빵 1호(10종 각 2개씩 / 총20개),15170,14670,-500
2018-06-01,1433442173,C012060,여자내의,멜빵치마/멜빵바지/멜빵청바지/점프수트/원피스,12900,12900,0
2018-06-01,8565579,C013010,점퍼,[스타일빅걸][스타일빅걸]루즈 라이더 자켓 BOR230,74520,71540,-2980
2018-06-01,1597120750,F011130,홍삼,정관장 아이패스주니어,130000,130000,0
2018-06-01,1465403825,C012030,여자상의,빅사이즈 뷔스티에마투피스 IR1707 뷔스티에마투피스I,72100,64890,-7210
2018-06-01,1201095883,C012060,여자내의,롱스커트 오프라 맥시 DM-3800,12380,12380,0
2018-06-01,1972137463,F011120,인삼,우리땅 진품 토종 새싹삼 100뿌리200뿌리 산양삼 산삼,39900,39900,0
2018-06-01,296362927,C013010,점퍼,신상/남자바람막이/아웃도어/코치자켓/바막/윈드자켓,28900,28900,0
2018-06-01,1085838321,C013020,티셔츠,[마르조] [6종]여성시그니처앙상블패키지,49800,41340,-8460
2018-06-01,1400804017,C012040,여자학생복,[플라스틱아일랜드][18여름] 니트 투포켓 가디건(PJ2KG562)[갤러리아],59000,47200,-11800
2018-06-01,976237023,C021040,실내화,[리복(Reebok)]세일런닝화4종 남 여 트레인플렉스 2.0(본점),62300,52590,-9710
2018-06-01,911197267,A018010,초콜릿,무료배송_롯데/13500미니초코바모음/웨하스/크런키,12300,12300,0
2018-06-01,728119872,I031040,생화,[헬리녹스(Outdoor)]헬리녹스 캠핑용품 선셋체어 [블랙],150000,147000,-3000
2018-06-01,2083117990,C013010,점퍼,쓰리포켓 베이직 자켓_PU31 /(참고)점퍼 블루종 자켓,98100,86330,-11770
2018-06-01,2027643241,E061040,부엌용세제,그라인더세정제 퓨로그라인더클리너 - 그라인더세정제,52650,46860,-5790
2018-06-01,1746045980,C012020,원피스,[오픈더도어]mustang long coat,119700,113720,-5980
2018-06-01,1705931488,A019020,참깨,볶음참깨1kg 볶음검은깨1kg 박피들깨 볶음 들깨가루,6500,6500,0
2018-06-01,304490044,C011020,남자상의,[르젠]봄신상 코디전 트렌치코트/셔츠/슬랙스/맨투맨,12800,9800,-3000
2018-06-01,443813999,C015020,모자,(컬러:사이즈 : 챠콜:FREE) ACC-CAP102 베이,19630,19630,0
2018-06-01,1826554058,C013040,청바지,[피핀][피핀] 일루밍 데님 멜빵 팬츠 73386,27400,26030,-1370
2018-06-01,358439440,C012060,여자내의,[공구우먼] 라이노 린넨 뒷밴딩 슬랙스 29868 빅사이즈 여성의류,34000,34000,0
2018-06-01,1351315930,E031070,에어컨,천장용 선풍기 DWF-3322WS SIF-16CSH 천장형,34000,34000,0
2018-06-01,1399969649,C011050,남자내의,[올젠]18 S/S 캐주얼 스판 데님팬츠 2종 택1 (ZRY2DP1301 ZRY2DP1302)(경기점),45000,37110,-7890
2018-06-01,1397081702,C012040,여자학생복,수지네 일본 구제 swing 블랙줄무늬 울 베스트 여성 S,15050,15050,0
2018-06-01,574913596,C014010,아동복,컬럼비아 아동용 바람막이 똑딱단추 남방 75,25000,25000,0
2018-06-01,723620381,E021010,침구,DAYON 헝가리산거위털 호텔베개 기절베개 구스베개1+1,49700,49700,0
2018-06-01,957682069,A018020,사탕,[크라운]크라운 새콤달콤모음 (116G),1800,1800,0
2018-06-01,1301787511,C015040,장갑,[프로스펙스] (SIZE : LXL) 핑거 메이저 2 니트 글러브(GR,8740,8740,0
2018-06-01,1110618479,C015040,장갑,햇빛가리개 썬캡/골프용품/등산/낚시/모자/여름,3900,3590,-310
2018-06-01,1259790169,L021060,유모차,신상품 윙스S 에스 포시즌 양대면 블랙 인기급상승,224000,224000,0
2018-06-01,1948532757,C012060,여자내의,[핑크시슬리]리트 쿨 롱스커트/ 핑크시슬리,16100,12880,-3220
2018-06-01,1319053866,C011050,남자내의,보풀방지 블랙화이트라인 롱 교복조끼 남자 학생복쇼,29980,29980,0
2018-06-01,1163690427,C011020,남자상의,AG 빅사이즈 야상 피쉬 오버코트 BW 남성코트 오버코,113150,113150,0
2018-06-01,988212883,G022010,자동차용품,3M언제나맑음에탄올워셔액,4700,4700,0
2018-06-01,957682092,A018020,사탕,[롯데]롯데 목캔디 블루베리 (148G/용기),2290,2290,0
2018-06-01,1482968852,C014010,아동복,아이러브파파n마마 티셔츠 4종 1택(6-24개월)202213,12010,12010,0
2018-06-01,895831140,A019060,된장,해찬들 재래식된장 500G,3450,3450,0
2018-06-01,957682093,A018020,사탕,[롯데]롯데 목캔디 허브 (148G/용기),2290,2290,0
2018-06-01,957682094,A018020,사탕,[롯데]롯데 목캔디 허브 (274G),4300,4300,0
2018-06-01,957682095,A018020,사탕,[롯데]롯데 목캔디 믹스베리 (274g),4300,4300,0
2018-06-01,895806188,A013160,맛살,한성 크래미 (140G*3입),6480,5990,-490
2018-06-01,957682097,A018020,사탕,해태 신쫄이 상큼 사과 (27G),500,500,0
2018-06-01,965797599,L021020,장신구,사은품 판촉용 진주모양 귀걸이 100쌍 /(참고) 플라스,40900,36000,-4900
2018-06-01,952260488,C012040,여자학생복,레이스뷔스티에/니트조끼/크롭티/커버업/베스트,16900,16900,0
2018-06-01,766889454,I031040,생화,폴딩파라솔 3m/8립(베이스별도)-3M/파라솔/대형파라솔,105000,93980,-11020
2018-06-01,1642730327,C012060,여자내의,[시에로(siero)]오비밴딩 큐롯 팬츠 SD2PTF512(영등포점A),89400,72450,-16950
2018-06-01,229210747,C012040,여자학생복,[부루앤쥬디] 골지날반팔 니트 B1KD3PO002 (4컬러),19900,17910,-1990
2018-06-01,988929037,E061020,섬유유연제,샤프란시트 코튼50매_3P,23850,16740,-7110
2018-06-01,862412231,A022050,탄산음료,[무료배송] 맥콜 250ml x 30캔 1박스,10900,10900,0
2018-06-01,899462581,F011120,인삼,새송이버섯(슬라이스) 130G/팩,1490,1490,0
2018-06-01,2066969376,F012010,종이기저귀,다솜이팬티 기저귀 162매+아기물티슈80매+사은품 증정,27900,27900,0
2018-06-01,2083117962,C011020,남자상의,남자코트 베이직 블랙 싱글 롱코트 /(참고)킹스맨 봄,55700,49020,-6680
2018-06-01,1053419072,A016160,과일가공품,시아스 미국산 A등급 프리미엄 블루베리1kg 특가,5500,5500,0
2018-06-01,783455667,C021040,실내화,매장정품 90종 남성 운동화 나이키 아디다스 런닝화,78900,78900,0
2018-06-01,1968637043,L021020,장신구,사은품 판촉용 진주모양 귀걸이 100쌍 악세서리 플라,36390,36390,0
2018-06-01,78559569,A011030,찹쌀,수입보리모음/늘보리/찰보리/10kg/미국산,12800,12800,0
2018-06-01,1119768427,I012010,컴퓨터,[E]Z70EV-ARP2S1/7세대/펜티엄/8G/SSD128G/윈10/HOME,715000,679250,-35750
2018-06-01,1238103597,C012040,여자학생복,[제쉬나인][제쉬나인]에스닉 꽃자수 수술가디건,27600,24840,-2760
2018-06-01,1317207814,C012060,여자내의,페일론 기모 플레어가죽스커트 SD-5077 플레어스커트,15340,15340,0
2018-06-01,1319822633,E061060,살충제,쥐파크 터널 끈끈이 터널형 3개입 - 쥐약 바퀴벌레 파,13950,13950,0
2018-06-01,1982699925,A011170,떡,[블루탐] 제주 오메기떡 현지가격 그대로(20/40개입),18500,18500,0
2018-06-01,1509316812,I053010,공책,데스노트 - 빅사이즈 데스노트+브로마이드+깃털펜 - 미사노트/엘/미사/류크/라이토/캐,8000,8000,0
2018-06-01,1387672137,E061040,부엌용세제,그라인더세정제 퓨로그라인더클리너 커피장비세정제,47970,47970,0
2018-06-01,841942646,A019090,카레,우리밀 바몬드카레 (순한맛X5개) 뜨레봄 행복한밥상,23500,23500,0
2018-06-01,468587055,I053010,공책,묶음상품 플라스틱링(38mm)흑색 50개입x3개 제본링 링,60480,60480,0
2018-06-01,1831066093,C013050,운동복,컴프레셔 총집합/RCP-A1/RCP-C21E/RCP-F1/에어맨 Hawk,34900,29850,-5050
2018-06-01,535156839,C011050,남자내의,여름트레이닝반바지/츄리닝/5부/7부/운동복/바지/남성,12700,12700,0
2018-06-01,1509593731,A022050,탄산음료,칠성사이다 190mlx30캔/콜라/탄산음료/캔음료/음료수,11900,11900,0
2018-06-01,447958544,C013020,티셔츠,[난닝구]핸즐 언발후드티,15000,13800,-1200
2018-06-01,73282779,C012040,여자학생복,[반에이크]린넨 베스트J(V76VTM403Z),59800,53820,-5980
2018-06-01,2056495478,A011110,당면,시골다람쥐동부묵2kgX2개(BOX),14700,14700,0
2018-06-01,1656919607,L021020,장신구,14K/18K베루스 0.1ct다이아몬드귀걸이,547000,547000,0
2018-06-01,881930142,F011130,홍삼,건강보조식품 선물세트 기획전,34000,34000,0
2018-06-01,1057341627,E021010,침구,호텔식 순면 이불커버 / 침대누빔패드/매트리스커버,19900,19900,0
2018-06-01,2003856273,C013040,청바지,여자청바지 빅사이즈스키니.배기바지.반바지 일자청바,9900,9900,0
2018-06-01,1431587601,C013010,점퍼,[벤시몽] BENSIMON 엘리 화이트 여성 스니커즈 HTSO8G402WT,39200,34540,-4660
2018-06-01,1901103364,A011010,쌀,17년산 영양쌀 20kg / 당일도정,44200,44200,0
2018-06-01,805342640,E031010,전기밥솥,CRP-N0680SR 쿠쿠 6인용 전기압력밥솥/분리형커버 ens,106300,97620,-8680
2018-06-01,140806178,A012010,국산쇠고기,정남진 장흥한牛 장흥한우 안심 500g 구이용안심 소안,103620,92230,-11390
2018-06-01,415073562,C013010,점퍼,바람막이 야상 WS-YSM22 바람막이 야상 점퍼 남자야상,87540,85790,-1750
2018-06-01,455988249,C013050,운동복,AXEMEN 소프트 접이식 루프백 - 스포츠 레저 낚시 여,102970,84320,-18650
2018-06-01,2017794220,D031010,주택수선재료,데코타일 바닥재/이케아 runnen/데크타일/조립마루,18900,18900,0
2018-06-01,1497184455,A012010,국산쇠고기,[무항생제] 양지 300g 1+등급,21300,21300,0
2018-06-01,1320558414,E011020,침대,프리미엄 패밀리침대 Q+SS 가드형 포켓양면 매트리스,790600,766890,-23710
2018-06-01,1387672171,E061040,부엌용세제,커피머신세정제 어넥스퓨로 에스프레소세정제 어넥스,41440,41440,0
2018-06-01,446296113,A012060,햄및베이컨,롯데 런천미트 340g x 10캔 외 로스팜 햄 통조림 캔햄,20500,20500,0
2018-06-01,1397030162,C015040,장갑,스마트터치 눈꽃 니트 벙어리 여자 장갑 겨울장갑 겨,24170,24170,0
2018-06-01,1506722457,E011040,소파,[조은가구]티파니 카우치소파/4인용쇼파/수도권 무료배송,435000,384300,-50700
2018-06-01,1011059881,E041030,솥,[CUAN] 쿠앤 바일레 냄비 28곰솥,99000,59000,-40000
2018-06-01,1069132666,A014030,치즈,슬라이스치즈 100매/모짜렐라/대용량/업소용/카페용,22900,22900,0
2018-06-01,1968568468,C013040,청바지,[프랜치캣]Q82DKP150 170프릴속바지,17100,14030,-3070
2018-06-01,1934643780,C012040,여자학생복,빅사이즈 DWW0113 골지 라운드 조끼 801 88사이즈조끼,30460,30460,0
2018-06-01,1464715892,C013060,등산복,2018 NEW 몬태뉴 액티브 플랙스 트리코트 7부 팬츠,19900,19900,0
2018-06-01,478400098,C013050,운동복,REARVIZ 자전거 후사경 백미러 레드 자전거 거울 미,58940,58940,0
2018-06-01,895772396,A013170,생선통조림,오뚜기 마일드참치 150G*3입,8390,8390,0
2018-06-01,1754158844,E011060,의자,인테리어 벤치의자/식탁의자/원목스툴/다용도벤치,39900,39900,0
2018-06-01,609073082,A013070,굴,크레이피쉬 자연산 민물가재 1kg 부드럽고 담백한맛,20900,20900,0
2018-06-01,833180705,A021010,커피,일리 캡슐커피 3+1 반짝 이벤트 /당일출고 원두커피,49500,49500,0
2018-06-01,1363731632,F012010,종이기저귀,출시특가 폴맘 오버나이트 26px2팩 하기스 굿나이트,28900,28900,0
2018-06-01,2071167114,C012020,원피스,빅사이즈/옆/트임/루즈/롱/가디건 / 참고 빅사이즈 큰,51400,45240,-6160
2018-06-01,1724928075,A018090,잼,[무료배송] 작은행복 국산 딸기쨈 1+1 총 2KG,9900,9900,0
2018-06-01,1011059878,E041030,솥,[CUAN] 쿠앤 바일레 냄비 20양수,49000,32000,-17000
2018-06-01,1011059879,E041030,솥,[CUAN] 쿠앤 바일레 냄비 24양수,65000,39000,-26000
2018-06-01,1300955849,F012050,의료측정기,로슈 뉴 아큐첵 액티브 혈당계 혈당측정기,23000,21350,-1650
2018-06-01,1798163663,E061060,살충제,지네퇴치법 판데스 해충퇴치제 지네퇴치 곱등이,9000,9000,0
2018-06-01,1011059875,E041030,솥,[CUAN] 쿠앤 바일레 냄비 16전골,37000,25000,-12000
2018-06-01,1552702200,C013010,점퍼,[피핀][피핀] 보니타 패치포인트 숏 점퍼 67968,35100,33350,-1750
2018-06-01,1011059877,E041030,솥,[CUAN] 쿠앤 바일레 냄비 16편수,40000,27000,-13000
2018-06-01,93616356,A014050,달걀,[무료배송] 한보 알장군 구운계란 135g ×30 (90구),26900,26900,0
2018-06-01,821013073,C013010,점퍼,발렌시아 봄 여름 가을 남성자켓 중년자켓 콤비마이,59800,59800,0
2018-06-01,936273191,E041010,식기,[백동거북은수저4P-비단케이스] 스푼세트 수저세트 숟가락세트 부부수저세트 예쁜수저,89800,88700,-1100
2018-06-01,1059618861,C012020,원피스,파올라 쉬폰 항아리라인 9부 밴딩팬츠 A172SL0010 백화점브랜드 통바지 여름바지 시원,90000,81000,-9000
2018-06-01,1320558478,E011020,침대,프리미엄 패밀리침대 Q+Q 가드형 포켓양면 매트리스,870300,844200,-26100
2018-06-01,2146603295,F012020,생리대,예지미인 숲속이야기 텐셀 대형14Px5개 생리대 정품,11200,11200,0
2018-06-01,1858479232,A014030,치즈,코리원/썬리취 어린이 슬라이스치즈 100매/아기치즈,18500,18500,0
2018-06-01,736568429,A021010,커피,지노바리스타 커피믹스 900g /믹스커피/자판기커피,2800,2800,0
2018-06-01,119711734,C013010,점퍼,[웰메이드]웰메이드[인디안모드] 17 여름 캐주얼점퍼 집업점퍼 바람막이점퍼 [MITCLTM,99500,82590,-16910
2018-06-01,1877771979,F012010,종이기저귀,리베로 기저귀 팬티5단계42매/ 리베로,19800,18810,-990
2018-06-01,215607444,E031050,냉장고,[삼성전자] 인증점 삼성 김치냉장고 김치 플러스 RQ47M92127Z,2376900,2376900,0
2018-06-01,421377402,E011040,소파,[2만원추가할인]][PookShuim] 푹쉼 로잔 침대 그네,399000,399000,0
2018-06-01,1980444536,F012010,종이기저귀,[LG생활건강]360핏 마미포코 중형 남여공용 44매,9900,9900,0
2018-06-01,1270595751,C021040,실내화,엘칸토 천연가죽 남성 캐주얼슈즈 LCSF74CE10,83160,83160,0
2018-06-01,1358993828,F011150,건강기능식품,새싹보리 보리새싹가루 300g 보리순 어린잎,11000,11000,0
2018-06-01,1011059853,E041030,솥,[CUAN] 쿠앤 바일레 냄비 16양수,40000,27000,-13000
2018-06-01,1067418805,E031130,보온매트,한일의료기 전기요 말-소,25000,25000,0
2018-06-01,1067418806,E031130,보온매트,한일의료기 전기요 말-중,23400,23400,0
2018-06-01,1524121669,I011030,사진기,캐논 EOS 200D + 18-55mm 정품 명품,610990,562020,-48970
2018-06-01,1011059850,E041030,솥,[CUAN] 쿠앤 바일레 냄비 14전골,34000,23000,-11000
2018-06-01,1877771949,F012010,종이기저귀,리베로 기저귀 밴드3단계68매/ 리베로,20800,19760,-1040
2018-06-01,2017733275,E011050,책상,[이스마트] 스틸 테이블 24종/철제책상/식탁,79000,71100,-7900
2018-06-01,1877771948,F012010,종이기저귀,리베로 기저귀 밴드5단계56매/ 리베로,19800,18810,-990
2018-06-01,507614072,E021010,침구,굿몽 이불세트 이불+요커버+요솜+베개커버 침구세트,39800,39800,0
2018-06-01,1877771947,F012010,종이기저귀,리베로 기저귀 밴드4단계60매/ 리베로,19800,18810,-990
2018-06-01,1067418807,E031130,보온매트,한일의료기 전기요 말-대,24750,24750,0
2018-06-01,1877771945,F012010,종이기저귀,리베로 기저귀 밴드2단계88매/ 리베로,23800,22610,-1190
2018-06-01,1081453821,A017150,버섯,건고사리 선물세트_(90g x 3EA)]나물,54360,54360,0
2018-06-01,985293456,A017130,도라지,(친환경)당근 (400G/봉),3490,3490,0
2018-06-01,1914437873,E041020,컵,[와드몰]사마도요 sama 티포트 s043 045 046 048 049,11500,11500,0
2018-06-01,1751959222,L021010,손목시계,MARCJACOBS MJ1480 마크제이콥스 여성용 가죽밴드 패션시계,149000,149000,0
2018-06-01,1751959220,L021010,손목시계,MARCJACOBS MJ1479 마크제이콥스 여성용 가죽밴드 패션시계,149000,149000,0
2018-06-01,465490053,L012090,기초화장품,네이처리퍼블릭 진생 로얄 실크 아이 크림 25ml 1개,71370,69230,-2140
2018-06-01,1689807528,C013020,티셔츠,V넥오프숄더긴팔티/브인넥티/골지티/섹시티/슬림티.,8900,8900,0
2018-06-01,1693344926,E031010,전기밥솥,쿠쿠 내솥 [H042] CRP-AHSN1010FS 밥솥 교체용,66310,66310,0
2018-06-01,1964541465,I011020,영상음향기기,LG미니빔TV 빔프로젝터 PF50KA 시네빔 스마트빔,841050,799000,-42050
2018-06-01,1322874978,C011050,남자내의,(색상:사이즈 : 블랙:L) DON 1846 린넨9부,28220,28220,0
2018-06-01,1300918825,C013030,스웨터,[동대문] (색상 : 네이비 | 사이즈 : 3XL(115)) BIG,56200,56200,0
2018-06-01,933332884,F011150,건강기능식품,박카스F/홍삼원/까스활/미에로화이바 각종음료모음,12000,12000,0
2018-06-01,2076436840,F011150,건강기능식품,독일 비타하임 발포비타민 멀티 비타민C 아연 6통,18700,18700,0
2018-06-01,1011059846,E041030,솥,[CUAN] 쿠앤 나짱웍 36cm,165000,99000,-66000
2018-06-01,1963106031,L012010,면도기,고급 일회용 면도기(2중날 3중날)100개~500개 무료배송!! 도루코 쉐이코 쉬크 면도기,10000,9900,-100
2018-06-01,1427967482,C013010,점퍼,하프 자켓 점퍼 경량패딩 롱패딩 빅사이즈 오리솜털,46000,41800,-4200
2018-06-01,732722515,C013050,운동복,빅사이즈 트레이닝 상하세트/기능성~4XL [더블온스],74900,74900,0
2018-06-01,1385733992,C013010,점퍼,ACC(필골드) SL1008 프리미엄 SLM 프린트 네오프랜 집,61000,60390,-610
2018-06-01,1751959219,L021010,손목시계,MARCJACOBS MJ3495 마크제이콥스 여성용 메탈밴드 패션시계,169000,169000,0
2018-06-01,77847586,E061020,섬유유연제,(추가금액NO)피죤 2100mx6개 섬유유연제 /3400mlx4개,14500,14500,0
2018-06-01,1751959218,L021010,손목시계,MARCJACOBS MJ1513 마크제이콥스 여성용 가죽밴드 패션시계,169000,169000,0
2018-06-01,165788013,A022010,주스,식자재 식당 양념 음료 차 레몬에이드 컨츄리타임 585,11040,11040,0
2018-06-01,298940743,E041070,밀폐용기,보르미올리/유리밀폐병/유리병/오일병/더치병/스윙,1750,1610,-140
2018-06-01,1062367224,A013040,고등어,주문후 바로 구운생선구이6종 냉동NO 대형마트 판매용,2900,2900,0
2018-06-01,1549532292,C011030,남자학생복,2018 NEW 하와이안 린넨코튼 셔츠 시리즈,35600,35600,0
2018-06-01,985327209,E061050,청소용세제,[아토세이프] 뽀글이 배수구세정제 40gX24EA(3BOX),29900,9900,-20000
2018-06-01,1239165349,C011020,남자상의,블랙 체크 밍크털 코트 캐주얼코트 털코트 남성털코트,105820,105820,0
2018-06-01,483790295,C011030,남자학생복,밀란시아 베이직 양기모 집업후드가디건 is12-2 남성,45500,44590,-910
2018-06-01,1407390420,A012030,돼지고기,칠레산 프리미엄 삼겹살 5kg,47000,47000,0
2018-06-01,584328030,A017050,미나리,[가족사랑] 유기농 양배추즙 100ml X 50포 HACCP인증,14900,14900,0
2018-06-01,1345933094,C013020,티셔츠,[핫핑] 빅사이즈 티셔츠 단가라 반팔 프린트 맨투맨,17800,12800,-5000
2018-06-01,2068311951,C011020,남자상의,(티티뱅크) JK550W 캐주얼 방한 자켓 / 참고 방한 캐,69600,61250,-8350
2018-06-01,1877771953,F012010,종이기저귀,리베로 기저귀 밴드6단계52매/ 리베로,19800,18810,-990
2018-06-01,907797884,E031140,비데,[신제품] 노비타비데 콤팩트플러스 BD-SD600 + 이벤트,259000,239000,-20000
2018-06-01,606744351,F011120,인삼,국내산 산양삼 6년근 3뿌리 한세트 무료배송 싱싱한 산삼 국내 최저가 장뇌삼 산양 산,29700,29700,0
2018-06-01,570273041,A017140,콩나물,배즙/파는 곳/맑은 배즙/도라지즙 도라지배즙/탄닌성,45900,45900,0
2018-06-01,1345490172,C013020,티셔츠,단독 3000원부터! 테이트 여름 남녀 의류 COOL SALE!,4400,4400,0
2018-06-01,728022450,L012090,기초화장품,크리니크 드라마티컬리 모이스춰라이징 로션 125ml,31900,31900,0
2018-06-01,1432779470,A011160,빵,이솝찐빵 동물모양 [HACCP 인증] 1kg(40개) 간식/호빵,11100,11100,0
2018-06-01,985268437,A013070,굴,냉동 꽃게(마리/200g 내외),3300,3300,0
2018-06-01,456231572,E011050,책상,[아이디어스터디] 합격5호 가정용 독서실책상,135000,135000,0
2018-06-01,1877771921,F012010,종이기저귀,리베로 기저귀 밴드1단계28매/ 리베로,9000,8550,-450
2018-06-01,1974165980,F012010,종이기저귀,마미포코 에어핏/보송허그 3 4팩,43500,43500,0
2018-06-01,1877277798,A013090,전복,함평 천지농협 왕우렁이 1kg/ 푸르젠,15900,15900,0
2018-06-01,469899029,C012020,원피스,[SOUP]고리장식 미디기장 체크자켓 SU5JK98[갤러리아],129000,103200,-25800
2018-06-01,1663503829,E011050,책상,굿 데스크 책상 컴퓨터 학생 일자 다용도 멀티 테이블,19900,19900,0
2018-06-01,225662118,A013050,오징어,꽁치 400g 삼포 꽁치캔 통조림 고등어,1780,1780,0
2018-06-01,515911723,C012060,여자내의,[모다아울렛][코인코즈]도트 스커트(MIW8MS188),70400,66880,-3520
2018-06-01,385506708,C011030,남자학생복,오투_쿨링타올 특대형,33510,31500,-2010
2018-06-01,1784188282,L021020,장신구,[바보사랑]Flamingo earring,12000,12000,0
2018-06-01,1784188284,L021020,장신구,[바보사랑]두산베어스 박건우 클래식 열쇠고리,15000,15000,0
2018-06-01,1784188283,L021020,장신구,[바보사랑]제이드 앤 플라워 귀걸이,12500,12500,0
2018-06-01,739066763,E061010,세탁세제,비트 오래오래 향기 2L x 5개 세탁 세제,18900,18900,0
2018-06-01,747263405,A016110,딸기,제이제이 냉동딸기 1kg 2개,16850,16850,0
2018-06-01,1006873736,A022020,두유,매일 아몬드브리즈 아몬드두유 950ml x5팩190ml x24팩,13700,13700,0
2018-06-01,1784188278,L021020,장신구,[바보사랑]gob_925silver,19250,19250,0
2018-06-01,432470869,A017100,당근,열무 400g 10개,48700,48700,0
2018-06-01,2066551891,A017250,고사리,한농 유기농 브로콜리 분말 가루 100g x 3개,83880,83880,0
2018-06-01,1297130390,E011020,침대,인쏘노 디오 DIO 가죽 침대 + 매트리스 포함 (SS),309000,309000,0
2018-06-01,1784188275,L021020,장신구,[바보사랑]wei 진주포인트드롭귀걸이,8750,8750,0
2018-06-01,1530594280,C012020,원피스,MELODY F118 모카/코트/여자코트/겨울코디/겨울코트/자켓/점퍼 미국 여성토탈브랜드 멜,54700,54700,0
2018-06-01,1784188277,L021020,장신구,[바보사랑]goblet 포인트 뱅글 팔찌,9450,9450,0
2018-06-01,1784188276,L021020,장신구,[바보사랑]mutobra 원석 포인트 볼드 뱅글 팔찌,19250,19250,0
2018-06-01,671522259,A017140,콩나물,도라지 250g (경북 영주 재배산) 도라지차재료 도라지,18820,18820,0
2018-06-01,1443222973,C021020,구두,[탠디]온라인초특가 남성 패션구두 11종,99840,99840,0
2018-06-01,1897073242,A017280,김,[원하프]무맛나쌈무(와사비맛)4kg/민속[총알배송!,8290,8290,0
2018-06-01,548644616,C011050,남자내의,면반바지/슬랙스/마반바지/밴드반바지/남자/남성/여름,10800,10800,0
2018-06-01,806400187,E041010,식기,스텐/냉면기/탕기/비빔기/이중/그릇/면기/식기/식당,4300,4300,0
2018-06-01,839653800,L012090,기초화장품,대용량300ml1000ml스킨토너/알로에수딩로션/에센스/겔,19900,19900,0
2018-06-01,1922959834,C012020,원피스,쥬크 17신상 핸드메이드A라인코트 Z174MSG501,175200,175200,0
2018-06-01,1104736999,C011020,남자상의,여름용 리빌모아 정품 남성 콤비 정장자켓 40종,58900,58900,0
2018-06-01,287066577,C014010,아동복,[밍크뮤] 래빗캐릭터티셔츠 (37323-332-07),26000,21320,-4680
2018-06-01,1324932453,C021040,실내화,국내배송]나이키 에어 맥스270 검흰/ 흰검 AH8050-002,122000,122000,0
2018-06-01,631917590,A016060,감,달콤샤르르 자연그대로 만든 아이스 홍시 50개(컵)/개,65800,57910,-7890
2018-06-01,113935659,F011150,건강기능식품,대상웰라이프 울트라 더블업 복합 쏘팔메토 옥타코사놀 x 4병,170280,170280,0
2018-06-01,1800253835,A017140,콩나물,도라지가루 200g 도라지가루효능 약도라지 도라지효능,18660,18660,0
2018-06-01,987970957,A011160,빵,삼립 베이커리 모닝롤 500g,3690,3690,0
2018-06-01,63647827,F012010,종이기저귀,팸퍼스 프리미엄케어 팬티/밴드 기저귀 모음,41800,39800,-2000
2018-06-01,349196945,C012060,여자내의,[에고이스트]포켓 핫피스 스키니PT(EH2EP300),47400,36980,-10420
2018-06-01,1453599340,C013040,청바지,[게스][18SS] MI2D9090 WHT 남 화이트 스키니,47900,45990,-1910
2018-06-01,10866655,I011010,TV,(공식파트너)삼성 138cm FHD LED TV UN55K5100BF,990000,679000,-311000
2018-06-01,1240803627,C012060,여자내의,펀칭 포인트 브이 니트티/ 양브이넥 슬리브리스,21630,21630,0
2018-06-01,2032802045,C012060,여자내의,트리아나 린넨 7부 고무줄바지 AD2XA47,46400,46400,0
2018-06-01,364662801,C014010,아동복,갭키즈 키즈 남아 반팔 그래픽 티셔츠 4종 택1 (5218126246061)CH,10000,9500,-500
2018-06-01,1262685390,C014010,아동복,[젤리스푼][젤리스푼] 멋스런타이거상하복_MO,14900,13410,-1490
2018-06-01,1897073237,A013070,굴,[원하프]냉동장어4kg[바다장어][고객만족!총알배송!],33250,33250,0
2018-06-01,844533105,G022020,자동차타이어,[미쉐린] 서울 무료장착 미쉐린 PRIMACY MXM4 225/45R17 미국산,188000,142230,-45770
2018-06-01,1236402260,C011020,남자상의,체크 밍크털 코트 털코트 코트 남성코트 남성용털코트,105820,105820,0
2018-06-01,1499463993,A012060,햄및베이컨,[동원] 리챔(자연레시피)200g x 10캔 + 리챔120g,20900,20900,0
2018-06-01,1297166337,C011020,남자상의,MJ-915 보카시 트위드 투버튼자켓-블루 남성점퍼 캐주,156570,156570,0
2018-06-01,2058761686,C012060,여자내의,[핑크시슬리] 데일리 와이드 아이스팬츠/ 핑크시슬리,11400,9120,-2280
2018-06-01,1225325772,C015040,장갑,스마트 터치 토끼털 모직 장갑 토끼털장갑 여성장갑,32060,32060,0
2018-06-01,766131420,L021010,손목시계,훈남의선택 남자 메탈시계/남성시계/손목시계/남성용,29800,29800,0
2018-06-01,1438830670,A014020,분유,[베비언스] 킨더밀쉬 200ml 24입,34900,34900,0
2018-06-01,601094792,C012040,여자학생복,경북상사/흰색면티/반팔면티/무지티/아동면티/단체티,2400,2400,0
2018-06-01,1256704790,I031010,장난감,포르쉐718 박스터 유아용 어린이 푸시카/파파야나인,229000,229000,0
2018-06-01,523269929,C013050,운동복,빅사이즈 여성 반바지 트레이닝 요가바지 통바지,9800,9800,0
2018-06-01,81307277,E041030,솥,풍년 압력밥솥 가정용/ 업소용 47종 모음전  압력솥,53500,53500,0
2018-06-01,371280107,C013020,티셔츠,[대구백화점 II관] [게스키즈]로즈숄더홀티(G84KAT020),66000,52800,-13200
2018-06-01,1804625149,F011130,홍삼,[CJ직배송]키크몬홍삼(배)100ml*10입,12000,12000,0
2018-06-01,2110473274,E011040,소파,완전최저가!New모건4인소파+테이블+쿠션+사이드테이블,499000,499000,0
2018-06-01,1179916761,C012040,여자학생복,(L XL)디멜라 니트-1877/ 레이디플러스,23900,21510,-2390
2018-06-01,1553847393,C013010,점퍼,[크로커다일]캐주얼자켓 일본수출품 초특가 세일 블레이져 마이 정장 원버튼 롤업 코트,50000,49000,-1000
2018-06-01,1003341224,A012040,닭고기,푸드원 훈제 닭가슴살 100g 국내산,980,980,0
2018-06-01,933932620,A019180,즉석식품,2대째 강남 맛집 남순남순대국 620g 즉석국/탕/국,3500,3500,0
2018-06-01,252610739,C013050,운동복,접이식 안전 삼각대/비상용 안전반사판 차량용삼각대,14500,14070,-430
2018-06-01,1002808754,E011030,거실장,동서가구 프라임 3인용 가죽소파 DF635966,990000,990000,0
2018-06-01,1422231685,C013020,티셔츠,[타미진]남여 베이직/스트라이프 반팔 티셔츠 10종 택1(TUMS1KOE28D0외9종)(강남점),25770,25770,0
2018-06-01,1804625150,F011130,홍삼,[CJ직배송]키크몬홍삼(포도)100ml*10입x5개,60000,60000,0
2018-06-01,2084128751,C012060,여자내의,(벨트SET)체스 체크 슬랙스- 체크슬랙스 체크패턴슬랙,54700,48140,-6560
2018-06-01,1804625151,F011130,홍삼,[CJ직배송]키크몬홍삼(포도)100ml*10입x3개,36000,36000,0
2018-06-01,895772619,A015010,참기름,[오뚜기]오뚜기 참기름 (500ML),11500,11500,0
2018-06-01,1804625154,F011130,홍삼,[개성인삼농협/산지직송] 홍삼 양갱 600g,18100,18100,0
2018-06-01,1804625155,F011130,홍삼,[CJ직배송]한뿌리 홍삼대보 용돈박스 ( 40ml x 20포),29900,29900,0
2018-06-01,895772618,A015010,참기름,[오뚜기]오뚜기 참기름 (320ML),7250,7250,0
2018-06-01,1804625152,F011130,홍삼,[CJ직배송]키크몬홍삼(포도)100ml*10입,12000,12000,0
2018-06-01,895772615,A011090,국수,오뚜기 진라면컵 순한맛 65G*6입,4200,2990,-1210
2018-06-01,1974177768,F012010,종이기저귀,보솜이 2017 프리미엄 천연코튼신생아-공용60P x 1팩,10900,10900,0
2018-06-01,1480881224,A011010,쌀,더든든 엄마밥줘 집밥 현미/백미/쌀/소포장/잡곡/캠핑,16900,16900,0
2018-06-01,1804625153,F011130,홍삼,[개성인삼농협/산지직송] 에브리데이 홍삼과 석류 5ml*28ea,37400,37400,0
2018-06-01,895772616,A019090,카레,[오뚜기]오뚜기 짜장 100g,2150,2150,0
2018-06-01,1132138309,E061010,세탁세제,타요 크림형 세탁세제 30입 3無 S마크 고농축 세제,11900,11900,0
2018-06-01,1343491695,A018100,꿀,잡화꿀 (다드림 500g) X20,131260,116830,-14430
2018-06-01,1509664770,F012010,종이기저귀,2018 보솜이 리얼코튼 밴드 공용 5단계 특대 36매3팩/ 보솜이,34900,33860,-1040
2018-06-01,895772614,A011090,국수,[오뚜기]오뚜기 진라면컵 매운맛 (65g*6입),4200,2990,-1210
2018-06-01,1212352241,C012030,여자상의,nn66 스트랩 베이직 린넨원피스 - 네이비 여성린넨원,35130,35130,0
2018-06-01,895772611,A011090,국수,[오뚜기]오뚜기 진라면 순한맛 멀티(120g*5입)*8봉지,22800,22000,-800
2018-06-01,2019400786,C011050,남자내의,블리치 워싱 데님팬츠(SAPDM17001INX)/ 시리즈(series),119400,101490,-17910
2018-06-01,2124133392,C011030,남자학생복,여름셔츠/남자셔츠/반팔셔츠/캐주얼셔츠/패션남방,29800,29800,0
2018-06-01,1151321454,C012060,여자내의,[밀스튜디오] 앵콜 머메이드 스커트 (SD514Q327),19000,19000,0
2018-06-01,1528689503,A012010,국산쇠고기,(애플파이)무배 함평월야농협 숙성 한우 부위별 모음,22900,22900,0
2018-06-01,214055218,D031010,주택수선재료,은분페인트 반짝이는 은색 4L 철재용,24000,24000,0
2018-06-01,959347506,F012020,생리대,나트라케어날개형대형10P,7900,6900,-1000
2018-06-01,490880330,C012040,여자학생복,피핀 디카누 엔틱 블라우스 #41962/ 피핀,20600,16280,-4320
2018-06-01,957589750,A011170,떡,풀무원 바로조리국물떡볶이 (423.5G),4700,4700,0
2018-06-01,862270593,A012040,닭고기,하림파주지점 훈제닭가슴살 저염5가지맛 3kg 5kg,28900,28900,0
2018-06-01,179472205,E031090,공기청정기,[캐쉬백1만원]다이슨 공기청정기 TP04 /이벤트,842000,786780,-55220
2018-06-01,1713745741,A018020,사탕,하오리위안 밀크츄 70g x 10봉 5가지맛 카라멜,9800,9800,0
2018-06-01,1864030839,F012020,생리대,바디피트 소프트앤핏 4팩+증정6P/생리대/귀애랑,11500,11500,0
2018-06-01,1880710395,A014020,분유,[LG생활건강]간편 액상분유 베비언스6~12개월 2단계 40개입 (니플미포함)/ 베비언스,55300,55300,0
2018-06-01,921866668,E061040,부엌용세제,헨켈 프릴 과실초 주방세제 750ml x3개 / 1000ml Y,12900,12900,0
2018-06-01,597434113,C012040,여자학생복,[루시다]M80 V4466/레베카 진주포인트 베스트,43800,39420,-4380
2018-06-01,1772001988,C012040,여자학생복,[베스티벨리]진주 포인트 페미닌 가디건 (BMCBD2186)_J5S3,34900,33160,-1740
2018-06-01,988932826,A011040,보리쌀,[월드그린] 한드레 현미1kg,3100,2370,-730
2018-06-01,630927348,C012060,여자내의,진청 밑단 커팅 앞 트임 H라인 롱 치마 데님 스커트,19900,19900,0
2018-06-01,1564253149,I011010,TV,삼성패널 49인치TV 50인치TV 55인치TV UHDTV LEDTV,320650,309000,-11650
2018-06-01,383923078,L021030,가방,KINMAC 노트북파우치 태블릿 그램 13.3 15.6인치10~17,9900,9900,0
2018-06-01,1048755411,C014010,아동복,[래핑차일드] 오프숄더 프릴 티 (88426-331-52),19000,17100,-1900
2018-06-01,1229037113,L021010,손목시계,로제타 여성 손목시계 FW-15 이쁜시계 손목시계 디지,14260,14260,0
2018-06-01,919117786,I011030,사진기,후지필름 X-H1+VPB-XH1 킷 (4k용 64GB 증정),2737000,2737000,0
2018-06-01,60571099,C021010,아동화,월드컵 아동운동화 유아신발 아동화 아동신발,21700,21700,0
2018-06-01,641504681,L012090,기초화장품,오휘 포맨 내츄럴 UV CC크림 기획/레포츠 선크림/헤라,23200,23200,0
2018-06-01,1407113420,L021060,유모차,유모차 겸용 차량멀티 포켓 - 차량용품,21700,19320,-2380
2018-06-01,1457108653,E061030,전구,장수램프 삼파장 형광등 FPL FPX 36W 55W 13W,450,450,0
2018-06-01,1212327260,C012030,여자상의,nn66 스트랩 베이직 린넨원피스 - 소라 린넨원피스 긴,35130,35130,0
2018-06-01,1636751931,A019180,즉석식품,CJ 비비고 국/탕/찌개 8종,1200,1200,0
2018-06-01,522423509,E061020,섬유유연제,[무료배송] 피죤 대용량 20리터/샤프란 20리터/섬유유연제/말통/세탁/세제/빨래/말통,17700,17700,0
2018-06-01,1651301299,C013010,점퍼,바람막이 발수제 발수스프레이 의류 자켓 다운 점퍼 패딩 여성 자켓 레인점퍼,20000,20000,0
2018-06-01,102689531,A022010,주스,청솔 희석용 주스모음/음료/만들기/오렌지/포도/키위,2700,2700,0
2018-06-01,1231833379,E031120,믹서,보만 과열방지 다용도 멀티믹서기 블렌더 UM5260,49800,44900,-4900
2018-06-01,1010404477,A018030,껌,뉴 볼라볼라 18G,500,500,0
2018-06-01,935007273,C013020,티셔츠,영문보트넥나시티/민소매/프린트티/끈나시/여름나시,6900,6900,0
2018-06-01,895708040,A011110,당면,풀무원 연두부 250G,1690,1690,0
2018-06-01,1376641390,F012050,의료측정기,아크레이 팔뚝형 혈압계 HL-858NA+아답터 혈압측정기,39000,39000,0
2018-06-01,168538464,L021020,장신구,정품 실버 silver 925 체인 팔찌 발찌 모음,17800,17800,0
2018-06-01,1730826221,A016150,아몬드,18년 햇 브라질너트 300g 마카다미아 브라질넛트 넛츠,11500,10900,-600
2018-06-01,2139179498,C014010,아동복,신축성이 우수하고 착용감이 편안한 상하복세트 [쿨라이프세트]/ 블랙야크(키즈),50000,41000,-9000
2018-06-01,824543034,E061020,섬유유연제,특가 다우니 고농축 섬유유연제 3.06L 에이프릴프레쉬,11900,9900,-2000
2018-06-01,900299833,I031040,생화,파라솔받침대 모음전 파라솔세트 삼각 사각 신소형,7800,7180,-620
2018-06-01,872374665,E041010,식기,[덴비] 임페리얼 블루 파스타 보울,24200,20090,-4110
2018-06-01,1507507877,C011030,남자학생복,남자 오버핏 남방/체크셔츠 박스 루즈핏 롱 긴팔 공용,26800,26800,0
2018-06-01,898927185,A013100,마른멸치,명품완도활전복 8-9 특대(VVIP선물용) 1kg,44900,44900,0
2018-06-01,536493456,C013040,청바지,[리틀그라운드]데님인더박스 트리플 데님팬츠(77311-414-19),45000,45000,0
2018-06-01,1159385413,C011050,남자내의,S~3XL 멀티입체포켓 카고반바지 남여공용 건빵바지,32800,29800,-3000
2018-06-01,988092879,E041070,밀폐용기,PET) 블루원형 과실주병 15L,8000,8000,0
2018-06-01,739426415,A019080,고추장,[농협] 우리땅우리찹쌀 전통식 찹쌀고추장 1kg,19900,17900,-2000
2018-06-01,174722641,I012010,컴퓨터,[E]Z70EV-AP75S2/7세대/i5/8G/SSD256G+500G/윈10프로,1010000,959500,-50500
2018-06-01,313817048,C012040,여자학생복,쿨젠.린넨조끼니트조끼.시스루가디건.롱조끼.뷔스티에,25800,23800,-2000
2018-06-01,772195336,A011050,콩,17년산 국산햇 생땅콩1kg 볶음땅콩800g / 견과류,11900,11900,0
2018-06-01,416051671,C013010,점퍼,바람막이 야상 WS-YSM23 바람막이 야상 점퍼 남자야상,77310,75770,-1540
2018-06-01,989970519,A013170,생선통조림,CJ 계절어보바로먹는직화골뱅이 150G*2번들,6980,6980,0
2018-06-01,1218860011,C014010,아동복,[알로봇] 9부져지배기팬츠 (17319-415-02),31000,25420,-5580
2018-06-01,237671534,E041010,식기,보타닉가든 로션디스펜서/ 포트메리온,26000,25740,-260
2018-06-01,280027793,E061010,세탁세제,숲에서 피톤치드 치약(200g)5개/편백함유/입냄새제거,50000,44000,-6000
2018-06-01,1208301489,A012050,소시지,천하장사 소세지 100입 1+1 /키스틱60g 20개 더블링,9350,9350,0
2018-06-01,466358313,E041010,식기,예담은/방짜유기/방짜/유기/그릇/세트/예단/혼수/반상기/세트/부부반상기/단반상기/옥,780000,750000,-30000
2018-06-01,165970789,C012030,여자상의,홀복/4 + 1 event/유니폼/미니원피스/클럽/섹시,56000,56000,0
2018-06-01,433181542,E011030,거실장,스피드랙 철제 TV거실장 티비다이 거실선반장 와이드,29800,29800,0
2018-06-01,1237175025,C013010,점퍼,걸크러쉬 슬림 가죽 자켓-m1071 (블랙) 겨울가죽자켓,55740,55740,0
2018-06-01,1809615385,A012050,소시지,초특가세일 [동원] 리얼 크랩봉 540g*2세트+리얼 치즈봉 540g*2세트(30g*72개입),17900,17190,-710
2018-06-01,762584076,F011150,건강기능식품,다솜 블랙 앤 화이트 강낭콩 미숫가루 3봉,11900,10900,-1000
2018-06-01,1388481328,C012040,여자학생복,[모다아울렛][레노마레이디]브이넥 숏가디건 D1 CW22KC080,59000,53100,-5900
2018-06-01,1010404412,A019180,즉석식품,[미소가]부드럽고 단백한 흑마늘 무뼈족발 300g,16900,9200,-7700
2018-06-01,1010404413,A019180,즉석식품,[미소가]고소한 북경훈제오리 220g,15900,7300,-8600
2018-06-01,2066416543,C013010,점퍼,후드티/후드집업/맨투맨/점퍼/커플티/단체티/빅사이즈,18900,18900,0
2018-06-01,1363200548,A017050,미나리,동결건조 유기농 양배추가루 50g x 3개 양배추 분말,30000,30000,0
2018-06-01,667013248,C012060,여자내의,[하프클럽/티뷰]402팬츠(TBH6PT611),15000,13500,-1500
2018-06-01,1692715744,C013020,티셔츠,[체이스컬트]16 SS 남성용 레터링 그래픽 민소매 티셔츠-FCAK5905EJ0,7000,6650,-350
2018-06-01,652605049,I031040,생화,SOS 긴급 구호세트,22010,19650,-2360
2018-06-01,1143002202,C012040,여자학생복,리스트 트럼펫 심플 라운드넥 니트 TSKPOH60040,29000,26100,-2900
2018-06-01,630005937,C012020,원피스,프레임직사각쟁반 중,30720,27350,-3370
2018-06-01,218439026,I031010,장난감,줄라이카 미니바이크 핑크 유아 무소음붕붕카 푸쉬카,49800,49800,0
2018-06-01,820926019,C011050,남자내의,(평화)(여인견8파자마)식물성 천연 섬유 인견 파자마,12020,10700,-1320
2018-06-01,349351739,C012060,여자내의,[SOUP]앞트임 롱 청스커트 SU4DS41,55200,48580,-6620
2018-06-01,1582459489,C014010,아동복,아동운동복 주니어 기모 아동타이즈 아동티셔츠 야구,9900,9900,0
2018-06-01,508497050,C012060,여자내의,[더미니][1color]힐다 점프수트랩브이넥,21850,20980,-870
2018-06-01,942914885,A017080,무,[남도장터]새싹향기 최휘준님의 새싹삼 100뿌리+덤5,19900,19900,0
2018-06-01,684147957,I012060,저장장치,ABKO HACKER K8100 청축/갈축/적축 기계식키보드 특가,35000,28900,-6100
2018-06-01,766214482,A017150,버섯,[엉클팜]유기농 알로에 베라 생잎 3.3gk 일반 / 무료배송,15900,15110,-790
2018-06-01,249376068,C012020,원피스,~93% 초특가!쉬즈미스/리스트 여름 단독 선할인 100종,9900,9900,0
2018-06-01,1791447773,F012050,의료측정기,브라운 귀체온계 IRT-6520/6030/6510 + 필터21개포함,75260,70000,-5260
2018-06-01,1300355959,C011030,남자학생복,패딩 옷 수선 접착 테이프 패치 경량 간절기 남성,9000,9000,0
2018-06-01,227185929,A013090,전복,정남진 장흥 장흥특산물 키조개 200g,33500,33500,0
2018-06-01,1278504977,A011180,파스타면,라폰테 스파게티 11호 500g 파스타 마카로니,780,780,0
2018-06-01,1752900513,E061020,섬유유연제,G2향기나 2.5Lx4개 / 20L대용량 섬유유연제,8000,7900,-100
2018-06-01,1457121674,C013010,점퍼,[헬로시스터]빅사이즈헬로시스터 부부[린넨블루종점퍼],59800,56810,-2990
2018-06-01,346734592,E031040,전기레인지,A형 냉장고 스마트 블록 특대 대 풀세트 냉장고 정,39670,39670,0
2018-06-01,1274116609,A012010,국산쇠고기,[홍천한우마을]꽃등심 초특가/로스구이 모음,6900,6900,0
2018-06-01,1877771983,F012010,종이기저귀,리베로 기저귀 팬티7단계36매/ 리베로,19800,18810,-990
2018-06-01,630365463,E041060,수저,티타늄 고급 전통수저세트 금수저/기념품/답례품/선물,36900,36900,0
2018-06-01,298229816,L012060,샴푸,최신정품 1+1 / 알페신 카페인 샴푸 C1 250ml 2개,19800,19600,-200
2018-06-01,232426493,C015040,장갑,레져 장갑모음 긴장갑 반장갑 자전거장갑 등산장갑,13000,13000,0
2018-06-01,392102803,A019060,된장,된장(일식 부천몽고 2㎏)X8 된장 재래식된장 식자재,56350,50720,-5630
2018-06-01,1588463322,C012060,여자내의,빈티지 스크래치워싱 청핫팬츠 TK-5728 청반바지 반바지 3부바지 핫팬츠 5부바지,25320,22540,-2780
2018-06-01,364011530,F012010,종이기저귀,[하기스] 매직핏&썸머(팬티/밴드) 1~6단계 2/3/4팩,30900,30900,0
2018-06-01,380288926,E011050,책상,해피클래스 1인용책상 2인용책상 H형책상/서랍장,99000,98000,-1000
2018-06-01,1238068720,A017140,콩나물,도라지 250g (경북 영주 재배산) 도라지차 건도라지차,18990,18990,0
2018-06-01,1498185411,E011040,소파,[조은가구]아리아 카우치소파 3인용+카우치/4인용쇼파,435000,319500,-115500
2018-06-01,900299834,I031040,생화,대형 폴딩 알루미늄 파라솔 그늘막 햇빛가리개,89000,70750,-18250
2018-06-01,840845925,I031010,장난감,레고41318 하트레이크 병원/프렌즈,115680,115680,0
2018-06-01,1860709612,E061020,섬유유연제,스너글 드라이시트 275매 빨래 의류 건조기,16900,16900,0
2018-06-01,1210543732,C013020,티셔츠,[글리밍]2018 여성 반팔 티셔츠 모음전 최대 57% 할인,5900,5900,0
2018-06-01,1265710669,C013020,티셔츠,[SOUP]숲 쿨체크롱셔츠(SU6LS42),49000,40180,-8820
2018-06-01,1880205029,A012050,소시지,사조 정통수제모듬소세지/그릴소시지/후랑크/안주,3500,3500,0
2018-06-01,164907243,A011140,부침가루,이른아침애 눈꽃 더블 치즈케이크 무스 크림 케 굿,14900,14900,0
2018-06-01,936576880,A011010,쌀,2017년산 늘조은쌀 20kg / 당일도정,46300,43900,-2400
2018-06-01,778487076,A018080,설탕,한혜진 다이어트 설탕 스테비아 240g용기/레몬밤 분말,9900,9900,0
2018-06-01,175385123,A019060,된장,[1+1]청정원 순창 조개멸치찌개된장양념 450g+450g(PET),9200,9200,0
2018-06-01,641431169,A018060,스낵과자,신흥 차원이 다른 꼬꼬스낵 대용량 1kg + 1kg 닭다리,11900,11900,0
2018-06-01,175385125,A019080,고추장,[1+1]청정원 순창 100%현미 태양초매운고추장 1kg+1kg(사각),23400,23400,0
2018-06-01,1632974077,A021010,커피,카카오닙스/식이섬유/카테킨/폴리페놀/미국/카카원두,17900,17900,0
2018-06-01,175385127,A019080,고추장,[1+1]청정원 순창 100%현미 태양초매운고추장 500g+500g(사각),14600,14600,0
2018-06-01,1049874299,A019080,고추장,해찬들 우리쌀로 만든 태양초 고추장 500g(1+1),6800,6800,0
2018-06-01,359969521,A013140,북어채,자연건조 황태채 200g / 황태포 진미채 먹태 건어물여,4900,4900,0
2018-06-01,1787777004,A018110,물엿,명인 쌀조청 480g/꿀 조청 물엿/국가지정 명인 강봉석,7000,7000,0
2018-06-01,175385121,A019060,된장,[1+1]청정원 순창 조개멸치찌개된장양념 900g+900g(PET),16800,16800,0
2018-06-01,989970575,L021050,우산,코멕스아이스쿨러백보태니컬22L,25900,25900,0
2018-06-01,450600266,C012040,여자학생복,MJ_1221 카키 양털 조끼 남성조끼 여성털조끼 남성털,31080,31080,0
2018-06-01,1485043530,C013010,점퍼,봄신상 블루종 자켓 점퍼 야상 후리스 바람막이,25800,24800,-1000
2018-06-01,1688735752,E031010,전기밥솥,CRP-CHS107FS/쿠쿠/IH압력/10인용/음성/GH,400000,367910,-32090
2018-06-01,1429321748,C012060,여자내의,[제이빔]저온스퓨어앵클스키니 JVTJ184G1,29900,29900,0
2018-06-01,2046947899,C012040,여자학생복,[모조에스핀]플라워 하이넥블라우스_S174MSC023(GN1),89000,84550,-4450
2018-06-01,1800841544,F011130,홍삼,㉤ 천제명 홍삼차가버섯,60000,60000,0
2018-06-01,2026750032,C012040,여자학생복,[로렌즈앤]로렌즈앤 쿨링씨스루가디건,22800,19380,-3420
2018-06-01,1708824306,C013020,티셔츠,남성 남자 여성 여자 골프웨어 냉감 골프 이너웨어,23900,21280,-2620
2018-06-01,237803931,C012040,여자학생복,[모다아울렛][쉬즈미스]쉬즈미스 타이넥 프린트 블라우스(SWWBLI11100-YE),54000,51300,-2700
2018-06-01,897688028,A013010,갈치,[여수고기]국내산 갈치/고등어 2kg/삼치 2kg/아귀 1kg,9900,9900,0
2018-06-01,2000408206,F012020,생리대,한결 16Px4팩+gift키트/생리대/바디피트/오버나이트,10900,10900,0
2018-06-01,1327610784,C013020,티셔츠,면스판 기본 박스 라운드티 DM-5639 반팔티 박스반팔,6660,6660,0
2018-06-01,1582148885,C013010,점퍼,아디다스 아디제로 트랙자켓 ( S99687 ),150570,140040,-10530
2018-06-01,268393707,C012020,원피스,[쉬즈미스][쉬즈미스] 코튼 블렌드 버튼다운 체크 셔츠_SWWSTI20010_RE,69000,65550,-3450
2018-06-01,151047899,A013090,전복,영신 냉동명태포슬라이스 7kg(700gx10),70910,70910,0
2018-06-01,771977955,L021060,유모차,루키 스마트 웨건/KC안전검사/안전브레이크/유아웨건,70000,70000,0
2018-06-01,2102829412,L012010,면도기,도루코 페이스 6 일회용 면도기 10개 묶음,10900,10900,0
2018-06-01,1727788481,C011030,남자학생복,댄디해 두줄배색포인트 포켓 남자니트가디건 간절기 봄초여름가을겨울,27000,27000,0
2018-06-01,369953458,C014020,유아복,여름신상/여아티/프릴티/레이스카라티/면스판반팔티,16000,16000,0
2018-06-01,592503603,A011030,찹쌀,2017년 햇 국산 보리쌀 10kg/찰보리/쌀보리/늘보리,20900,20900,0
2018-06-01,271453775,A018090,잼,스머커즈잼/지프땅콩버터/딸기잼/포도잼/오렌지잼,4800,4800,0
2018-06-01,1342318522,L021010,손목시계,무조건 무배!헤네스 패션시계/메탈시계/손목시계,5700,5700,0
2018-06-01,218577,L021010,손목시계,카파 손목시계 DS116UA 카파 손목시계 전자시계 스포,25670,25160,-510
2018-06-01,2008694552,A017100,당근,큼직한 열무 김치용 4Kg / 국내산,29650,29650,0
2018-06-01,1941721911,E061040,부엌용세제,세이프 주방세제 700mlx3 자연퐁 트리오 퐁퐁 참그린,10000,9900,-100
2018-06-01,1611796655,I031040,생화,2018 고탄성 발목 보호대(BM-100) 1세트/실리콘 아대,24000,21480,-2520
2018-06-01,895686121,A019030,생강,햇 생강(150G/봉),2990,2990,0
2018-06-01,995310354,E011070,식탁,실용적인버베나홈바! / 다용도테이블 / 수납정리함 / 렌지대 / 밥솥 / 가구직배송,70000,62910,-7090
2018-06-01,1209312432,A016070,귤,자연농부고냉지 거창한사과 선물세트1호 5kg11-13과/,65810,65810,0
2018-06-01,2085612996,C013010,점퍼,아디다스 유소년 콘디보16 스타디움자켓 ( AN9871 ),134540,134540,0
2018-06-01,357081476,C012040,여자학생복,[매그제이(MAGJAY)]베이직U넥니트 (J11PNT214),13900,13070,-830
2018-06-01,453539057,C013060,등산복,여름 쿨티셔츠 남자반팔티 냉감티 라운드티w025,9900,9900,0
2018-06-01,553971441,A013060,게,충남 갑오징어 냉동1kg/쭈꾸미/돌게,17900,17900,0
2018-06-01,1915508245,A018100,꿀,오뚜기 벌꿀 아카시아 1kg X 6EA(Hanworld2),240600,211730,-28870
2018-06-01,358261712,A016120,바나나,명품 스위티오 Dole 바나나 (2~4다발) 꿀덩어리,11900,11900,0
2018-06-01,874724961,E061080,키친타월,무료배송 롤/화장지/미용티슈/각티슈/키친타올/물티슈,15600,15300,-300
2018-06-01,1041929118,A017160,오이,표고버섯 200g 목이버섯 슬라이스 통표고 표고채 버섯,5900,5900,0
2018-06-01,325684683,C013030,스웨터,밀란시아 빅사이즈 후드 집업가디건 big9-no.2 빅사이,57330,57330,0
2018-06-01,1006574967,E061060,살충제,클레어 살균소독제크린 유아용(500ml) - 유아용 탈취,22230,19790,-2440
2018-06-01,1803242536,C012060,여자내의,[미미앤디디]chaste 치마바지_4558/ 미미앤디디,22880,20370,-2510
2018-06-01,549753964,C014010,아동복,로하스 한지 키즈 남 런닝 셋트 NO1 닥나무 원료의,28420,28420,0
2018-06-01,153310157,I031010,장난감,무료배송/조이트론 EX3 프리미엄 조이패드/PS3/PC호환,27500,27500,0
2018-06-01,2009071958,A018010,초콜릿,[캔디마을]x-5 엑스파이브 1곽(36gX18개) 초코바 간식,7800,7800,0
2018-06-01,1979190362,A014020,분유,일동산양분유2단계 800g*3캔평일오후6시마감,119500,119500,0
2018-06-01,839506749,F011150,건강기능식품,일양약품 플래티넘 종합비타민미네랄 영양제 12개월,23900,23900,0
2018-06-01,1387555824,C013010,점퍼,AG BOX 3단배색 오픈 CC 집업점퍼 집업 집업잠바 지퍼,52100,52100,0
2018-06-01,572634439,C014020,유아복,[트윈키즈]데일리슬럽가디건 (M7MB9G01),7000,7000,0
2018-06-01,530512477,C012040,여자학생복,보풀방지 블랙 교복 가디건 여자 교복 예쁜교복 교복,37070,35960,-1110
2018-06-01,1284325081,C013020,티셔츠,T1880-낭뜨 소매셔링 라운드 티셔츠 반팔티셔츠 정장,21040,19990,-1050
2018-06-01,1180807221,C013050,운동복,24_고구마베이비 아기옷-무형광 슬라브 차콜 민소매,19110,18540,-570
2018-06-01,1007499465,A012040,닭고기,푸드원 훈제 닭가슴살 100g 외 13종 선택,980,900,-80
2018-06-01,1325298968,C012060,여자내의,빅사이즈 기모베이직레깅스 CM1711 빅사이즈 미시옷 여성의류 기모베이직레깅스CM1711,28440,25320,-3120
2018-06-01,1195661428,A018010,초콜릿,킨더 초콜릿 T8 X 10개 / T4 X 20개,19000,19000,0
2018-06-01,1407497323,E061010,세탁세제,퍼실 컴플리트솔루션 라벤더 2.7LX4,83200,39900,-43300
2018-06-01,6682140,C012040,여자학생복,빅사이즈 헬로시스터 비트윈[가디건]/ 헬로시스터,39000,30420,-8580
2018-06-01,1000603743,E031070,에어컨,NEW 신일 SIF-16CSM 천장형 선풍기 천장용 선풍기,51900,51900,0
2018-06-01,767131083,C012060,여자내의,[리스트] TWWSKI50080 사이드 슬릿 솔리드 미디스커트,49000,40180,-8820
2018-06-01,570236496,A017110,감자,건도라지채_100g x 2EA 버섯/나물/건나물/말린나물/말,59300,59300,0
2018-06-01,369243651,G011070,자전거,700C 레브 7 휠라 하이브리드자전거 커플하이브리드,274370,249900,-24470
2018-06-01,328709965,A019160,밑반찬,반찬모음 1kg 무말랭이 양념깻잎 콩조림 일미 마,5900,5900,0
2018-06-01,244748528,C013010,점퍼,AGC빅사이즈 폴라폴리스 자켓 MC 1210 큰자켓 빅사이,83440,83440,0
2018-06-01,1254910990,C013020,티셔츠,봄 여성 브이넥티/반팔티셔츠/오프숄더/U넥/무지/나시,19800,19800,0
2018-06-01,1874635782,A021010,커피,이태리 트롬베타 하드파드커피 150개입,89000,76000,-13000
2018-06-01,1405280423,A021010,커피,네스카페 돌체구스토 아메리카노 캡슐커피 12종,9500,9500,0
2018-06-01,386399696,E021020,커튼,롤스크린 그림 암막_1451,39790,39790,0
2018-06-01,1170309675,C012040,여자학생복,[루시다]C57 KN4561/베이브 짜임 니팅 베스트,28200,25380,-2820
2018-06-01,2141649510,F011150,건강기능식품,산과들에선식처럼미숫가루900g*2봉 쉐이크통 꿀차,13900,13900,0
2018-06-01,2115791421,C012040,여자학생복,임페리얼 구제매니아몰 여성 90 후드 풀집업 니트 조끼 베스트 프렌치소매 살짝롱기장,37530,37530,0
2018-06-01,799861311,C014010,아동복,[키키제제]여아 원피스/여름/ 롱티/ 상하복/ 가디건,10900,10900,0
2018-06-01,2061884330,A018020,사탕,크라운 마이쮸 328gx3봉 대용량사탕 과자 간식,10800,10800,0
2018-06-01,1491181761,A019060,된장,해찬들 담백한 재래식된장 3kg /고추장,14900,14900,0
2018-06-01,601033771,A014030,치즈,아담스 파마산치즈 치즈가루 1kg,15240,15240,0
2018-06-01,1468466924,A012010,국산쇠고기,[무항생제] 불고기 600g 1+등급,36100,36100,0
2018-06-01,2136660841,A018100,꿀,*당일출고*무료배송*담터 사양벌꿀 1kg+1kg,15900,15900,0
2018-06-01,1564640365,E061050,청소용세제,홈스타 클리너 모음전/싱크대/세면대/변기/세탁조/발,3500,3500,0
2018-06-01,2127927222,C013040,청바지,[공구우먼] 업다운 히든밴딩 스키니 29410 빅사이즈 여성의류,37000,37000,0
2018-06-01,1011180962,A011100,라면,[풀무원직배송]생생 물냉면 10인분 구성(냉면10+육수10),19300,19300,0
2018-06-01,1938984949,C011030,남자학생복,[TI FOR MEN] 티아이포맨 도트 베스트 M144MVT280M1NV,15300,13470,-1830
2018-06-01,922276119,C013050,운동복,소프트99 글라코 유막제거제(G-47)+발수코팅제(G-4),28500,21200,-7300
2018-06-01,60117871,C012040,여자학생복,#NAME?,52160,51120,-1040
2018-06-01,1804625125,F011130,홍삼,[CJ직배송]키크몬홍삼(사과)100ml*10입,12000,12000,0
2018-06-01,1011180937,A011100,라면,[풀무원직배송]생물냉면육수290mlx20개,19000,19000,0
2018-06-01,1804625126,F011130,홍삼,[CJ직배송]키크몬홍삼(배)100ml*10입x5개,60000,60000,0
2018-06-01,1804625123,F011130,홍삼,[CJ직배송]키크몬홍삼(사과)100ml*10입x5개,60000,60000,0
2018-06-01,1804625124,F011130,홍삼,[CJ직배송]키크몬홍삼(사과)100ml*10입x3개,36000,36000,0
2018-06-01,2078507462,C012040,여자학생복,kk34 헨리넥st 하프버튼 데님셔츠_진청 데님셔츠 패션,16620,16620,0
2018-06-01,1804625127,F011130,홍삼,[CJ직배송]키크몬홍삼(배)100ml*10입x3개,36000,36000,0
2018-06-01,1940862065,A013100,마른멸치,완도생산자직송/ 꼬마전복1kg(40~50미)/당일조업/전복,22900,22900,0
2018-06-01,2013768852,G011070,자전거,스마트 아동용/어린이자전거 틴탑/탑키즈 16/18/20형,86200,76720,-9480
2018-06-01,1385226544,L012090,기초화장품,1+1+1 더페이스샵 허브데이 클렌징크림 3개/클렌징폼,9000,8900,-100
2018-06-01,600946900,C011050,남자내의,창고정리초특가 3장무배 컬러포켓스판반바지 빅사이즈,9800,9800,0
2018-06-01,155949048,F012010,종이기저귀,보솜이 리얼코튼기저귀 신생아/소형/중형/대형/특대형,29000,29000,0
2018-06-01,1500608049,C012060,여자내의,[모다아울렛][플라스틱아일랜드]린넨 와이드 팬츠 (ph2wp703),29400,29400,0
2018-06-01,184572359,C014010,아동복,뿌찌 폴젠 남아 아동 주니어 옷 티셔츠 라운드 카라티,11200,11200,0
2018-06-01,1092328913,E031080,선풍기,신일산업 히터/캐비넷/이동식/가스난로 SCG-RB1000,188000,188000,0
2018-06-01,1092328914,E031080,선풍기,대원가전 히터/원통형/순간발열 DW-630,64500,64500,0
2018-06-01,1667132411,C012030,여자상의,빅사이즈원피스/루즈핏/캐주얼 빅사이즈여성의류 O3,37800,35800,-2000
2018-06-01,440916241,C012040,여자학생복,[블루종]베이직 쿨링 숄가디건_[B1806CD030B],19000,15030,-3970
2018-06-01,483115330,C013010,점퍼,MD추천 여성양털무스탕 여자명품무스탕 여자무스탕브랜드(국내제작/44~88사이즈별맞춤,768000,768000,0
2018-06-01,175385156,A019080,고추장,[1+1]청정원 순창 100%현미 태양초찰고추장 200g+200g(사각),5800,5800,0
2018-06-01,1133153736,D031010,주택수선재료,본덱스 방부방충용도료 20L 오일스테인,250000,220000,-30000
2018-06-01,1428401279,E011040,소파,[동서가구]LV 통가죽 PU 3인 가죽소파 외 DF907945,239000,239000,0
2018-06-01,1780006992,C013040,청바지,COMPAGNA 꼼빠니아 슬림 웨이스트 밴드 데님팬츠 3종,69900,66410,-3490
2018-06-01,2026750004,C012040,여자학생복,[로렌즈앤]로렌즈앤 이츠롱가디건,22800,19380,-3420
2018-06-01,175385150,A019080,고추장,[1+1]청정원 순창 100%현미 태양초찰고추장 2Kg+2Kg(사각),31000,31000,0
2018-06-01,1959417356,A022010,주스,천연 코코넛워터 지코 330mlx12개,18500,18500,0
2018-06-01,988067827,F011150,건강기능식품,[뉴트리나] 콜로스트럼 세트(1000mgx150개)x2개,140000,140000,0
2018-06-01,334054643,C012030,여자상의,여름신상 데일리룩은 데일리샵,12900,12900,0
2018-06-01,175385152,A019080,고추장,[1+1]청정원 순창 100%현미 태양초찰고추장 1Kg+1Kg(사각),22000,22000,0
2018-06-01,2079749124,E041060,수저,은수저닷컴/칠보99%은수저2벌세트/선물예단포장,318000,318000,0
2018-06-01,175385154,A019080,고추장,[1+1]청정원 순창 100%현미 태양초찰고추장 500g+500g(사각),14000,14000,0
2018-06-01,1061716780,E011050,책상,FiXA 컴퓨터책상/H형책상/L형책상/학생책상/의자모음,23900,23900,0
2018-06-01,2108317753,A017220,양파,(면)(냉동)청학 대파1kg,3240,3240,0
2018-06-01,2007764272,I012060,저장장치,로지텍코리아 G402 Hyperion Fury 마우스 A/S 2년,53080,49900,-3180
2018-06-01,1299729045,L021060,유모차,마리꼬/바니 휴대용유모차/등받이조절/쿨시트/파라솔,58000,58000,0
2018-06-01,450252635,C013030,스웨터,킬라이트 옆트임 롱니트 SD-6467,17160,17160,0
2018-06-01,424211417,I031040,생화,아웃팅/사은품증정/침낭/캠핑침낭/연결침낭/캠핑용품,13900,13900,0
2018-06-01,110455819,C011050,남자내의,푸마 트레이닝 팬츠(65382437),58600,58600,0
2018-06-01,476497553,C011020,남자상의,MJ-062 패딩 싱글 하프코트-차콜 겨울코트 남성코트,165440,165440,0
2018-06-01,457700236,E061060,살충제,화학제품을 사용하지 않은 친환경 피톤치드 1L 탈취제,15610,15610,0
2018-06-01,551320003,A019130,스프,오뚜기 양송이 스프 1kg 간식스프 간식양송이스프 스,13780,13780,0
2018-06-01,1334217669,F012050,의료측정기,뉴 아큐첵 액티브 GU 혈당측정기+시험지60매+정품침110개+솜100매+ 로슈혈당수첩외/로,57000,51420,-5580
2018-06-01,1001303695,C013050,운동복,불스원 에탄올그린워셔 6개 무료배송 탑크린 발수코팅,14900,13710,-1190
2018-06-01,603165342,F012010,종이기저귀,[마미포코] 마미포코 쿨썸머그린 팬티기저귀 특대 남아 28매X3팩,36900,36900,0
2018-06-01,1931351448,C011020,남자상의,봄 신상 정장바지/남성바지/슬랙스/스판/남자/남성,24000,17800,-6200
2018-06-01,1248711793,L021060,유모차,(호코)호코 슬림 앤 슬라이드 유모차,492600,438420,-54180
2018-06-01,1293993365,C011030,남자학생복,MCD-917 빈티지 스타일 롱가디건 가을가디건 빈티지가,47970,47970,0
2018-06-01,1555465659,A013120,낙지,정화 해오징어 버터구이 30gx5.,17230,17230,0
2018-06-01,1067453302,E031080,선풍기,인터비즈_ 선풍기형 세라믹 전기히터 IB-714R(레드),32550,32550,0
2018-06-01,1067453303,E031080,선풍기,대웅 세라믹 벽걸이히터 CZ-STW2802,26040,26040,0
2018-06-01,1067453304,E031080,선풍기,신일_좌석용 원적외선 세라믹 히터 SEH-JS30,53010,53010,0
2018-06-01,1067453305,E031080,선풍기,신일_벽걸이형 원적외선 세라믹 히터 SEH-AW95,49290,49290,0
2018-06-01,1880077894,C015020,모자,(당일출고)팀킨정품 군모 볼캡 야구 모자 남자 여성,5900,5900,0
2018-06-01,725395921,C012060,여자내의,라크레시아 크롭팬츠 4종,59900,58900,-1000
2018-06-01,2083117873,C011020,남자상의,남자코트 베이직 네이비 싱글 롱코트 /(참고)남자봄아,55700,49020,-6680
2018-06-01,392126739,L021020,장신구,(피어싱 금속 방지 리메인) 귀걸이 화장소품 피어싱,12340,11110,-1230
2018-06-01,170482770,L012060,샴푸,[코스트코] 자올 닥터스오더 시너지 부스터 100ML,36230,36230,0
2018-06-01,1086227706,E031050,냉장고,K337SN15E o클릭o 디오스/김치냉장고/스탠드/LG전자,1381100,1381100,0
2018-06-01,589225316,C013020,티셔츠,남여공용 피그먼트 독수리자수 브이넥 티셔츠(JH2TSU403)/ 지프,24500,20830,-3670
2018-06-01,1915533262,A018100,꿀,오뚜기 벌꿀 야생화 500g X 10EA(Hanworld2),188100,165530,-22570
2018-06-01,1640536250,C013010,점퍼,로시뇰 아동 신장 140-160 패딩점퍼 눈썰매 보드/802,19000,18810,-190
2018-06-01,521855390,A013090,전복,큰조개세트/4인기준4kg~/무료배송,35800,35800,0
2018-06-01,1943309366,A019060,된장,타푸리 오토쿠 32p 미소된장 4종/일본즉석미소된장,13900,13900,0
2018-06-01,1243697256,I031010,장난감,뽀로로 샤워놀이 유아 아동 목욕 물놀이 완구 장,24420,21490,-2930
2018-06-01,988246550,A018060,스낵과자,농심 쌀 새우깡 80G,980,980,0
2018-06-01,1014168736,L021030,가방,브랜드 백팩/ 학생/가죽/천/정장/캐주얼/남자/배낭,29500,29500,0
2018-06-01,298504333,C013010,점퍼,캐주얼세미정장자켓 여름쿨마린넨자켓 남자콤비마이,49800,49800,0
2018-06-01,1090483861,E031130,보온매트,클래파_ 전기요 2인용 BFB-EB002,36000,36000,0
2018-06-01,1010284139,A018030,껌,롯데 자일리톨 라이트 용기 87G,4000,3290,-710
2018-06-01,1090483862,E031130,보온매트,클래파_ 전기요 3인용 BFB-EB003,39000,39000,0
2018-06-01,1090483860,E031130,보온매트,클래파_ 전기요 1인용 BFB-EB001,33000,33000,0
2018-06-01,1290044950,C012020,원피스,[구엘]Guell_ 브이네크롱린넨코트 (G85-WCT026),59800,56810,-2990
2018-06-01,1010284135,A014030,치즈,더래핑카우 벨큐브구르메(15큐브)78G,4850,4850,0
2018-06-01,92811884,C011050,남자내의,[지오다노]여 부츠컷 슬랙스 418506 (영등포점B),35820,29540,-6280
2018-06-01,950100113,E011030,거실장,브리쉘 3인 쇼파,189900,189900,0
2018-06-01,1674594333,E031010,전기밥솥,쿠첸/정품/쿠첸패킹/리홈패킹/클린커버패킹/핸들패킹,8300,8300,0
2018-06-01,950100111,E011030,거실장,브리쉘4인쇼파,305900,305900,0
2018-06-01,699155478,F011130,홍삼,초이스엘프라임 홍삼 타블렛(500MG*60정),20000,20000,0
2018-06-01,232597521,C013020,티셔츠,[제이디엑스][JDX] 남성 가슴절개포인트 요꼬에리 티셔츠 2종 택1 (X2NSTLM03),29000,27550,-1450
2018-06-01,1004655920,F011130,홍삼,[정원삼] 6년근 고려홍삼정 365스틱(10g x 30포) / 홍삼스틱,29800,29800,0
2018-06-01,988246580,A018060,스낵과자,[농심]농심 알새우칩 68G,1200,990,-210
2018-06-01,233440201,F012050,의료측정기,VT 오토첵 노필터 적외선 체온계 TS-42(사은품증정),35000,32550,-2450
2018-06-01,2099920487,A011140,부침가루,베이킹 아크릴 스텐실도안 어린이날 제빵용케익스텐실,10680,10680,0
2018-06-01,1300688311,C015040,장갑,[프로스펙스] (SIZE : 0SM) 슬리브 메이저 2 니트 글러브(,8740,8740,0
2018-06-01,2139517781,I012010,컴퓨터,119만 삼성노트북9 Always NT900X5V-A58A,1314730,1249000,-65730
2018-06-01,1221502400,C012040,여자학생복,[포에버21]드레이프 니트 판초/FOREVER21/니트/스웨터/롱니트,33900,16950,-16950
2018-06-01,1090483858,E031130,보온매트,비비스_ 스누피 전기요(싱글) SM-1012,48000,48000,0
2018-06-01,1090483859,E031130,보온매트,비비스_ 스누피 전기요(더블) SM-2012,52000,52000,0
2018-06-01,2071419568,E031110,청소기,POLTI 폴티 스팀청소기 SV440 스틱형 핸디형 2 in1,118000,118000,0
2018-06-01,368785935,L021020,장신구,슬림 가죽 초커 목걸이 골드스틱 가죽 스틱초커 슬림,11290,11290,0
2018-06-01,1224446994,C013020,티셔츠,[지오다노] 018503 슬릿넥 반팔 폴로,19800,15840,-3960
2018-06-01,1714986959,C012040,여자학생복,[올리브데올리브]펀칭자수프릴블라우스(OW7MB548)(경기점),59000,52660,-6340
2018-06-01,1840612478,C013010,점퍼,바람막이/점퍼/후드점퍼/야상/남자점퍼/남성/블루종,59800,39800,-20000
2018-06-01,1262502182,C021040,실내화,푸마 BASKET HEART 363073,42510,42510,0
2018-06-01,1618147179,C013020,티셔츠,[라코스테] 남성 스트라이프 반팔티 LCST TH3218-18BEV0,98000,93100,-4900
2018-06-01,1248708166,C011020,남자상의,(색상 : 카키 | 사이즈 : XL) WMJ-009 지,88300,88300,0
2018-06-01,32254233,E031120,믹서,[해피콜]초고속 블렌더 해피콜 엑슬림,279800,279800,0
2018-06-01,175219725,C014010,아동복,[키키제제]남아 상하복/바람막이/세트/트레이닝복,10900,10900,0
2018-06-01,290753473,L012010,면도기,질레트 블루 투 플러스 일회용 면도기 10+1입 x 1팩,3380,3380,0
2018-06-01,545713716,E061010,세탁세제,찌든때제거제 바르는테크 220ml 얼룩제거제 제거제 부,5750,5750,0
2018-06-01,1884244421,C011050,남자내의,초특가 여름 면바지 남자 일자 데님 팬츠 밴딩 바지,28000,15800,-12200
2018-06-01,1234293268,L012040,치약,2080 치약 140g x10개 시그니처 진지발리스 페리오,10900,10900,0
2018-06-01,490348310,E041070,밀폐용기,글라스락/국산/유리병/밀폐용기/잼병/실링지/쥬스병,500,460,-40
2018-06-01,988246578,A018060,스낵과자,[농심]닭다리 후라이드 66G,1200,1200,0
2018-06-01,988246577,A018060,스낵과자,[농심]농심 감자깡 75G,1200,1200,0
2018-06-01,954933477,E061090,방향제,[P&G]페브리즈 차량용 맑은하늘바람 (2ML),5600,5600,0
2018-06-01,989081628,A013050,오징어,참숯고등어구이 70G/팩,2990,2990,0
2018-06-01,988246575,A018060,스낵과자,농심 포스틱 84G,1200,1200,0
2018-06-01,954933478,E061090,방향제,[P&G]페브리즈 차량용 라벤더2ML,5600,5600,0
2018-06-01,609506983,F012010,종이기저귀,[네띠] 스웨덴 친환경 네띠 기저귀 밴드형 4단계 4팩,50000,50000,0
2018-06-01,1799811753,A021010,커피,커피생두 1Kg 다양한 산지별 New Crop,7300,7300,0
2018-06-01,453169668,L012010,면도기,특가 도루코 터치3 X 24개/30개/일회용면도기/페이스7,8800,8800,0
2018-06-01,574482537,C011050,남자내의,[스파오(SPAO)]슬림 슬랙스(9부)_SPTA825M94,22900,22900,0
2018-06-01,438173541,C012040,여자학생복,[22XX]하넬니트나시/ 엔비룩,14900,12520,-2380
2018-06-01,1836081272,C013040,청바지,리얼타임[알렉스로간-알슨 프리미엄 데님진]빅사이즈,29800,29800,0
2018-06-01,1264652760,C011050,남자내의,[지오다노]남 슬림핏 치노 팬츠 117521,13000,10660,-2340
2018-06-01,494628320,C012020,원피스,(JJ지고트) 트위드 체크 코트형 자켓 GI3A0JK14/ 제이제이지고트,379000,341100,-37900
2018-06-01,1315207916,E031040,전기레인지,황토진공멀티누름락직8호대/16.2L,27170,27170,0
2018-06-01,1428897445,A014010,우유,엿기름(성진 1K)X10개/엿기름가루 식혜재료,48260,46820,-1440
2018-06-01,954010855,A014010,우유,빙그레 딸기타임 200ML,500,500,0
2018-06-01,233765742,L021020,장신구,우하나 너를사랑한시간 14K 정품 Gold 슬림큐빅스틱,211150,211150,0
2018-06-01,690511272,E061050,청소용세제,Mr홈스타 바르기만하면/뿌리기만하면 곰팡이싹,13900,13900,0
2018-06-01,954010856,A014010,우유,빙그레 초코타임 200ML,500,500,0
2018-06-01,954010857,A014010,우유,빙그레 커피타임 200ML,500,500,0
2018-06-01,417037590,C015040,장갑,아놀드파마_APGW-BY1221(가죽장갑_여성용) 여자장갑,27420,27420,0
2018-06-01,2143111998,C012020,원피스,[마일리지]헤링본베이직코트 JK062D7,57800,54910,-2890
2018-06-01,1121543611,F012020,생리대,엘리스 생리대 메가미 슬림 날개 대형 18P x 2팩/ 엘리스,10500,9980,-520
2018-06-01,397332221,E061020,섬유유연제,샤프란 꽃담초 / 한입 꽃식초세제 용기 2.4L x 2개 외,15900,15900,0
2018-06-01,1748973980,I031010,장난감,[해피store][와우토이즈 두들리 덤프트럭] 자동차장난감 장난감자동차 장난감 완구,57710,57710,0
2018-06-01,1514140602,E011040,소파,편하고 푹신푹신한 리클라이너형 에어빈백 에어소파,24500,24500,0
2018-06-01,1239202882,C013010,점퍼,여성 체크코트 후드코트 KK 셀린체크 후드CT 가을자켓,99350,99350,0
2018-06-01,1806474921,E011030,거실장,윌리 하이쿠션 좌식의자 루나,100000,100000,0
2018-06-01,1093254330,E031080,선풍기,홍진 BTI 전기라디에이터 9핀 BTI-900,33700,33700,0
2018-06-01,537960382,C012040,여자학생복,빅사이즈 DWW1586 커버 오픈 롱 베스트 803 빅사이즈,40980,40980,0
2018-06-01,1433224143,A012010,국산쇠고기,[무항생제] 국거리 600g 2등급,29500,29500,0
2018-06-01,961709392,A022010,주스,뽀로로 음료수 235ml x 24개 어린이음료 어린이간식,16900,16900,0
2018-06-01,954933450,A022010,주스,[롯데]롯데 콜드 비타민 플러스 2입 기획 (950ML*2),4980,4980,0
2018-06-01,2131295441,E041020,컵,도자기 머그컵/커피잔 머그잔 물컵 인쇄 찻잔 답례품,1000,1000,0
2018-06-01,1320558323,E011020,침대,프리미엄 패밀리침대 Q+Q 가드형 본넬 매트리스,765100,742150,-22950
2018-06-01,1641586374,C012040,여자학생복,레이스 7부 가디건 JCD006/ 웬디즈갤러리,25700,23910,-1790
2018-06-01,1390845677,C012060,여자내의,쉬폰 플레어 스커트형 팬츠 TWWSPH60070/ 리스트,17000,15300,-1700
2018-06-01,2110077109,C013050,운동복,코코스 결빙방지제 600ml 차량성에제거제 자동차용성,13020,13020,0
2018-06-01,1093254328,E031080,선풍기,홍진 BTI 전기라디에이터 5핀 BTI-500,28000,28000,0
2018-06-01,132179301,I011010,TV,LG 울트라 HD TV 49UJ6220 123cm IPS패널,842000,808320,-33680
2018-06-01,1167787045,F012020,생리대,시크릿데이 new센스 슬림 중형/대형 7팩,9900,9900,0
2018-06-01,1093254329,E031080,선풍기,홍진 BTI 전기라디에이터 7핀 BTI-700,31400,31400,0
2018-06-01,1428917247,A017300,미역,삼각김밥김100매(조미김/일반김:선택구매)성형틀 없음,10500,10500,0
2018-06-01,1319797491,C012060,여자내의,빅사이즈 동글레이스스커트 CM1703 미시옷 임부복 빅,28720,28720,0
2018-06-01,197256243,C012060,여자내의,RT5 단가라 오픈숄더 티-M1037,18870,18500,-370
2018-06-01,235331146,E041070,밀폐용기,밀폐용기 모음전 반찬통 보관 김치통 밀폐 양념통 수납 용기 김치 냉장고 냉동실 찬통,1300,1190,-110
2018-06-01,1121543641,F012020,생리대,엘리스 생리대 고쿠수이 날개 대형 16P x 2팩/ 엘리스,12500,11880,-620
2018-06-01,502866545,C013020,티셔츠,라비아 단가라 폴라티 SD-9022 여자목폴라티 목폴라티,10020,10020,0
2018-06-01,244543176,C012040,여자학생복,레니본 구제매니아 여성 XS 앙고라 램스 울 반팔 니트,82900,82900,0
2018-06-01,519987694,A011040,보리쌀,미국 흰강낭콩4kg/캐나다산 검은강낭콩4kg,8800,8800,0
2018-06-01,1155865545,C012040,여자학생복,[타미힐피거여성]여성 플래그 그래픽 니트 스웨터(TFMS1WOE44A0),192500,173250,-19250
2018-06-01,2088589642,C013040,청바지,[리바이스]남성 여름 502 테이퍼드핏 퍼포먼스 쿨 진 (29507-0168),129000,118680,-10320
2018-06-01,484118780,A016070,귤,S일해/보석건귤 선물세트 16호 2박스-말린귤/제주의맛,49700,49700,0
2018-06-01,432528712,E031110,청소기,[에이스전자] 싹스 코드리스 무선청소기 LC-7300T 고출력진공청소기,148000,148000,0
2018-06-01,2040425837,E031130,보온매트,[한일의료기] 한일꽃잠 카페트매트 7인용 183x270.좌우분,224000,224000,0
2018-06-01,123750726,C013050,운동복,가스경보기 ND-104N(LNG),21700,21700,0
2018-06-01,954933422,A013100,마른멸치,전복(중대),3667,3000,-667
2018-06-01,971546074,A014050,달걀,[성연식품] 국산 돈육 그린팜 (200gX5개) 햄 스팸 어,27840,27010,-830
2018-06-01,448465240,C012030,여자상의,여름 루즈핏원피스/빅사이즈/린넨/나시/롱/쉬폰/반팔,22800,22800,0
2018-06-01,1558950881,L012090,기초화장품,멜라루카 레몬브라이트 텁앤타일 프리스팟 세제 치약,19800,19800,0
2018-06-01,1049010874,C013010,점퍼,아르크네 양털 무스탕 DM-4044-양털무스탕자켓 양털,20800,18520,-2280
2018-06-01,1103196859,C013050,운동복,[마운틴리서치] 아동 주니어 여름 트레이닝바지 모음,6900,6900,0
2018-06-01,1011155921,L012040,치약,[LG]LG)히말라야핑크솔트치약아이스100G*2,10900,6990,-3910
2018-06-01,957767563,A021010,커피,동서 맥심 화이트골드믹스 220T*11.7G,26900,26900,0
2018-06-01,416373262,A016070,귤,[속이 빨간 2018년 햇 레드자몽] 15kg 대용량 중과,44300,41800,-2500
2018-06-01,278588237,A011120,두부,켈로그 대용량시리얼 식사대용 간편식 다이어트씨리얼,10400,9880,-520
2018-06-01,1081221170,A019050,간장,바로만드는 장아찌간장소스1800ml 맛장소스100ml 증정,9000,9000,0
2018-06-01,1980525076,C011030,남자학생복,[지오다노] 348517 여 포플린 숏슬리브 롱 셔츠/ 지오다노,49800,40340,-9460
2018-06-01,843906895,A017010,배추,(아이스박스 포장) 강원도 고랭지 절임배추 20kg,32900,32900,0
2018-06-01,1660477246,F012020,생리대,시크릿데이 생리대 입는 오버나이트2PX5팩,10900,10360,-540
2018-06-01,654813738,L021020,장신구,실버 체인 커플 팔찌 5돈 7돈 10돈 15돈,49000,49000,0
2018-06-01,439639314,A018090,잼,오뚜기 딸기잼500gX12개(1박스)블루베리잼 딸기잼 후,95100,83690,-11410
2018-06-01,1833827928,C014010,아동복,랄프로렌 남 아동 2- 4세 짚업 춘추 점퍼 자켓/211,19000,18810,-190
2018-06-01,1528579026,A019090,카레,오뚜기 카레 약간매운맛 1kg 10개(1box) /순한맛 P,48900,48900,0
2018-06-01,959408947,A017130,도라지,[고구마루] 고구마 스틱 65g x 5 봉,18900,15300,-3600
2018-06-01,959408948,A017130,도라지,[고구마루] 맛탕(빠스) 120g x 5,18900,14900,-4000
2018-06-01,657946328,C013010,점퍼,롤리 봄자켓/야상/블라우스/가디건/원피스,10000,5800,-4200
2018-06-01,1859169901,C012020,원피스,(무료배송) (해외직배송)세미정장 원피스자켓 세트 정,146520,128940,-17580
2018-06-01,449059888,E021020,커튼,마이펫 우주선 애견백팩 우주선가방 이동장 반려묘이,66130,66130,0
2018-06-01,1206203702,C011050,남자내의,(남자옷도매) DP-247 린넨마 ST팬츠 (S-XL) 베이지 남,30140,30140,0
2018-06-01,924457494,E031080,선풍기,[하이마트] 양면 발열 충전식 손난로 LZHW-T5200 [블루],27000,27000,0
2018-06-01,428404507,C011050,남자내의,남자조거팬츠 밴드바지 카고바지 조거팬츠 빅사이즈,19500,19500,0
2018-06-01,924457495,E031080,선풍기,[하이마트] 양면 발열 충전식 손난로 LZHW-T5200 [골드],27000,27000,0
2018-06-01,924457496,E031080,선풍기,[하이마트] 양면 발열 충전식 손난로 LZHW-T5200 [블랙],27000,27000,0
2018-06-01,898628612,A018050,비스킷,[크라운]크라운 쿠크다스 화이트 72G,1000,1000,0
2018-06-01,924457497,E031080,선풍기,[하이마트] 양면 발열 충전식 손난로 LZHW-T5200 [핑크],27000,27000,0
2018-06-01,386399700,C011030,남자학생복,오투아이스_망사얼음조끼,57680,54220,-3460
2018-06-01,362011526,C015040,장갑,양가죽 무스탕 벙어리 여성장갑 겨울장갑 겨울용장갑,25320,25320,0
2018-06-01,1831933905,C013010,점퍼,[예시카]YA1MJP484. 지퍼 포인트 오버핏 점퍼,44000,41800,-2200
2018-06-01,1325140019,E041030,솥,풍년압력솥 PC압력밥솥 영업용 20인용-50인용 업소용,145000,145000,0
2018-06-01,1293836684,C012060,여자내의,허리밴딩 TR 큐롯팬츠 숏팬츠 치마바지 플레어스커트,8100,7700,-400
2018-06-01,988932761,L012040,치약,[페리오] 안심키즈 청포도 80Gx3개,5850,5850,0
2018-06-01,895892489,A021020,차,[동서]동서 프리마 웰빙 1/2 라이트 (500g),3900,3900,0
2018-06-01,1064681476,C011050,남자내의,여름신상/빅사이즈~42/면바지/슬랙스/스판/남자/남성,19800,19800,0
2018-06-01,1020772331,C013010,점퍼,[알토]구스 후디드 점퍼 2 ALJD181G5,39000,39000,0
2018-06-01,813986901,E031120,믹서,켄우드 BLEND-X PRO 초고속 블렌더 BLP900BK 믹서기,329000,329000,0
2018-06-01,619443832,L021020,장신구,스와로브스키 은침귀걸이 이어링 귀고리 유색 크리스탈 여성악세사리선물 패션쥬얼리,12500,12130,-370
2018-06-01,1961190107,E021010,침구,겨울왕국 면기모 패드 - 뷰티선샤인 (064187) 요이불,58190,51940,-6250
2018-06-01,417603623,C012040,여자학생복,빅사이즈 헬로시스터 초퍼[린넨로브]/ 헬로시스터,29800,23250,-6550
2018-06-01,80523158,A011010,쌀,백미 4kg / 현미 찰흑미 찹쌀 현미찹쌀 오대쌀,11500,11500,0
2018-06-01,507506191,C013050,운동복,스타투스 신형 도어가드 자동차인테리어 보호대 차량,9960,9090,-870
2018-06-01,1463305393,E061010,세탁세제,세제 아기사랑3p선물세트 유아전용세제 세탁세제 액상,51930,50380,-1550
2018-06-01,1405798449,E041050,냄비,무수분요리 전골냄비 키친아트 베스트매직팬,26350,26350,0
2018-06-01,1261863125,E021020,커튼,아이캐노피 침대캐노피 어린이집 유치원 가정집,28900,28900,0
2018-06-01,988185105,A017180,호박,순창완두콩(팩),5990,4990,-1000
2018-06-01,974083597,E061020,섬유유연제,샤프란 피죤 향기나라 20L/섬유유연제 대용량 말통,19500,19500,0
2018-06-01,987970833,A021010,커피,이디야 비니스트 오리지널 아메리카노 30T*30G,6900,6900,0
2018-06-01,98165457,E061100,습기제거제,알뜰세트제습제 선반8개+서랍8개(4팩)+옷걸이120g 8개,19900,19900,0
2018-06-01,600190773,F011150,건강기능식품,남성용 종합비타민 3개월분 종합 영양제 멀티 포맨,25900,25900,0
2018-06-01,1710899524,C013010,점퍼,[포에버21]새틴 봄버 자켓/FOREVER21/점퍼/블루종,31900,15950,-15950
2018-06-01,1314122908,C013030,스웨터,밀란시아 양두 반폴라티 mar171-004 남성캐쥬얼 캐쥬,43950,43080,-870
2018-06-01,2132222242,A018040,아이스크림,하겐다즈 아이스크림 쿼터1개 + 파인트1개,25900,25900,0
2018-06-01,319595467,C014010,아동복,타미힐피거키즈칠드런 (TBMS1JJL22A0) 후드바람막이점퍼 TOMMY HILFIGER (3∼16주니어,101500,86280,-15220
2018-06-01,895708103,F011120,인삼,새송이버섯(300G/봉),2490,1990,-500
2018-06-01,798296475,C012060,여자내의,[로엠][로엠] 망사 패턴 심플 스커트 RMWH522R22,9900,9410,-490
2018-06-01,1437407030,A021010,커피,[일동후디스] 노블 커피믹스 100T,29600,29600,0
2018-06-01,949713636,C014010,아동복,[남아정장]남아캐주얼정장 주니어17호까지- 아동정장,49900,49900,0
2018-06-01,317713093,C013050,운동복,트라제XG후사경 주차미러 렉스턴후방거울 빽미러,19000,17390,-1610
2018-06-01,79070763,A011090,국수,컵라면 91종 최다구성 특가/신라면 진라면 오뚜기,2590,2590,0
2018-06-01,35471237,A013030,조기,부세조기 1박스 15마리내외 조기 굴비 제수용 생선,29500,29500,0
2018-06-01,1379945631,A017080,무,3년숙성/강화사자발약쑥/강화약쑥/약쑥진액 오리지널 60팩/강화마니/마니수/티백/수제,34900,34900,0
2018-06-01,2094387046,A014030,치즈,코리원/레프리노 스트링치즈 11mm/치즈/스트링/피자,68500,68500,0
2018-06-01,1433779384,C013040,청바지,[컨셉원]여름 TR 슬랙스 2종 118502/118503,59800,47840,-11960
2018-06-01,2054650523,A022040,기능성음료,포카리스웨트 340ml x 24캔 사이다 음료수 탄산음료,12500,12500,0
2018-06-01,1122025704,F011130,홍삼,[개성인삼농협/산지직송] 한송정 에브리데이 10ml*28포,57900,57900,0
2018-06-01,1016238034,L012090,기초화장품,설화수 예서 트윈케이크/스킨커버/파우더/파운데이션,27500,27500,0
2018-06-01,1122025702,F011130,홍삼,[개성인삼농협/산지직송] 한송정 홍삼으로만 만든 tea 1.5g*15봉,20600,20600,0
2018-06-01,1122025703,F011130,홍삼,[개성인삼농협/산지직송] 한송정 홍삼농축액 오리진 240g,98800,98800,0
2018-06-01,1816500072,C013050,운동복,아디다스 나이키 푸마 미즈노 트레이닝복 기모 세트,69000,67620,-1380
2018-06-01,989139411,E041060,수저,[지홈] 우드 뒤지게+미니볶음스푼+필터볼(중 랜덤칼라),16200,8780,-7420
2018-06-01,1787802524,A011010,쌀,고시히카리쌀5kg 밥선생,19900,19900,0
2018-06-01,1940825162,A012060,햄및베이컨,롯데햄 런천미트 340g x 10개 무료배송 /햄/햄통조림/,22700,22700,0
2018-06-01,565955661,C013040,청바지,[블라키] 아이스데님 여자 (라이트블루),29000,29000,0
2018-06-01,350809915,C013040,청바지,[제이알주니어] 여아 청바지/숏팬츠/치랭스/레깅스/속,10900,8900,-2000
2018-06-01,378754294,C011050,남자내의,MP-228 카키 고무줄 슬랙스 후면밴딩허리벤트 남성슬,45040,45040,0
2018-06-01,899437687,A014010,우유,빙그레 바나나우유 (240ml*5입),4950,4250,-700
2018-06-01,33302769,E061010,세탁세제,런드레스 베이비 유아세제 아기섬유유연제 475㎖ 3종,28050,28050,0
2018-06-01,36904110,F012020,생리대,릴리안 초흡수 중형 16P x 1팩,1950,1950,0
2018-06-01,483971737,C012060,여자내의,[스타일온에어+]18SS장미쉘바스키아 여성썸머팬츠,79000,79000,0
2018-06-01,1749921282,A012050,소시지,천하장사 / 꼬마장사 / 키스틱,7500,7500,0
2018-06-01,236851735,C015040,장갑,[프로스펙스] (SIZE : LXL) 아미드 메이저 2 니트 글러브(,8740,8740,0
2018-06-01,777136251,C013050,운동복,카타 보스파워핸들 볼베어링 파워봉 핸들봉/화물차/RV,9900,8660,-1240
2018-06-01,699155450,F011130,홍삼,초이스엘 프라임 홍옥정(700MG*90정),20000,20000,0
2018-06-01,379528959,C014010,아동복,MLB키즈[엠엘비키즈] 71TSS5831 아동 메쉬 배색 반팔 티셔츠 3종 중 택1,49000,41650,-7350
2018-06-01,443211323,C013010,점퍼,[스파오][스파오] 헤링본 재킷(SPJK34TM40_BR),19900,18910,-990
2018-06-01,427669701,C012060,여자내의,빅사이즈/쉬폰/주름/롱/스커트 쉬폰주름롱스커트 빅사,44310,42990,-1320
2018-06-01,957323553,A015020,식용유,카놀라유/해바라기유 500mlx4개 식용유 포도씨유 오일,7000,6900,-100
2018-06-01,987970860,A019090,카레,요리하다 인디아 치킨 마살라 커리 160G,3480,3480,0
2018-06-01,2134393395,A022010,주스,웅진)(6입)자연은 포도100-1.5L 과즙음료 과채음료 과,29990,29400,-590
2018-06-01,1924214609,G011070,자전거,[스마트] 엘레강스26 여성용자전거 7단 26인치,85000,85000,0
2018-06-01,1010404383,A019180,즉석식품,[미소가]부드럽고 촉촉한 전통 진수육 300g,17900,10900,-7000
2018-06-01,220841426,E061010,세탁세제,비트 10kg 가루세제 세탁세제 대용량,17800,17800,0
2018-06-01,443715602,E021020,커튼,로맨틱 레이스 천정 캐노피 모기장 감성 침실인테리어,17350,17350,0
2018-06-01,548524587,C013010,점퍼,[대구백화점 II관] [르피타]면비비안P점퍼(L182UJP501),59800,56220,-3580
2018-06-01,1056161651,A012030,돼지고기,조물조물 맛난 고소한 삼겹살 돼지 고기 구이용 독일산 삼겹살 돼지고기 삼겹 목살 소,15000,14550,-450
2018-06-01,1010404388,A014010,우유,매일 우유기획 900ML*2,4780,4590,-190
2018-06-01,1506988616,A013070,굴,은하수산 항공직송 살아있는 랍스타 800g  1100g 내외,36000,36000,0
2018-06-01,246531317,C013010,점퍼,[알프렌즈]51800~남자 PU 가죽 라이더 레더 자켓 점퍼,67800,67800,0
2018-06-01,1831933940,C013010,점퍼,[예시카]YA1MJP483. 심플 오버핏 블루종,31700,30120,-1580
2018-06-01,1830209656,A019060,된장,[CJ직배송] 해찬들 명품 집된장 900gX2개 /된장,11900,11900,0
2018-06-01,882860187,A022050,탄산음료,코카콜라 500ml x 24병,18800,18800,0
2018-06-01,1008764103,I031040,생화,시마노 바다 릴 원투 낚시대,46000,43510,-2490
2018-06-01,77791896,A013030,조기,정품수산 제주 감귤고등어+참조기세트 고등어 고등어팩 감귤고등어 조기 참조기 수산,103600,103600,0
2018-06-01,62886575,C013020,티셔츠,[셀덴]셀덴 PNC02 블럭반팔티 EDRA82405J,15900,15590,-310
2018-06-01,1516585457,C015030,넥타이,보타이 리본타이 유아동 돌 나비넥타이,4800,4800,0
2018-06-01,258118069,F012010,종이기저귀,[2018]하기스 에어솔솔썸머 팬티/밴드 3~5단계,40200,40200,0
2018-06-01,393918014,A019040,소금,일회용식초(연합 6gx200) 일회용식초 식당용일회용식,11620,10460,-1160
2018-06-01,1663297150,I031040,생화,유니엔유 캠핑해머 (다기능 팩망치/후크/미니삽),11000,10020,-980
2018-06-01,2125991792,L012090,기초화장품,아이오페 모이스트 클렌징 크림/휘핑 폼/크리미 폼,10900,10900,0
2018-06-01,1290044978,C012020,원피스,[구엘]Guell_ 아사면야자수프린트로브 (G85-WCT027),19800,18810,-990
2018-06-01,468587337,I053010,공책,묶음상품 플라스틱링(28mm)백색 50개입x3개 제본용플,56990,56990,0
2018-06-01,368817196,E031120,믹서,해피콜 초고속 블렌더 엑슬림Z[컨테이너 2종 + 엑슬림 전용 마이보틀 4p],389000,357880,-31120
2018-06-01,578471669,C012060,여자내의,잇걸 멜빵청롱스커트 SD-9106 치마 롱치마 여성청스커,46650,46650,0
2018-06-01,1714408794,F012010,종이기저귀,미국산 팸퍼스 이지업4~6단계 남여팬티기저귀,41800,41800,0
2018-06-01,739030467,L012030,칫솔,닥터세닥 슈퍼슬림 x 12개 칫솔 치약 구강,9800,9800,0
2018-06-01,924457472,E031080,선풍기,[하이마트] 양면 발열 충전식 손난로 LZHW-T5200 [실버],27000,27000,0
2018-06-01,1339126612,C015040,장갑,스트레이트 포인트 피혁장갑(남성) 남자장갑 남성용장,12770,12770,0
2018-06-01,250885904,A016040,포도,동원)황도 슬라이스 400g x 12개 사시사철 맛있는,41360,41360,0
2018-06-01,406369774,C014010,아동복,어린이 방한 마스크 WT0190 샐리캣체리,8720,8720,0
2018-06-01,1669939452,A013150,어묵,풍년 고급수제어묵320gx5개/부산 모듬오뎅 꼬치 장국,18500,18500,0
2018-06-01,614148045,E041010,식기,국내생산 핸드페인팅 프로방스 식기 그릇 공기 대접 접시 찬기 나눔접시 우동기 면기,2300,2120,-180
2018-06-01,1073049163,F012020,생리대,500원할인)바디피트 볼록맞춤대형20Px5 100매 생리대,11900,11400,-500
2018-06-01,988246545,A018060,스낵과자,농심 꿀꽈배기 90G,1200,1200,0
2018-06-01,2069228905,C013040,청바지,여성 (710) 슈퍼스키니 핏 쿨맥스 데님 팬츠 52339-0001/ 리바이스,58000,52200,-5800
2018-06-01,794222806,E031080,선풍기,린나이 스탠드형 가스스토브 RHS-450S (2단화력/연속자동점화/26.8㎡),176200,176200,0
2018-06-01,932969679,C013020,티셔츠,S~3XL 비침없는 반팔 오버핏 빅사이즈 20수무지티셔츠,10000,9400,-600
2018-06-01,988246548,A018060,스낵과자,농심 양파링 84G,1200,1200,0
2018-06-01,868071576,C013010,점퍼,[포에버21]페이크 스웨이드 봄버 자켓/FOREVER21/점퍼/블루종,54900,27450,-27450
2018-06-01,988246546,A018060,스낵과자,농심 오징어집 83G,1200,1200,0
2018-06-01,2110378225,E011050,책상,분위기갑! 철제 강화유리 중역책상 컴퓨터 사무용책상,146000,131400,-14600
2018-06-01,1692821424,A016160,과일가공품,미국산 건블루베리x310g 말린 블루베리,32000,31680,-320
2018-06-01,1880710368,A014020,분유,[LG생활건강]간편 액상분유 베비언스 12~24개월 3단계 40개입 (니플미포함)/ 베비언스,55300,55300,0
2018-06-01,1869883210,A018090,잼,"땅지기 유기농 ""햇"" 딸기잼 2.4kg (1.2kg*2병)  1박스",36000,36000,0
2018-06-01,897532116,A019040,소금,[CJ]CJ 백설 천일염 오천년의 신비 (250g),1550,1550,0
2018-06-01,696240742,A017100,당근,싱싱한 열무 4kg,8900,8900,0
2018-06-01,1233784040,C021040,실내화,[나이키] 나이키 에어포스 1 로우 올백,62500,62500,0
2018-06-01,1681984664,A022010,주스,카프리썬1BOX(200ml_10봉)딸기키위/사과/오렌지/6종,4900,4900,0
2018-06-01,989139466,A019180,즉석식품,CJ 비비고 부대찌개 460G,7180,5590,-1590
2018-06-01,1737228200,C014010,아동복,[아동남방셔츠]남아 아동 유아 셔츠 정장 남방 돌복,27900,27900,0
2018-06-01,1345249879,C013020,티셔츠,[핫핑] 프린팅티셔츠 9900원 모음전,9900,9900,0
2018-06-01,573684038,A022010,주스,봉봉 238ML 24캔 과즙음료 캔음료 과일주스 음료수 주,25460,25460,0
2018-06-01,404296541,I031040,생화,단조팩 텐트팩 데크팩 땅콩 삼각 막대스토퍼 타프폴대,4900,4510,-390
2018-06-01,1751719132,L021010,손목시계,DKNY 도나카란 뉴욕 NY2367 여성 메탈밴드 패션시계,159000,159000,0
2018-06-01,946484661,A011020,현미,두레생협 찹쌀백미(4kg 유기) 가정용찹쌀 주방용찹쌀,50490,50490,0
2018-06-01,1676189958,E021010,침구,2018신상 시원한 여름이불/이불세트/패드/토퍼,24900,22910,-1990
2018-06-01,73039707,E061060,살충제,다이안 쉴드윙 모기퇴치 팔찌/밴드/클립/스프레이,3200,2490,-710
2018-06-01,725222036,C012060,여자내의,빅사이즈/페미닌/레이스/스커트 빅사이즈,60570,58150,-2420
2018-06-01,1951284990,A011170,떡,[강릉 떡함지] 청정 강원 수리취로 쑥으로 만드는 떡,15000,15000,0
2018-06-01,1544938785,C012040,여자학생복,[샤트렌]베이직 블라우스[HC7MBL805],29000,27550,-1450
2018-06-01,1315315877,A021010,커피,[커피디씨마트]맥스웰하우스 화인500g/네스카페클래식,6270,5900,-370
2018-06-01,172986374,C012060,여자내의,5부 반바지 빅사이즈반바지 밴드반바지 카고반바지,34000,18700,-15300
2018-06-01,1500608109,C012060,여자내의,[모다아울렛][플라스틱아일랜드]데님 멜빵 반바지 (ph2wp461),49000,46060,-2940
2018-06-01,61961945,L021020,장신구,[로로스피어싱] *2018 봄신상* 피어싱/써지컬스틸,2000,2000,0
2018-06-01,2012767318,A022010,주스,망고주스(델몬트 롯데 1.5L)X12개/망고 원액 망고스무디 망고스틴 젤라또 아이스크림,43250,41960,-1290
2018-06-01,1885704833,L021020,장신구,[패션플러스][HRjewelry]실버92.5정품)인기상승]톡톡튀는]개성만점)순은[HR]실버 유니,129000,122550,-6450
2018-06-01,1261057007,C012060,여자내의,잇걸 멜빵청롱스커트 SD-9106 여성치마 청치마 여성청,46600,45210,-1390
2018-06-01,163762087,C021040,실내화,프로스펙스 르까프 마라톤화 런닝화 헬스화 로드런,35000,34650,-350
2018-06-01,1361488642,C012020,원피스,프레임직사각쟁반 중,30660,27290,-3370
2018-06-01,770325524,F011130,홍삼,[GMS]동진제약 고려 홍삼 농축액 240g,79000,79000,0
2018-06-01,1011238565,A021020,차,담터 핫초코 70T,15900,15900,0
2018-06-01,309612226,L012090,기초화장품,겟잇뷰티 1위! 토니모리 블랙데이 Up to 50% + 사은품,8800,8800,0
2018-06-01,46299344,L021060,유모차,2018 오샤인 쌍둥이 휴대용 유모차 멜란지 그레이,169000,169000,0
2018-06-01,2125028978,E041010,식기,청동/방짜/유기/칠첩/7첩/반상기/세트/셋트/선물/외국인/식기/추천/가격/파는곳/VIP/V,690000,680000,-10000
2018-06-01,1751719159,L021010,손목시계,DKNY NY2509 正品 여성 메탈 밴드 시계,139000,139000,0
2018-06-01,895772525,A011090,국수,[오뚜기]오뚜기 열라면 120G*5입,3300,3300,0
2018-06-01,1751719154,L021010,손목시계,DKNY 도나카란 뉴욕 NY2286 여성 메탈밴드 패션시계,159000,159000,0
2018-06-01,2065043298,C013040,청바지,[리바이스]52339-0000 여성710 쿨맥스 슈퍼스키니진,90000,75600,-14400
2018-06-01,1751719156,L021010,손목시계,DKNY 도나카란 뉴욕 NY2365 여성 메탈밴드 패션시계,139000,139000,0
2018-06-01,1751719155,L021010,손목시계,DKNY 도나카란 뉴욕 NY2489 여성 메탈밴드 패션시계,159000,159000,0
2018-06-01,96787050,C015040,장갑,[지맥스] 지맥스 아이스 장갑/통기성 매쉬/등산 자전거 스포츠,5000,4950,-50
2018-06-01,1751719158,L021010,손목시계,DKNY 도나카란 뉴욕 NY2507 여성 가죽밴드 패션시계,139000,139000,0
2018-06-01,1751719157,L021010,손목시계,DKNY 도나카란 뉴욕 NY2514 여성 가죽밴드 패션시계,139000,139000,0
2018-06-01,1301449862,E011050,책상,탑 데스크 책상 컴퓨터 학생 책장 다용도 h형 테이블,27900,27900,0
2018-06-01,691585744,A012010,국산쇠고기,농협축협 명품 갈비선물세트 3.2kg 갈비세트 한우갈비,270000,267300,-2700
2018-06-01,1010382438,A019150,김치,아워홈)아삭포기김치 1.9KG,13900,13900,0
2018-06-01,1129113380,C013030,스웨터,DTG1521 오비 빅 니트 803 여성용루즈핏니트 여자니트,53210,53210,0
2018-06-01,1994021784,E041050,냄비,곱돌 전골냄비 가마솥 구이판 돌솥 불고기불판,24000,22800,-1200
2018-06-01,767901742,A019060,된장,해찬들 구수한 집된장(2KG),11800,11800,0
2018-06-01,1468222147,C021040,실내화,[리복]남성용 트레인플렉스 2.0 BS9906,56070,44860,-11210
2018-06-01,1320558290,E011020,침대,프리미엄 패밀리침대 Q+SS 가드형 본넬 매트리스,698900,677940,-20960
2018-06-01,1093340999,E031080,선풍기,대성하이원_ 해바라기 건조기 DSH-33,847000,847000,0
2018-06-01,1010382433,A011140,부침가루,[풀무원직배송]토이쿠키냠냠간식만들기 200gx3개,19200,16900,-2300
2018-06-01,1250461763,C014010,아동복,[블루독] 변형STRIPE티셔츠 (27315-332-08),29000,23780,-5220
2018-06-01,1417924753,C012040,여자학생복,[로엠] 로엠 꽃잎가디건(RMCK724RQ4),39900,29000,-10900
2018-06-01,408923766,I031040,생화,SOS 긴급 구호세트 캠핑장비 야외구호세트 캠핑공구,24330,22170,-2160
2018-06-01,115935099,A011170,떡,(맛나)박스/장푸드햇살떡국4kg*3,23780,23780,0
2018-06-01,1122025680,F011130,홍삼,[개성인삼농협/산지직송] 개성홍삼액골드 70ml*30포,54300,54300,0
2018-06-01,450927995,D031010,주택수선재료,왓코 부처블락 오일&피니쉬/도마용 오일/식기류 전용,19800,19800,0
2018-06-01,1751719163,L021010,손목시계,DKNY 도나카란 뉴욕 NY2402 여성 메탈밴드 패션시계,129000,129000,0
2018-06-01,1751719162,L021010,손목시계,DKNY 도나카란 뉴욕 NY2401 여성 메탈밴드 패션시계,129000,129000,0
2018-06-01,260015921,C012060,여자내의,(원모어) 여성 넉넉한 밴딩 롱 청 플레어 스커트 치마,19900,19900,0
2018-06-01,1997323514,E011020,침대,[골든잼]잣나무 천연 생황토 평상/침대쇼파 돌평상,1974200,1914980,-59220
2018-06-01,1010201617,A014040,발효유,매일)엔요100_100ML*3,1000,700,-300
2018-06-01,1751719160,L021010,손목시계,DKNY 도나카란 뉴욕 NY2295 여성 가죽밴드 패션시계,139000,139000,0
2018-06-01,1010201612,A013020,명태,[수협]진공굴비 10마리 (미당 65g 이상),24900,18000,-6900
2018-06-01,1786648719,C011030,남자학생복,[킨록by킨록]17 s/s 그레이 린넨혼방 스트링 가디건 JTY01 (man1384)(강남점),30000,26190,-3810
2018-06-01,1805062715,L021050,우산,초대형 방풍 골프 의전용 빅사이즈 자동 장우산 모음,15900,15900,0
2018-06-01,1122025679,F011130,홍삼,[개성인삼농협/산지직송] 한송정 홍삼과 흑마늘 50ml*28포,43400,43400,0
2018-06-01,1316625126,C013050,운동복,P 이탈리아 트레이닝복 세트 GIVOVA 릴렉스슈트 축구,14900,14900,0
2018-06-01,395199156,C012040,여자학생복,[쎄쎄쎄]여성 셔츠남방 모음/체크/박스/롱/스트라이프,14900,14900,0
2018-06-01,237480988,C021010,아동화,잭앤질 키즈 에어 우븐슈즈!,29800,29800,0
2018-06-01,561014677,C013010,점퍼,[구제]라코스테 점퍼/여성M/면혼방/집업/자켓/OT4470,32000,32000,0
2018-06-01,1757123937,C012040,여자학생복,[올리브데올리브]펀칭자수프릴블라우스(OW7MB548)(강남점),59000,52660,-6340
2018-06-01,444344801,C011050,남자내의,[탑보이][탑보이] 심플 캐주얼 5부 밴딩팬츠 (KKA041),7900,6960,-940
2018-06-01,102842197,A021010,커피,[엔탑커피]엔탑 자판기용 커피 및 국산차 최저가 판매,2500,2500,0
2018-06-01,590094529,F012020,생리대,위스퍼 보송보송케어 소형18Px6개 생리대 최근제조,25800,25800,0
2018-06-01,1124446322,A013010,갈치,제주 은갈치(대) 4마리(1마리당350g내외 선물포장) 싱,120100,116500,-3600
2018-06-01,985352017,A011060,땅콩,[우리마을농협쌀]무농약 백미(4kg),27000,17900,-9100
2018-06-01,1343763193,A015020,식용유,오뚜기카놀라유18L / 콩식용유 대두유 업소용식용유,32000,32000,0
2018-06-01,1161170380,I011030,사진기,소니 광학50배줌 DSC-HX400V +소니U11가방/공식대리점,630000,579600,-50400
2018-06-01,985352018,A011060,땅콩,[우리마을농협쌀] 무농약 백미(10kg),48500,34900,-13600
2018-06-01,1885694970,A021010,커피,핸드립커피 알뜰형/커피세트/아메리카노/블랙커피,16900,16900,0
2018-06-01,252609812,C013050,운동복,차량용 안전 삼각대/자동차 안전용품 접이식삼각대,9320,9050,-270
2018-06-01,1348011311,A013070,굴,서해안 자연산 살이꽉찬 돌게 1kg 감칠맛 일품,10900,10900,0
2018-06-01,1533788848,E061030,전구,LED모듈/LG정품최고급칩/LED거실등/LED방등/주방 리폼,18000,15390,-2610
2018-06-01,335403964,A015020,식용유,HONEST 유기농엑스트라버진코코넛오일,12800,12800,0
2018-06-01,1626192934,C013040,청바지,마르딕 5부배기팬츠/ 시크폭스,21800,17010,-4790
2018-06-01,1803109882,C013020,티셔츠,[블루독](NY)도기그래픽티셔츠(27335-332-02),26000,20020,-5980
2018-06-01,1093340977,E031080,선풍기,유니맥스_ 파티오 벽걸이형 히터 UMH-6708W,33800,33800,0
2018-06-01,339284245,A016090,참외,성주 꿀 참외 가정용 5kg/7+1kg+상추150g증정이벤트,11900,11900,0
2018-06-01,2067934084,C012040,여자학생복,여성 숄 가디건 패션 담요 패션 보온 사무실 디자인,9320,9320,0
2018-06-01,430563184,A019180,즉석식품,CJ 비비고 사골곰탕 500g×20개/ 씨제이제일제당,19900,19900,0
2018-06-01,84600727,C013040,청바지,[지오다노]라이트웨이트 스키니 데님 팬츠 117546(인천점),25000,22500,-2500
2018-06-01,793688014,D031010,주택수선재료,친환경페인트 멀티플러스 3.8L 반광 다용도 방문 가구,33000,33000,0
2018-06-01,1751719185,L021010,손목시계,디케이엔와이 DKNY NY2355 여성 손목시계,119000,119000,0
2018-06-01,1010201640,A014040,발효유,매일 케피어(스트로베리) 200ML,1500,1000,-500
2018-06-01,1751719187,L021010,손목시계,DKNY NY2234 正品 여성 메탈 밴드 시계,109000,109000,0
2018-06-01,1751719186,L021010,손목시계,DKNY 도나카란 뉴욕 NY2400 여성 메탈밴드 패션시계,119000,119000,0
2018-06-01,1187021749,A011050,콩,커피땅콩 1Kg 우유땅콩/ 초코볼 땅콩초코볼 사탕 캔디,3500,3500,0
2018-06-01,1413706470,A013120,낙지,[윈지스토어]주전부리통오징어 숯불다리구이 50gx5봉 술안주 마른오징어 간식 오징어다,20230,18010,-2220
2018-06-01,196557658,A019130,스프,NEW 보노스프 7종/콘스프/포타주/크림스프/버섯스프,2760,2760,0
2018-06-01,1913282731,C013020,티셔츠,이오스 정품 반팔티/라운드티/크루넥/긴팔티,12800,12800,0
2018-06-01,1126628635,L012090,기초화장품,이자녹스 턴오버28 클렌징 2종세트 1+1,12900,12900,0
2018-06-01,52555556,E031110,청소기,LG 로보킹 터보 청소기 VR6480VMNC 카메라3개 원격,831830,769000,-62830
2018-06-01,701519257,C011030,남자학생복,名品 오마샤리프셔츠 남자 긴팔 와이셔츠 정장 체크,13500,10500,-3000
2018-06-01,1915065842,C013050,운동복,아디다스 zne 후디 푸마 나이키 바람막이 져지 트랙탑,69800,69800,0
2018-06-01,238297158,C014010,아동복,남아여아 긴팔티셔츠 5종세트(3-36개월) 202470,42500,37830,-4670
2018-06-01,2013947604,C012060,여자내의,[쉬즈미스] 시퀀 허리밴딩 니트 와이드 8부기장 팬츠/ 쉬즈미스,25800,23740,-2060
2018-06-01,1308609739,C011020,남자상의,MJ_1133 차콜 래글런코트 겨울자켓 트렌치코트 겨울잠,91580,91580,0
2018-06-01,1129416908,I053040,기타문구,3M 포스트잇 테이프 스카치 대용량 플래그 디스펜서,13800,13800,0
2018-06-01,1784923828,C013020,티셔츠,올젠 봄/여름 가성비최고 특가찬스!/ 무료배송,10000,10000,0
2018-06-01,334544241,I011030,사진기,올림푸스 Tough TG-5 정품 정품배터리 이벤트 명품,454900,454900,0
2018-06-01,2098208013,C012020,원피스,[포에버21]오버사이즈 울 블렌드 코트/FOREVER21/코트/하프코트,72900,36450,-36450
2018-06-01,326878535,C013020,티셔츠,[와이드앵글] 메쉬패치 반넥 이너웨어 -WWM18212,58000,58000,0
2018-06-01,1429188523,A011170,떡,메밀과자 10봉 단호박과자 10봉 감귤과자 10봉 토마토,76180,67810,-8370
2018-06-01,561570702,A014020,분유,[LG생활건강]베비언스 액상분유 6-12개월(2단계) 12개입 니플1개 포함,24890,23650,-1240
2018-06-01,366687565,C012040,여자학생복,루즈핏 66 77 88 빅사이즈 청 데님 롱 남방 셔츠,22900,22900,0
2018-06-01,1485067648,C013010,점퍼,봄신상 블루종 자켓 점퍼 야상 후리스 바람막이,25800,24800,-1000
2018-06-01,1175609038,A016090,참외,달콤한 성주 꿀참외3kg,8500,8500,0
2018-06-01,322973798,E011030,거실장,시스템 수납함 바스켓 (네이비  대형)(39.5*35*20.5CM),3500,3500,0
2018-06-01,753041934,A011140,부침가루,딤섬 화권꽃빵1.5kg 2개,29000,28130,-870
2018-06-01,1218174348,C014010,아동복,한국 꼬마숙녀 럭셔리 원피스 블랙(3-24개월)203534,64100,62180,-1920
2018-06-01,1347372393,C013020,티셔츠,[파코라반베이비]레이스프릴T/S PT353302[갤러리아],23200,17870,-5330
2018-06-01,434568805,I011020,영상음향기기,비비텍 DW832 20만원할인 밝기5000 와이드 프로젝터,1199000,999000,-200000
2018-06-01,1315301268,C011050,남자내의,리바이스 남성 511 슬림핏 쿨맥스 데님 04511-2865,110940,110940,0
2018-06-01,349517360,A013070,굴,캐나다산 살아있는 활 랍스타 2kg(한정세일),76000,76000,0
2018-06-01,1772001810,C012060,여자내의,[씨]헤짐 포인트 일자 면 팬츠 (SMPKD2215)_C9O3,48300,45890,-2410
2018-06-01,1775687540,C013010,점퍼,[헬로시스터]빅사이즈헬로시스터 마오[항공야구점퍼],49800,47310,-2490
2018-06-01,895772589,A011090,국수,오뚜기 진라면 순한맛 120G*5+1입 증정입고,2850,2750,-100
2018-06-01,1235197249,E041020,컵,수제 예쁜 커피잔 머그컵 머그잔 쌍화차잔 뚜껑머그,22900,22900,0
2018-06-01,1140264372,C012020,원피스,엄마옷 마담4060 체크주머니자켓-XJK805006-,77900,72180,-5720
2018-06-01,895772588,A011090,국수,오뚜기 진라면 매운맛 120G*5+1입 증정입고,2850,2750,-100
2018-06-01,895772585,A019180,즉석식품,[오뚜기]오뚜기 즉석북어국 17g*2입,2490,2490,0
2018-06-01,1790386938,A019060,된장,화미 조선된장 14kg (화미된장/조선 된장),22500,22500,0
2018-06-01,895772584,A019180,즉석식품,[오뚜기]오뚜기 즉석미역국 8g*2입,1750,1750,0
2018-06-01,990031313,A011100,라면,[CJ직배송]함흥비빔냉면 2인분 X4개,18680,15800,-2880
2018-06-01,983567496,A018060,스낵과자,롯데 아몬드빼빼로 32G,960,960,0
2018-06-01,983567495,A018060,스낵과자,롯데 초코빼빼로 46G,960,960,0
2018-06-01,1295139491,A012060,햄및베이컨,콩으로만든 식물성 쏘시지 구프랑 200g 12입,58860,58860,0
2018-06-01,535036860,C012040,여자학생복,[모다아울렛][레노마레이디]플라워 프린트 블라우스 F01CW21BL290(네이비 아이보리),89000,80100,-8900
2018-06-01,2057231353,C021040,실내화,[아디다스 퍼포먼스]플루이드클라우드 CG3820 외2종,49000,39200,-9800
2018-06-01,1618208591,C012020,원피스,잭필드 레이디스 팬츠 3종,39800,38800,-1000
2018-06-01,1656366102,A022050,탄산음료,롯데 밀키스 1.5L(12페트)/ 페트음료 탄산음료 음료,19900,19900,0
2018-06-01,985352040,A011060,땅콩,[우리마을 농협쌀]무농약 백미(20kg),97000,74800,-22200
2018-06-01,717798622,I011020,영상음향기기,H3000 후속[HaiWay 17년형 H3200] 스마트 빔프로젝터,259000,246050,-12950
2018-06-01,1311564296,E031130,보온매트,한일생명 183X270 거실매트13T 분리난방 전기매트 가,213460,213460,0
2018-06-01,2108965341,A017100,당근,(면)(냉동)청학 열무1kg,2730,2730,0
2018-06-01,769214067,C012040,여자학생복,봄가을 원버튼 정장 베스트,26800,26800,0
2018-06-01,985352042,A011060,땅콩,[청운농협]물맑은 양평쌀10kg,52000,36900,-15100
2018-06-01,1010225673,A016100,수박,유기농)아사이베리분말 70G/봉,6990,6990,0
2018-06-01,985352048,A011060,땅콩,[물맑은양평쌀]청운농협의찰보리쌀1kg,10000,7800,-2200
2018-06-01,985352049,A011060,땅콩,[물맑은양평쌀]청운농협의찰보리쌀4kg,24500,15900,-8600
2018-06-01,1010225671,A016100,수박,유기농)블랙커런트분말 70G/봉,6990,6990,0
2018-06-01,985352046,A011060,땅콩,[물맑은양평쌀]청운농협의일반현미1kg,10000,7800,-2200
2018-06-01,161042384,E011040,소파,휴시스 아이리스 3인용 소파,169000,159000,-10000
2018-06-01,985352047,A011060,땅콩,[물맑은양평쌀]청운농협의 현미4kg,25000,14900,-10100
2018-06-01,394897141,C011030,남자학생복,HOT신상 남성 배색가디건 캐주얼가디건 짧은가디건 니,54300,48870,-5430
2018-06-01,641372421,A019070,양념소스,할인-큐피 참깨드레싱 1000ml/일본식품/코스트코,9900,9900,0
2018-06-01,1277923697,E061050,청소용세제,Mr.홈스타 변기 세정제 모음전,11900,11900,0
2018-06-01,406357902,C012060,여자내의,빅사이즈/밴딩/망사/롱/스커트 밴딩망사롱스커트 빅사,31480,30540,-940
2018-06-01,854335055,E031080,선풍기,포시즌라디에타 타이머형 SFR7-25T,102000,102000,0
2018-06-01,854335057,E031080,선풍기,포시즌전기컨벡터 FC-1000L,88400,88400,0
2018-06-01,1282048378,I031040,생화,미제 물통 생수통 캠핑물통 선택구매 현진포커스,16000,14870,-1130
2018-06-01,754943772,C013020,티셔츠,도노마드레 아동반팔티 아동상하복,9900,9900,0
2018-06-01,854335059,E031080,선풍기,포시즌전기컨벡터 FC-2000L,115600,115600,0
2018-06-01,985352073,A011060,땅콩,[물맑은양평쌀]청운농협의백태500g,11000,7900,-3100
2018-06-01,985352074,A011060,땅콩,[물맑은양평쌀]청운농협의백태4kg,48500,38900,-9600
2018-06-01,985352071,A011060,땅콩,[물맑은양평쌀]청운농협의압맥800g,9800,7900,-1900
2018-06-01,1743439567,E031010,전기밥솥,키친아트 스텐레스 전기밥솥 미니 보온밥솥 SB-56RC,21800,21800,0
2018-06-01,985352072,A011060,땅콩,[물맑은양평쌀]청운농협의할맥1kg,11500,7900,-3600
2018-06-01,1085031172,A021010,커피,노옵션무료배송 200g+200g 총400g당일로스팅원두커피,12000,12000,0
2018-06-01,1306767729,L021010,손목시계,젤리 아쿠아 방수시계 방수시계 패션팔찌시계 고무밴,13950,13950,0
2018-06-01,677096826,C012060,여자내의,BYC여성 국내 베이직 무발 타이즈(T7901) 팬티스타킹 타이즈 BYC 레깅스 스타킹,5600,4990,-610
2018-06-01,985352079,L012040,치약,LG페리오 토털7 오리지널_90G,1000,1000,0
2018-06-01,726610219,A011120,두부,퀘이커 오츠 오트밀 1.19kg /건강식 /귀리100%,9600,9600,0
2018-06-01,440295583,A018090,잼,(무)오뚜기 딸기쨈850gX8개딸기잼 쨈 딸기잼 잼 과일,105500,92840,-12660
2018-06-01,1395463382,C012030,여자상의,썸걸 수술 원피스 예쁜 스커트 DM-5738,51600,49020,-2580
2018-06-01,768675918,C013020,티셔츠,코오롱쿨론 기능성 카라반팔티셔츠/골프/레저/단체,9900,8820,-1080
2018-06-01,854335029,E031080,선풍기,포시즌라디에타 일반형 SFR7-20S,82900,82900,0
2018-06-01,1302873690,I031040,생화,버팔로 뉴 와이드 캠핑체어 세트 / 캠핑의자 낚시의자,50000,38270,-11730
2018-06-01,524748452,A011050,콩,[가온애]하모니콘 800g 옥수수콘 알땅콩 과자 스낵 안주 간식 주전부리 말린고구마 바,3900,3900,0
2018-06-01,1557936968,A017150,버섯,꼬불꼬불 곱슬이콩나물 3.5Kg,4450,4450,0
2018-06-01,372511574,C013050,운동복,804392-063 나이키 클럽 프렌치 테리 풀 집 후드집업남성,46000,46000,0
2018-06-01,1314856689,C012060,여자내의,SK1586-퓨어 나뭇잎 프린트 스커트 FREE(55~77) 프린,44000,43560,-440
2018-06-01,245591251,A013090,전복,[새우몰] 조개살모음 / 손질된 자숙홍합살 바지락살 가리비살 대합살 신선한 조개살모,1800,1800,0
2018-06-01,2083331456,A012010,국산쇠고기,신선 한입닭갈비 1.3kg3개,59970,59970,0
2018-06-01,426225830,I031010,장난감,씨투엠 스피드스톰 유아전동오토바이 전동바이크,109000,109000,0
2018-06-01,854335030,E031080,선풍기,포시즌라디에타 일반형 SFR7-25S,92500,92500,0
2018-06-01,1769240860,A018110,물엿,단풍나무 조청쌀엿9kg 쌀엿 물엿 창평쌀엿 전통엿,18500,18500,0
2018-06-01,731639939,C021020,구두,비버리폴로올인원원터치신사화트레킹화등산화하나로OK,128000,128000,0
2018-06-01,1274271403,L012040,치약,어금니까지 하얘지는 투스홀 치아미백치약 180g,14900,14900,0
2018-06-01,1004655897,F011130,홍삼,[정원삼] 6년근 고려홍삼정 365스틱 황 (皇) 홍삼스틱 (10g x 30포),29800,29800,0
2018-06-01,1004655896,F011130,홍삼,[정원삼] 구증구포 6년근 고려흑삼 365스틱 홍삼스틱 (10ml x 30포),37800,37800,0
2018-06-01,2055590109,C021020,구두,라코스테 남녀 스니커즈 4종 택1/ 라코스테(의류),94500,89780,-4720
2018-06-01,197317774,C013040,청바지,신상 스키니진/면/데님/일자/부츠컷/하이웨스트/청바,18000,16900,-1100
2018-06-01,266462895,C012060,여자내의,[아이잗바바]치마바지 BI6A0SL06,148000,140600,-7400
2018-06-01,1282638923,E041010,식기,글라스온 누들 머그 1P/라면컵/면기,5600,5160,-440
2018-06-01,2018325649,C021040,실내화,드라이버 2(18998103) 런닝운동화 런닝화 러닝신발 런,86590,86590,0
2018-06-01,441066218,C013050,운동복,화이어킬러 400g 스프레이 소화기 던지는 소화기 가,28160,25650,-2510
2018-06-01,374908591,C012060,여자내의,빅사이즈/그란데/망사/스커트 그란데망사스커트 빅사,44830,43490,-1340
2018-06-01,191839057,C013040,청바지,[게스]18SS신상] 남녀 슬림핏 데님 20종 택1,47900,47900,0
2018-06-01,2015432505,I031040,생화,무료배송 쿨페트병커버 아이스박스 아이스가방 물병 보냉 등산지팡이 아이스머플러 생,2400,2400,0
2018-06-01,1948721367,C013040,청바지,남여공용 SPAN 밴딩 배기팬츠 바지(B172PT475P)/ 버커루 브이아이피,30000,25500,-4500
2018-06-01,2024813972,C013040,청바지,C2 남성 아쿠아 쿨 진 3종,79000,76000,-3000
2018-06-01,321994289,C013010,점퍼,[베네통]포니 요루 캐쥬얼점퍼-BAJP55831(대구신세계),149500,133420,-16080
2018-06-01,67229646,C013040,청바지,[컨셉원]한여름 사방스판 히든 밴딩슬랙스 117508/10117508,45000,36900,-8100
2018-06-01,854335083,E031080,선풍기,프레쉬 온풍팬히터겸용 선풍기 SWF-14H (이동바퀴/리모컨/14인치/2.5KW),129200,129200,0
2018-06-01,1453431477,C012040,여자학생복,(르샵) 절개 디테일 민소매 블라우스(LH5BL652)/ 르샵,19900,17910,-1990
2018-06-01,1675017807,A016020,배,신고배 선물용 15kg 대용량 25과 22.900원,22800,22800,0
2018-06-01,1754203189,D031010,주택수선재료,에코플라스터 미장재(4L)-방 거실 결로곰팡이 방지,75000,75000,0
2018-06-01,1077532139,C012040,여자학생복,무지/티셔츠 기본티 긴팔/반팔/티 여성의류 허밍퍼플,9900,9800,-100
2018-06-01,1139276414,E031140,비데,{신제품}노비타 스마트플러스 비데 BD-AE500 생활방수,209000,189000,-20000
2018-06-01,485036800,C013050,운동복,프론트 리어 범퍼 가드 보호대 몰딩 블랙 범퍼가드 차,21850,19910,-1940
2018-06-01,1456276482,E061030,전구,우리조명 장수램프 삼파장 형광등 EL 11W ~ 75W,1400,1400,0
2018-06-01,529065078,C012060,여자내의,[모다아울렛][나이스크랍]면밴딩와이드팬츠 (a182psa251),77400,77400,0
2018-06-01,394897179,C013050,운동복,CW3590 COMM M TEE 트레이닝상의복 남성트레이닝반팔,42200,42200,0
2018-06-01,586153807,A011020,현미,2017찹쌀10kg28900원찹쌀현미10kg 26900원선택,24900,24900,0
2018-06-01,375919770,E031130,보온매트,일월 프리미엄 카페트 온수매트 2018년형 일월매트,116000,110200,-5800
2018-06-01,603755307,A011110,당면,[홈플러스]홈플러스좋은상품_찌개두부_380G,1100,1050,-50
2018-06-01,440916142,C012040,여자학생복,[블루종]썸머 포켓 루즈핏 가디건_[B1806CD033B],29000,22940,-6060
2018-06-01,431674516,C012060,여자내의,요이츠 부채통 블루밍 팬츠 YC04PQL71,58650,58650,0
2018-06-01,2096701289,C013020,티셔츠,스퀘어 나시/민소매 사각 짱짱한나시 여름니트 쿨소재,16000,14000,-2000
2018-06-01,571551890,C013010,점퍼,[모다아울렛][레코브]클로져체크점퍼(LY317ZJP520X),63800,58700,-5100
2018-06-01,950100107,E011030,거실장,아이린쇼파베드,99900,99900,0
2018-06-01,1847137389,A018080,설탕,스테비아 200g,6400,6400,0
2018-06-01,983567465,A021010,커피,수프리모 크레마 인텐소 아메리카노 미니(30T),6090,6090,0
2018-06-01,370185206,E011030,거실장,킨포크 그레이 높은거실장 1200,129000,129000,0
2018-06-01,22584023,C013040,청바지,[바지킹]신상/청바지/바지/블랙진/스판진/슬림핏,17900,17900,0
2018-06-01,2065791990,F012020,생리대,릴리안 순수한면 중형 16P x 1팩,2250,2250,0
2018-06-01,87829324,C014010,아동복,맨투맨샤스커트set/여아복세트/외출복/행사복/연주,9900,9900,0
2018-06-01,1136360759,E011050,책상,서재 책상 일자/컴퓨터/책장/H형/사무실/서랍/의자,95000,85500,-9500
2018-06-01,1488610474,A012010,국산쇠고기,[무항생제] 불고기샤브샤브 600g 1등급,30400,30400,0
2018-06-01,854335060,E031080,선풍기,포시즌전기컨벡터 FC-2500L,129200,129200,0
2018-06-01,1011180815,A016160,과일가공품,DOLE후룻볼망고4입100%주스,3490,3490,0
2018-06-01,948330679,E061040,부엌용세제,그라인더세정제 퓨로그라인더클리너 업소용우유청소세,46380,46380,0
2018-06-01,2038281455,A012030,돼지고기,이베리코 갈비살 300g/목살 갈매기살 돼지고기 흑돼지,10100,10100,0
2018-06-01,851922235,A012060,햄및베이컨,에쓰푸드 하몽 세라노 슬라이스 120g/몬테사노/SFOOD,13750,13750,0
2018-06-01,983567435,A018010,초콜릿,크레용 신짱 쵸코비 초코맛(20G),2100,1890,-210
2018-06-01,1058015561,C013020,티셔츠,아베크롬비 후드티 후드집업 홀리스터 맨투맨 바지,58900,58900,0
2018-06-01,1946745266,L012090,기초화장품,무료배송/사은품/이니스프리 그린티 밸런싱/씨드/스킨,12900,12900,0
2018-06-01,86458511,C013050,운동복,트레이닝복 스포츠레깅스 요가복 헬스복 휘트니스복,14900,14900,0
2018-06-01,2043438823,A022050,탄산음료,칠성사이다 190mlx30캔 콜라/사이다/음료수/캔음료,11900,11900,0
2018-06-01,2090203231,F011150,건강기능식품,알유21 12갑 (72정) /RU21/여명808/컨디션/모닝케어,28000,28000,0
2018-06-01,403691755,C013020,티셔츠,[대구백화점 II관] [게스키즈]ST타이티(G84KAT050),56000,44800,-11200
2018-06-01,244724465,A018090,잼,[복음자리]과일잼 입맛에따라 골라담기,4500,4500,0
2018-06-01,895772558,A019130,스프,[오뚜기]오뚜기 옥수수스프 80g,1690,1690,0
2018-06-01,895772557,A011100,라면,[오뚜기]오뚜기 옛날국수 (중면/900G),2990,2290,-700
2018-06-01,895772554,A011080,밀가루,오뚜기 옛날국수(소면/900G),2990,2290,-700
2018-06-01,438089974,C021010,아동화,정품만취급/다이얼끈조절/아동화/아동운동화/아동신발,30900,30900,0
2018-06-01,895772550,A011100,라면,[오뚜기]오뚜기 옛날당면 (1KG),11490,11490,0
2018-06-01,895772551,A011100,라면,[오뚜기]오뚜기 옛날당면 500G,5990,5990,0
2018-06-01,1010225696,A016100,수박,유기농)아로니아분말 80G/봉,6990,6990,0
2018-06-01,988126608,A019170,냉동식품,CJ 비비고 불고기 비빔밥 403G,5990,4990,-1000
2018-06-01,2099618476,L021030,가방,13형 15형 14인치 맥북 프로 파우치 랩탑 슬리브,15900,15900,0
2018-06-01,446634343,C014010,아동복,한국 체크 원피스 유아정장3종 세트(3-24개월)203456,68920,61340,-7580
2018-06-01,813284089,F012020,생리대,[쏘피] 한결 생리대 슈퍼롱 20P×2팩+사은품(한결중형10P×1팩)/ 바디피트,14900,14900,0
2018-06-01,1530560709,C012020,원피스,MELODY F106/코트/여자코트/겨울코디/겨울코트/자켓/점퍼 미국 여성토탈브랜드 멜로디,84700,84700,0
2018-06-01,988126607,A019170,냉동식품,CJ 비비고 낙지비빔밥 436G,5990,4990,-1000
2018-06-01,1179973097,L021020,장신구,피지 미니 버튼 반지 GP-RG-FASR-DIA/ 모니카비나더(주얼리),338000,304200,-33800
2018-06-01,311349337,E021010,침구,퓨리 화이트 리플 점프차렵이불(Q)+베개커버2장,42900,42900,0
2018-06-01,775857459,C012040,여자학생복,[앳코너] 아이보리 비스코스 혼방 소매배색 스웨터 ATSW8B206 IV,39000,33150,-5850
2018-06-01,1106124692,C011030,남자학생복,남자 니트 가디건 남성 빅사이즈 롱가디건 오버핏 숄,15800,15800,0
2018-06-01,1805542088,A011070,혼식곡,큐원 밀가루 (다목적용)(2.5KG),3350,3350,0
2018-06-01,601752209,C012040,여자학생복,경북상사 PK카라티 성인아동단체티 반팔반티긴팔과티,3900,3900,0
2018-06-01,1594096847,C014010,아동복,[블루테일] ASA5TS07BU 남아 블루 패턴 반팔 티셔츠,28000,24360,-3640
2018-06-01,598208835,I053040,기타문구,오피스네오/포스트잇모음/플래그/인덱스탭/접착식메모,5500,5500,0
2018-06-01,1192310545,A017210,파,속이 꽉 찬 논공 최상품 정품 찰 토마토 5kg 산지직송,14900,14900,0
2018-06-01,1476278746,C011030,남자학생복,여름/와이셔츠/빅사이즈/스판/긴팔/반팔/남자/남성,14700,14700,0
2018-06-01,523843227,A011080,밀가루,[백제물산]백제쌀국수(혼합가능) 무료배송 멸치맛 김치맛 얼큰한 육개장,14300,14300,0
2018-06-01,574683286,L021010,손목시계,알마니 시계 남성용 18ss 국내재고 백화점 동일구성,98000,98000,0
2018-06-01,895857992,A019180,즉석식품,CJ 햇반 210g*6입,8600,5990,-2610
2018-06-01,1020355910,C012060,여자내의,177 르프랑 와일드 여성 청바지 YY 여자청바지 여성청바지 청바지 나팔청바지 여자청바,33820,30100,-3720
2018-06-01,1971303375,C013010,점퍼,[알로봇]에센셜바람막이18329-110-04라이트그레이,55200,44160,-11040
2018-06-01,384999608,C012060,여자내의,[대구백화점 I관] [멜로디가든]슈가린넨팬츠(M8M5P04),46000,41400,-4600
2018-06-01,1911953650,A014020,분유,[LG생활건강]산양 액상분유 0-6개월 1단계 180ml 6개입 (니플S1포함)/ 베비언스,15000,15000,0
2018-06-01,1441579295,D031010,주택수선재료,[던에드워드]아리스토쉴드 약1리터- 현관문  철재대문,32000,29440,-2560
2018-06-01,1011155827,A013100,마른멸치,[기획전]완도 활전복 9~10미 1kg,54900,43900,-11000
2018-06-01,244579218,C012030,여자상의,헬로우스위티 봄~여름 신상 원피스/블라우스/팬츠,8700,8700,0
2018-06-01,953151213,A013040,고등어,제주 간고등어/실속형14마리/순살고등어 갈치 가자미,10800,10800,0
2018-06-01,467300612,C011030,남자학생복,[르젠] 남성 여름셔츠/린넨/하와이안/반팔/스트라이프,8900,8900,0
2018-06-01,494628259,C012020,원피스,(JJ지고트) 브레이드 장식 트위드 자켓 GI3A0JK22/ 제이제이지고트,289000,260100,-28900
2018-06-01,413384485,C012060,여자내의,[피핀][피핀] 제리벤 야자수 점프슈트 73681,24100,22900,-1200
2018-06-01,1180065736,C012040,여자학생복,베이직 골지 니트 (J11PNT149)/ 매그제이(MAGJAY),18000,16200,-1800
2018-06-01,663901060,E031030,전자레인지,무료배송 SK매직 전자레인지 20L MWO-20M7,59900,59300,-600
2018-06-01,794861732,A019110,드레싱,CJ 파인애플 샐러드소스(585G),4780,4780,0
2018-06-01,1931990390,E021010,침구,[아망떼] 스윗드림 프릴 이불커버+베개커버세트,48900,29900,-19000
2018-06-01,1885053596,C013010,점퍼,[대구백화점 I관] [오가닉맘]최초가(84.000)클라우드공용바람막이점퍼(MAS6JP01),42000,36540,-5460
2018-06-01,1198567675,L012090,기초화장품,2gy 필오프팩 구매시 화장품샘플 사은품증정,6800,6800,0
2018-06-01,2089409740,C011030,남자학생복,빈폴 폴로 타미 해지스 구제 반팔 남방 셔츠 카라티,19000,19000,0
2018-06-01,961252115,A012040,닭고기,브랜드 닭볶음탕 (1KG)[점포마다 브랜드가 상이할수 있습니다],5990,5990,0
2018-06-01,1312423949,A013070,굴,두레생협 손질꽃게(500g) 손질꽃게 탕용꽃게 튀김용꽃,49530,49530,0
2018-06-01,532357877,C012040,여자학생복,남여공용 경량 조끼 1629_1639 빅사이즈 조끼 베스트,60050,58250,-1800
2018-06-01,874423884,E061030,전구,LED모듈 모음 방등/거실등/주방등 LG정품칩 리폼용,10500,10500,0
2018-06-01,1343393359,C013020,티셔츠,[NBA]_남여공용 엔비에이 절개 배색 매쉬소재 아노락 반팔 후드티셔츠(N182TH103P)(강,52500,45840,-6660
2018-06-01,2285317,E031020,가스레인지,SK매직 2구 POP 원터치 가스레인지 GRA-813SR,120000,114000,-6000
2018-06-01,468587242,I053010,공책,묶음상품 플라스틱링(32mm)흑색 50개입x3개 책제본 링,58160,58160,0
2018-06-01,276874075,A017230,마늘,싱싱아삭! 2018년 첫출하 햇 양파 5kg 특사이즈 무배,5900,5900,0
2018-06-01,1090483737,E031080,선풍기,신일산업 히터/할로겐/풋터치/타이머/2단온열조절 SEH-900HK,35640,35640,0
2018-06-01,1090483735,E031080,선풍기,신일산업 전기히터/세라믹/스탠드형 SEH-900BBY,53500,53500,0
2018-06-01,2145711238,A019110,드레싱,[증정행사]청우캡사이신매운맛소스550g 매운분말400g,4600,4600,0
2018-06-01,1509040687,C013050,운동복,콜라보배색집업 MS1710 운동복상의 트레이닝집업 운동,54280,48310,-5970
2018-06-01,1107762611,A019170,냉동식품,부산 당면만두 소/대 외 3종 20개+20개+20개,6900,6900,0
2018-06-01,1264194591,C011030,남자학생복,브랜드남성 여름신상/셔츠/남방/와이셔츠/헨리넥/린넨,14900,14900,0
2018-06-01,672018902,A019080,고추장,청정원 순창 찰고추장(60G*3입),6560,6560,0
2018-06-01,895857985,A018080,설탕,[삼양]삼양 큐원 갈색 설탕 1kg,2200,2200,0
2018-06-01,586958951,C012060,여자내의,[마담그레이스]PT90550 배기핏 밴딩 데님팬츠,80550,80550,0
2018-06-01,1483016134,A016060,감,[친환경팔도]국산 호두 160g (조각호두살),13900,13900,0
2018-06-01,1405546848,C014010,아동복,[블루독] 라이트우븐팬츠 (27275-410-04),49000,40180,-8820
2018-06-01,1837021322,C013020,티셔츠,[지프 (JEEP)][유니] 소문자 JEEP 작은로고 반팔티 8종택1(GJ0TSU092 외)[갤러리아],17500,13480,-4020
2018-06-01,956840321,A022030,생수,제주 삼다수 500ML,450,450,0
2018-06-01,956840320,A022030,생수,제주 삼다수 2L,970,970,0
2018-06-01,1281468099,A012060,햄및베이컨,태림 훈제삼겹살 400g2개,38020,38020,0
2018-06-01,2065727468,E031130,보온매트,일월 온돌마루 카페트매트/전기장판 온열매트 방석,86500,81800,-4700
2018-06-01,1930615910,D031010,주택수선재료,KCC데코타일/바닥재/우드바닥/바닥시공/비접착/시공,27500,27500,0
2018-06-01,437557790,E011050,책상,로엠가구 pc pc방 목재 컴퓨터 콜센타 책상,32900,32900,0
2018-06-01,2089987918,C013020,티셔츠,커터앤벅 남성 면 반팔티셔츠 - SL-12-162-101-51,79900,69900,-10000
2018-06-01,1090483760,E031080,선풍기,SEH-W600S 신일산업 히터/석영관/2단온열조절,16650,16650,0
2018-06-01,1090483761,E031080,선풍기,신일산업 히터/석영관/2단온열조절 SEH-W800S,20500,20500,0
2018-06-01,2035337803,E031050,냉장고,LG공식인증(주)삼정 김치냉장고 K332S11 327L,1150000,1098000,-52000
2018-06-01,609264205,A017080,무,우엉차 선물세트 고급/실속 도라지차 연근차 침출차,34900,34900,0
2018-06-01,1190624746,E011050,책상,(칼라 접이식 테이블) 공부/학원/사무용 책상/식탁,51600,51600,0
2018-06-01,1580146460,A022010,주스,건망고(비앤지월넛 1K) X 10 태국 필리핀 업소용,176640,176640,0
2018-06-01,494991949,A011170,떡,(냉동)명가에프씨 치즈떡볶이1kgX6개식품 분식 식자재,57200,46910,-10290
2018-06-01,1981503186,C011030,남자학생복,레귤러 블랙 포인트 패턴 긴팔셔츠_S8102 정장셔츠 기,31990,31990,0
2018-06-01,322741101,C011050,남자내의,[지오다노] 롯데최대물량 남성 버뮤다 꿀 특가 묶음 택1/ 지오다노,14000,11340,-2660
2018-06-01,1332036464,L021010,손목시계,50M 5기압 방수시계 군인시계 군대시계 듀얼 알람,32900,32900,0
2018-06-01,166417453,I011030,사진기,[정품]A6000/16-50mm렌즈포함 32G풀패키지,725000,657800,-67200
2018-06-01,1899676556,C013020,티셔츠,[필골드] DB004n005 스판 단가라n맨투맨 목폴라 티셔,25800,25800,0
2018-06-01,985413455,L012110,색조화장품,해피바스 썬스프레이_150ML,16900,16900,0
2018-06-01,392785051,A019060,된장,된장(지함 재래 해찬들 14K) 된장 재래식된장 식자재,50690,45630,-5060
2018-06-01,1300953453,C013030,스웨터,[동대문] (색상 : 블랙 | 사이즈 : XL(105)) BIGWM-,56200,56200,0
2018-06-01,957494764,A022010,주스,[빙그레]빙그레 따옴 주스 오렌지220ML,1000,1000,0
2018-06-01,1225622007,C013010,점퍼,ACC(필골드) SL1009 프리미엄 세인트 루크 네오프랜,53980,53980,0
2018-06-01,957494766,A011080,밀가루,[백설]백설 제일제면소 중면 (900G),3490,3490,0
2018-06-01,1153007410,I031040,생화,캠핑 접이식 야외 행사 브로몰딩테이블 1200 야외용,38400,38400,0
2018-06-01,243015704,C012040,여자학생복,[아띠벗] 신상/남방/셔츠/블라우스/빅사이즈여성의류,34900,24900,-10000
2018-06-01,1486502624,A013160,맛살,건맛살 (차오름 1K) X10,216770,192930,-23840
2018-06-01,441872458,A015020,식용유,에버코코 엑스트라버진코코넛오일120ml 10개,78740,78740,0
2018-06-01,1810716814,A013170,생선통조림,동원 자연산 골뱅이400g,5700,5700,0
2018-06-01,1557936934,A017220,양파,대파 1kg,6940,6940,0
2018-06-01,352832374,A016100,수박,아삭아삭 달콤한 명품 고령 우곡수박 5~6kg,19900,19900,0
2018-06-01,204925645,L012040,치약,[본사직영정품] 메디안 치약(옵션),10900,10900,0
2018-06-01,301573966,A014040,발효유,희창유업 러빙유 요거트 파우더 1kg / 요거트 분말,6400,6400,0
2018-06-01,1810232106,C013020,티셔츠,여성골프웨어 크리스바니 에슬레져 이너티 (배색),36000,36000,0
2018-06-01,1748946275,I031010,장난감,[해피store][아이코닉스 춤추는 타요] 꼬마버스 타요 자동차장난감 장난감 완구,32510,32510,0
2018-06-01,451373373,C012040,여자학생복,씨에르 블라우스(EWBLHE05)/ 케네스 레이디,29000,26100,-2900
2018-06-01,489878995,I031040,생화,캠핑테이블/폴딩테이블/간이/접이식테이블/캠핑용품,18000,16470,-1530
2018-06-01,108414305,A019030,생강,생강마트 봉동 생강종자/세척생강/울금종자 1kg,6500,6500,0
2018-06-01,537612930,C012060,여자내의,[무료배송 44~110]634357SK_정장스커트/오피스룩/유니폼,19900,18900,-1000
2018-06-01,912558514,C014010,아동복,[바브키즈] 여름신상 아동 상하복 자체생산,5900,5900,0
2018-06-01,1734543930,A013040,고등어,[여수고기]노르웨이 순살 고등어 한마리 3kg/10-12팩,30000,27900,-2100
2018-06-01,1597034166,C013050,운동복,S~XL 트레이닝세트 신상 빅사이즈 여성 트레이닝복,31800,31800,0
2018-06-01,1133322800,E011060,의자,체스의자/ 공부의자/ 식탁의자/ 테이블 체어/ 매장,35550,35550,0
2018-06-01,1844568658,E021020,커튼,[뷰하우스] 데님 린넨 암막커튼 거실 안방 맞춤제작,30000,22640,-7360
2018-06-01,1586916089,E021010,침구,사계절용 이불베개세트 / 차렵이불+베개커버 2종세트,24900,22910,-1990
2018-06-01,1208073410,A017160,오이,유기농인증노루궁뎅이버섯 / 환  엑기스  스페셜 판매,53900,53900,0
2018-06-01,273202702,C021040,실내화,아디다스 나이키 운동화 스니커즈 남자여성 신발 특가,19800,19800,0
2018-06-01,997001945,C021020,구두,[파이어트랩] 영국브랜드 남성화 39종 초특가,28000,28000,0
2018-06-01,691811192,A011160,빵,삼립 아침미소토스트 700g 2봉지 토스트 샌드위치식빵,4080,4080,0
2018-06-01,1636819176,A014030,치즈,[동원]화이트 슬라이스치즈 100매외/업소용/카페용,14800,14800,0
2018-06-01,487827328,C011020,남자상의,마자켓 봄자켓 리넨자켓 남성아우터 정장자켓 832JK03,25700,25700,0
2018-06-01,1703558591,L021020,장신구,1부시그니티 커플링/14k골드/예물로도굳/4681,310000,310000,0
2018-06-01,1326128699,L021030,가방,USB 충전 스마트 백팩 랩탑백 학생 직장인 가방 사각,34900,34900,0
2018-06-01,2095151979,C013050,운동복,다이아코트 프리미엄 트렁크정리함_콘솔박스 (소형),22820,22820,0
2018-06-01,988932883,A011040,보리쌀,[월드그린] 한드레 서리태1kg,19800,13300,-6500
2018-06-01,988932882,A011040,보리쌀,[월드그린] 한드레 찰보리1kg,8600,2370,-6230
2018-06-01,334328602,C013030,스웨터,(215) 니트가오리티 가오리니트 가오리,23800,23800,0
2018-06-01,239710701,C015030,넥타이,(색상 : 와인) ATIE_004 와인 사선 스트라이,15310,15310,0
2018-06-01,521591342,C013010,점퍼,남녀공용 자수레터링 항공점퍼(KA7F8-UGJ010)/ 테이트,25000,21750,-3250
2018-06-01,1796507562,A019070,양념소스,라리 글레이즈 모데나 발사믹 베네가소스 500ml /크림,7300,7300,0
2018-06-01,476461647,C012060,여자내의,미라클 메탈 머메이드 밴딩 스커트 여성의류 여성옷,33710,33710,0
2018-06-01,1917944654,C013010,점퍼,[모다아울렛][쉬즈미스]라이더 가죽쟈켓,397600,377720,-19880
2018-06-01,1802505578,C013020,티셔츠,[임블리] S/S 여름 세일 한정특가!,15500,15500,0
2018-06-01,345255999,I031040,생화,리퍼브상품 헤드랜턴 해드랜턴 헤드라이트 헤드램프,17000,16830,-170
2018-06-01,1966772638,E031030,전자레인지,쿠잉 전자렌지 MC-R20EW 20L/전자레인지/소형/미니,61590,57900,-3690
2018-06-01,493977237,A011170,떡,(쌀떡)진공포장 쌀떡1.4kg 국산(일반미)쌀떡1kg 떡국,3500,3500,0
2018-06-01,1681566983,I031040,생화,휴대용/접이식/낚시/캠핑/의자/등산/레져/캠핑용품/,2000,1900,-100
2018-06-01,807352281,C021010,아동화,아동운동화 아동화 캔버스화 슬립온 주니어신발 단화,22800,22800,0
2018-06-01,11361248,A013140,북어채,강원도 먹태 특대 5/10마리 / 손질먹태 짝태 노가리,28900,28900,0
2018-06-01,896545977,A018050,비스킷,[해태]해태 아이비(270g),3400,3400,0
2018-06-01,1370361365,C011050,남자내의,린넨/면/4부/5부/디자인 신상 반바지 기획전,9900,9900,0
2018-06-01,1835177053,E011050,책상,특가 NEW 접이식테이블[입식.좌식] 간이테이블 식탁,14900,14900,0
2018-06-01,224803020,C011030,남자학생복,[디자인유나이티드][디자인유나이티드]공용 코튼린넨_7부 셔츠_7337221001,15000,14250,-750
2018-06-01,2135827454,E011050,책상,책상/컴퓨터책상/학원/독서실/공부방/학생/다용도책상,35000,32900,-2100
2018-06-01,784755465,C014010,아동복,[M.K] 한국 아기정장 레드곰돌이 5종세트 (3-36개월) 203122,80510,71660,-8850
2018-06-01,1651940085,A013150,어묵,(부산 사각어묵)상천 어묵 잡채어묵 대나무꼬지30cm,3500,3500,0
2018-06-01,22896568,A018040,아이스크림,디핀다트 구슬아이스크림(50mlx12개) 기프트팩,21600,21600,0
2018-06-01,1773195351,A019160,밑반찬,[식품명인] 김순자님의 포기김치 4kg+4kg,43900,43900,0
2018-06-01,337510350,C013010,점퍼,여름후드/핑크후드/화이트후드/후드집업/망사집업,18500,18500,0
2018-06-01,717640200,F011120,인삼,산삼그대로 20ml X 30vial 비트로시스 산삼음료 산삼,86450,83860,-2590
2018-06-01,525522701,C012060,여자내의,빅사이즈/밴딩/망사/롱/스커트 밴딩망사롱스커트 빅사,32970,32970,0
2018-06-01,1196603852,A017150,버섯,대용량 곱슬이 콩나물 3.5kg 아이스박스쿨팩 무료배송,9500,9500,0
2018-06-01,923160931,C013040,청바지,[핫핑] 청바지 빅사이즈 스커트 슬랙스 스키니,27800,23800,-4000
2018-06-01,273848159,A011170,떡,하림유노타니 구워먹는 찹쌀떡 키리모찌1kg/떡/,12900,12900,0
2018-06-01,2117718658,C012060,여자내의,바나나리퍼블릭 구제매니아 리프팅 거들 S 보정속옷,19610,19610,0
2018-06-01,1795903356,L012030,칫솔,2080 유아칫솔 12개 스테이지 10개 어린이 칫솔,9900,9900,0
2018-06-01,910845678,A019050,간장,옹가네 진간장 1.8L / 양조간장 1.8L,3200,3200,0
2018-06-01,989139533,E041080,부엌용용구,[지홈] PN풍년 하이클래드 IH 압력밥솥 10인용(사은품_우드 뒤집게),117700,91000,-26700
2018-06-01,1498628835,C015020,모자,여성남자무지빅사이즈빈티지여름군모큰야구모자볼캡,11900,11900,0
2018-06-01,226337373,E031020,가스레인지,2018년 자동불꽃조절 린나이 2구 가스렌지 RTR-AT221,168000,168000,0
2018-06-01,1095881297,C013010,점퍼,[하프클럽/체이스컬트]원데이특가 여름점퍼 균일가 (바람막이/윈드브레이크/레인코트外,9900,9900,0
2018-06-01,989139531,E041080,부엌용용구,[지홈] PN풍년 하이클래드 IH 압력밥솥 6인용(사은품_우드 밥주걱),105600,80800,-24800
2018-06-01,989139532,E041080,부엌용용구,[지홈] PN풍년 하이클래드 IH 압력밥솥 8인용(사은품_우드 뒤집게),114700,85800,-28900
2018-06-01,1432476148,C021040,실내화,[나이키] 다이나모 프리 (PS) 343738_620,39800,38210,-1590
2018-06-01,1856795955,E011050,책상,(new 칼라접이식 좌식책상) 공부상/밥상/학생/좌식,18900,18900,0
2018-06-01,1124505059,A013010,갈치,제주어가 은갈치 2호(4마리 선물포장) 싱싱함이 살아,190800,185080,-5720
2018-06-01,1444461336,A018040,아이스크림,하겐다즈 아이스크림 파인트 473ml X 2개,22600,22600,0
2018-06-01,1621594091,A022020,두유,서울대 쌀눈으로 더 똑똑한 약콩두유 190mlx24팩,22900,22900,0
2018-06-01,576083156,E021020,커튼,암막커튼1+1/화이트사암막/DTP/북유럽풍/가,9800,9800,0
2018-06-01,687448389,E041060,수저,명품/수저 세트/숟가락/수저/젓가락/업소용/영업용,270,270,0
2018-06-01,2049213150,C011030,남자학생복,여름신상/남방/셔츠/체크/청/데님/빅사이즈/남자/남성,14800,14800,0
2018-06-01,2085441033,C012060,여자내의,푸조 여성 워테레깅스 ( S26-2 ),28300,28300,0
2018-06-01,1302765990,C011050,남자내의,(색상:사이즈 : 네이비:L) DON 1846 린넨9,28220,28220,0
2018-06-01,951497011,E061030,전구,두영조명 형광등 EL 11W 15W 20W 25W 30W / 램프 /,1700,1700,0
2018-06-01,398455617,C011050,남자내의,[지오다노] 118526 라이트웨이트 테이퍼드 플리츠 치노 (슬라우치)/ 지오다노,19000,15390,-3610
2018-06-01,1617775761,A011040,보리쌀,흰강낭콩 귀리 퀴노아 병아리콩 2kg 4kg,9000,9000,0
2018-06-01,607107589,F012030,안경,울템/안경테/하이플렉스/베타/안경/뿔테안경,19800,19800,0
2018-06-01,322973864,E011030,거실장,시스템 수납함 바스켓 (화이트  대형)(39.5*35*20.5CM),3500,3500,0
2018-06-01,447511032,C011050,남자내의,[무료배송]팀 클럽 커프 팬츠(658679010) 하의바지 하,57550,57550,0
2018-06-01,2124448759,C012040,여자학생복,수지네 빈티지 스케쳐스 네이비 거위털 베스트 여성 M,27530,27530,0
2018-06-01,2134887508,C011050,남자내의,와이드팬츠 린넨 남자 마바지,38400,38400,0
2018-06-01,1944972375,C013020,티셔츠,롱티셔츠 박스티 반팔티 빅사이즈 여성의류 롱원피스,19800,19800,0
2018-06-01,62490132,C014020,유아복,HelloGeeks Stripe top패션 여성의류 티셔츠 스트라이,22320,22320,0
2018-06-01,427885125,E031080,선풍기,한빛 원적외선 전기온풍기 hv-5050(5.0kw) - 전기히터,663150,590210,-72940
2018-06-01,1010142901,L012030,칫솔,LG페리오키즈양치세트(라이언),6990,6500,-490
2018-06-01,1391974005,A013160,맛살,올리브녹차 돌자반 70gx20개 입안에서 살살녹는 고,57540,57540,0
2018-06-01,1966458739,E041070,밀폐용기,전자렌지용기 쿠킹볼4개/냉동밥용기 밥보관용기,15700,14450,-1250
2018-06-01,1010142902,A013140,북어채,[우리바다애]숏다리 20g 5봉,12900,10000,-2900
2018-06-01,1010404261,E061020,섬유유연제,[살림의정석] 세탁선생 섬유유연제2.5LX4개,10900,6900,-4000
2018-06-01,1549532463,C021040,실내화,PJM/조던/나이키/아동화/키즈/맥스/농구화/아디다스,93900,93900,0
2018-06-01,1165895724,L012040,치약,(특가)페리오치약150gX24개 2080/글리스터/덴티스테,10000,9800,-200
2018-06-01,2084777001,C011050,남자내의,[지오다노] 108220 코튼 버뮤다 웨빙벨트 사은품 증정/ 지오다노,17820,14440,-3380
2018-06-01,1010382410,A011140,부침가루,[풀무원직배송]토이쿠키씽씽자동차만들기 200g x3개,19200,16900,-2300
2018-06-01,1490044007,C011050,남자내의,컨셉원 히든밴딩 슬림 스트레치 TR 슬랙스 117903 10117903,33540,33540,0
2018-06-01,138542553,A011100,라면,소면/밀가루를전혀사용하지않은/쌀소면/800g/G46/z99,3900,3900,0
2018-06-01,71734357,A014050,달걀,사조오양 깐 메추리알1kg/한성 깐 메추리알1kg,5500,5500,0
2018-06-01,1920149067,C012040,여자학생복,그로 샌드캐슬트레블그로백 유아 의류 아동 실내 어린,83660,83660,0
2018-06-01,1987975352,C013010,점퍼,남자 빅사이즈 기모 후드 자켓 점퍼 집업 특가 9900,9900,9900,0
2018-06-01,521300263,C011030,남자학생복,압구정클럽 남녀공용 프리사이즈 하찌후드니트숄가디,73680,73680,0
2018-06-01,958420945,E061070,가정용비닐용품,필아띠 위생백 중(80매),990,990,0
2018-06-01,1057880464,E031040,전기레인지,차량 휴대용 냉온장고 175x320x315 7.5L 차량냉온장고,75110,75110,0
2018-06-01,1287219644,E061060,살충제,천연제올라이트 (1kg) 탈취/제습/새집증후군/악취제거,9900,9900,0
2018-06-01,2121397141,A012010,국산쇠고기,[무항생제] 잡뼈 1kg 1+등급,11200,11200,0
2018-06-01,1013263550,F012050,의료측정기,녹십자 BPM-642 가정용혈압계 혈압측정기 사은품3종,48860,45000,-3860
2018-06-01,1729007692,A018030,껌,[캔디마을]졸음번쩍껌 1곽6통 후식 자일리톨 간식 껌,19500,19500,0
2018-06-01,721583536,C013010,점퍼,남여후드시보리롱패딩점퍼 WWS1814G 빅사이즈,55890,54220,-1670
2018-06-01,1912508859,C013050,운동복,(덴마크) 스노우브러쉬(고급차용)/눈브러쉬/눈제거,11000,10120,-880
2018-06-01,50855237,A011080,밀가루,(참소당 멸치진육수1.8L)국시장국 멸치육수 멸치장국,12100,12100,0
2018-06-01,1053747740,A011100,라면,백설 햇당면 500g2개/1kg/당면/국내산/국수/소면/사리,7900,7900,0
2018-06-01,1900512617,A011170,떡,[CJ제일제당] CJ 즐거운동행 우리햅쌀 떡국떡 700g,5380,5380,0
2018-06-01,947473598,A013050,오징어,밀감캔(소교 3k)X6 밀감깡통 캔 식당용 업소용 깡통,55080,55080,0
2018-06-01,1461390764,C014010,아동복,홀리데이 티셔츠 17419-332-04/ 알로봇,19000,19000,0
2018-06-01,1020916458,C011050,남자내의,[캘빈클라인진] 남성용 베이직 카라 반팔 티셔츠(4ASKJL2),22500,18900,-3600
2018-06-01,1241578967,I053010,공책,근영사)아이디얼 양장노트(그리드_그린)박스(24개입),125470,125470,0
2018-06-01,539868810,A012050,소시지,신제품 천하장사 15gx50개/더블링/맥스봉/치즈/소세지,9900,9900,0
2018-06-01,1742137823,A011080,밀가루,(생면모음) 칼국수 소면 중사리 우동면 메밀면,3800,3800,0
2018-06-01,269969763,G011070,자전거,레드폭스 베니스27/시마노 하이브리드자전거27단,270000,243000,-27000
2018-06-01,1511833379,I031040,생화,[사은품]에밀리온 프리미엄 침낭+에어베개+사은품,21000,18710,-2290
2018-06-01,1781392886,L021010,손목시계,DKNY 도나카란 뉴욕 NY2588 여성용 메탈밴드 패션시계,179000,179000,0
2018-06-01,346734501,E031040,전기레인지,B형 냉장고 스마트 블록 특대 대 풀세트 냉장고 정,41340,41340,0
2018-06-01,1297622459,L021030,가방,탐스백 1+1 어썸 썸머백/신상/숄더백/라탄백/여성가방,11900,11900,0
2018-06-01,636344444,C012060,여자내의,와이드 린넨 팬츠 LRP018 통바지 여자바지 (YA02004),67510,59410,-8100
2018-06-01,1256897555,A017120,고구마,2018년 포근포근햇감자10kg 11900원/20kg-18900원,9900,9900,0
2018-06-01,1538852637,E031110,청소기,스팀덕스팀다리미/스팀덕다리미/커피포트,34800,34800,0
2018-06-01,429200159,A019020,참깨,들깨가루 (산들샘 1k),38720,34470,-4250
2018-06-01,1995370775,C012060,여자내의,입점할인DENIM핏예쁜 데님 청치마 치마바지 롱,24900,24900,0
2018-06-01,602083554,C014020,유아복,아동 유아 데일리 라운드 면티 반팔티 3~17호,10000,9900,-100
2018-06-01,393945753,A019040,소금,황물엿(화미 8K) 황물엿 식자재도매 업소용식자재 대,21140,19030,-2110
2018-06-01,2145615495,C013010,점퍼,[핑크시슬리]데이루 후드집업/ 핑크시슬리,41300,33040,-8260
2018-06-01,493674177,A013140,북어채,먹태구이 먹태포 마요네즈 와사비포함 105g X 10개입,70000,59500,-10500
2018-06-01,607109568,E061100,습기제거제,당신의하루와 곰팡이방지 습기제거제x18개/참숯제습제,13400,13400,0
2018-06-01,747987732,A022050,탄산음료,롯데칠성몰 트레비500mlx20펫(레몬/라임/자몽/플레인),15000,15000,0
2018-06-01,2135768559,C013050,운동복,라이커불 [남여공용] 여름 반팔 반바지 세트,86000,35900,-50100
2018-06-01,1966759254,C014010,아동복,[스타일노리터][BIU] 호호 점프수트.pts (마산점),27800,25620,-2180
2018-06-01,1951030568,A017040,양배추,웰파인 황금부추 부추즙 건강즙 부모님선물 효도선물,30500,30500,0
2018-06-01,175576029,E061040,부엌용세제,EM 원액 3.5리터/이엠 유용미생물/효소/용액,27950,27950,0
2018-06-01,956284127,E031070,에어컨,유니맥스 타워형 선풍기 UMF-TN163 타워팬 스탠드,32800,32800,0
2018-06-01,955890758,A018040,아이스크림,와쿠와크 (10개),12000,7000,-5000
2018-06-01,1289810163,I031010,장난감,태그미 리틀스네일 킥보드 유아킥보드 어린이킥보드,119000,119000,0
2018-06-01,409726085,D031010,주택수선재료,부틸 고무양면 방수테이프 두께 3mm 폭 30mm 길이 1,11410,11410,0
2018-06-01,1111630587,E021010,침구,[아망떼] 모닝벨 호텔식 순면 이불커버 싱글/퀸/킹,16900,16900,0
2018-06-01,1555369961,A011140,부침가루,[코스트코 냉장냉동] CHEESECAKE FACTORY 오리지널 치즈케익 1.81KG,25360,24350,-1010
2018-06-01,393027073,I053020,스케치북,브런치 스케치북 4종 220g크라프트/도형 모양스케치북,4900,4900,0
2018-06-01,356414757,E011050,책상,[채우리]쿠키앤크림 컴퓨터 책상 책장모음,19900,17910,-1990
2018-06-01,233041194,I012010,컴퓨터,[E]Z70EV-AP73S1/7세대/i3/8G/SSD128G+500G/윈10프로,823000,781850,-41150
2018-06-01,259386397,I011030,사진기,캐논 PowerShot G1X Mark III+8GB+보호필름[명품],1064700,1022020,-42680
2018-06-01,685810698,C014010,아동복,아둘 유아 쥬니어 조던 로고 볼캡 야구모자 65,14300,14300,0
2018-06-01,246919919,A013170,생선통조림,동원 살코기참치210g 10캔/마일드 210g10캔/135g 12개,24900,24900,0
2018-06-01,1708452949,A022050,탄산음료,음료수 152종 코카콜라 칠성사이다 캔음료 탄산음료,9900,9900,0
2018-06-01,1974909659,C013050,운동복,아디다스/츄리닝/트레이닝복/세트/트레이닝복/75종,69000,69000,0
2018-06-01,441066957,C013050,운동복,ABC 분말소화기 3.3KG 축압식 소화기 소방용품 가정,39920,36370,-3550
2018-06-01,740079121,A019050,간장,[농협] 우리땅우리콩 전통식 재래간장 900ml,9900,8900,-1000
2018-06-01,58088227,A012010,국산쇠고기,효도 견과세트 4호(고품격 웰빙 선물세트)사은품 답례,81200,81200,0
2018-06-01,94643203,E031130,보온매트,수지씨앤엘 동의보감 모노륨 온열매트 SZ10034,78000,78000,0
2018-06-01,1162475848,D031010,주택수선재료,듀프리코트4L/페인트/곰팡이,21500,21500,0
2018-06-01,2037409829,E041050,냄비,쿡에버 Cook304 3중 멀티팟,27800,27800,0
2018-06-01,759942391,E031130,보온매트,★TV홈쇼핑정품!!★일월 정품 나노륨 온돌마루 모노륨 카펫트 매트 수퍼 특특대형 183,238000,235620,-2380
2018-06-01,708945408,F012020,생리대,좋은느낌 울트라 날개 생리대 소/중/대/오버 18px6팩,29900,29900,0
2018-06-01,1102892445,C013060,등산복,[역시즌특가]여성 경량 옴니히트 다운자켓 CX4-YLP371/ 컬럼비아,79000,67150,-11850
2018-06-01,1104339562,A012050,소시지,진주햄 천하장사 28g x 3개 X 60EA_1BOX 미니소시지,86920,85190,-1730
2018-06-01,952115159,A013030,조기,[영광굴비] 영광굴비/법성포굴비/참조기/국산굴비/영광법성포굴비,109900,109900,0
2018-06-01,900236432,A016150,아몬드,삼계탕재료기획 (97G/봉),3990,3990,0
2018-06-01,1317504110,A018080,설탕,[큐원] 하얀설탕 [3kg] 삼양사/백설탕/갈색 P,3290,3290,0
2018-06-01,1728973921,A016030,복숭아,100% 자연산 야생 개복숭아/5kg/경북 청도,19900,19900,0
2018-06-01,1898769439,I031040,생화,폴딩스틸/야전삽/모종/캠핑/등산/낚시/캠프/나들이/휴가/휴대용/추천/가격/파는곳/좋은,12200,11900,-300
2018-06-01,956754699,A018040,아이스크림,조안나 5리터 딸기,15000,12000,-3000
2018-06-01,901226073,A019060,된장,[대상]순창 재래식안심생된장 500G,3150,3150,0
2018-06-01,1022160475,E041070,밀폐용기,락앤락 비스프리 온더테이블 반찬통 밀폐용기,8900,8190,-710
2018-06-01,2088477117,C013020,티셔츠,아디다스 반팔티셔츠 반바지 남자반팔티 반팔 커플티,25900,25900,0
2018-06-01,912693501,I012010,컴퓨터,[E]B70EV-AR77S1/7세대/i7/8G/128G+1TB/키보드+마우스,1075000,1021250,-53750
2018-06-01,1466353120,C013020,티셔츠,맨투맨 반팔티 여름 신상 빅사이즈 여성의류 허밍퍼플,10000,9800,-200
2018-06-01,1635845008,I012010,컴퓨터,정품 윈도우10설치 브랜드 고사양PC 신품SSD120G장착,198000,198000,0
2018-06-01,372567049,I053010,공책,신학기 과목노트(음악)(10개입)-랜덤 과목노트 학교노,10960,10960,0
2018-06-01,526506343,A012060,햄및베이컨,[코스트코 냉장냉동] 롯데햄 에센뽀득 900g,14490,14490,0
2018-06-01,1302728759,A012050,소시지,소시지 모음전 (소세지/천하장사/키스틱/치즈얌),7500,7500,0
2018-06-01,1770106742,C015030,넥타이,넥타이 수동 자동 타이 검정 화이트 노랑 교복타이,2800,2800,0
2018-06-01,2002532856,D031010,주택수선재료,꼼지락단품세계지도벽지gm-012_1폭_100cmx200cm 풀바른水실크벽지 인테리어소품 벽지시,88700,87600,-1100
2018-06-01,1113393908,A013140,북어채,명태껍질 1Kg /명태껍데기/황태껍질/깨끗하게 건조된,27900,27900,0
2018-06-01,1124420058,E021010,침구,[소프라움] 국내산 면/모달 차렵이불베개 세트 Q 4종택1,79000,63200,-15800
2018-06-01,880630052,A011070,혼식곡,백설 찰밀가루(2.5KG),4480,4480,0
2018-06-01,1082874254,E021020,커튼,[리드센스]창문차양 캐노피/방충망/비막이/방범창,35190,35190,0
2018-06-01,993730629,C014010,아동복,[쿨쿨곰]흰남방/아동남방/주니어/옥스퍼드/가족/커플,17500,17500,0
2018-06-01,984869074,A022010,주스,모구모구 리치x6개+피치x6개+요거트x6개+자몽x6개,24500,23900,-600
2018-06-01,651292190,L012030,칫솔,[오랄비 어린이칫솔x6개/8개]캐릭터칫솔/유아칫솔,12000,12000,0
2018-06-01,2037409801,A012030,돼지고기,(특가행사)돼지고기/삼겹살/목살/벌집/대패/오겹살,5900,5900,0
2018-06-01,511958618,C013010,점퍼,비브레이커스 청자켓/데님자켓/데님 베스트/남자/남성,19800,19800,0
2018-06-01,1010286062,A017100,당근,로컬)얼갈이,2790,2790,0
2018-06-01,67732688,I031040,생화,원투낚시대 바다 민물 선상 원투대 릴 루어 세트 용품,35000,33250,-1750
2018-06-01,766047975,C012040,여자학생복,[쎄쎄쎄]여성 셔츠 남방 모음/청/데님/체크/스트라이,13900,13900,0
2018-06-01,1780667962,E061030,전구,두영조명 삼파장 형광등 램프 FPL 36W 55W FPX 13W,790,790,0
2018-06-01,1394713859,C013030,스웨터,소렌스 루즈핏 언발 니트티 여성티셔츠셔츠 예쁜여성,35400,33630,-1770
2018-06-01,1627007107,L021020,장신구,순은 레이어드 실반지 모음(925silver),2800,2800,0
2018-06-01,1242970077,C013050,운동복,트레이닝복세트 여름츄리닝 남자반팔운동복 아웃도어,29800,29800,0
2018-06-01,720016680,L021020,장신구,브이 롱목걸이 NM-0033 목걸이 패션목걸이 브이 롱목,11460,11460,0
2018-06-01,982434607,A013110,마른오징어,초이스L)신선한 하루 볶음조림 멸치(100G/봉),3990,3990,0
2018-06-01,1032250338,C011030,남자학생복,압구정클럽 남녀공용 프리사이즈 하찌후드니트숄가디,72770,70590,-2180
2018-06-01,56401941,C013010,점퍼,[리스트][LIST] 7부 펀칭 점퍼 TWWJPH60050 (2가지 색상),59000,48970,-10030
2018-06-01,982434608,A013110,마른오징어,초이스L 신선한 하루 볶음용멸치(110G),3990,3990,0
2018-06-01,612965793,C013040,청바지,골드아이/봄신상/아동청바지/본딩바지/기모바지,8900,8900,0
2018-06-01,193708483,L012010,면도기,일회용면도기 대량1BOX(700개)두날 2중날 원터치포장,64900,64900,0
2018-06-01,1010262099,A013150,어묵,동원 바른어묵국탕용 245G*2,3480,3480,0
2018-06-01,486434989,E011050,책상,포밍테이블 회의용 사무실 세미나 다용도 실용적 탁자,43500,43500,0
2018-06-01,1782197092,F011130,홍삼,[일화]6년근 홍삼농축액 240g,120000,120000,0
2018-06-01,1782197090,F011130,홍삼,[일화]예비채 진스트15 홍삼정스틱 10ml*30포,39000,39000,0
2018-06-01,1710523341,C021040,실내화,슈퍼스타 운동화 C77124/ 아디다스(슈즈),77000,64680,-12320
2018-06-01,311205882,C013010,점퍼,걸크러쉬 슬림 가죽 자켓-m1071 (블랙) 여성자켓 겨울,54450,54450,0
2018-06-01,500411929,A017010,배추,괴산청정 통배추 1등급 배추 3포기 8~10k내외,9900,9900,0
2018-06-01,673668842,C013010,점퍼,델레바인 M~4XL 후드집업 맨투맨 후드티,19900,19900,0
2018-06-01,1782197087,F011130,홍삼,[일화]진스트15파우치 50ml X 42포,49000,49000,0
2018-06-01,1782197088,F011130,홍삼,[일화]진스트15 앰플플러스 20ml*30병,120000,120000,0
2018-06-01,1851211722,I031040,생화,[콜맨] 54쿼터 스틸 벨트 쿨러 유광 6155B707 / coleman 병행수입/ 3000003023,193000,187210,-5790
2018-06-01,450996453,C013010,점퍼,패딩점퍼 경량패딩 PD36 WS,38320,38320,0
2018-06-01,1780464378,L021020,장신구,[바보사랑]이태리 컷팅볼 실버팔찌,18000,18000,0
2018-06-01,1548234679,I053040,기타문구,[3M]포스트잇 이젤스텐드패드모음/이젤패드/559/561/5,84000,84000,0
2018-06-01,373894394,C013020,티셔츠,여름신상/반팔티/반팔카라티/7부티/티셔츠/카라티,15800,14800,-1000
2018-06-01,1826721034,C011030,남자학생복,빅사이즈 긴팔반팔셔츠 청자켓 큰남방 남성의류 스판,18790,18790,0
2018-06-01,245497236,C013040,청바지,[게스] 게스키즈 브러쉬 스키니진 G76KCP311-N1,79000,55300,-23700
2018-06-01,1118647091,E031070,에어컨,휠까지 청소가능한 분리구조 네모트리 타워팬 NE-TF30,159000,149000,-10000
2018-06-01,381549299,G011070,자전거,알톤 라레이 RLB26 26인치 고급 클래식 여성자전거,225000,207000,-18000
2018-06-01,1291995741,C013050,운동복,차량용 루프백/루프렉/루프탑/ 카고백/캐리어백/루프박스/캠핑가방/오토캠핑/텐트/타프,37900,37900,0
2018-06-01,602998814,C013050,운동복,차량용 버스컵홀더/관광버스/마을버스/트럭/음료수/,4900,4420,-480
2018-06-01,1104340581,A019020,참깨,해가원 볶음검정깨 70g X 35EA_1BOX 검은깨 볶음검정,67380,66040,-1340
2018-06-01,284747347,L021030,가방,[리뽀] 에코백 플럼 베이직 숄더 스트랩 2종 1택 AZ036017 AZ001017,39000,33150,-5850
2018-06-01,1950196778,C012020,원피스,[쉬즈미스(SHESMISS)] 매직라인 스트레치 스판 밴딩 팬츠,5900,5900,0
2018-06-01,2015640904,C013050,운동복,비상경광봉 LED 안전신호 주차유도 교통안전 도로안전,4000,3500,-500
2018-06-01,739424438,C012020,원피스,[보니알렉스](보니알렉스)허리포인트 데님 밴딩 팬츠(BAQY200A),13300,11710,-1590
2018-06-01,1061041580,L021010,손목시계,CASIO 카시오 LQ-142LB-1BDF 여성 가죽밴드 패션시계,32900,32900,0
2018-06-01,728891672,E061050,청소용세제,[유한양행]유한락스2리터2개 펑크린2리터2개/하수구,8900,8900,0
2018-06-01,1061041581,L021010,손목시계,CASIO 카시오 LQ-142E-9ADF 여성 우레탄밴드 패션시계,23500,23500,0
2018-06-01,984426667,A019140,이유식,[남양]남양 임페리얼 분유XO 1단계 800G,26900,26900,0
2018-06-01,1089636862,E011020,침대,[홈잡스]정품단면매트리스/발통포함(무료반품),65000,59700,-5300
2018-06-01,1061041575,L021010,손목시계,CASIO 카시오 LTP-V007L-7E1UDF 여성 가죽밴드 패션시계,31900,31900,0
2018-06-01,1061041576,L021010,손목시계,CASIO 카시오 LTP-1095Q-7A 여성 가죽밴드 패션시계,35900,35900,0
2018-06-01,1061041577,L021010,손목시계,CASIO 카시오 LTP-1177A-3ADF 여성 메탈밴드 패션시계,39500,39500,0
2018-06-01,1071984176,A016150,아몬드,[무료배송]2017년 켈리포니아 볶은아몬드 500gX2팩,10500,10500,0
2018-06-01,1061041578,L021010,손목시계,CASIO 카시오 LTP-1177A-1ADF 여성 메탈밴드 패션시계,39500,39500,0
2018-06-01,1061041579,L021010,손목시계,CASIO 카시오 LTP-1095E-7ADF 여성 가죽밴드 패션시계,31900,31900,0
2018-06-01,1244493709,C012040,여자학생복,[리스트][리스트] 베이직 기본가디건 TSKCDH60040 (P000363495),29000,25520,-3480
2018-06-01,1194037522,C013020,티셔츠,[세컨플로어] [여성] 코튼혼방 러플 오프숄더 탑 SWMS2WI42400001,175000,148750,-26250
2018-06-01,1576332247,E061030,전구,오스람 LED스틱전구 7W9W10W12W/기존 삼파장 대체용,2490,2490,0
2018-06-01,503845714,C013010,점퍼,[마담4060]엄마옷 마담4060 플라워펀칭점퍼-XJP805015-,85900,81610,-4290
2018-06-01,397981230,A022030,생수,롯데 트레비(라임.자몽) 300ml x 20펫/탄산음료,9700,9700,0
2018-06-01,1241816485,L021020,장신구,애니버셔리 도로시(14K) TESLG0082S/ 티르리르(주얼리),139000,125100,-13900
2018-06-01,321815721,C013010,점퍼,내셔널지오그래픽N174UDW050 유니섹스블루웨일/ 내셔널지오그래픽(남성),354000,290280,-63720
2018-06-01,137119588,C014010,아동복,여름신상 주니어 여아 상하복 원피스 아동복의류세트,25900,25900,0
2018-06-01,583944445,C013050,운동복,봄신상 긴팔트레이닝복세트/빅사이즈/운동복세트/커플,29800,29800,0
2018-06-01,251934508,A019090,카레,[코스트코] 에스비 골든카레 중간매운맛 198G x 5팩(고형),15690,15690,0
2018-06-01,985051341,C011050,남자내의,[필골드] YS3082 기모 듀엣라인 면트레이닝팬츠,16800,16800,0
2018-06-01,1864088883,C013010,점퍼,남자 블루종 남성점퍼 항공점퍼 잠바 자켓,30800,29800,-1000
2018-06-01,1990681584,C013020,티셔츠,여성프린트티/나시/민소매/반팔/롱원피스티/v넥박스,18000,17000,-1000
2018-06-01,1101230564,I031040,생화,몬스터라이트 2300 올마이티 XP-L V6 LED 자전거/캠핑,32500,29090,-3410
2018-06-01,384160722,C014010,아동복,[타미힐피거][남아] 코튼 크루넥 반소매 티셔츠 TBLS1KOS20A0 N00,28000,22400,-5600
2018-06-01,1010227719,A012050,소시지,목우촌 주부9단비엔나 180G*3,7980,5290,-2690
2018-06-01,897529201,A019110,드레싱,CJ 오리엔탈드레싱 105G,1380,1380,0
2018-06-01,895804140,A019130,스프,[동원]양반 전복죽 (285g),3100,2790,-310
2018-06-01,983222856,C013010,점퍼,[포에버21]새틴 자켓/FOREVER21/점퍼/블루종,44900,22450,-22450
2018-06-01,226555728,E021020,커튼,창안애 1+1암막커튼 거실창문/아일렛커텐/방한방풍,19700,19700,0
2018-06-01,449145750,A011100,라면,백설 치킨튀김가루1kg 10개(1박스),114840,114840,0
2018-06-01,1134502382,C011050,남자내의,빅사이즈 면팬츠/ 슬랙스/~46 4XL [더블온스],29900,29900,0
2018-06-01,895828105,E061090,방향제,[P&G]페브리즈 에어 봄의소생 (275G),5900,5900,0
2018-06-01,287475806,C012060,여자내의,[바비앤펌킨]필수템 니트 스커트,27500,24750,-2750
2018-06-01,655684810,A017220,양파,동결건조 대파가루 30g 4개 대파분말 국산 대파,39210,39210,0
2018-06-01,1490950454,L021010,손목시계,Nibosi 남성 메탈 손목시계 크로노기능 No.2320화이트,59900,59900,0
2018-06-01,510176457,E061060,살충제,레인보우에어 휘산기 용액 - 비바크린 블루 5Lx4 소독,82850,82850,0
2018-06-01,440882542,E021020,커튼,GT 퍼셀 강아지 고양이 이동가방 펫 슬링백 그린 소,55830,55830,0
2018-06-01,452927552,A011140,부침가루,코스트코 빵/샌드위치식빵/치즈케익/햄버거빵/단팥빵,7800,7800,0
2018-06-01,82093388,D031010,주택수선재료,KCC륨장판(모노륨)/10CM단위판매/KCC숲그린/KCC총판,1100,1100,0
2018-06-01,271047984,C013050,운동복,차량용분말소화기 차량용소화기 화재소화기 차량소화,39030,35550,-3480
2018-06-01,266486957,L021020,장신구,[폭스타일] [실버] 롤랜드 큐빅 반지,17000,15470,-1530
2018-06-01,1114213448,C013010,점퍼,빅사이즈 DSM1044 빅 포인트 울 자켓 801 미시재킷 큰,87660,87660,0
2018-06-01,571801502,C012060,여자내의,SK1019-데일리 20대 30대 예쁜스커트 땡땡이 니트sk,18660,18660,0
2018-06-01,1904348767,C011050,남자내의,남성 카고바지 면바지 밴딩바지 스판 일자바지 w077,16000,15800,-200
2018-06-01,497667186,A017280,김,(무)스위트웰 월남쌈300gX24개월남쌈 식재료 쌈 식자,107500,94600,-12900
2018-06-01,599281152,E041070,밀폐용기,메탈락 스텐 반찬통 밀폐용기 찬통 김치통17종,10600,9760,-840
2018-06-01,1239912875,C012040,여자학생복,빅사이즈 DWW001A 편한 데님 롱 셔츠 802 여자데님셔,63320,63320,0
2018-06-01,1124047010,A014030,치즈,[남양] 유기농 아기치즈1 2 3단계 본품60매+증정36매,30900,29520,-1380
2018-06-01,444346719,C014020,유아복,[디플랜][디플랜] 일러스트포인트티셔츠(네이비 그레이),6500,6180,-320
2018-06-01,1853921687,L021060,유모차,킨즈웨건2 유아웨건 디럭스 쌍둥이 유모차,348000,348000,0
2018-06-01,450191346,C015040,장갑,아놀드파마_APGW_BY322(여성가죽장갑) 장갑 가죽장갑,21010,18910,-2100
2018-06-01,900657444,C011030,남자학생복,패딩 패딩수선 패딩수선패치 패딩수선테이프 패딩패치,9000,9000,0
2018-06-01,1610129276,C012020,원피스,김발 겉대x20,20180,20180,0
2018-06-01,1874995442,E011040,소파,[삼익가구]쏘렌토 이태리 천연가죽 라텍스 4인용 소파(스툴포함),702000,631800,-70200
2018-06-01,1690145061,A014020,분유,일동후디스 프리미엄 트루맘 1~4단계 3캔,66000,66000,0
2018-06-01,400339039,A017160,오이,금산에서 키운 생 표고버섯 1kg,6990,6990,0
2018-06-01,575674227,C011050,남자내의,DON 1846 린넨9부밴딩슬렉스남자바지 남성슬랙스 남성,27610,27610,0
2018-06-01,1397304307,C011030,남자학생복,AGC빅사이즈 바투스 청남방 BW청남방데님남방청카바청,72050,72050,0
2018-06-01,1665087967,C021040,실내화,[푸마]푸마 우먼스 튜린 360914-06,45100,42850,-2250
2018-06-01,583584405,I031070,애완동물관리비,[슬레진저] SLAZENGER EXODUS 테니스라켓 입문용/초급 교재용라켓,22900,22900,0
2018-06-01,423184135,C012060,여자내의,[에스크]빈티지 포켓 면팬츠 (AO3MPT004F)(여차콜그레이),3000,3000,0
2018-06-01,836133243,A011090,국수,오늘출발 컵누들 15개 진라면 진짬뽕 참깨라면 컵라면,13900,13900,0
2018-06-01,480524257,C012030,여자상의,빅사이즈여성의류/루즈핏/엄마옷/원피스/린넨/마/,30000,15000,-15000
2018-06-01,486647059,A014020,분유,[특가] 피그비 향균 아기 지퍼백 / 우체국 택배,10000,9500,-500
2018-06-01,1456372409,C013060,등산복,콜핑&BTR 여름맞이 남자 기능성 바지 22종 모음전,26900,26900,0
2018-06-01,58825750,E031140,비데,이누스 방수비데 모음전 (정품필터30개월분증정),199000,169000,-30000
2018-06-01,1262347667,F012010,종이기저귀,[리베로] 팬티형 7단계 36매 4팩 UP&GO,69900,69900,0
2018-06-01,1441748110,G022020,자동차타이어,한국타이어 벤투스S2 AS H462 무료배송 특가,117000,97750,-19250
2018-06-01,1949184203,E061080,키친타월,[크리넥스] 안심 키친타올 클래식 200매 2롤 x6개,12900,12900,0
2018-06-01,987115630,E061090,방향제,훠링) 핸드폰 거치대 (통풍구형),14900,14900,0
2018-06-01,987115631,E061090,방향제,훠링) 급속 충전기 4.8A,16900,16900,0
2018-06-01,625973603,L021020,장신구,실버 체인 은팔찌 각인 커플 남자 여자 사각 7/10/15D,86000,86000,0
2018-06-01,1400900498,C013010,점퍼,[블랙야크키즈] 역시즌 특가! BK 제로 경량구스다운 자켓(강남점),40380,40380,0
2018-06-01,1597239856,F011130,홍삼,정관장 굿베이스 푸룬홍삼정(100G),18000,18000,0
2018-06-01,1827740860,E031010,전기밥솥,쿠쿠공식몰/CRP-P0610FD/전기압력/6인용,171930,171930,0
2018-06-01,94749613,C013050,운동복,한벌몸빼/한벌옷/홈웨어/투피스/파자마/잠옷/실내복,7900,7900,0
2018-06-01,1239549996,D031010,주택수선재료,황토 미장재 20kg/100% 황토/친환경 인증/본드 무첨가,12000,12000,0
2018-06-01,689314006,E011060,의자,프리미엄 침대형 의자/사무용/컴퓨터의자/PC방의자//,89000,89000,0
2018-06-01,2013274476,C013050,운동복,#NAME?,9000,8910,-90
2018-06-01,670356615,I031040,생화,아베나키 퍼핀 스틸쿨러 3종 - 디자인 아이스박스,123000,113070,-9930
2018-06-01,69396281,C012060,여자내의,[핑크시슬리] 젤리 히든밴딩 스판슬랙스/ 핑크시슬리,27200,21490,-5710
2018-06-01,1385769360,A011160,빵,안흥찐빵마을 우리밀우리팥 수제 안흥찐빵 (500g 10입,35200,35200,0
2018-06-01,1897421767,C013060,등산복,여름 남성 등산바지 등산복 반바지 작업복 등산티셔츠,16800,13250,-3550
2018-06-01,516072432,C013040,청바지,[톰키드]에센셜 10부 브러쉬드 쿨데님 팬츠 (9218231701056)(인천점),15000,13830,-1170
2018-06-01,1701616320,L012010,면도기,[2천원쿠폰!]*도루코 페이스6 면도기+ 날11입,22900,22900,0
2018-06-01,2104749975,E031120,믹서,당일발송한일 대용량 믹서기 HMF-3450S 이영,81950,81950,0
2018-06-01,1870465930,C013020,티셔츠,챔피온 USA 그래픽 반팔티,16900,16900,0
2018-06-01,280159413,C012060,여자내의,[ab.plus][ab.plus] 앙고라믹스 트임 스커트 (LSR4MW83A)_Q7Y7,32400,27540,-4860
2018-06-01,1748836451,G022020,자동차타이어,[공식인증점] 전차종 경차 타이어 모음 / 175/50R/15,49000,49000,0
2018-06-01,808414088,L021010,손목시계,젤리 아쿠아 방수시계 패션팔찌시계 패션시계 시계 방,12770,12770,0
2018-06-01,1656437793,C011030,남자학생복,여름신상/남방/셔츠/체크/청/데님/빅사이즈/남자/남성,19700,19700,0
2018-06-01,123727673,C011050,남자내의,남자 여름코디/티셔츠/셔츠/슬랙스/반바지/린넨,9800,9800,0
2018-06-01,392787751,A019060,된장,된장(찌개용 옛날식 양지뜰14K) 된장 재래식된장 식자,52890,47610,-5280
2018-06-01,2069319084,C012060,여자내의,빅사이즈/벨리/레이스/스커트 / 참고 벨리레이스스커,39800,35030,-4770
2018-06-01,651796055,L012110,색조화장품,[본품 1+1 증정] 레이저 썬스크린100 50ml + 50ml ~ 6월03일까지/ 셀퓨전씨,42000,33600,-8400
2018-06-01,1262252893,C013040,청바지,무릎고양이진/청바지/캐릭터바지/면바지/기모바지,9900,9900,0
2018-06-01,1691614136,C013010,점퍼,[대구백화점 II관] [레코브]피유 블루종 점퍼(LY317ZJP518X),64000,60800,-3200
2018-06-01,1010166209,A019150,김치,CJ 비비고썰은배추김치(용기형) 500G,7400,5990,-1410
2018-06-01,375775490,E061040,부엌용세제,롯데 3종 주방세제세트/세제선물세트/주방세제/세제,2900,2900,0
2018-06-01,75019869,C012040,여자학생복,하얀비3000원쿠폰/봄가디건/나시/롱베스트/린넨롱조끼,13800,10800,-3000
2018-06-01,1266601577,C011030,남자학생복,린넨 7부셔츠 BTT0166 셔츠 여름셔츠(YA02004) 남자셔,26160,26160,0
2018-06-01,1705928406,C013010,점퍼,SAVANNA 양가죽 무스탕 (66-77사이즈) - 5187,48900,48900,0
2018-06-01,1734697795,I031040,생화,비치파라솔 낚시파라솔 꺾임파라솔 우산 캠핑 야영,12900,11760,-1140
2018-06-01,619597773,L021020,장신구,스와로브스키 귀걸이 이어링 귀고리 은침 실버침 크리스탈 유색 여성악세사리선물 패션,12500,12130,-370
2018-06-01,582605142,I012010,컴퓨터,LG총판 LG데스크탑 B71EV-AX7716 i7-7700 Free-Dos,924460,869000,-55460
2018-06-01,127966293,C014010,아동복,[게스키즈] 성조기 스터드티 G75KBT040,29000,23200,-5800
2018-06-01,193990551,C014010,아동복,[아동 남아 정장]셔츠 주니어 유아 흰색셔츠 돌복,27900,27900,0
2018-06-01,1572368076,A011110,당면,안동전통 국산콩 두부 찌개용2팩+부침용2팩(210gx4팩),13900,13900,0
2018-06-01,390077885,C015020,모자,(컬러:사이즈 : 챠콜:FREE) ACC-CAP103 빈티,19630,19630,0
2018-06-01,733449967,E011070,식탁,리안 주방수납장/수납장/조리대/뷔페장/다용도수납,85000,84000,-1000
2018-06-01,1011310953,F012010,종이기저귀,슈베스 기저귀 밴드 팬티 4팩/초슬림 썸머 여름기저귀,22900,22900,0
2018-06-01,1917102224,A015020,식용유,오뚜기 프레스코 포도씨유 900ml 오일 기름 가정용포,16840,16840,0
2018-06-01,1886101705,C013010,점퍼,[화이트폭스][화이트폭스]버팔로 레더 무스탕자켓,71000,64610,-6390
2018-06-01,1495217835,C013020,티셔츠,빅사이즈 DWW083 단가라 트임 티셔츠 801 빅사이즈티,51120,51120,0
2018-06-01,945530447,C012030,여자상의,[아뜨랑스]신규입점!러블리/로맨틱/원피스,13570,12570,-1000
2018-06-01,749265234,A011140,부침가루,두레생협 에그타르트(60g/2개)2개,22070,22070,0
2018-06-01,955890703,A018040,아이스크림,와플 통팥 (10개),12000,7000,-5000
2018-06-01,1286257560,C013060,등산복,[컬럼비아][역시즌특가]남성 파이에스테와 폴즈 구스 다운 자켓 CW4-YM3687.EDM,129000,103200,-25800
2018-06-01,1385770378,A011160,빵,안흥찐빵마을 우리팥 수제 안흥찐빵 3종세트 먹거리,31140,31140,0
2018-06-01,1345396538,C012060,여자내의,비긴 7부 멜빵 데님 팬츠-M1066 힙합청바지 데님스커트 멜빵청바지 와이드 데님팬츠,30770,27390,-3380
2018-06-01,215509352,C011030,남자학생복,[메이드]가디건/남성/남자/숄/롱/하프/니트/남방/자켓,12800,12800,0
2018-06-01,673654274,A019070,양념소스,빅마마 이혜정 소스/맛장/국물팩,4900,4900,0
2018-06-01,1108518423,A017080,무,러시아산 녹용/뉴질랜드산 건녹용/원용/분골/상대,70000,70000,0
2018-06-01,128140156,A019180,즉석식품,천일볶음밥 19종 내맘대로 골라담기,780,780,0
2018-06-01,1907471720,E061010,세탁세제,아이마망 젖병&주방세제 500ml  5개 [1종/액상형],32500,27700,-4800
2018-06-01,1166453880,C012040,여자학생복,[비올] 링마벨 셔츠/여성 루즈핏 면 블라우스/~빅사이즈,23700,23700,0
2018-06-01,428624885,A011140,부침가루,삼립 치즈무스 조각케익 (5입) 6가지/케이크/디저트,13000,12870,-130
2018-06-01,982615179,A012060,햄및베이컨,[롯데]롯데 장조림(95G),2200,2200,0
2018-06-01,1870585760,C013020,티셔츠,전품목세일/5900원~/민소매/나시티셔츠/라운드/여성,7900,7900,0
2018-06-01,983567530,A018060,스낵과자,[해태]해태 구운감자 2번들_48G,1200,1200,0
2018-06-01,1994395530,A019130,스프,나가사끼짬뽕소스 (초담원 2K),32260,28720,-3540
2018-06-01,1196660228,A018100,꿀,생로얄제리 로알제리 ROYALJELLY 밀랍 로열제리 왕유,129900,129900,0
2018-06-01,1421531894,G011070,자전거,알톤 아크라A 하이브리드자전거 로드 삼천리자전거,210000,186900,-23100
2018-06-01,382045253,L021010,손목시계,서바이벌 군인 시계,14140,12590,-1550
2018-06-01,895892645,F012020,생리대,[LG]바디피트 순간흡수기획 (중형32개입+중형16개입+오버나이트12개입),16500,8900,-7600
2018-06-01,880390779,I031040,생화,(야외필수소품~세일)코멕스/케이원~흡입/램프형~버그킬러/포충기/모기채/파리채/벌레퇴,36000,35000,-1000
2018-06-01,1376868336,C012020,원피스,[CC콜렉트] 겹마혼방트렌치코트@벨트(C182MSI031),209300,167440,-41860
2018-06-01,1014646245,C011050,남자내의,아디다스 이큐티 블록드 타이츠(BP9275),44050,44050,0
2018-06-01,2103555552,I031040,생화,충전식 37구LED 서치라이트/손전등/후레쉬/랜턴/써치,15900,14630,-1270
2018-06-01,1489824117,C013050,운동복,차량용컵홀더 자동차 악세사리 거치대,2000,1900,-100
2018-06-01,1704572597,C013020,티셔츠,반팔 L~3XL 큐티/후드티/빅사이즈/롱티/박스티/반,13900,12900,-1000
2018-06-01,1895122745,A012060,햄및베이컨,청정원 참나무로 훈연한 베이컨 1kg,18900,18900,0
2018-06-01,1153668366,C013010,점퍼,윌슨[Wilson]브랜드특가 기능성투습방풍발수/윈드자켓/바람막이/아웃도어자켓/등산자켓,42500,39000,-3500
2018-06-01,1201379350,A019060,된장,신주 아와세 미소컵된장(1KG),5980,5980,0
2018-06-01,156708433,A018090,잼,오뚜기)딸기쨈 500g x 6개 국산딸기 달콤 빵 과자,39690,39690,0
2018-06-01,116238448,C012060,여자내의,비앙카 허리리본 통바지 DM-5861,18000,16020,-1980
2018-06-01,475293076,I011010,TV,NEX 40인치 TV/ 100% 무결점/ 돌비사운드/ 2018년형,238600,229000,-9600
2018-06-01,294166518,C012040,여자학생복,[위쉬몰]HG 아이스슬림가디건(0175H805),30240,26660,-3580
2018-06-01,1451071197,C013050,운동복,헬스장 찜질방납품전문/반바지/운동복/단체복,6000,5900,-100
2018-06-01,899464620,E061050,청소용세제,[LG]엘지 MR 홈스타 주방을 부탁해(500ML),5900,3000,-2900
2018-06-01,457714636,A018100,꿀,뉴질랜드 마누카꿀x1kg UMF5+ 마누카 수입꿀 천연벌꿀,138000,136620,-1380
2018-06-01,963653558,C012020,원피스,무지대형 숄목도리 겨울 목도리 머플러 남성자목도리/,34400,30280,-4120
2018-06-01,1931821304,E011040,소파,무료체험3일 폴리몰리 빈백 701A 라임그린,199000,137910,-61090
2018-06-01,895892652,A021010,커피,[동서]동서 아라비카 (리필/150g),7800,6990,-810
2018-06-01,1021185870,A013170,생선통조림,[동원]포차골뱅이 간장소스100gx6 + 원조생쫄면 2인분,10900,10900,0
2018-06-01,1566916815,F012010,종이기저귀,하기스 밴드형(매직핏/보송/썸머/꿀벅지) 1~5단계,38900,38900,0
2018-06-01,484588434,C012030,여자상의,말랑루즈/럭셔리섹시원피스/데이트룩/파티/오피스룩,25000,25000,0
2018-06-01,2112606864,A022010,주스,초록매실 500mlx20펫 매실음료 건강음료,36720,36720,0
2018-06-01,197987154,E031130,보온매트,2018년형 일월 전기매트 총집합 온열 1인용전기장판,49800,49800,0
2018-06-01,806206390,C013050,운동복,문콕 방지 보호 카닉스 스마일베어 캐릭터 도어 가드,8500,7480,-1020
2018-06-01,1408594537,C014010,아동복,[키키제제]여아 면바지/7.5부/청바지/스키니/반바지,10900,10900,0
2018-06-01,679838586,F011150,건강기능식품,뉴트리가든 프리미엄 프로바이오틱스 키즈(2개월),16900,16900,0
2018-06-01,1799500,A019140,이유식,매일 맘마밀 안심이유식 5팩/6.9.12개월/요미,11500,11500,0
2018-06-01,919223225,I031040,생화,라이트캠핑침낭 야영침낭 사계절침낭 아동침낭 군용침낭 어린이침낭 담요 모포 캠핑용,13000,11870,-1130
2018-06-01,443575830,A011180,파스타면,스파게티(먹물 디벨라 500g)X12,115590,115590,0
2018-06-01,872976865,I031040,생화,[마운틴컴퍼니] SOS 긴급 구호세트 캠핑용품 캠핑장비 캠핑편의용품,23040,20990,-2050
2018-06-01,280159440,C012060,여자내의,[ab.plus][ab.plus] 랩스타일 골지 스커트 (LSR4MW68A)_J1C5,22400,19040,-3360
2018-06-01,2120479514,A012010,국산쇠고기,[무항생제] 안심 이유식 다짐육 300g 2등급(6구),30700,30700,0
2018-06-01,1272319432,C013040,청바지,[에꼴] 아이스 구제 데님 - P86DPB080Z,107400,89150,-18250
2018-06-01,499067017,C021010,아동화,[페이퍼플레인키즈] PK7728 아동단화 슬립온,26900,24750,-2150
2018-06-01,2084909140,C012060,여자내의,#NAME?,80000,70400,-9600
2018-06-01,1775675733,A022050,탄산음료,칠성사이다/펩시콜라PT/500ml/1.25L/1.5L/코카콜라,12500,12500,0
2018-06-01,292403168,C013050,운동복,고휘도 LED 인솔지시봉 경광봉 ST-900R 어린이안전 공,16900,15410,-1490
2018-06-01,356245493,E041070,밀폐용기,국산/글라스락/냉장고정리용기/캐니스터/밀폐용기,3000,2670,-330
2018-06-01,476522505,C011020,남자상의,MJ-077 베이직 모던 싱글 코트 남성하프코트 정장코트,114600,114600,0
2018-06-01,1375328835,A013030,조기,영광 법성포 보리 굴비 마른 부세 참조기 선물 세트,100000,97000,-3000
2018-06-01,872433340,I031010,장난감,PS4 용과같이 극 한글판 빅히트버전 / 용과 같이 극,22800,22800,0
2018-06-01,285379514,A017050,미나리,안심먹거리 유기농 양배추즙 120mlX30포,23900,23900,0
2018-06-01,987115665,A018030,껌,롯데ID자몽_25G,960,960,0
2018-06-01,226962204,A018020,사탕,수제 달고나 30g x 1봉,690,690,0
2018-06-01,1506048757,F012020,생리대,위스퍼 보송보송 울트라 날개 오버나이트 14P,3900,3900,0
2018-06-01,898663239,A014030,치즈,동원 고칼슘치즈 180G,4600,4600,0
2018-06-01,2025748144,A012010,국산쇠고기,[무항생제] 탕갈비 800g 1+등급,93000,93000,0
2018-06-01,1331172946,E011040,소파,[잉글랜더]New 모건 4인용 라텍스 거위털 가죽 소파,399000,399000,0
2018-06-01,1297201648,C011030,남자학생복,레귤러 티니-스트라이프 블루 일반셔츠 남자셔츠 스트,28950,28950,0
2018-06-01,143308987,I031040,생화,캠핑의자/릴렉스체어/접이식/야외의자/슬림체어/캠핑,26000,23830,-2170
2018-06-01,2061943096,E031050,냉장고,LG전자 K332S11 스탠드형 김치냉장고 (주)대명,1144000,1098000,-46000
2018-06-01,490625734,C012040,여자학생복,부루앤주디(WGKE3CD001)부루앤쥬디 스카시 롱 가디건,39900,35910,-3990
2018-06-01,1121815287,F012010,종이기저귀,[앙블랑] 킵밴드/팬티 프리미엄 기저귀 모음,35900,35900,0
2018-06-01,617020358,F012020,생리대,[실화가격]내츄럴코튼 순면커버 생리대 11팩/라이너,9900,9900,0
2018-06-01,2056023014,C012040,여자학생복,내추럴 단가라 린넨셔츠 ( 2 color ),29000,29000,0
2018-06-01,197535816,I031040,생화,[BUCK703] 하이파워 충전식 줌 후레쉬 헤드랜턴/LED,3900,3900,0
2018-06-01,1109330269,E011050,책상,가이온 리파인 서랍형/책장/트윈 책상,78800,70920,-7880
2018-06-01,1010142191,A013140,북어채,[우리바다애]매콤쫄깃 오징어육포 300g,13900,9800,-4100
2018-06-01,706754188,F012010,종이기저귀,[밤보]덴마크 프리미엄 밤보기저귀 2~6단계 1박스 구성,89900,79120,-10780
2018-06-01,266462963,C012040,여자학생복,[모다아울렛][크로커다일레이디스]여성스러운 넥크 민소매 블라우스(CL8MBL126),39900,37910,-1990
2018-06-01,1941275166,C013010,점퍼,[대구백화점 II관] [레코브]레자롱 점퍼(LZ2182BY801X),79800,75810,-3990
2018-06-01,80897453,A017180,호박,국내산 청양고추 10kg/5kg,29900,29900,0
2018-06-01,1440651704,C012020,원피스,[르오트] (TV홈쇼핑방송/무료배송) 메이크 퍼펙트 피팅라인 모던 팬츠-사이즈 55∼88다,6900,6210,-690
2018-06-01,1010142190,A013140,북어채,[우리바다애]버터구이오징어포 300g,14900,11500,-3400
2018-06-01,897530125,A018060,스낵과자,[오리온]오리온 초코송이 2입기획 36G*2,1000,1000,0
2018-06-01,1078822210,A016100,수박,첫출하 국내산 블랙망고수박 (11브릭스이상),9900,9900,0
2018-06-01,1163655767,C013010,점퍼,AG 가죽자켓 라이더자켓 가죽점퍼 P171 라이더자켓 남,91920,91920,0
2018-06-01,1950050278,A018010,초콜릿,롯데수입정품 길리안250g 시셀시리즈8종 초콜릿벨기에,14800,14800,0
2018-06-01,970513605,C013050,운동복,카스타-미르웨이 후사경/4WD/RV용품/사각지대/후진주차/현대/기아/대우/쌍용,27000,24600,-2400
2018-06-01,988958797,A011010,쌀,농사꾼 메뚜기쌀(포)/20KG,59900,46900,-13000
2018-06-01,963653503,C012020,원피스,체크대형숄 겨울체크 목도리 남여성목도리 겨울목도/,34400,30280,-4120
2018-06-01,2055592160,C011030,남자학생복,[레노마셔츠]2018 S/S 반소매셔츠(슬림/일반핏) 30종 택1(강남점),30000,24740,-5260
2018-06-01,1314095102,A012030,돼지고기,순빛살 구룡농장 No항생제 돼지 목살500g 앞다리살500,58890,58890,0
2018-06-01,61897679,A016100,수박,델리참 국산가당딸기퓨레 1kg x 16개입 딸기스무디 냉,93360,93360,0
2018-06-01,1095137451,E021020,커튼,/벌집블라인드 베이지 호프발스 120x155 cm/ 롤스크린,63870,56850,-7020
2018-06-01,1020857941,C013010,점퍼,[시보니] 패치양털박시무스탕,127900,127900,0
2018-06-01,958515185,L012040,치약,LG 페리오 토탈7치약 오리지널 120G*3입,7900,7900,0
2018-06-01,1167315001,I012010,컴퓨터,[E]B70EV-AR75S3/7세대/i5/16G/512+1TB/키보드+마우스,1190000,1130500,-59500
2018-06-01,897529139,A015010,참기름,[오뚜기]오뚜기 고소한 참기름 (450ml),10500,10500,0
2018-06-01,895892615,A019010,고춧가루,빛깔찬 국산 고추가루(매운맛) 1kg,42900,42900,0
2018-06-01,756054430,A012010,국산쇠고기,한우꼬리반골세트 5kg 한우꼬리반골세트 한우꼬리세트,149840,134860,-14980
2018-06-01,1386720721,E041020,컵,(1+1)손잡이 유리컵/드링크자 드링킹자 유리병 빨대컵,6900,3900,-3000
2018-06-01,895892612,A019010,고춧가루,[2016년도 생산]빛깔찬 고추가루(보통맛) 500G,22900,22900,0
2018-06-01,122700827,F011150,건강기능식품,광동 위생천 75ml 100병 무료배송 식후 까스 활명수,42480,42480,0
2018-06-01,1386203937,E061040,부엌용세제,트리오 항균 주방세제 14kg,14900,14900,0
2018-06-01,1107174699,C013010,점퍼,[게스]MI2W2872 스탠카라 점퍼 (본점),75840,66220,-9620
2018-06-01,211099198,L012090,기초화장품,1+1 녹차 클렌징크림 마사지크림 클렌징티슈 중 2개,12300,12300,0
2018-06-01,464153188,C013040,청바지,PB1407 (남) 더티스크레치캣스판세미스키니 패션스키,45590,45590,0
2018-06-01,1447646778,F012050,의료측정기,(NEW)서흥 전자동혈압계/혈압측정기/혈압기/고혈압,39800,39800,0
2018-06-01,885575621,E041010,식기,방짜 유기그릇 놋그릇 면기 냉면기 찬기 공기 접시,21500,18800,-2700
2018-06-01,873623487,A013010,갈치,제주은갈치30토막/고등어/참굴비/황돔(홈쇼핑구성),59900,59900,0
2018-06-01,1069801268,E051030,디지털도어록,유가드UG-630N/UG-630D/무타공도어락/도어락/번호키,70000,59800,-10200
2018-06-01,1396246952,C013020,티셔츠,(GN)포켓기본티셔츠(28375-332-04)/ 블루독,42000,34440,-7560
2018-06-01,2059341973,E051020,건전지,1000회충전[ALLO 대용량 3050mAh 충전지 4알] AA/AAA,6270,5900,-370
2018-06-01,451001500,C013010,점퍼,남자아우터 후드 롱 패딩,85250,85250,0
2018-06-01,951358888,L021020,장신구,(실버) 니트 스틱 목걸이 (Gold Rose Gold) 포인트목,24320,24320,0
2018-06-01,732648435,C013010,점퍼,2018/여름/봄/점퍼/신사점퍼/바람막이/백화점용/,39800,39800,0
2018-06-01,1654734050,C013060,등산복,[케이투(K2)][역시즌] (행사) 케이투 k2 남여공용 헤비다운 자켓 푸키(POOKEY) KMW155,85000,85000,0
2018-06-01,2096906509,C013010,점퍼,라벨 워싱 중청자켓 캐주얼자켓 디자인청자켓 남성재,95310,95310,0
2018-06-01,1271474798,L012040,치약,2080 스마트케어 치약 x12개/구취제거/충치예방,11900,11900,0
2018-06-01,1204200427,C013010,점퍼,초경량 바람막이 점퍼ZPY2JJ1501/ 올젠,74000,59200,-14800
2018-06-01,1909611398,C011020,남자상의,칼하트 반팔 K87 블루스톤 S 남자반팔티셔츠/기본티/,28900,28900,0
2018-06-01,1644238205,A017110,감자,장흥표고_흑화고혼합세트2호건강식품 명절선물세트 특산품 추석선물세트 효도선물 표고,68350,68350,0
2018-06-01,2082559609,E021010,침구,순면차렵이불+패드+베개세트/이불세트/요토퍼,49900,49900,0
2018-06-01,982615182,E061010,세탁세제,스파크 리필(5KG/리필),8990,6500,-2490
2018-06-01,507592366,E061050,청소용세제,아스토니쉬 만능찌든때 클리너모음/곰팡이제거,8000,7900,-100
2018-06-01,958515162,A012050,소시지,CJ 브랏비엔나 540G,9980,9980,0
2018-06-01,1449081055,I012010,컴퓨터,특가81만/삼성노트북5 NT500R5M-K54A 마우스+가방,925260,879000,-46260
2018-06-01,1072520608,A021010,커피,맥심 아이스커피믹스 150T/70T/냉커피,28800,28800,0
2018-06-01,984367885,A019180,즉석식품,와인오리훈제기획 (500G*2입),19800,19800,0
2018-06-01,337355021,C011050,남자내의,여름 반바지 9900원/남자반바지/남자바지/면반바지,11900,11900,0
2018-06-01,1494721616,I031040,생화,K4Camp/캠핑 폴딩 테이블/접이식/피크닉/야외/매대,19610,19610,0
2018-06-01,894097584,C013020,티셔츠,30%쿠폰! MNC 신상 반팔티/7부티/셔츠/반바지/청바지,9900,9900,0
2018-06-01,304752181,D031010,주택수선재료,EP-10 FEC 3M 영일 UT-5000 E-7 고열페인트 언더코팅,3300,3300,0
2018-06-01,1504419903,E021010,침구,시원한 여름침구 시어서커 이불 패드 홑이불 베개커버,19900,19900,0
2018-06-01,798715553,C013020,티셔츠,LAYERED MTM GREY SHIRT /맨투맨/ 오디너리피플,67200,63840,-3360
2018-06-01,1147715475,A016030,복숭아,100% 야생 개복숭아/복숭아의 고장 청도 개복숭아 5kg,19900,19900,0
2018-06-01,122606618,A019170,냉동식품,대림 포자찐만두3kg,15300,15300,0
2018-06-01,956668205,A021010,커피,동서 카누 마일드 아메리카노 미니 (30T*0.9g),6090,6090,0
2018-06-01,77520134,I011010,TV,(공식파트너)삼성 138cm FHD LED TV UN55K5110BF,890000,679000,-211000
2018-06-01,989105899,A021010,커피,루카스나인 바닐라라떼 16.9G*30T,12400,12400,0
2018-06-01,273261668,E021010,침구,쉬즈홈 순면 차렵이불/토퍼 패드 베개/침구세트,21900,21900,0
2018-06-01,989105898,A021010,커피,루카스나인 라떼더블샷 14.9G*30T,12400,12400,0
2018-06-01,1468537203,A012010,국산쇠고기,{TV홈쇼핑정품}목우촌 한우 사골세트/꼬리반골/소뼈,79000,78210,-790
2018-06-01,1324777125,C014010,아동복,[R.ROBOT]BL)히어로7부티셔츠(18219-331-02),39000,30030,-8970
2018-06-01,385508816,C012030,여자상의,줄지배색 원피스 HM2214M805 빅사이즈,35850,33700,-2150
2018-06-01,2035406314,C011050,남자내의,어스앤뎀 남여공용 쿨 린넨 밴딩 팬츠 TBPB775EL,33150,33150,0
2018-06-01,745441404,A013020,명태,523 먹태 1kg이상10마리 속초아바이,57240,57240,0
2018-06-01,1856396103,A014030,치즈,킹스코 자연치즈100%/피자치즈 2.5kg/모짜렐라 스틱,19900,19900,0
2018-06-01,483995974,C011030,남자학생복,밀란시아 원버튼 클래식조끼 sh1201-001 남성베스트,48610,47640,-970
2018-06-01,717916096,C013030,스웨터,티티뱅크 특양면 후드 지퍼 후드짚업 특양면후드자켓,26010,26010,0
2018-06-01,774183298,A017170,풋고추,(맛나)#느티만가닥버섯(국산)2kg,14900,13410,-1490
2018-06-01,954788465,A011120,두부,[동서]동서 포스트 그래놀라 블루베리 (500G),8420,8420,0
2018-06-01,712118561,E011030,거실장,앳홈 디에나 사이드테이블 대형,19200,19200,0
2018-06-01,2139358383,C012060,여자내의,[부루앤쥬디]단추롱스커트(WGKE3SK002),29900,29550,-350
2018-06-01,378620559,L021010,손목시계,로제타 여성 손목시계 FW-16 이쁜시계 디지털시계 시,14080,14080,0
2018-06-01,1861023063,A017220,양파,흙쪽파1단/국내산/최상품/팜웨이,8500,8500,0
2018-06-01,1252462855,E031070,에어컨,[당일발송]한일 신일 천장용 선풍기 대박세일/FCR-64/16인치 천정용 선풍기 리모컨선풍,58800,58800,0
2018-06-01,2033840616,E021010,침구,여름이불 60수아사면100% 친환경/인견/리플,53000,44800,-8200
2018-06-01,1209400967,C011030,남자학생복,초경량 망사 조끼 빅사이즈 MC80 조끼 베스트 빅사이,41540,40300,-1240
2018-06-01,1368853816,A018020,사탕,대용량사탕(3+1)행사 목캔디 말랑카우 마이쮸 간식,9900,9900,0
2018-06-01,986400681,A017130,도라지,[농협청과33번] 당도높은 꿀고구마 3kg 중(한입크기),21900,15900,-6000
2018-06-01,534300881,E041010,식기,스텐 면기 모음/냉면기 탕기 대접 라면기 우동기 비빔기 그릇,5900,5430,-470
2018-06-01,972572357,A018030,껌,자일리톨 껌 5000x3통/알파+증정x3봉/츄잉껌/금연껌,11900,11900,0
2018-06-01,987318215,E061080,키친타월,코디 기름먹는 키친타올 140매×4롤×6팩,27000,15900,-11100
2018-06-01,499917273,C013020,티셔츠,[3장 13900원 특가 남자 나시] 티 여름 민소매 골지 망고 일자 기본,7900,5900,-2000
2018-06-01,1012416324,E011030,거실장,무료배송 거실장 티비다이 TV 다이 장 선반 수납선반,44900,44900,0
2018-06-01,639467357,C015030,넥타이,젠키//나비타이/주니어정장/연주/타이/보타이/주니어,990,990,0
2018-06-01,365147818,A011030,찹쌀,국산 찰보리쌀 4kg 늘보리 찰맥 압맥 보리쌀 찰보리,8900,8900,0
2018-06-01,553848255,A018050,비스킷,로아커 웨하스 클래식 37.5g 45g 7종/수입 과자/간식,650,650,0
2018-06-01,289294165,C011030,남자학생복,[라코스테 라이브] 공용 린넨 코튼 핀 스트라이프 긴,168000,157920,-10080
2018-06-01,1209400939,C013040,청바지,[Blouson]카브라 주름 린넨 반바지_[B1806PT053B],27000,24000,-3000
2018-06-01,496893242,E011060,의자,프로그 의자 학생의자 책상의자 아동의자,54900,49410,-5490
2018-06-01,7554729,E041070,밀폐용기,[홈쇼핑 정품][이젠황토 진공항아리 원형기획전] 밀폐용기/매실/매실청/매실주/매실통,25000,21390,-3610
2018-06-01,44983047,C013040,청바지,여름 청바지 여성 여자 스키니진 밴딩 스판 찢어진,15800,15800,0
2018-06-01,1387171642,A014030,치즈,네츄럴푸드 모짜렐라치즈 2.5kg/자연치즈99%,18900,18900,0
2018-06-01,453087380,I053030,복사용지,무료배송 밀크 복사용지 A4용지 80g 2BOX(5000매),46040,39600,-6440
2018-06-01,965783247,I011010,TV,공식파트너 삼성 163cm UHDTV UN65KU6250FXKR,1810000,1369000,-441000
2018-06-01,952441354,A015020,식용유,백설 해표식용유 1.8x3개/1.8x2개/포도씨유/카놀라유,9500,9500,0
2018-06-01,957645389,A013150,어묵,[CJ]CJ 부산 어묵 사각 (업소용/1KG),3990,3990,0
2018-06-01,878870278,A019060,된장,해찬들 재래식된장 (봉)(500G),2750,2750,0
2018-06-01,988899991,F012020,생리대,[정기배송]LG 바디피트 유기농순면중형 20P*2개,18000,7980,-10020
2018-06-01,988899992,F012020,생리대,[정기배송]LG 바디피트 유기농순면소형 20P*2개,16400,7980,-8420
2018-06-01,1631762758,F012050,의료측정기,녹십자 TS-7 귀체온계 녹십자 체온계+사은품선택,39000,39000,0
2018-06-01,1491012369,C012040,여자학생복,MUNSINGWEAR 반폴라 니트/여성 LL/울/스웨터/중고,25000,25000,0
2018-06-01,849731576,A013090,전복,무배 HACCP 국내산 얼리지않은 손질한 홍합 1kg,8690,8690,0
2018-06-01,20705994,L012090,기초화장품,무료 해피바스 솝베리 클렌징크림 2개-3개 선택,11800,11800,0
2018-06-01,1065655176,C021040,실내화,아즈텍 REEBOK AZTEC WL (BS5942)/ 리복,55000,45100,-9900
2018-06-01,1013938699,G011070,자전거,삼천리자전거 여성용자전거 26인치7단 시애틀레이디7,129000,116100,-12900
2018-06-01,1367443674,C013060,등산복,!! 쿨론/쿨론티/V넥반팔/쿨티셔츠/쿨티//반팔/긴팔,2900,2800,-100
2018-06-01,1010286154,A017130,도라지,[중앙일보 농마드] 해남 반시고구마 60g x 10입 (꿀  호박 선택),17000,16000,-1000
2018-06-01,2064317342,I031040,생화,[크린랩]일회용 봉투컵 4000매(1박스)생수컵 사각컵P,13900,12450,-1450
2018-06-01,1010286155,A017130,도라지,[중앙일보 농마드] 해남 반시고구마 60g x 20입 (꿀  호박 선택),32000,28500,-3500
2018-06-01,435793236,L012110,색조화장품,순한 썬크림 1+1/SPF50+ PA+++/백탁NO유분NO끈적임NO,23900,23900,0
2018-06-01,576538179,C013040,청바지,[닉스] 남성 반전 레터링 티셔츠(FNLMCTR167P),7000,5950,-1050
2018-06-01,450781682,C013010,점퍼,ZNE 트랙 탑 LS 그레이 트랙자켓 트랙탑LS 운동자켓,123510,123510,0
2018-06-01,118323242,C013050,운동복,ECO그린 친환경 에탄올워셔액/자동차워셔액/차량용품,2320,2000,-320
2018-06-01,2138592992,C012030,여자상의,셔츠배색체크원피스 PE1710 라운드넥 체크무늬원피스,76040,76040,0
2018-06-01,1780464434,L021020,장신구,[바보사랑]제이로렌 M02559 코랄데이 크리스탈 자개꽃 귀걸이,28000,28000,0
2018-06-01,1764536994,A011160,빵,국산팥100% 안흥찐빵(30개X1박스/2박스)단호박/흑미,12800,12800,0
2018-06-01,953983265,L012080,화장지,유한킴벌리)크리넥스클래식180매*6,9300,7490,-1810
2018-06-01,2128703798,C013040,청바지,폴앤제이 아동 마들렌 멜빵 청바지,37200,36800,-400
2018-06-01,1463800644,C012040,여자학생복,빅사이즈 슬림 후드 가디건,29610,29610,0
2018-06-01,1780464432,L021020,장신구,[바보사랑]제이로렌 N0804 팅커벨 나비 화이트자개 롱목걸이,38000,38000,0
2018-06-01,1440590108,C012060,여자내의,부루앤쥬디 린넨 단추롱 스커트 WGKE3SK002,29900,26910,-2990
2018-06-01,297566228,A017160,오이,[남도장터]향긋하고 쫄깃한 장흥 생표고버섯 500g,9900,9900,0
2018-06-01,520503507,A019030,생강,백초생강 (참존 1.2k) X10,45560,40550,-5010
2018-06-01,1541430266,C012040,여자학생복,[반에이크]쏠라롱가디건(VA86CDM402Z)[갤러리아],19800,17820,-1980
2018-06-01,1470539373,C011030,남자학생복,[포에버21]스트라이프 베스트/FOREVER21/조끼/베스트/니트,28900,14450,-14450
2018-06-01,1345590863,E021010,침구,겨울왕국 면기모 패드 - 뷰티선샤인 (064187) 캐릭터,63280,57640,-5640
2018-06-01,1201862184,C012040,여자학생복,[꼼빠니아][꼼빠니아] 큰꽃 5부소매 블라우스 CB7U6-WRC241_450 (P000336932),41400,37260,-4140
2018-06-01,1844169401,C021040,실내화,[락스톤] 품절대란 에스파드류 슬립온,17900,17900,0
2018-06-01,484309981,A019110,드레싱,[소스모음전]탕수육소스/돈까스/머스타드/스테이크 외,5500,5500,0
2018-06-01,421473524,E061050,청소용세제,유한아비타 20KG 수영장 정수장 용수 살균 소독약품,13000,13000,0
2018-06-01,958540148,A019110,드레싱,[풀무원]키위 저지방 샐러드소스 235G,3980,3980,0
2018-06-01,2112606832,A022010,주스,자연은 알로에 180mlx12병x4set 병음료 알로에음료,43140,43140,0
2018-06-01,1344500764,C012020,원피스,남자아우터 프린팅 트랜치 코트 가을자켓 캐주얼자켓 반코트 베이지코트 남자아우터 바,49610,44160,-5450
2018-06-01,552071317,C011050,남자내의,팀 클럽 커프 팬츠(658679050) 바지 운동팬츠 팬츠바,61010,61010,0
2018-06-01,1977766128,C013010,점퍼,루즈핏숏점퍼(SF7MJP202)/ 스테파넬,98000,83300,-14700
2018-06-01,323456694,C012060,여자내의,[바비앤펌킨]블랙문 미디스커트,85200,76680,-8520
2018-06-01,478019861,C012060,여자내의,랩형옆트임치마바지(RMTW738R21)/ 로엠,10000,9000,-1000
2018-06-01,1946289918,C013040,청바지,[BEEN]BS15PT02SB남아라이트데님(광주신세계),94400,77840,-16560
2018-06-01,1189618292,A011180,파스타면,판타넬라 14호 페투치네 스파게티면 500g (4.50mm),1400,1400,0
2018-06-01,550081102,A014010,우유,엿기름(뚜레반 1K)/가루 티백 식혜재료 보리가루,6840,6640,-200
2018-06-01,1660956409,C013020,티셔츠,반팔 기본 티셔츠 [CMM8KLL1/CMM8KLL2]/ 까르뜨블랑슈남성,35000,27300,-7700
2018-06-01,338234606,C011020,남자상의,[백화점SAY][CC콜렉트]후드형 트랜치코트 (C181MSI007),227400,186200,-41200
2018-06-01,767292863,E011020,침대,책장형수납/USB콘센트 평상형침대 양면매트리스포함,249000,249000,0
2018-06-01,190299409,E031040,전기레인지,[신일산업] 신일 차량용 냉온장고 33L SCR-S446KP 사계절용 냉장고 온장고 대용량 캠핑,168000,151200,-16800
2018-06-01,1156754299,D031010,주택수선재료,ㅇ무료배송ㅇ국산 품질인증/접착식 데코타일 11장,12900,11900,-1000
2018-06-01,2020048119,C012060,여자내의,아디다스 여성 M10 쇼트 (CE2013 ),50490,44940,-5550
2018-06-01,1780464408,L021020,장신구,[바보사랑]제이로렌 M02450 엔젤 브라운 나뭇잎 자개 드롭귀걸이,32000,32000,0
2018-06-01,1780464409,L021020,장신구,[바보사랑]제이로렌 M02449 팅커벨 나비모양 자개 드롭귀걸이,38000,38000,0
2018-06-01,1556250057,I012060,저장장치,{장패드증정행사} 앱코 K640 게이밍 기계식 키보드-,38900,38900,0
2018-06-01,1295740301,E061060,살충제,1+1 해피홈 에어넷x2개/모기기피제/모기약/모기퇴치기,20800,20800,0
2018-06-01,1780464405,L021020,장신구,[바보사랑]제이로렌 M02442 에이프릴 포도송이 골드 진주귀걸이,9600,9600,0
2018-06-01,1010347564,A014030,치즈,Lemnos 화이트치즈 180G,8900,8900,0
2018-06-01,1459603988,C012020,원피스,[올리비에스클로젯]심플 밴딩 4부팬츠_[O1804PT042B],11700,10530,-1170
2018-06-01,880630024,A011070,혼식곡,백설 찰밀가루(1KG),1930,1930,0
2018-06-01,1780464403,L021020,장신구,[바보사랑]샤인컷팅 실버 은팔찌,31000,31000,0
2018-06-01,287245614,C011030,남자학생복,[찐링] 긴팔와이셔츠 90~130 빅사이즈 남성와이셔츠,14800,14800,0
2018-06-01,1663686610,A017280,김,초생강(적색 참존 1.2k)X10,33110,33110,0
2018-06-01,432624749,E011070,식탁,커플식탁세트/의자/2인/주방/테이블/다용도/선반/수납,81900,81900,0
2018-06-01,170506960,C012060,여자내의,기모 밍크 융털 기모바지 여성 남성 밴딩 바지 팬츠,6920,6920,0
2018-06-01,1659126561,A018010,초콜릿,닥터유 에너지바 40g x 15개 트리플베리 핫브레이크,14980,14980,0
2018-06-01,1366118236,C013050,운동복,아동기모바지/아동겨울바지/배기바지/편한바지/팬츠,6000,5900,-100
2018-06-01,2123072332,E041070,밀폐용기,국산/정품/공장직판 글라스락 밀폐용기/반찬통/양념통,3000,2670,-330
2018-06-01,954850861,E041080,부엌용용구,P&Q)컬러 양면도마 (대/초록색),6500,6500,0
2018-06-01,974318133,F012010,종이기저귀,국내/빠른배송) 미국산 팸퍼스 스와들러 4단계 기저귀,72700,72700,0
2018-06-01,368014151,C014010,아동복,남아 정장 모음 ///// 양복정장/연미복/턱시도/캐쥬얼,29900,29900,0
2018-06-01,2003028363,C013050,운동복,밀리터리룩 봄 여름 반바지 반팔 트레이닝복 세트,23900,23900,0
2018-06-01,752494416,C013040,청바지,正品 구제청바지 리바이스 게스 디젤 플랙 캘빈클라인,17900,17900,0
2018-06-01,1912895543,L012110,색조화장품,(1+1)푸로루나 퍼펙션 프로텍트 선스틱/대용량/썬스틱,17400,17400,0
2018-06-01,1969134428,C011030,남자학생복,MNC 신상 셔츠/조끼/긴팔/후드/맨투맨/니트/폴라/커플,11000,9900,-1100
2018-06-01,415036950,C013040,청바지,EX 1630 청반바지 청반바지 청5부 청 반바지 남자청반,60860,59650,-1210
2018-06-01,972317211,A011130,시리얼,버터양파맛 감자튀김 시즈닝(500g)X10 가루분 식자재,79590,79590,0
2018-06-01,1349308066,A013050,오징어,펭귄 꽁치캔 (400g) x24,70710,70710,0
2018-06-01,423791999,C013010,점퍼,유벤투스 앤섬 스쿼드 자켓 트레이닝복 져지 운동복,131710,129080,-2630
2018-06-01,1197556453,A022040,기능성음료,포카리스웨트 340mlX20페트/페트음료/이온음료/음료수,9900,9900,0
2018-06-01,1250427823,C013030,스웨터,MJ_1200 아이보리 양면 양털 집업,75040,66790,-8250
2018-06-01,1471901400,L012110,색조화장품,라끄베르 UV 썬크림 SPF50+PA+++ / 4개 / 국민선크림,13900,13900,0
2018-06-01,955889891,A018040,아이스크림,더위사냥 (커피10개),20000,7000,-13000
2018-06-01,2013416334,A019040,소금,신안군 국산천일염 짠도리 10kg/20kg 1등급 천일염,10000,9900,-100
2018-06-01,985325078,A018060,스낵과자,오리온 스윙칩 볶음고추장 112G,2400,2190,-210
2018-06-01,2103460500,C015040,장갑,스마트터치 양가죽 장갑 4종 남성장갑 스웨이드장갑,37680,37680,0
2018-06-01,1703139992,C012030,여자상의,레이스원피스 쉬폰원피스 쉬폰스커트 레이스스커트,7900,7900,0
2018-06-01,62335722,C011050,남자내의,[모다아울렛][테이트]테이트남성 기본 레귤러핏 슬랙스KA7F7-MPL010,14000,13300,-700
2018-06-01,1399152963,A012060,햄및베이컨,CJ 스팸 클래식 1.81kg / 업소용스팸 / 대용량스팸,18350,18350,0
2018-06-01,2085465773,A017160,오이,모듬버섯 전골용 새송이/팽이/황금팽이/느타리/만가닥,8500,8500,0
2018-06-01,1021220071,C012060,여자내의,PBM8060 쎄무롱플레어스커트,21110,21110,0
2018-06-01,488061102,C013020,티셔츠,쉬폰 오프숄더 셔링 탑/쉬폰 믹스 플레어 프릴,19800,19800,0
2018-06-01,1194338603,C012040,여자학생복,엄마옷 데드라 8B-BL934 꽃사지스팽클인견블라우스,57300,51800,-5500
2018-06-01,1253725664,F011150,건강기능식품,커클랜드 실버 멀티비타민 430정/코스트코히트,19900,19900,0
2018-06-01,985350025,A022020,두유,[매일]매일 아몬드 브리즈(오리지널)950ML,3500,3500,0
2018-06-01,174915252,F012020,생리대,에리에르 엘리스 순수감촉 날개 대형 10P / 생리대,1900,1900,0
2018-06-01,1909348859,E021010,침구,애쉬[AASH] 100% 국내생산/쿨 리플 시어커서 침구,17900,17900,0
2018-06-01,1049428514,C013010,점퍼,[펠릭스키즈]지퍼 포인트 까슬 집업 FXJM7671,9900,9900,0
2018-06-01,1010168941,F011150,건강기능식품,네이처피아 프리미엄 아로니아진액 70ML*21포,18900,18900,0
2018-06-01,409812629,C013010,점퍼,초겨울 라이더 자켓 가죽점퍼 15_6 K2 남성집업자켓,154680,154680,0
2018-06-01,876266890,E031030,전자레인지,[SK매직] 실속형 20L 전자레인지 MWO-18M1,61590,57900,-3690
2018-06-01,1689197341,A021010,커피,맥심 부드러운 블랙 2.7g X 100T/모카골드/아라비카,11900,11900,0
2018-06-01,1010168942,F011150,건강기능식품,네이처피아 프리미엄 아사이베리진액 70ML*21포,18900,18900,0
2018-06-01,593363614,D031010,주택수선재료,우리집단장은 친환경페인트 벽지 방문 베란다 현관문,8000,7500,-500
2018-06-01,984522612,A018060,스낵과자,[해태]해태 허니버터칩 120G,2400,2400,0
2018-06-01,42703486,E021010,침구,여름 시어서커 이불세트 요커버 요토퍼 요이불세트,49500,49500,0
2018-06-01,984522611,A022020,두유,정식품 베지밀A 고칼슘 190ML*16,15180,8000,-7180
2018-06-01,660314845,I011010,TV,[LG전자]공식인증점(LG특급)LED TV 43LJ5620(벽걸이),568740,546000,-22740
2018-06-01,664155059,F011150,건강기능식품,국산헛개차 CJ 헛개수 340ml x 40병 컨디션 헛개수,18900,17580,-1320
2018-06-01,1425186130,I011010,TV,LG UHD TV 스마트 TV 43인치 49인치 55인치 60인치,549000,549000,0
2018-06-01,50855953,E011040,소파,[마리나홈/아이와비] 2인 쇼파 특가 모음전,69000,69000,0
2018-06-01,1849039191,L012030,칫솔,자일덴트 클린 미세모 칫솔 15개외,6900,6900,0
2018-06-01,378683984,L021010,손목시계,로제타 여성 손목시계 FW-15 아날로그시계 디지털시계,14820,14820,0
2018-06-01,801963615,I031070,애완동물관리비,[바볼랏] 바볼랏 테니스라켓 테니스 초보자 입문용,79000,69920,-9080
2018-06-01,1124471549,A013010,갈치,제주 옥돔(중) 2kg(마리당200g내외 선물포장) 탐라의,123500,119800,-3700
2018-06-01,2053575052,C013020,티셔츠,역대급특가! 칼카니 남녀공용 반팔/긴팔 팬츠 99종,5900,5900,0
2018-06-01,577900213,L021030,가방,F803 노트북가방 손가방 군용 전술배낭 숄더백 백팩,28300,28300,0
2018-06-01,1156766162,C012060,여자내의,[LAP][LAP] AF2WS564. 레이저컷팅 스커트,45360,43100,-2260
2018-06-01,811887466,A021010,커피,인텐소 소프트포드커피(직경66mm)낱개포장50개 파드커피/일리라바짜아이젠소카페인벤토,20000,19500,-500
2018-06-01,300572790,C012040,여자학생복,[카라]KARRA 가오리핏배색쿨니트_KBI6PO202A,43800,41610,-2190
2018-06-01,1838842495,L021060,유모차,이태리 베네지아 디럭스 유모차 사륜유모차 슈퍼조거,620000,613800,-6200
2018-06-01,745811023,A014010,우유,소화가잘되는우유 190ml x 24팩 멸균우유 매일우유,17900,17900,0
2018-06-01,961347163,E011020,침대,[잉글랜더]마네 평상형 침대/슈퍼싱글침대/매트선택,148770,148770,0
2018-06-01,1034339974,A014030,치즈,치즈(파마산 아담스 1K)X10/ 식자재 전문,116900,116900,0
2018-06-01,1171443526,C012060,여자내의,매킷 헤지 청반바지 패션파지 데님반바지 여성반바지 여성바지 반바지,16180,14410,-1770
2018-06-01,1860124741,F012010,종이기저귀,그로 헤티스와들 유아 의류 아동 실내 어린이 어린이,32980,29360,-3620
2018-06-01,1806386454,L021010,손목시계,[PRIZ RICH]프리즈리치 PR1806 여성용 팔찌시계,132000,132000,0
2018-06-01,1297262541,E021020,커튼,럭셔리 프리미엄 엔젤 캐노피 모기장,29800,29800,0
2018-06-01,1911091986,E021010,침구,국내산 사계절 이불패드세트 기숙사이불 베개세트,36900,33950,-2950
2018-06-01,1269521996,C013010,점퍼,장미자수 JP(A8MJ128)/ 에이지도르,26800,25460,-1340
2018-06-01,323841561,C021040,실내화,필맥스 맨발 신발 스킨 슈즈 가벼운 산책용 올,45000,45000,0
2018-06-01,66430246,D031010,주택수선재료,도로표지용/노면표지용/도로용/주차라인/주차선 18L,96000,96000,0
2018-06-01,499021867,C013020,티셔츠,폴로/빈폴/버버리/라코스테/반팔/티셔츠/셔츠/남방/PK티/카라티/명품 구제 초특가!!!,13900,13900,0
2018-06-01,2068276329,C012020,원피스,빅사이즈/힐링/가디건/세트 / 참고 힐링가디건세트 빅,56200,47770,-8430
2018-06-01,487288898,F012010,종이기저귀,[VIP 5%쿠폰]팸퍼스베이비드라이 점보팩기저귀1~2단계,19900,19900,0
2018-06-01,987259533,A012020,수입쇠고기,초이스엘 호주산 우 다짐용 400G,9920,8035,-1885
2018-06-01,385215226,I031040,생화,바낙스 슈퍼캐스터왕 원투 바다낚시대 PWR25 450cm,45000,41400,-3600
2018-06-01,572636335,C014020,유아복,[트윈키즈]구제데님4부바지 (M7HB9P04),16900,10990,-5910
2018-06-01,1451516648,A013070,굴,[유진수산] 해물모듬  해물전 해물스파게티 해물밥,4860,4860,0
2018-06-01,450286331,A013080,조개,왕중왕 해물나라 900g2개 해물나라 해물모듬 냉동식품,30110,27100,-3010
2018-06-01,1182618763,L021020,장신구,스키니 스태닝 반지 MV_RP_RG_BASR_BDI/ 모니카비나더(주얼리),308000,277200,-30800
2018-06-01,868899906,E021020,커튼,화이트 암막 작은창문 가리개커튼 바란스 미니커튼,16800,14540,-2260
2018-06-01,1520502708,A012050,소시지,진주 천하장사 더블링 할라피뇨치즈720g(45gx16개),18950,18950,0
2018-06-01,86471301,A018080,설탕,비정제설탕/원당(마대)15kg/매실 천연당 과일청 효소,19900,19900,0
2018-06-01,693355512,C012060,여자내의,국산/기모/바지/레깅스/겨울/여성/청바지/팬츠/스키니,14400,14400,0
2018-06-01,985207830,A013020,명태,참굴비 1.3KG내외/20미,32900,32900,0
2018-06-01,1780616490,L021020,장신구,[바보사랑]줄리아와인 초커목걸이,6900,6900,0
2018-06-01,1780616491,L021020,장신구,[바보사랑]아르젠심플 초커목걸이,5900,5900,0
2018-06-01,1780616492,L021020,장신구,[바보사랑]로랑심플하트 초커목걸이,7900,7900,0
2018-06-01,1780616493,L021020,장신구,[바보사랑]로랑심플원 초커목걸이,7900,7900,0
2018-06-01,1780616494,L021020,장신구,[바보사랑]니플심플골드 초커목걸이,9500,9500,0
2018-06-01,574634466,C014010,아동복,루니툰 후드 집업 (87419-111-50)/ 래핑차일드,15000,13050,-1950
2018-06-01,1780616495,L021020,장신구,[바보사랑]니플심플실버 초커목걸이,9500,9500,0
2018-06-01,1895467592,C012060,여자내의,[코코애비뉴][코코애비뉴]플레인훌스커트_80303,35970,34540,-1430
2018-06-01,985350061,A013100,마른멸치,[속초특산물] 속이곽찬 동해안싱싱홍게3kg(명품형),59000,42900,-16100
2018-06-01,1258859003,I012010,컴퓨터,[가온씨앤씨] 2015 NEW iMac MK442KH/A 21.5형/코어i5/8GB램/1TB하드/애플코리아정품,1778000,1778000,0
2018-06-01,197114666,C013030,스웨터,빅사이즈민짱/무배/가벼운니트모음/55-100/롱,16900,16900,0
2018-06-01,1463268584,A011140,부침가루,백설 컵케익 (쵸코) 55g x 12,19520,19520,0
2018-06-01,1806386476,L021010,손목시계,[PRIZ RICH]프리즈리치 PR1807 여성용 팔찌시계,140000,140000,0
2018-06-01,76537809,I031040,생화,코멕스 바이오 탱크 물통-베이직 /6L/10L/12L 생수통,5200,4660,-540
2018-06-01,2101550033,L012060,샴푸,트레제메 샴푸+컨디셔너 900mlX2,16900,16900,0
2018-06-01,1428777323,A017010,배추,치자(슬라이스 한진 500g)X10개/치자열매 통치자 천연염색 치자염색 노란색깔염색 말린,69950,67860,-2090
2018-06-01,896819144,A018050,비스킷,크라운 참크래커 280G,3450,3450,0
2018-06-01,1806386478,L021010,손목시계,[PRIZ RICH]프리즈리치 PR1808 여성용 팔찌시계,140000,140000,0
2018-06-01,1780616486,L021020,장신구,[바보사랑]빈티지 링 이어링 (2colors),10000,10000,0
2018-06-01,1806386477,L021010,손목시계,[PRIZ RICH]프리즈리치 PR1809 여성용 팔찌시계,140000,140000,0
2018-06-01,1780616487,L021020,장신구,[바보사랑]Make a wish Wishbone Ring,18000,18000,0
2018-06-01,1780616488,L021020,장신구,[바보사랑]리슬리진주블랙 초커목걸이,3900,3900,0
2018-06-01,1806386479,L021010,손목시계,[PRIZ RICH]프리즈리치 PR1805 여성용 팔찌시계,140000,140000,0
2018-06-01,1780616489,L021020,장신구,[바보사랑]줄리아실버 초커목걸이,6900,6900,0
2018-06-01,983460894,C014010,아동복,[게스키즈] 호일나염롱티 G65KAT041-Y2,26000,20800,-5200
2018-06-01,394871172,C013010,점퍼,캡스록 여성 초경량 바람막이 자켓(CSR-4017) 바람막,36060,36060,0
2018-06-01,986126578,A011120,두부,동서 포스트 그래놀라 크랜베리 아몬드 570G,7750,7750,0
2018-06-01,599714825,A018030,껌,오리온 더 자일리톨 61g x 8개/알뜰팩/세가지맛/껌,10880,10880,0
2018-06-01,679134892,C013010,점퍼,아동초경량 포켓바람막이/점퍼/가정의날 특가세일!!,7900,7900,0
2018-06-01,343730358,C014010,아동복,[앤디애플] 파파야루즈핏반바지,8900,7120,-1780
2018-06-01,986126580,A011100,라면,풀무원 가쓰오메밀냉소바 116G*4입,5480,4490,-990
2018-06-01,441475209,C021040,실내화,트랜디 명품 키높이 스니커즈 커플 운동화 슬립온,23900,22900,-1000
2018-06-01,1159904917,E041050,냄비,고급 세라믹냄비/인덕션냄비/냄비/냄비세트/곰솥/찜기,28000,23500,-4500
2018-06-01,1806386481,L021010,손목시계,[PRIZ RICH]프리즈리치 PR1804 여성용 팔찌시계,140000,140000,0
2018-06-01,1806386480,L021010,손목시계,[PRIZ RICH]프리즈리치 PR1802 여성용 팔찌시계,140000,140000,0
2018-06-01,1806386483,L021010,손목시계,[PRIZ RICH]프리즈리치 PR1803 여성용 팔찌시계,140000,140000,0
2018-06-01,1806386482,L021010,손목시계,[PRIZ RICH]프리즈리치 PR1801 여성용 팔찌시계,132000,132000,0
2018-06-01,1237978271,C013020,티셔츠,여름티 폴라나시 반팔티 시스루 흰티 나시티 폴라티,7900,7900,0
2018-06-01,986126583,A011120,두부,동서 아몬드후레이크 300G + 콘푸라이트 300G 기획,6650,6650,0
2018-06-01,324697549,C013050,운동복,후미 사각지대미러 후미사각지대 미러 보조룸미러 확,23910,21790,-2120
2018-06-01,586728156,E011050,책상,스마일 h형 1500 책상세트,256430,256430,0
2018-06-01,1067734987,E011050,책상,친환경 에코투명매트 식탁 책상 테이블매트 데스크,100,10,-90
2018-06-01,262361127,C013050,운동복,프론트 리어 범퍼 가드 보호대 몰딩 블랙 자동차범퍼,21590,19670,-1920
2018-06-01,1260551809,L021030,가방,신사의품격 서류가방 지갑세트,35000,32000,-3000
2018-06-01,766743483,C013050,운동복,타이어마커 카페인트 차페인트 타이어수명 타이어보,7500,7400,-100
2018-06-01,1128572456,A012030,돼지고기,비엔에프푸드 오뗄 장작통삼겹 500g/삼겹살,9350,9350,0
2018-06-01,1453538705,A012010,국산쇠고기,해인 진국사골분말500g 10개,232000,225040,-6960
2018-06-01,1628672523,I053040,기타문구,양군네 포스트잇/플래그/인덱스 모음,3500,3500,0
2018-06-01,1073349615,E031130,보온매트,TV홈쇼핑 한솔참사랑 초절전 싱글 더블 전기 온열매트,71000,69800,-1200
2018-06-01,1656340182,A022010,주스,롯데 델몬트 망고 180ml (30캔)/ 음료수 청량음료,11200,11200,0
2018-06-01,6741358,C013020,티셔츠,RUDDER 프리미엄 반팔티 M~XXXL 빅사이즈 반팔티셔츠,9900,9900,0
2018-06-01,234979377,C012020,원피스,[이사베이]면호방 노카라 트위드 자켓 (VQJAD2150)_T7L4,71000,67450,-3550
2018-06-01,2005173483,C011020,남자상의,(무료배송) AG WS 자켓508 트윌스판 테일러드 자켓 야,145250,127820,-17430
2018-06-01,867115659,L021020,장신구,실버92.5정품)히트)예쁜(HR)실버 모던 쌍가락지(소),49000,44100,-4900
2018-06-01,2143137951,I053030,복사용지,더블에이 퀄리티 A4 복사용지(A4용지) 80g 2BOX,40110,34900,-5210
2018-06-01,138698459,C012030,여자상의,[빅사이즈]청원피스/데님원피스/멜빵치마/뷔스티에,33900,33900,0
2018-06-01,1367360737,C012030,여자상의,섹시 홀복 브라끈 섹시원피스 브라스트랩 등파인원피스 드레스 원피스 파티복 브래어지,4000,3900,-100
2018-06-01,315463668,C013010,점퍼,기모캐주얼라이더자켓 MS1711 여성집업라이더자켓 라,100750,100750,0
2018-06-01,1273282411,E061030,전구,오스람 FDL 18W 삼파장 전구 장수 FDX 13W 26W 형광등,1680,1680,0
2018-06-01,1126702504,C013010,점퍼,[비투퍼폼] 무퇴(無退) -화이트 HD-03W 후드집업,95900,95900,0
2018-06-01,2137133675,A017140,콩나물,간장(우스구찌 야마사 1.8L)/rkswkdRotdlv/간장깻잎,11350,11350,0
2018-06-01,1710679220,E011050,책상,이지심플/컴퓨터책상/의자/책상/철제/콘솔책상/수납,25900,25900,0
2018-06-01,1707825524,E061080,키친타월,커클랜드 키친타올 160매 12롤/화장지/휴지/코스트코,28980,28980,0
2018-06-01,480524103,A013090,전복,장흥 득량만 키조개 생 슬라이스 관자,13800,13800,0
2018-06-01,1974731853,A022030,생수,초정탄산수 190ml x 30캔/트레비/천연사이다/맥콜,9900,9900,0
2018-06-01,2084909081,C013010,점퍼,WWS2160G 커플여자웰론후드롱패딩점퍼 /(참고)여자잠,69700,61340,-8360
2018-06-01,1715770261,L021020,장신구,원석sale/천연투어멀린/2.05ct/tourmaline,20000,20000,0
2018-06-01,1933294223,A013100,마른멸치,100% 살아있는 완도 참전복 1kg 7마리-11마리,52500,52500,0
2018-06-01,1091264434,A013170,생선통조림,[동원] 라이트스탠다드참치x15캔 + 양반 김치찌개x4봉,19900,19900,0
2018-06-01,1609214844,C015020,모자,방충모/접이식 낫/벌초/양봉/벌레/모기/모자/성묘,1900,1900,0
2018-06-01,449493471,E011040,소파,장인가구 컴피 천연면피 소가죽 4인소파/카우치형소파,699000,699000,0
2018-06-01,1037963798,E021010,침구,로라애슐리 샌드포드 시어서커 침구세트 (누비이불+패드+베개커버*2) (Q),69900,69900,0
2018-06-01,1502458832,L021010,손목시계,보헤미안 스타일 시계 팔찌 6개 깡통악세 패션 손목,53000,47700,-5300
2018-06-01,1161493105,A013090,전복,장흥무산김 3호 선물세트일반김1봉+조미김5봉+구운김5봉+도시락김5묶음김 재래김 일반,35400,35400,0
2018-06-01,531069504,C013010,점퍼,[블랙야크키즈]솔리드형태의 경량바람막이[BK실버자켓],55000,55000,0
2018-06-01,1124745163,A018050,비스킷,로투스 커피과자 300개입 外 박스판매 모음전,18900,18900,0
2018-06-01,895625524,F011120,인삼,초L)팽이버섯(한송이/봉),1000,900,-100
2018-06-01,1975737137,E031010,전기밥솥,쿠첸 10인용 전기압력밥솥 CJS-FC1004F,111000,111000,0
2018-06-01,549669547,C012040,여자학생복,꽈배기 V형 니트 여성 스웨터 캐주얼니트 V라인,31290,31290,0
2018-06-01,1935916200,E031140,비데,[블루밍]18년형 IPX-500 방수 비데 마사지 좌욕 세정,159000,159000,0
2018-06-01,2053034351,C013010,점퍼,최신형/국내산/깔깔이/깔깔이세트/깔깔이패딩/군용,15400,15400,0
2018-06-01,379249175,A017200,토마토,[하늘농가]순수국산 건가지 70gX2팩/ 롯데식품관,11900,11900,0
2018-06-01,259494371,C011050,남자내의,[TBJ] TBJ반바지 남성 면스판 5부 팬츠(T182PT580P),29900,24220,-5680
2018-06-01,308818895,F012050,의료측정기,오므론 팔뚝형 자동혈압계 HEM-7121+수첩 혈압측정기,69000,69000,0
2018-06-01,111492394,A017140,콩나물,길경농원 무농약인증 6년근 도라지조청 300g  600g,65000,65000,0
2018-06-01,1836921286,L021060,유모차,TG 2018-타보베이직 엣지 기내반입형 휴대절충형,185000,185000,0
2018-06-01,166464507,C014010,아동복,[아동흰색남방]아동와이셔츠 아동정장 남아정장 남아,27900,27900,0
2018-06-01,49827507,A016040,포도,동원)황도 슬라이스 400g x 12개 사시사철 맛있는,41360,41360,0
2018-06-01,687632848,C021040,실내화,아디다스 운동화/런닝화/스니커즈/신발,45900,45900,0
2018-06-01,1093136652,E041030,솥,PN풍년 와인펄 압력밥솥 4인용 찜냄비압력솥/가스압력,92770,92770,0
2018-06-01,1161468187,A017110,감자,장흥표고_슬라이스세트200g건강식품 명절선물세트 특산품 추석선물세트 효도선물 표고,35710,35710,0
2018-06-01,1028368541,C013010,점퍼,티비제이 유니 롱기장 항공점퍼 T171JP430P,39000,32370,-6630
2018-06-01,1609890979,E031010,전기밥솥,CRP-QS1010FS/쿠쿠/전기압력/10인용/음성/GH,162500,149370,-13130
2018-06-01,394692697,C011030,남자학생복,RFAC1004 스타일 입술포켓 슬림셔츠 긴팔와이셔츠 긴,37280,37280,0
2018-06-01,1899001626,A018010,초콜릿,킨더크리스피 킨더조이 킨더미니 특가모음전,20900,20900,0
2018-06-01,960265171,A011070,혼식곡,백설 부침용 밀가루 (1KG),1750,1750,0
2018-06-01,12709106,I031040,생화,현존최강스펙 LED라이트모음 후레쉬 등산랜턴 캠핑,30000,26780,-3220
2018-06-01,1838758627,A014010,우유,매일유업 상하목장 유기농우유 200ml 24팩 멸균우유,19900,19900,0
2018-06-01,856243575,L021060,유모차,베베앙떼 안전+디자인 초경량 휴대용유모차/시트/커버,49900,49900,0
2018-06-01,1491948664,E031120,믹서,윌파 스무디 블렌더 SB-250 쥬서기 강력한 블랜딩,26900,26900,0
2018-06-01,218368451,C014010,아동복,[붐붐키즈]바지세트/상하복/세트/단체복/츄리닝세트,11900,11900,0
2018-06-01,1060775871,C014020,유아복,[대구백화점 I관] [치크]디자인반팔에리티(CKRW18S1G),15900,14790,-1110
2018-06-01,300692619,C014010,아동복,리본끈샤원피스/쉬폰공주드레스/리본원피스/결혼식,28900,18900,-10000
2018-06-01,947713374,C013010,점퍼,덕다운/조끼/패딩/여성/경량/오리털/라이트/빅사이즈,17900,17900,0
2018-06-01,1955512259,I031010,장난감,PS4 슬림 본체 신형 2017 500GB 1TB 소니정품.,450000,450000,0
2018-06-01,567551878,C011030,남자학생복,MCD-917 빈티지 스타일 롱가디건 남성롱가디건 남자롱,48010,48010,0
2018-06-01,1180830401,C013050,운동복,4_고구마베이비 아기옷-핑크 공룡 민소매 상하세트 아,6580,6390,-190
2018-06-01,1424080717,C021020,구두,토즈 헤븐 라세토 드라이빙슈즈 XXW0FW05030 모음전,375000,327080,-47920
2018-06-01,1619293506,C011050,남자내의,냉장고 반바지 5부 여름 남성 여성 쿨바지 바다 바지,4460,4460,0
2018-06-01,1916304702,E051030,디지털도어록,무료설치 WG-200 게이트맨도어락 번호키 전자키 현관,146000,130950,-15050
2018-06-01,1444282105,C021020,구두,VA-141 남성구두 정장화 캐주얼화 캐주얼화 로퍼 남성,60820,54740,-6080
2018-06-01,168609188,C012060,여자내의,[디어제인][디어제인]세미배기9부팬츠M4284,6700,6370,-330
2018-06-01,399165541,A011030,찹쌀,보리쌀 (1K) X10,55750,49620,-6130
2018-06-01,1922309126,C013010,점퍼,New 몬스터에너지 바람막이 점퍼 자켓 스페셜 에디션,68100,68100,0
2018-06-01,1063726578,L021010,손목시계,CASIO 카시오 LTP-1165N-1CDF 여성 메탈밴드 패션시계,57000,57000,0
2018-06-01,745524260,C013050,운동복,제노바 벤트클립 컵홀더 차량 송풍구 컵받침대 거치대,6500,5720,-780
2018-06-01,311445416,L021030,가방,고퀄리티 여성 백팩/배낭/책가방/학생가방/캐주얼,14900,14900,0
2018-06-01,21124408,C013050,운동복,소낙스 워셔액 더 뷰 2L 1박스 (6개입)/에탄올워셔액/,33000,33000,0
2018-06-01,1148981398,A017230,마늘,샬롯 1kg 미니양파 (지퍼팩 포장),11800,11800,0
2018-06-01,1034340931,A012060,햄및베이컨,청정원 고소하고 바삭한 베이컨 1kg 청정원베이컨 냉,34950,34950,0
2018-06-01,1109762736,A019170,냉동식품,취영루 인기만두 3봉+군만두 증정 (총 2.24kg),14900,14900,0
2018-06-01,2145786963,I012060,저장장치,로지텍코리아 G512 RGB 기계식 게이밍 키보드,129000,129000,0
2018-06-01,960170900,D031010,주택수선재료,[던에드워드]무독성친환경페인트 약4L- 문/가구/천정/,66000,60720,-5280
2018-06-01,553167246,L021030,가방,무지 백팩/책가방/여학생/신학기/여성/여자/데일리,13000,13000,0
2018-06-01,1148486728,C013050,운동복,시크 차량용 노트북거치대 / 식사 테이블 다용도선반,11900,11900,0
2018-06-01,897532919,E061010,세탁세제,LG 수퍼타이 표백플러스(6KG/리필),23900,9900,-14000
2018-06-01,984519017,A011120,두부,켈로그 아몬드 후레이크 (630G),7980,7980,0
2018-06-01,921032153,I031040,생화,울트라서치2 초고휘도 LED 후레쉬 정품 Cree XP-L V6,41900,41900,0
2018-06-01,1293130794,C011050,남자내의,남자청바지 반배기 밴딩 조거팬츠 A0816001 워싱바지,23250,23250,0
2018-06-01,972138590,A018110,물엿,뚜레반 엿기름가루티백240g(국산),2500,2500,0
2018-06-01,959467423,E041010,식기,스텐 소스볼 소스컵 종지 앞접시 쨈볼 찬기 미니,1200,1110,-90
2018-06-01,1103037196,C015040,장갑,쟈칼 등산장갑반장갑롱장갑/라치오/마르케/토스카,5900,5290,-610
2018-06-01,2118766425,I012060,저장장치,스카이디지탈 NKEY 104키 측각 PBT 키보드 키캡,17900,17900,0
2018-06-01,1315569716,C012060,여자내의,SK1375-수술 프린징 머메이드 스커트(머메이드/스커트,43080,43080,0
2018-06-01,893074884,A019010,고춧가루,해오름 햇고추가루 1kg 매운맛 고춧가루 김치 김장,7900,7900,0
2018-06-01,592598089,C013050,운동복,안전벨트클립 모음전 자동차용품 안전밸트 클립,4660,4200,-460
2018-06-01,1647602559,A018010,초콜릿,킨더조이 20gx12개 초콜릿/킨더/킨더초콜릿,13720,13720,0
2018-06-01,320917155,C013040,청바지,생지 흑청반바지 캐주얼반바지 남자반바지 청반바지,15730,15730,0
2018-06-01,477570991,C011030,남자학생복,V.CUT(브이컷) 썸머 린넨 셔츠 3종세트,69900,68900,-1000
2018-06-01,1316605742,A013100,마른멸치,완도사랑참전복1kg(11~12미)선물용/사은품(전복죽)1개,43900,43900,0
2018-06-01,476857176,C013050,운동복,DYT 오픈져지(GLS-641) 남성의류 긴팔져지 긴팔슈트,85720,85720,0
2018-06-01,684581267,I031040,생화,피요르드 야전침대/침대의자/간이침대/캠핑,31000,28520,-2480
2018-06-01,2112887959,I031040,생화,보온보냉가방/아이스박스/도시락/쿨러백/물병골프캠핑,33000,18900,-14100
2018-06-01,987198099,A013020,명태,국산 참굴비 800G내외 (20마리/두름),9990,9990,0
2018-06-01,2001714772,C012060,여자내의,부분 펀칭 스커트-IJ6U5WQC230,35500,34080,-1420
2018-06-01,32864122,E011060,의자,[비애노]공식 정품 판매처 책상사무용컴퓨터중역 의자,49300,44370,-4930
2018-06-01,333138830,C012060,여자내의,런샵 융털안감 왕기모바지 DK-2193 기모바지 반바지레깅스 반바지기모 기모레깅스 레깅,18000,14400,-3600
2018-06-01,1512675100,C013010,점퍼,[써스데이아일랜드][AK분당점][써스데이아일랜드][18년 여름]패턴 레이스 가디건형 아,239000,227050,-11950
2018-06-01,1837023268,C011050,남자내의,[킨록by][매니져추천] 18 S/S 구김없는 데일리 쿨맥스 TR슬렉스 3종 택1 [OVP8486] J,49000,36750,-12250
2018-06-01,28783676,C014020,유아복,아둘 패밀리룩 오버룩 ROLL 후드티 유아 티셔츠 11,19100,19100,0
2018-06-01,37978109,E031010,전기밥솥,CRP-FA0621MR [쿠쿠]6인용 전기압력밥솥 ens,98900,90260,-8640
2018-06-01,597931986,I053040,기타문구,리갈패드 S노트 A4 B5 A5 프로패드 절취 노트 메모,550,550,0
2018-06-01,921298233,F012020,생리대,시크릿데이 생리대 러브 울트라 슬림 중형 16P,2500,2380,-120
2018-06-01,1269700988,C013020,티셔츠,aa12 부들 목폴라 네이비 목폴라티셔츠 목폴라 긴팔폴,14830,14830,0
2018-06-01,267500935,C021010,아동화,도티 캐릭터 아동운동화 학생신발 아동화 캐릭터신발,40500,39290,-1210
2018-06-01,1402049761,C011030,남자학생복,[탑텐]공용) 스트라이프반팔티셔츠_MSY2TS1331 MSY2TS3911 MSY2TS3912,14900,12670,-2230
2018-06-01,1180805481,C013020,티셔츠,[빈폴아웃도어]COOLHAN 한지 솔리드 칼라 티셔츠 10종 택1 (10종 택1),69300,54750,-14550
2018-06-01,271226517,I031010,장난감,(스플래쉬대셔) 라이팅로케트 물놀이소품 작동완구 물,24130,24130,0
2018-06-01,1512675076,C013010,점퍼,[써스데이아일랜드][AK분당점][써스데이아일랜드][18년 여름]레이스 블루종 점퍼 T184,329000,312550,-16450
2018-06-01,1102963156,E031080,선풍기,뉴초절전원적외선 데스크히터/액자히터 벽걸이히터 데,95990,95990,0
2018-06-01,319766769,L021030,가방,노트북가방 케이스 서류가방 삼성9 LG그램 HP 맥북,39000,39000,0
2018-06-01,1630195283,F012020,생리대,좋은느낌 좋은순면 슬림 날개 중형 18+18p(36개)x2팩,14900,14900,0
2018-06-01,546905064,A017230,마늘,특가/하와이 노니주스 946mlx3병/100%노니원액 직수입,125000,125000,0
2018-06-01,1774253484,A013040,고등어,제주 생 고등어 12마리 약3.5kg+무료손질,14900,14900,0
2018-06-01,1374112242,C012040,여자학생복,FREE 페미닌브이넥긴팔니트티,14660,14660,0
2018-06-01,226746605,L021020,장신구,92.5 실버 토우링 34종 발가락찌 발가락지 발가락반지,5900,5900,0
2018-06-01,2112606739,A022010,주스,가야농장 알로에 1.5Lx12펫 펫음료 알로에음료,51500,51500,0
2018-06-01,2126485990,C013010,점퍼,빅사이즈 폴라폴리스 자켓 MC 1210 빅사이즈잠바 빅사,86580,86580,0
2018-06-01,922352963,E061060,살충제,편백 피톤치드 4L 편백나무 원액 편백수 새집증후군,34900,34900,0
2018-06-01,1025568001,C013020,티셔츠,T691-세련된 여성 데일리 티셔츠 캘리t 롱티셔츠 라운,20140,19140,-1000
2018-06-01,394559503,L021060,유모차,[접이식 웨건]/캠핑대차/다목적카트/유아용웨건/아동용카트/캐핑카트/유아카트/,224000,224000,0
2018-06-01,2127342603,A019180,즉석식품,CJ 비비고 사골곰탕500gx10팩,12900,12900,0
2018-06-01,1838771521,D031010,주택수선재료,[10+1풀바른벽지]광폭합지(폭93cm)/포인트/도배지,1000,1000,0
2018-06-01,1922309054,C012040,여자학생복,봄신상 체크/솔리드/블라우스/레이스/여성셔츠/데일리,10900,9900,-1000
2018-06-01,532262486,C012030,여자상의,여름 나시원피스/쉬폰/롱/끈/플라워/비치/반팔/민소매,26800,26800,0
2018-06-01,747417423,C011030,남자학생복,겸용조끼 양면 MC 92 빅사이즈,61770,59300,-2470
2018-06-01,733012546,A019060,된장,해찬들 우리재료로 만든 국산 된장(900G),11480,11480,0
2018-06-01,1862014817,A013170,생선통조림,[사조해표]사조참치(안심따개) 100g x 10캔,11800,11800,0
2018-06-01,379577622,C014020,유아복,순면 여자 아이 아동 어린이 여아 민소매 나시 반바지,10440,10440,0
2018-06-01,282125777,C012060,여자내의,[ab.plus][ab.plus] 버튼장식 체크 미 스커트 (LSR4MS54A),41200,35020,-6180
2018-06-01,2056241378,I053010,공책,GT 모닝 초등 3-6 알림장 좁은칸 여 어린이알림장 여,5230,5230,0
2018-06-01,1351565637,A017220,양파,[무료배송] 냉동 식품 삼아 아시아 냉동 아스파라거스,78680,67670,-11010
2018-06-01,1383865720,A017010,배추,황생원 2017년 생강 1kg,7000,7000,0
2018-06-01,724418585,C011030,남자학생복,BIG803 남자빅사이즈빗살니트가디건 빅사이즈,58580,56830,-1750
2018-06-01,895649421,A017180,호박,뉴질랜드 단호박(통),3990,2490,-1500
2018-06-01,209087696,A022010,주스,[롯데칠성 델몬트 망고 240ml x 30캔] 과즙음료/망고주스/과일주스/1박스포장/온가족건,38400,37250,-1150
2018-06-01,1201585579,C012060,여자내의,[하프클럽/막스까르띠지오]큐빅 글리터 포인트 밴딩팬츠,94000,94000,0
2018-06-01,1352647110,C014010,아동복,트로피컬 앞치마세트 유치원앞치마 아동 앞치마,21980,21980,0
2018-06-01,1529650034,C013020,티셔츠,[바람난신디] 30%쿠폰 롱티셔츠/빅사이즈 여성의,12900,12900,0
2018-06-01,1694269640,C013020,티셔츠,투톤 포인트 카라 티셔츠 ZAX2TT1102_LI/ 올젠,35000,28000,-7000
2018-06-01,1266076380,C012060,여자내의,jj42 꽈배기니트 미디스커트_진그레이 스커트 미디스,14000,13860,-140
2018-06-01,475100473,C013010,점퍼,쭈리야상점퍼[AFS2UU04E]/ 에이비에프지,139000,125100,-13900
2018-06-01,924034290,E011010,장롱,까사미아 까사온 9자/10자/장롱/장농/옷장/초특가,555000,499000,-56000
2018-06-01,1654991882,E061100,습기제거제,1+1 써니버블 보송보송 제습제30gx20개/습기제거제,13800,13800,0
2018-06-01,456088150,I031070,애완동물관리비,몰텐/폭스40/아이워너/전자/호루라기/호각/휘슬,15000,13280,-1720
2018-06-01,922146823,F012010,종이기저귀,[하기스]하기스 보송팬티 드라이 기저귀 4~6단계 4팩구성,28900,28900,0
2018-06-01,686375542,E011040,소파,코쿤 C107 소형 빈백/ 키즈빈백/어린이빈백 쿠션/소파,59900,59900,0
2018-06-01,1111546781,C012030,여자상의,여름신상!우리가족 커플룩!,6500,6500,0
2018-06-01,570128799,A017140,콩나물,도라지배즙 기관지에 좋은 음식/배즙만들기/도라지차,42900,42900,0
2018-06-01,1490335775,E041030,솥,PN풍년 컬러쿡 압력밥솥 4인 6인 정품 패킹추가 증정,55900,54900,-1000
2018-06-01,7023301,A011160,빵,네니아 친환경 단호박찐빵 400g,8500,8500,0
2018-06-01,888348636,L021030,가방,[레니앨리스] 천연소가죽가방 여성가방 가죽가방 백팩,69800,69800,0
2018-06-01,501635434,A016110,딸기,세미원 냉동 딸기 1kg 2개,25480,25480,0
2018-06-01,1488729797,A012010,국산쇠고기,[무항생제] 사골 2kg 1등급,41000,41000,0
2018-06-01,355177704,C012040,여자학생복,캐쥬얼한루즈핏니트(N182KSK016)/ 나이스클랍,239000,215100,-23900
2018-06-01,895892558,A018060,스낵과자,해태 초코홈런볼(46g),1290,1290,0
2018-06-01,314108364,C012060,여자내의,티셔츠 스트라이프 리본 A라인 스커트세트 리본스커트,24820,24820,0
2018-06-01,895892557,A018060,스낵과자,[해태]해태 맛동산(85G),1300,1300,0
2018-06-01,925581307,A011110,당면,잔다리 국산콩100% 콩국수용 콩물 320g 5팩,13400,13400,0
2018-06-01,895892555,A018060,스낵과자,[해태]해태 초코 홈런볼 (46g*4),4800,4800,0
2018-06-01,1055662590,A013170,생선통조림,[동원] 라이트스탠다드참치 150g x 10캔,19900,19900,0
2018-06-01,570789381,C012040,여자학생복,여성 롱 니트 KKS 소매 패치,80890,80890,0
2018-06-01,443575732,A011180,파스타면,스파게티면(12번 데체코보라 1K)X12,113290,113290,0
2018-06-01,700474108,A019070,양념소스,뉴그린푸드 파우치13종/소스/식자재/업소용/,8500,8500,0
2018-06-01,427084971,C014010,아동복,[ASK주니어]여아 다이마루 3부 데님 JA2ZDS360FL,19000,16150,-2850
2018-06-01,69433704,C015030,넥타이,볼로타이/타이슬링/댄디075 컬렉션/수제 클루아조네 쥬얼리/남자/친구/아버지/아빠/교,59000,59000,0
2018-06-01,1874096183,C013050,운동복,에탄올워셔액/천연발효에탄올/출시기념/최저가/1.8Lx6,10800,10500,-300
2018-06-01,1590394442,E011040,소파,조은가구 모하비 카우치소파(3인용+카우치)/4인용쇼파,398000,353700,-44300
2018-06-01,1906863555,A012010,국산쇠고기,한우잡이/한우사골세트3kg(거세우)/고급실속형,27800,27800,0
2018-06-01,1786022318,A021010,커피,그린커피빈 베트남 커피 가루 클로로 겐산 원두 콩 차,30900,30900,0
2018-06-01,632001104,C013010,점퍼,야상 빅사이즈 딜러자켓 BW 빅사이즈,95420,92560,-2860
2018-06-01,537291757,C012060,여자내의,[반에이크]큰꽃스커트(VA85SKM313Z)[갤러리아],29800,26820,-2980
2018-06-01,1389203379,A018090,잼,트라피스트수녀원 유기포도잼 410g 포도잼 과일잼,17590,17590,0
2018-06-01,463620084,C011020,남자상의,레드 체크 밍크털 코트 캐주얼코트 털코트 남성용코트,111770,111770,0
2018-06-01,2125570538,C014010,아동복,듀크솔리드래쉬가드세트 외 래시가드 18종 (CBH2SS401S)/ 크록스(키즈),39500,35550,-3950
2018-06-01,1661550638,D031010,주택수선재료,붙이면 끝! 만능풀바른벽지 풀바른실크벽지 폭106cm,7400,7400,0
2018-06-01,1581503200,C013040,청바지,기본데님 HKTJ8110I1 NC아울렛,12900,9000,-3900
2018-06-01,984341130,A012020,수입쇠고기,E-호주산 곡물우 갈비살 (구이용/100G),4980,4480,-500
2018-06-01,553968154,C021040,실내화,나이키 운동화/조던/에어포스/코르테즈/컨버스/신발,37800,37800,0
2018-06-01,987318377,A013140,북어채,[바다원]구운 오징어채 (얇은) 150g,10700,10700,0
2018-06-01,804783325,E031090,공기청정기,(s3)위닉스 공기청정기 타워 XQ500 ATXH593-HWK,459000,459000,0
2018-06-01,1257430452,C011020,남자상의,레드 체크 밍크털 코트 남성용털코트 캐쥬얼코트 남성,102370,102370,0
2018-06-01,663521932,A016100,수박,델리참_국산가당딸기퓨레 1kg x 10개입 / (주)남양냉,82600,70210,-12390
2018-06-01,1240840161,C014010,아동복,[래핑차일드] 디즈니 윈드브레이커 (88329-110-51),29000,23780,-5220
2018-06-01,1316737596,C012040,여자학생복,[위쉬몰][위쉬몰]BG 레이디리본블라우스(2018H805),40320,34280,-6040
2018-06-01,1572310602,F012020,생리대,유기농 그날엔순면 생리대 중형 16p x3팩 + 사은품,15000,15000,0
2018-06-01,1313941956,C012060,여자내의,[디어제인][디어제인]SXXL사방스판 얼음보다시원 아이스밴딩팬츠M4485,7700,7320,-380
2018-06-01,1718194933,C014010,아동복,아동남방/여아롱셔츠/청남방/흰남방/여아셔츠/가디건,17900,17900,0
2018-06-01,710661859,E011060,의자,국내생산/기능성/실속의자/컴퓨터책상의자/학생사무용,21900,19710,-2190
2018-06-01,724382192,I011020,영상음향기기,뷰소닉 PX747-4K 밝기3500 UHD고해상도 빔프로젝터,2073000,2073000,0
2018-06-01,1311794960,L021020,장신구,블랙 썸 초커 목걸이 10대 협찬 30대 겨울 큐빅 여름,11290,11290,0
2018-06-01,1312986843,C013010,점퍼,[지이크] (PQM6002M6003) 봄 여름 얇은 항공점퍼 블루종4종,140000,112000,-28000
2018-06-01,2015410549,A018020,사탕,[네슬레]싱글폴로 개별포장 폴로사탕 민트 캔디 후식,9800,9800,0
2018-06-01,620924432,L012060,샴푸,(신보부상) 레브론샴푸 or 린스/FLEX/2개중택1/발삼,4900,4900,0
2018-06-01,2047069973,C015040,장갑,랜드스케이프_모장갑W(여성용) 모직장갑 보온장갑 방,16470,16470,0
2018-06-01,1399768949,C015040,장갑,양가죽 무스탕 벙어리 여성장갑 예쁜장갑 양가죽장갑,26080,26080,0
2018-06-01,944883745,A013100,마른멸치,완도활전복 특대 15미(4-5년산),59900,56900,-3000
2018-06-01,973733869,E031040,전기레인지,SK매직 레트로 소형냉장고 RFG-KE09501BL(1등급/미니),379000,379000,0
2018-06-01,422393523,C013010,점퍼,리즈 떡볶이 더플코트 SD-6137,31410,31410,0
2018-06-01,1354364872,C013020,티셔츠,심플 후드집업 LTT0042 여성후드집업 트레이닝복,30210,29610,-600
2018-06-01,1213283631,C012040,여자학생복,[기비/키이스][블룸스버리]라운드넥 니트T_B8MT4K3,148000,148000,0
2018-06-01,1512675074,C013010,점퍼,[써스데이아일랜드][AK분당점][써스데이아일랜드][18년 여름]셔링 볼륨 블루종 점퍼 T,239000,227050,-11950
2018-06-01,396137198,C011050,남자내의,어스앤뎀 남성 8부 슬림 팬츠 TBPA770,12210,12210,0
2018-06-01,1315462939,L021050,우산,일회용우의 일회용우비 비닐우의 우의 우비 비옷 비닐,340,340,0
2018-06-01,1803856575,I031010,장난감,유아붕붕카 랜드로버붕붕카 벤틀리붕붕카 벤츠붕붕카,29400,29400,0
2018-06-01,700535516,A017220,양파,대파모종 1주(1포트)/다농 새론흑외대파 품종,300,300,0
2018-06-01,1428800165,C015030,넥타이,공장도매 당일발송 신상 넥타이 방송협찬 자동 수동,2750,2750,0
2018-06-01,1720255820,I053010,공책,캘리그라피 드로잉 연습용 무지 노트 연습장/A5 크기,3400,3300,-100
2018-06-01,49960265,C011050,남자내의,XL~4XL 빅사이즈 아이스 쿨팬츠 아이스티셔츠,12900,12900,0
2018-06-01,409753826,A015020,식용유,알폰스 프리미엄 해바라기씨유_500ml 4P (신형),97700,95750,-1950
2018-06-01,748551401,A013070,굴,(살아서 도착) 대게 3마리 박달대게/영덕대게/포항대,94850,94850,0
2018-06-01,1779512980,L021020,장신구,[바보사랑]CROSS BRC,21000,21000,0
2018-06-01,1779512982,L021020,장신구,[바보사랑]WIDTH PENDENT NEC,23000,23000,0
2018-06-01,1779512981,L021020,장신구,[바보사랑]CIRCLE BRC,25000,25000,0
2018-06-01,1779512984,L021020,장신구,[바보사랑]CROSS NEC,23000,23000,0
2018-06-01,1779512983,L021020,장신구,[바보사랑]ZIPPER TAG NEC,23000,23000,0
2018-06-01,1779512985,L021020,장신구,[바보사랑]CIRCLE NEC,27000,27000,0
2018-06-01,1806421230,L021020,장신구,[바보사랑]데일리 귀걸이 6종 세트 25번,6320,6320,0
2018-06-01,797405692,L021030,가방,[질스튜어트ACC]핑크 로고포인트 가죽 쇼퍼백(JABA8E813P2),295200,236160,-59040
2018-06-01,1806421235,L021020,장신구,[바보사랑]작은 하트 언발란스 드롭귀걸이,12900,12900,0
2018-06-01,109154923,C011030,남자학생복,[지오다노]여 기본 목넥 래쉬가드 327570,15000,12000,-3000
2018-06-01,2128955523,A013130,오징어채,* 한정특가 * 국내가공 진미채 1kg [무료배송],23500,23500,0
2018-06-01,1109701801,C012030,여자상의,실루엣플라워롱ops/롱원피스럭셔리원피스/원피스..,10900,10900,0
2018-06-01,785671199,A013060,게,다용도 완전 손질 오징어다이스500g 라면 볶음밥 등,5900,5900,0
2018-06-01,746783799,C013020,티셔츠,30%쿠폰! 플루크 남여 반팔티/티셔츠/오버핏/반바지,10900,10900,0
2018-06-01,1581770395,I031040,생화,SOS 긴급 구호세트 안전용품 캠핑안전용품 캠핑편의용,23720,21620,-2100
2018-06-01,428937863,E021020,커튼,[세진아트]초내한용으로 냉동창고에 설치하는 비닐커튼/바람막이/보온/냉온/비닐커텐/,95000,87310,-7690
2018-06-01,1010406248,A011140,부침가루,[나폴레옹] 건쿠키세트 3호(4종),37000,35000,-2000
2018-06-01,988246604,A018060,스낵과자,농심 바나나킥 75G,1200,1200,0
2018-06-01,988246603,A018060,스낵과자,농심 조청 유과 96G,1200,1200,0
2018-06-01,989139310,F011150,건강기능식품,GNM자연의품격 순수한 유기농 케일사과즙 1박스,19200,19200,0
2018-06-01,2074106164,C013050,운동복,안전벨트 클립 세이프티클립 가드 띠 어린이 유아,11400,11400,0
2018-06-01,90894950,C012060,여자내의,티렌(Thyren)T171MSD003 여성스러운 플리츠 스커트,79000,68730,-10270
2018-06-01,1365897106,A014020,분유,니플(젖꼭지) 사이즈 S M L,1200,1200,0
2018-06-01,1619122107,C013010,점퍼,마크 스포츠 무지 바람막이 빅사이즈 MK1001_100 단체복 행사복 초경량 바람막이 빅사,60380,53740,-6640
2018-06-01,2110410089,A017140,콩나물,싱싱한 국산 약도라지1kg/소/중/나물용/더덕500g,6000,5900,-100
2018-06-01,464462010,A019100,식초,타임분 은진물산 350g / 타임 가루 Thyme Ground 백리,7200,7200,0
2018-06-01,1579131661,L021060,유모차,에코다 탭 2.0 절충형 기내반입 유모차(리퍼상품 한정판매),85000,85000,0
2018-06-01,869705969,C011030,남자학생복,[버커루]남성용 피그먼트 헨리넥 반팔 티셔츠(B172TS250P),13500,10800,-2700
2018-06-01,1999891779,I053040,기타문구,묶음상품 3M)포스트잇 팝업리필(KR-330 화이트 라인)2,56770,56770,0
2018-06-01,956668183,A021010,커피,동서 카누 다크 미니 아메리카노 (30T*0.9G),6090,6090,0
2018-06-01,1779512979,L021020,장신구,[바보사랑]WIDTH PENDENT BRC,21000,21000,0
2018-06-01,1354327903,C011030,남자학생복,[빈폴골프] 여성 네이비 두잉 베스트 (BJ8236A03R),298000,238400,-59600
2018-06-01,1806421228,L021020,장신구,[바보사랑]꽃송이 러블리 드롭 귀걸이,11920,11920,0
2018-06-01,563638140,C021020,구두,펌프스 하이힐 여성구두 스웨이드 힐 7.0cm 225 265mm,18120,18120,0
2018-06-01,322120778,C012040,여자학생복,여름에는 린넨남방 시원한 여름신상 린넨 셔츠/남방,14800,14800,0
2018-06-01,287186767,A014040,발효유,[CJ제일제당] 투썸 요거트 파우더 320g,4990,4640,-350
2018-06-01,265280541,A013130,오징어채,[장수왕] 가문어소가루1kg/식자재/가문어/반찬용,7900,7900,0
2018-06-01,487950505,C013040,청바지,(SR)MHA700 남자기모빅사이즈스판기모본딩청바지 기모,47980,47980,0
2018-06-01,750636340,C013020,티셔츠,[MLB]남여공용 스몰로고 후드 티셔츠 31MTN1711,44500,37830,-6670
2018-06-01,1415782492,E061010,세탁세제,울샴푸 아웃도어 리필 1000ml x2개/중성세제,11500,11500,0
2018-06-01,704575945,A017210,파,[5kg 9 900원] 자연수정 완숙토마토 3kg/5kg,7500,7500,0
2018-06-01,1222503416,E021010,침구,[슈에뜨룸]인견 이불토퍼세트/여름이불세트/침대패드,42900,42900,0
2018-06-01,839624004,C012060,여자내의,빅~3XL 신상 슬랙스 와이드,16900,16900,0
2018-06-01,562664436,A019100,식초,흑후추홀 통 맛미 태산 500g/통흑후추,12450,12080,-370
2018-06-01,989967731,A018090,잼,청우 통팥 빙수 스파우트 300G,4480,3990,-490
2018-06-01,989967732,A018090,잼,청우 통팥 빙수 스파우트750G,8980,7490,-1490
2018-06-01,1818837284,E041050,냄비,테팔 티타늄 쏘옵티말 편수냄비 16cm,30240,30240,0
2018-06-01,48214573,C011030,남자학생복,[앤듀]O172SH440P 남성)헨리넥 패턴린넨 7부SH,19000,15580,-3420
2018-06-01,1489193431,C013020,티셔츠,여름티 반팔티 흰티 나시티 롱티 민소매 여자티셔츠,7900,7900,0
2018-06-01,383830884,C011020,남자상의,빅사이즈 28~46 봄 여름 정장바지 슬랙스 남자 바지,19800,19800,0
2018-06-01,794209308,E041050,냄비,경질/전골/냄비/팬/해물탕/매운탕/찜/세트/주방/업소,9900,9900,0
2018-06-01,1092444391,A019110,드레싱,버나드 메이플시럽 250ml,10400,10400,0
2018-06-01,451520907,C013030,스웨터,MJ_1201 베이지 양면 양털 집업 여자집업 남자집업 집,65980,65980,0
2018-06-01,75642834,E041030,솥,정품 풍년압력솥 고무패킹 패킹 풍년압력밥솥 압력솥,3500,3500,0
2018-06-01,141294232,A019060,된장,[풀무원] 국산콩 나또 4종 골라담기(99gx12개),26900,26900,0
2018-06-01,686770062,E041020,컵,소담 핸드프린팅 예쁜 머그컵 머그잔,4000,3800,-200
2018-06-01,1159419359,E041010,식기,[르크루제][소르베컬렉션] 원형접시 15cm 4P세트(본점),78000,74100,-3900
2018-06-01,1806421202,L021020,장신구,[바보사랑][실버] 앰버 목걸이,18000,18000,0
2018-06-01,913112381,C012060,여자내의,[스파오(SPAO)](QR) 벨티드 4부 스커트_SPWH823G82,29900,29900,0
2018-06-01,1806421200,L021010,손목시계,[바보사랑]에테르넬 시계,52000,52000,0
2018-06-01,470700908,C021010,아동화,여름운동화 아동운동화 여아운동화 아동슬립온 아동화,9900,9900,0
2018-06-01,1751433563,F012010,종이기저귀,[추천]베베몬 시즌2 밴드/팬티기저귀 2팩/3팩/4팩,21800,20900,-900
2018-06-01,124327433,A012050,소시지,[쟌슨빌]A.냉동 스모크/B.냉동 베다체다 1810g-택1,27900,27900,0
2018-06-01,2115693539,A014050,달걀,HACCP 깐계란/깐메추리알 10+1/구운계란/훈제달걀,990,990,0
2018-06-01,1717641936,I031010,장난감,'LEMILLION' 유아용전동차/2016최신모델/최고인기/완,573010,573010,0
2018-06-01,985026352,C011050,남자내의,[필골드] YS3081 기모GROUND 트레이닝팬츠,22800,22800,0
2018-06-01,988246610,A019180,즉석식품,CJ햇반 컵반 직화볶음짜장덮밥 280G,2580,2380,-200
2018-06-01,209254170,A012050,소시지,HACCP 수제소시지 1kg / 콘 불고기 청양 소세지,5900,5900,0
2018-06-01,795520147,C014010,아동복,윌슨 반팔 트레이닝복3종세트(반팔티2+반바지1)30T3S,29800,29800,0
2018-06-01,450286298,C011030,남자학생복,PTU2075M 커플남자패딩조끼베스트,19460,19460,0
2018-06-01,651365778,I031070,애완동물관리비,[윌슨] 112sq 295g 입문자용 초급자용 매치포인트 테니스라켓,47000,46530,-470
2018-06-01,989967756,A018090,잼,청우 후레쉬미니제리 200G,2480,1990,-490
2018-06-01,989967757,A018090,잼,청우 빙수떡 골드 250G,3480,2990,-490
2018-06-01,989967758,A018090,잼,청우 NEW샤벳꽁꽁 1KG,6480,5990,-490
2018-06-01,611690870,C013010,점퍼,아르크네 양털 무스탕 DM-4044-양털무스탕자켓 양털,20790,18510,-2280
2018-06-01,2130113707,C012040,여자학생복,[갖고파]흰남방/무지셔츠/오피스룩/블라우스/봄/여성,12900,12900,0
2018-06-01,712202468,A021010,커피,2만원 이상 무배/돌체구스토/돌체구스토캡슐/사은품,9880,9880,0
2018-06-01,1534140284,A018010,초콜릿,자유시간 20개 크런키바 20개 가나초코바 연양갱,11900,11900,0
2018-06-01,1926593990,F011150,건강기능식품,세노비스 Advanced 트리플러스(90캡슐/45일),33900,33900,0
2018-06-01,1652999328,A014030,치즈,코리원/썬리취 레드 체다 모짜렐라 치즈 2.5kg/PRCH,24500,24500,0
2018-06-01,2037967956,E021010,침구,쿨~시어서커 여름이불/패드/이불세트/요토퍼,24900,24900,0
2018-06-01,1494914914,A011170,떡,[총각네] 영양찰떡 세트 (현미영양찰떡10개  흑미영양찰떡10개),25000,25000,0
2018-06-01,461871532,C012060,여자내의,#NAME?,34750,33710,-1040
2018-06-01,526773586,A021010,커피,NEW 까페리얼 아이스커피 230mlx10/액상커피/아이스티,5500,5500,0
2018-06-01,364613444,A019160,밑반찬,[김치르본]제대로 숙성시킨 홍어김치/40년전통 전라도식 남도김치/영산포/홍어/포기/김,23800,23800,0
2018-06-01,988246643,L012080,화장지,[유한킴벌리]크리넥스 미용티슈 클래식숲속향 200매*6입,10400,10400,0
2018-06-01,254333652,C013040,청바지,[리틀브렌]블루 데님 LBTJ18S07,19900,19900,0
2018-06-01,710791380,A019060,된장,해찬들 재래식 된장(1KG*2개입),7990,7990,0
2018-06-01,478597550,C013020,티셔츠,여름 남성 반팔 카라티셔츠 골프웨어 단체티 중년의류,22000,19410,-2590
2018-06-01,472205006,C011050,남자내의,K2 클래식 카고바지 빅사이즈,73590,73590,0
2018-06-01,718014551,C013050,운동복,아디다스 나이키 푸마 트레이닝복 세트 단체 츄리닝,39000,39000,0
2018-06-01,631173710,C012020,원피스,[케네스레이디]러블리 카라배색 패턴 원피스[EGOPIE9300](대구신세계),139000,112720,-26280
2018-06-01,451111803,A015010,참기름,해정원 고소한 들기름(병) 350ml2개 기름 들기름 고소,24630,22170,-2460
2018-06-01,989967760,A018090,잼,청우 씨앗빙수떡 350G,5480,4990,-490
2018-06-01,1570030672,F011150,건강기능식품,[CJ제일제당] CJ(냉장) BYO 멀티유산균 2g 30포 (30일분)피부유산균,20800,20800,0
2018-06-01,1320688400,E061060,살충제,에코 올_킬 바퀴겔 250g 바퀴벌레 바퀴약 해충제 해충,34700,34700,0
2018-06-01,399102018,A018100,꿀,잡화꿀 (다드림 500g) X20,131250,116820,-14430
2018-06-01,898380650,A019010,고춧가루,고품질 중국산 햇태양초 수입 고추가루 청양 고춧가루,7900,7900,0
2018-06-01,1051719056,E041020,컵,보르미올리 정품 드링크자/미국직수입 볼메이슨 드링킹자/유리병/컵/머그컵/머그잔/텀,1800,1800,0
2018-06-01,2112606702,A022010,주스,자연은 알로에500mlx20펫 펫음료 알로에음료,41220,41220,0
2018-06-01,604386860,F012030,안경,(2+1 모자증정) 패션 안경테 선글라스 안경 뿔테 철테,6500,5900,-600
2018-06-01,734169599,I031040,생화,키친아트 보온병/보냉병 원터치 골드메탈 템블러,7900,7900,0
2018-06-01,785274490,E021020,커튼,[아로마향파리문발]파리문발/자석문발방충망/방충망/모기장/현관문모기장/창문발/아로,8400,8400,0
2018-06-01,345035869,C013050,운동복,W모양 2종 차량용 도어가드 4P차문보호/ 미니도어가드 카도어가드 자동차도어가드몰딩,4800,3700,-1100
2018-06-01,1355355981,I031010,장난감,소니 정품 플레이스테이션4 Pro + VR 패키지 당일발송,1348980,1348980,0
2018-06-01,324548002,C013040,청바지,[빅브라더]청바지32~46 빅사이즈60종/면바지/기모바지,27010,27010,0
2018-06-01,2096882640,C011030,남자학생복,FSSF18033 블루 선염 도비 셔츠 정장셔츠 기본남성셔,38000,37620,-380
2018-06-01,1211282727,C013050,운동복,[중국] GT 토드 다용도 트렁크 콘솔박스 0749 수납함 공간박,16010,14590,-1420
2018-06-01,1429776056,C013010,점퍼,[리스트][리스트(LIST)] 트위드 배색 스타디움 점퍼 TWJKE11170,18000,17100,-900
2018-06-01,2057783458,A011170,떡,3대장인의 130년 전통 황대규옹 떡메찰떡 모듬 5종세,66230,66230,0
2018-06-01,1806421258,L021020,장신구,[바보사랑]지그재그 언발란스 크리스탈 귀걸이,14900,14900,0
2018-06-01,417747060,C011030,남자학생복,남자셔츠 스트라이프 롤업 헨리넥 셔츠 J0416012 남성,29690,29690,0
2018-06-01,898665903,A016130,키위,초L프레시)참살이실속배 (3~5입/봉),6990,6990,0
2018-06-01,396465648,E061020,섬유유연제,샤프란 섬유유연제 용기 2.1L x 6개 외,13900,13900,0
2018-06-01,918706517,L021030,가방,[레니앨리스] 따스한 날엔 밝은 가방으로!! 여성가방,15800,15800,0
2018-06-01,2040580205,C013020,티셔츠,[게스키즈]이월)펄삼각패밀리티셔츠(G63KDT011-B3)[갤러리아],15000,11550,-3450
2018-06-01,1979432640,C021040,실내화,여름 운동화 /트래킹화/등산화 /K2쿨토시/아쿠아슈즈,14900,14700,-200
2018-06-01,988246666,F012020,생리대,[LG]LG) 쏘피 한결 라이너 무향롱 40P,4500,4500,0
2018-06-01,988246665,F012020,생리대,[LG]LG) 쏘피 한결 라이너 무향 일반 48P,4500,4500,0
2018-06-01,2001787630,A011030,찹쌀,쌀보리 (농협 1K) X10,65790,58560,-7230
2018-06-01,1320007810,C011030,남자학생복,흰색 와이셔츠]하얀색 흰셔츠 남성 화이트 반팔 긴팔,10000,10000,0
2018-06-01,591188128,L021060,유모차,시크포베이비 유아웨건 위고웨건플러스 가죽핸들커버,15000,15000,0
2018-06-01,976085639,C013050,운동복,그랜드카니발-미르웨이 후사경/4WD/RV용품/사각지대/후진주차/현대/기아/대우/쌍용,27000,24600,-2400
2018-06-01,409345200,F011150,건강기능식품,[엄마사랑] 검은콩 미숫가루 600g 국산100% 밥선생,9900,9900,0
2018-06-01,988187867,A016060,감,DOLE 후룻볼 슬라이스(복숭아) 198G,1990,1990,0
2018-06-01,1709383894,I031040,생화,CREE L2 1300정루멘 줌 후레쉬 충전식 LED랜턴 손전등,30000,22380,-7620
2018-06-01,2140734119,I012010,컴퓨터,(T)LG 데스크톱 PC Z70EV-AR7P16 윈도우10 G4560,580950,549000,-31950
2018-06-01,464275431,I031040,생화,[블루앤피쉬] 나노카본 레베즈 전천후낚시대 /루어대,33000,31350,-1650
2018-06-01,598915946,C013020,티셔츠,여자면반팔티/나시원피스/민소매/남방/롱후드/박스,10000,9000,-1000
2018-06-01,76212865,C013010,점퍼,양털컬러무스탕,82900,82900,0
2018-06-01,480762203,A017250,고사리,(맛나)#브로컬리(경매.국산)8kg,76000,68400,-7600
2018-06-01,243605779,E011050,책상,오플로어 W120~160cm h형 책상세트 9종 시리즈,126000,126000,0
2018-06-01,1796520737,F012010,종이기저귀,[에코제네시스 프리미엄기저귀]밴드형 / 팬티형 - 4팩,67900,67900,0
2018-06-01,878870184,A019060,된장,ⓒ 해찬들 재래식된장(1KG),3100,3100,0
2018-06-01,391979765,A019060,된장,된장(메주 신송 14K) 된장 재래식된장 식자재 업소용,61750,55580,-6170
2018-06-01,1881078601,C012060,여자내의,[플라스틱아일랜드][예약][6월16일순차배송][18 여름]프린트점프수트팬츠(PJ2WP565)[갤,79000,63200,-15800
2018-06-01,900511213,A018060,스낵과자,[롯데]롯데 칸쵸 컵 (95G),1650,1650,0
2018-06-01,1352173588,I031040,생화,코스모스 아이스박스 레저 낚시 캠핑 쿨러백 보냉팩,34200,30520,-3680
2018-06-01,895770444,E061100,습기제거제,[P&G]페브리즈 상쾌한향 (리필/320ML),4990,4990,0
2018-06-01,895770447,A019050,간장,[샘표]샘표 진간장 금F3 500ml,3850,3850,0
2018-06-01,895770446,A019050,간장,[샘표]샘표 진간장금F3 1.8L,9580,9580,0
2018-06-01,1196106513,C013020,티셔츠,3+1 더드리는 이벤트 나시 모음전,3900,3900,0
2018-06-01,1957070214,I031040,생화,헤머스 /8400루멘 /고품격 /손전등 /등산랜턴/ 신상,50900,40900,-10000
2018-06-01,2098691151,C013010,점퍼,MJS18011 라벨 워싱 진청자켓 남자청자켓 남성데님자,73570,73570,0
2018-06-01,466273298,L012090,기초화장품,참존 디에이지 레드와인 에스 아이크림 기획세트 1개,56640,54380,-2260
2018-06-01,156769271,L021020,장신구,순은 게르마늄 팔찌 베스트 상품 특가전/실버/선물,150000,150000,0
2018-06-01,697706946,E031010,전기밥솥,CRP-DHXB0610FS/쿠쿠/IH압력/6인용/음성/GH,289180,265960,-23220
2018-06-01,753892390,F012010,종이기저귀,하기스 네이처메이드(밴드형/팬티형) 1~6단계/2팩/3팩,50900,50900,0
2018-06-01,1040798207,A022050,탄산음료,코카콜라 업소용 1.25L 사이다 업소용 스프라이트,16900,16900,0
2018-06-01,1175634517,I011030,사진기,SQ11 적외선 소형카메라 /미니카메라 동영상촬영 32Gb,28900,28900,0
2018-06-01,895804301,A011090,국수,[오뚜기]오뚜기 북경반점 짜장 (135g*5입),3950,3950,0
2018-06-01,1054719025,I031040,생화,CREE T6/L2 충전식 LED 랜턴 고휘도 후레쉬,13900,13900,0
2018-06-01,895769449,A022020,두유,[정식품]정식품 베지밀B 950ML,2500,2500,0
2018-06-01,85899047,A013090,전복,통영 자연산 비단가리비2~3kg/초장증정/당일발송,18800,18800,0
2018-06-01,59858262,A011070,혼식곡,곰표 밀가루 (다목적용)(1KG),1130,1130,0
2018-06-01,1238453393,A018100,꿀,뉴질랜드 타히 UMF10+ 마누카꿀 400g 야생화꿀 벌꿀,118000,116820,-1180
2018-06-01,895831919,A019110,드레싱,CJ 다담 된장찌개전용 (530g),5980,5980,0
2018-06-01,2023173478,L021060,유모차,특가[마모스]초경량 휴대용 유모차-2.9KG-그린색,39000,39000,0
2018-06-01,310615746,C014010,아동복,[멋키즈] 여름특가+20%추가할인/아동복/반팔티/반바지,3900,3900,0
2018-06-01,572469908,L021010,손목시계,보이런던시계와치 토마스 블랙 남자시계 팔찌시계 손,45240,45240,0
2018-06-01,700112142,E011040,소파,너스쇼파/쇼파/소파/1인용쇼파/3인용쇼파/패브릭쇼파,149000,99900,-49100
2018-06-01,1125245361,C013020,티셔츠,DDN1541 서클 레이스 단티 803S 여성용라운드티셔츠,35730,35730,0
2018-06-01,2115030429,E061050,청소용세제,[화야] 락스 향락스/액상뻥/가정용/업소용/말통,7490,7490,0
2018-06-01,656754471,A013130,오징어채,정화 맥반석 진미오징어 ( 채 ) 30g x 5,21360,21360,0
2018-06-01,45526719,E031040,전기레인지,차량용 온장고 냉장고/휴대용/7.5L/ 캠핑 야외 나들이,36000,36000,0
2018-06-01,1980877896,A018040,아이스크림,아이스크림 추억에 누가바 바밤바 쌍쌍바 선택 30개,15900,15900,0
2018-06-01,1126376599,A015020,식용유,뉴질랜드 엑스트라버진 아보카도오일 250ml,15900,15900,0
2018-06-01,693475069,C013020,티셔츠,물결넥세로줄티/브이넥티/슬림티/타이트티/골지티.,7900,7900,0
2018-06-01,1196542774,A016090,참외,나나푸드 성주 참외 5kg,12900,12900,0
2018-06-01,440977648,A017120,고구마,개진 감자 5kg 10kg 경북 고령군 햇 감자,24900,24900,0
2018-06-01,1542169064,C012040,여자학생복,베이직 블라우스[HC7MBL805]/ 샤트렌,29000,27550,-1450
2018-06-01,727946841,C013050,운동복,차량용 비상 안전 Led 경광봉 지시봉 안전봉 신호봉 주차유도봉 비상 랜턴 차량필수품,4400,3500,-900
2018-06-01,396081541,E031120,믹서,(공식)해피콜 다용도 믹서기 HC-MX1000B (분쇄/쥬서),35900,30930,-4970
2018-06-01,366820395,A017200,토마토,가지 3개/빠른배송,3000,3000,0
2018-06-01,1772206421,E041010,식기,스텐 이중 식기 밥공기 면기 탕기 국수 그릇 스텐컵,1600,1420,-180
2018-06-01,159374464,L021010,손목시계,전자 손목시계 방수 스포츠 남성여성 군인 군용 학생,6900,6900,0
2018-06-01,309142490,C011030,남자학생복,[예작셔츠]남성 반소매 슬림핏 미니 체크 YJ8MBS976,30000,25500,-4500
2018-06-01,416077802,C013010,점퍼,바람막이 야상 WS-JM22 바람막이 야상 점퍼 남자야상,36350,35630,-720
2018-06-01,573493886,L021060,유모차,엘레니어 국내 최초 분리 결합형 유모차 티크 솔로,209000,209000,0
2018-06-01,1844894951,C011050,남자내의,남녀공용 냉장고 아이스팬츠/5부/7부/조거/후드집업,9000,8800,-200
2018-06-01,336796128,C011050,남자내의,[닉스] 남성 밴딩 배기 팬츠(FNLMCPA111P),19000,16150,-2850
2018-06-01,1553870160,A019070,양념소스,CJ 다담 찌개양념 된장/순두부/청국장/부대찌개/두부,1000,1000,0
2018-06-01,244469144,A017250,고사리,브로콜리 노르망디 스타일 베지터블 블랜드/666853,17460,17460,0
2018-06-01,1414553552,A011120,두부,포스트 콘푸라이트1100g+랜덤증정품,7900,7900,0
2018-06-01,1733782023,A017230,마늘,2017 창녕 양파 5kg 장아찌 소형 중대형 특가,8000,7900,-100
2018-06-01,784698766,C014010,아동복,[M.K] 한국 스트라이프 마린룩 정장 4종(3-36개월) 203194,63900,56880,-7020
2018-06-01,1751010007,L021010,손목시계,Calvin Klein K5A311C6 캘빈클라인 CK 여성 가죽밴드 패션시계,289000,289000,0
2018-06-01,1751010006,L021010,손목시계,Calvin Klein K5A311C1 캘빈클라인 CK 여성 가죽밴드 패션시계,289000,289000,0
2018-06-01,438197083,C013010,점퍼,[대구백화점 I관] [SOUP](기존가:258 000원)백다트 털후드다운패딩(SU1DO80),50000,42500,-7500
2018-06-01,28842415,A017220,양파,국내산 대파 1단(2kg내외),5900,5900,0
2018-06-01,534730942,A014030,치즈,코리원/삼조 파마산 블렌드골드 1kg/대용량/피자/가루,11900,11900,0
2018-06-01,2037581663,A011100,라면,오뚜기 옛날 잡채 73g,1250,1250,0
2018-06-01,341945718,C012060,여자내의,[모다아울렛][코인코즈]배색 니트 스커트(MIK8MS151),29000,27550,-1450
2018-06-01,1807987200,A014040,발효유,밀크 앤 퍼니스트로우 초콜릿/딸기/바나나35gx10T,1900,1900,0
2018-06-01,1522912202,F011150,건강기능식품,애터미 프로바이오틱스10플러스 친생 유산균 300g/,51900,51900,0
2018-06-01,1047168707,L021010,손목시계,로제타 여성 손목시계 FW-26 시계 팔찌시계 디지털시,12850,12850,0
2018-06-01,1095817260,C013020,티셔츠,AAA/1701/트리플에이/Alstyle/반팔무지티셔츠/20수,8000,8000,0
2018-06-01,1111473422,C012060,여자내의,보들보들 치마바지 블랙 와이드팬츠,7450,6640,-810
2018-06-01,1511448199,A014030,치즈,코리원/썬리취 무색소 슬라이스치즈100매/치즈/토스트,13300,13300,0
2018-06-01,268919598,C014010,아동복,정품캐리옷 원피스 상하복 롱티 콩순이옷 시크릿쥬,25000,25000,0
2018-06-01,695841445,A019050,간장,일본간장/사시미간장/다시마쯔유/생와사비/타마고간장,5460,5460,0
2018-06-01,750710786,E021020,커튼,루루암막커튼/창문커튼/햇빛차단/작은창커튼,29400,27050,-2350
2018-06-01,716782380,C012020,원피스,[보니알렉스](보니알렉스)피그먼트 롱 트렌치 코트(BCHY104A),39900,35120,-4780
2018-06-01,1577084019,A021010,커피,네스프레소 호환 캡슐/5브랜드 33종/가성비 높은 캡슐,4200,4200,0
2018-06-01,1385853062,A011160,빵,안흥찐빵마을 수제 초코블랙찐빵 500g(10입) 2봉 수제,25370,25370,0
2018-06-01,666171539,C012060,여자내의,엄마옷 마담4060 플리츠주름밴딩팬츠-XPN805004-,26900,22810,-4090
2018-06-01,895745459,A011070,혼식곡,[대한제분]대한제분 중력분 (1KG),1550,1550,0
2018-06-01,198208746,C012060,여자내의,RT5 오프라 맥시 롱스커트 DM-3800,14970,14680,-290
2018-06-01,1196072602,C011030,남자학생복,30%패션쿠폰![멋남]풀코디룩/티셔츠/슬랙스/셔츠,7900,7900,0
2018-06-01,873251516,F012010,종이기저귀,보송허그 밴드기저귀 (신생아/소형/중형/대형) 3팩,41900,41900,0
2018-06-01,1655438132,C012060,여자내의,[셀렉트모카]셀렉트모카 하이웨스트 코튼 롱 스커트,43900,41270,-2630
2018-06-01,1968485111,E011020,침대,[골든잼]원목 천연 생황토 싱글 돌침대(백조)/흙침대,1450900,1334830,-116070
2018-06-01,1793254975,A021010,커피,UCC드립커피 18p/블랜디드립커피/유씨씨드립커피,6100,6100,0
2018-06-01,1122507475,C012060,여자내의,[모니카룸] 줄케이프set/세트/ 모니카룸,27700,21060,-6640
2018-06-01,1828820251,I031040,생화,[토이목] 감성 캠핑 해먹스텐드 풀세트 9종 행사,90000,90000,0
2018-06-01,449420149,L012010,면도기,여행용세트 모음/치약칫솔세트 미니스 페리오 2080,1090,1090,0
2018-06-01,501635184,A016110,딸기,23311307/ 냉동가당딸기(1kgX15개)-청솔,92660,92660,0
2018-06-01,2104179414,C013010,점퍼,남자 바람막이 야상 JM11 WS바람막이점퍼야상남자 바,96580,96580,0
2018-06-01,1665398252,C011050,남자내의,[TOP 10]여성 린넨코튼 4부쇼츠MSY2PH2006(영등포점A),19900,18350,-1550
2018-06-01,1223803733,C012040,여자학생복,[모다아울렛][코인코즈]와이드 소매 로브 가디건(IZ7MD605),49000,46550,-2450
2018-06-01,1295620242,G011070,자전거,시애틀모던D 하이브리드21단 하이림적용 삼천리자전거,149000,134100,-14900
2018-06-01,1471888282,F012020,생리대,화이트 와이드&롱 울트라 오버나이트 14P x 10팩,44800,44800,0
2018-06-01,979061247,A017210,파,짭짭한토마토 대동동토마토 대저동토마토,38000,38000,0
2018-06-01,895745461,A011070,혼식곡,[대한제분]곰표 찰진 햇 밀가루 1kg,2050,2050,0
2018-06-01,2000856886,C013040,청바지,남자청바지 디스트로이드 슬림 밴딩 바지 BX0717002,47890,47890,0
2018-06-01,645458843,A022050,탄산음료,칠성사이다 355mlx24캔/펩시콜라/코카콜라/환타/음료,14600,13870,-730
2018-06-01,895770412,A013150,어묵,CJ 삼호 부산어묵사각 210G,1490,1490,0
2018-06-01,895770414,A013150,어묵,[삼호]삼호 부산어묵 사각 (600G),3690,3690,0
2018-06-01,895770413,A013150,어묵,CJ 삼호 부산어묵사각 350G,2190,1990,-200
2018-06-01,779885209,F011120,인삼,산삼배양근 드링크 선물세트(75ml) (12병x3set),39500,39500,0
2018-06-01,380259148,C014020,유아복,여자 아이 아동 어린이 여아 반팔 상하복 순면 삐삐롱,11750,11750,0
2018-06-01,767314560,F012020,생리대,화이트 생리대/입는 오버나이트 8개입x3개/팬티라이너,23900,23900,0
2018-06-01,987198129,A013100,마른멸치,익혀먹는굴 150G,2790,2490,-300
2018-06-01,1196831947,C014010,아동복,[무료배송]아동정장모음/남아정장/주니어정장/돌복,69800,69800,0
2018-06-01,496954517,C011020,남자상의,아이보리 체크 밍크털 코트 남성코트 캐쥬얼코트 코트,107100,107100,0
2018-06-01,1149249647,C011050,남자내의,마/린넨반바지/면반바지/슬랙스/밴딩/밴드/팬츠/여름,8900,8900,0
2018-06-01,82032664,C012060,여자내의,[물건팜] 해외직배송 2018 봄 신상 캐주얼 루즈 핏,68480,68480,0
2018-06-01,1220727195,C013010,점퍼,리스판스 후드 윈드 자켓,115550,102840,-12710
2018-06-01,451554128,C013020,티셔츠,[아디다스골프]아디다스 SS 남성 셔츠 CI7556 CI7557 CI7558 골프웨어 필드웨어 ADIDA,41100,37880,-3220
2018-06-01,1889767895,I031010,장난감,전동 오토바이 에버바이크 선물 유아 스쿠터 사이클,109200,109200,0
2018-06-01,488087606,E041010,식기,사무실/가게/풍수/지리/인테리어/소품/용품/대박/선물,127000,124460,-2540
2018-06-01,161054063,C011030,남자학생복,빅사이즈 가디건 ~140 집업후드 큰옷[더블온스],36900,36900,0
2018-06-01,907337079,C012030,여자상의,인기신상 원피스 쉬폰 린넨 ops 롱원피스 특가모음전,16900,16400,-500
2018-06-01,44731049,C011050,남자내의,쿨바지/아이스/배기/팬츠/커플/잠옷/냉장고/남자/옷,4900,4900,0
2018-06-01,858757464,I031040,생화,경량체어 860g 높이조절/경량의자/캠핑의자/낚시의자/,24900,22460,-2440
2018-06-01,333472758,C013020,티셔츠,단독 ~86%! HUM 반팔티/셔츠외 여름 세일 2 900원~,5500,5500,0
2018-06-01,866468958,C013020,티셔츠,여리 브이넥 반팔 티 GO1279 빅사이즈 티셔츠 큰옷,9900,9900,0
2018-06-01,446800787,A013060,게,[마산어시장 이바다몰]국내산 냉동 오징어채 4kg,44800,44800,0
2018-06-01,1439810870,A017120,고구마,생 볶은 건 슈퍼 말린 자색 돼지감자 500g 차 가루,8000,8000,0
2018-06-01,2028491127,C011030,남자학생복,SSH01 남자 반팔 남방 롤업셔츠 린넨 남방 7부 체크,9800,9800,0
2018-06-01,467011168,A018110,물엿,초지일관 천연발효 팥호박 흑초 500ml x 5병세트 샐러,105590,95040,-10550
2018-06-01,1138720631,C021040,실내화,스티유 18 S S 81348be-81349ny 루쓰 샌들,51250,51250,0
2018-06-01,895804384,D031010,주택수선재료,3M 방수 페인트 스프레이 옥상 외벽 우레탄 방수제 침투 방수액 욕실 화장실 베란다 코,6500,6500,0
2018-06-01,1169188790,E011040,소파,프리백/스퀘어프리백/빈백/1인용소파/스툴/방석/좌식,14900,14900,0
2018-06-01,1508339224,C011030,남자학생복,4XL 빅사이즈 셔츠 남방 무지 체크남방 청남방 남자,13800,13800,0
2018-06-01,117473852,C013020,티셔츠,여름신상/반팔티/반팔카라티/7부티/티셔츠/카라티,15800,14800,-1000
2018-06-01,1011092337,L012110,색조화장품,해피바스 퍼펙트선크림80G 2입,14900,11400,-3500
2018-06-01,890769038,C013020,티셔츠,빅사이즈 반체크박시티 NB1609 여성의류 임부복 미시,44750,44750,0
2018-06-01,1223984518,C021010,아동화,[베베마루]운동화 아동화 캔버스 유아 스니커즈 우븐,17900,17900,0
2018-06-01,1774916782,F011130,홍삼,굿베이스 홍삼에너지업,56000,56000,0
2018-06-01,503759471,I031010,장난감,점보 지프와 피규어 운전수놀이장난감 운전사놀이장난,57000,56430,-570
2018-06-01,978817929,E011010,장롱,[포레아] 슬라이딩/장롱/장농/슬라이드/이불장/6자/9자/붙박이장/옷장/하이그로시/흑경,415000,410000,-5000
2018-06-01,522518833,C012040,여자학생복,[티렌]어깨포인트니트(T172KSK708),79000,63200,-15800
2018-06-01,832707640,A011110,당면,[농협] 안동 전통방식 국산콩 두부/순두부/연두부,8900,8900,0
2018-06-01,35163790,I012060,저장장치,로지텍코리아 G102 Prodigy 게이밍마우스 정품박스,28610,26900,-1710
2018-06-01,202766363,C012040,여자학생복,수지네 일본 구제 블랙 오픈베스트 여성 S 20-04,13170,13170,0
2018-06-01,149907523,E041060,수저,[가정의달선물]H.jin금수저/은수저세트/단체행사기념,22000,22000,0
2018-06-01,1900872363,E061030,전구,[LED 3구모듈]국산제품 채널 간판조명 캡형 커버형,330,330,0
2018-06-01,359791329,L021030,가방,고품격 서류가방 50종 초특가세일/남성가방,30800,29800,-1000
2018-06-01,2111247577,C012040,여자학생복,베이직 면 베스트 조끼 /오픈형마조끼/ F~2XL,29800,29800,0
2018-06-01,293361386,C012060,여자내의,[위쉬몰]RIN 언발헤짐스커트(0369RH805)/ 위쉬몰,50400,43350,-7050
2018-06-01,156708282,A018090,잼,오뚜기)딸기쨈 300g x 5개 국산딸기 신선한 과일 알,24760,24760,0
2018-06-01,988038075,A015010,참기름,초L)국산볶음참깨 200G,9990,9990,0
2018-06-01,1508768280,E031010,전기밥솥,CRP-HSXB0630FB/쿠쿠/6인용/IH압력/GH,247800,227800,-20000
2018-06-01,1773408069,L021030,가방,[델라스텔라] 멜수록 반하는 소가죽BEST 백! +30%쿠폰,16900,16900,0
2018-06-01,424557530,I011010,TV,공식파트너 삼성 123cm UHD TV UN49NU8050FXKR,1340000,999000,-341000
2018-06-01,990092847,F011150,건강기능식품,[비타민뱅크]스피루리나 480T,72000,48000,-24000
2018-06-01,990092848,F011150,건강기능식품,<비타민뱅크>CoQ10 90T Softgels,55000,33000,-22000
2018-06-01,2120382235,A017090,열무,국산 햇 무우 5kg(3~5개),9900,9900,0
2018-06-01,1862252131,E041010,식기,6230 4단건조망/대채반5p/ 대나무3종망사 뚜껑채반/건조망/건조대/채반/회채반/바구니,15000,15000,0
2018-06-01,1972233877,E011070,식탁,[스크래치] 디모토 산호석 타일 4인용 원목 식탁세트,99000,99000,0
2018-06-01,1010382156,A019180,즉석식품,CJ 햇반 210G*24,20700,16900,-3800
2018-06-01,894988397,E061100,습기제거제,물먹는 하마 일반용 16개/24개/슬림본품7개/제습제,17800,17800,0
2018-06-01,1860768409,C012060,여자내의,푸마 치마레깅스 3종 패키지(9차),59000,43430,-15570
2018-06-01,1023991822,C014010,아동복,여름신상/유아티셔츠/아동반팔/캐릭터티셔츠/주니어티,3900,3900,0
2018-06-01,1072180081,C013050,운동복,차아네 와이드 멀티컵홀더 5단 휴대폰 멀티수납YKM,21000,18310,-2690
2018-06-01,798984901,F012020,생리대,예지미인)중형108P+라이너30p+슈퍼롱10P+사은/생리대,10000,9900,-100
2018-06-01,2024316700,A017230,마늘,2018년 무안 햇양파 10kg,8900,8900,0
2018-06-01,1682227927,C013040,청바지,디젤 주니어용 블랙 스키니스판데님바지68-85/27,39000,39000,0
2018-06-01,535007167,C012040,여자학생복,[루코루코]18 DK 롱 가디건 3color(RSC4CD011),22000,20900,-1100
2018-06-01,1766573434,A022050,탄산음료,[Z]황성주두유190ml×72팩,35160,35160,0
2018-06-01,1077147004,E031010,전기밥솥,쿠쿠공식몰/CRP-P1010FD/풀스테인리스,182780,171720,-11060
2018-06-01,372246911,C013010,점퍼,경량바람막이 아웃도어 여름점퍼 남자잠바 등산복자켓,49800,49800,0
2018-06-01,1641322351,A019040,소금,신안 함초소금 3년묵은천일염사용 잔치답례품 가정용,9800,9800,0
2018-06-01,684412210,E031080,선풍기,신일_세라믹 히터 SEH-JS30_선풍기형 /탄소발열히터/파티션난로/파티션히터,53100,53100,0
2018-06-01,503603606,L021010,손목시계,손목 시계 클래식 브라운 MV21031BR 학생손목시계 가,125900,125900,0
2018-06-01,1239909483,A019090,카레,오뚜기3분요리 3분카레/미트볼/햄버그스테이크25종,1650,1650,0
2018-06-01,451060095,A013150,어묵,한성 크래미(F2) 1kg2개 크래미 맛살 한성크래미 냉동,44330,39900,-4430
2018-06-01,1002631499,I031010,장난감,PSVita 비타 본체 신형 PCH-2005 + 양면 액정보호필름,225000,225000,0
2018-06-01,835213015,C012040,여자학생복,득템찬스.자체제작 데님 롱블라우스 빅사이즈,19900,19900,0
2018-06-01,1369230625,A019090,카레,일본 고형카레 모음전 바몬드 에스비 일본카레 카레,2500,2500,0
2018-06-01,301764927,C012060,여자내의,멜빵바지 멜빵청바지 톰스 연청 멜빵 청반바지(멜빵탈,14760,14760,0
2018-06-01,300596656,A013150,어묵,모듬 가마보꼬 어묵 500g2개 어묵 모듬어묵 가마보꼬,25820,23240,-2580
2018-06-01,895770481,A014010,우유,서울 딸기우유 200ML,850,850,0
2018-06-01,1787802061,L021060,유모차,[이태리 수입완제품 디럭스 사륜 유모차 (베네지아/프라메떼)]/180도차양/170도등받이,465000,465000,0
2018-06-01,1493492481,A012010,국산쇠고기,[무항생제] 안심스테이크 600g 1등급,65000,65000,0
2018-06-01,1011092370,L012110,색조화장품,해피바스 마일드선밀크75ml 2입,14900,11400,-3500
2018-06-01,1011092372,L012110,색조화장품,해피바스 마일드선크림70G 2입,14900,10400,-4500
2018-06-01,239396691,C014010,아동복,[키키제제]여아 상하복/ 원피스/ 트레이닝복/ 세트,10900,10900,0
2018-06-01,759404347,A019080,고추장,[예동뜰]생활의 달인 손예순님의 황태고추장 1KG/양평,35000,35000,0
2018-06-01,330673304,C012060,여자내의,[밀바이 스튜디오화이트]릴리 플리츠 스커트 (RD6SKD101),19000,18050,-950
2018-06-01,988038044,A018080,설탕,CJ 스위트리 하얀 자일로스 설탕 500G,1950,1950,0
2018-06-01,1359065317,A019130,스프,보노스프 3개입 5곽 고르기 /카레/죽/치즈/간식/즉석,15900,15900,0
2018-06-01,1480614360,C013040,청바지,[엔키스타] 신상 청바지/팬츠/치마바지/멜빵바지,9900,9900,0
2018-06-01,404583217,C012030,여자상의,절개나시벨벳원피스 PG1710 절개나시원피스 여성나시,72730,72730,0
2018-06-01,515306333,C021010,아동화,안나투투메쉬운동화-0746 아동운동화 아동화,26900,26900,0
2018-06-01,958515342,A016130,키위,제스프리 그린키위 (8~10입/팩),4990,4990,0
2018-06-01,2068311144,C013010,점퍼,(티티뱅크) JK543W 세이프티 방한 자켓 / 참고 방한,69600,59160,-10440
2018-06-01,2112185468,A011090,국수,라면 골라담기 100종 모음전 신라면/안성탕면,2350,2350,0
2018-06-01,140305361,C012060,여자내의,여성 남성 밍크 융털 털 기모 바지 겨울 몸빼 일바지,11820,11820,0
2018-06-01,1308671313,C012040,여자학생복,ee38 형광 셔츠 오렌지 남방 블라우스 여성셔츠 심플,16000,16000,0
2018-06-01,899498292,A017180,호박,오이맛고추(봉),1990,1000,-990
2018-06-01,895770474,A019050,간장,[샘표]샘표 양조간장 501 500ml,4550,4550,0
2018-06-01,651471095,E011020,침대,인쏘노 티나 TINA 서랍 침대 + 매트리스 포함 (S/SS),200000,175770,-24230
2018-06-01,895770473,A019050,간장,[샘표]샘표 양조간장701 1.8L,16550,12490,-4060
2018-06-01,1906501586,C012060,여자내의,청치마/스커트/청스커트/핫팬츠/청반바지/5부반바지,12800,6800,-6000
2018-06-01,895770472,A019050,간장,[샘표]샘표 양조간장 501 1.8L,11900,10900,-1000
2018-06-01,1180773804,C013050,운동복,231_고구마베이비 아기옷- 무형광 나뭇잎 민소매 상하,10910,10590,-320
2018-06-01,897424744,A013090,전복,국산 자연산 바지락순살/홍합순살,10900,10900,0
2018-06-01,1753086152,A016120,바나나,고당도 Dole 바나나 3kg/6kg (2~4다발),9900,9900,0
2018-06-01,1264998922,I012010,컴퓨터,컴퓨존 삼성전자 DM500T7A-A57,1397250,1341360,-55890
2018-06-01,278554509,A011120,두부,[켈로그] 켈로그 첵스초코 1200g 대용량 시리얼 식사대용,12300,12300,0
2018-06-01,1536693405,C012040,여자학생복,지나블리스 체크 단추 긴팔 롱 셔츠 7424,18900,18900,0
2018-06-01,1011092366,L012110,색조화장품,해피바스 퍼펙트선로션200G 2입,18900,14200,-4700
2018-06-01,1011092368,L012110,색조화장품,해피바스 퍼펙트선스틱20g 2입,18900,16900,-2000
2018-06-01,895769482,G022010,자동차용품,[불스원]불스원 다용도 세정제,4900,4900,0
2018-06-01,895769488,G022010,자동차용품,불스원 스티커/타르 크리너,6900,6900,0
2018-06-01,442051016,A011170,떡,H/2/가락식품 찹쌀 새알 옹심이 1kg -10개/국내산찹쌀,58000,58000,0
2018-06-01,1262592919,A011030,찹쌀,찹쌀(4K)X4 찹쌀가격 찹쌀약과 찹쌀엿 수능찹쌀떡,62650,62650,0
2018-06-01,510760019,I012060,저장장치,정품 마우스 USB 유선 게이밍 삼성전자 LG 로지텍,4000,3800,-200
2018-06-01,2068311111,C011030,남자학생복,남자가디건 3선 집업 가디건 / 참고 남자가디건 커플,63900,54320,-9580
2018-06-01,979494243,A016020,배,시원한 과즙이펑펑 나주햇배 가정용 15Kg 35과내,19900,19900,0
2018-06-01,1450922261,C012020,원피스,(해외직배송)세미정장 원피스자켓 세트 정장자켓 원피,142820,125690,-17130
2018-06-01,281871945,C011030,남자학생복,남자 남방 반팔 7부 셔츠 체크 스트라이프 청남방,14900,14900,0
2018-06-01,1995950938,C012020,원피스,MSG (대원미 대원 3K) x4,63730,63730,0
2018-06-01,1541892876,C013040,청바지,아둘 패밀리룩 조던 민소매 메쉬 상하의 나시세트 54,15900,15900,0
2018-06-01,1011092394,L012110,색조화장품,해피바스 아쿠아모이스춰선로션150g 2입,18900,15200,-3700
2018-06-01,673021820,I012010,컴퓨터,(행사134.6만)삼성 노트북9 Always NT900X5N-X58W,1549000,1469000,-80000
2018-06-01,693852989,C011030,남자학생복,여름신상 솔리드남방 7부 스판 반팔셔츠 50여종 체크,14700,14700,0
2018-06-01,988038066,A018080,설탕,CJ 스위트 리브라운 자일로스 설탕 500G,2000,2000,0
2018-06-01,1011092398,L012110,색조화장품,일리윤 데일리디펜스 멀티선크림 50ml 2입,19900,11400,-8500
2018-06-01,827753632,C011050,남자내의,아로미 915 편하고 착용감 좋은 고급패턴 9부남파자마,12950,11530,-1420
2018-06-01,746932115,C011030,남자학생복,남자롱가디건/니트롱가디건/봄가디건/후드가디건,26800,25800,-1000
2018-06-01,1074197783,C013020,티셔츠,[퍼니러브] 리버티스트라이프 반팔 패밀리룩/가족티 아동 티셔츠(블루/레드/블랙),13000,11700,-1300
2018-06-01,471420241,C012060,여자내의,리즘 주름 롱스커트 SD-9028,12900,12900,0
2018-06-01,233814803,C013040,청바지,하이웨스트 여성스키니진 반하이 여자밴딩청바지,15900,15900,0
2018-06-01,1257971028,L021060,유모차,신상품 크라운s 에스/블랙 에디션/유모차/양대면 인기,510000,510000,0
2018-06-01,281215255,A018040,아이스크림,서강 바닐라 초코 소프트 아이스크림 분말 1kg 업소용,4600,4600,0
2018-06-01,1149321589,F012020,생리대,시크릿데이 생리대 러브 중형/대형/오버나이트/라이너,11900,11900,0
2018-06-01,1998804283,A017140,콩나물,유기농 인증 제주 산지직송 최상품 도라지 2kg,29900,29900,0
2018-06-01,230510641,A011090,국수,컵라면 소컵 6입 25종 골라담기 신라면/진라면,3030,3030,0
2018-06-01,1271188383,A012050,소시지,동원 친친 치즈빅 소시지(80g X 10개)10박스 무료배송,52000,52000,0
2018-06-01,553179585,A014020,분유,순산양분유 800gx1캔 / 400gx2캔 특가[사은품 증정],29890,29890,0
2018-06-01,1814369981,C013050,운동복,아동 레깅스/쫄바지모음/데님레깅스/컬러레깅스/배기레깅스/고무줄 레깅스바지/아동 기,9900,9800,-100
2018-06-01,521593378,C013020,티셔츠,[MRBOB] 두꺼운 헤비 기모 후드티 후드집업 M~3XL,36800,33800,-3000
2018-06-01,442907401,A013060,게,다나 사우나 오징어 900g2개,156650,156650,0
2018-06-01,881569704,E041050,냄비,[키친아트]스텐냄비/라면냄비/편수냄비,9900,8900,-1000
2018-06-01,1844290338,E061020,섬유유연제,다우니 인퓨전 라벤더 드라이시트 105매/의류 건조기,9900,9900,0
2018-06-01,1424530286,C011030,남자학생복,[패션플러스][더커버][더커버] 라이트 다운 퀼팅 베스트,51000,42330,-8670
2018-06-01,495522984,C012060,여자내의,내츄럴 워싱 수술 데님 언발 롱 스커트,39900,39900,0
2018-06-01,1876853774,C011050,남자내의,봄신상/남성청바지/배기팬츠/데님/조거팬츠/빅사이즈,18800,18800,0
2018-06-01,1922860156,C013050,운동복,(1+1 EVENT) 16ss 첨이첨이 플라워래빗나시세트 듀퐁 유아동의류 아동의류 공용 상하,33170,33170,0
2018-06-01,1378038156,F011150,건강기능식품,삼성제약 까스명수GOLD 75mlx50병 건강음료 소화제,40400,39600,-800
2018-06-01,1558171864,E061020,섬유유연제,샤프란 아로마시트 코튼블로섬 30매 x 12,57870,57870,0
2018-06-01,797660803,E041010,식기,[포트메리온] 악센트볼 5P 5월깜짝특가!,23900,23900,0
2018-06-01,1170674996,C011030,남자학생복,[백화점SAY][예작]P/C(T/C)슬럽솔리드 YJ8MBS970-화이트 네이비,30000,22360,-7640
2018-06-01,229175421,C012060,여자내의,P 243 (여)밑단올풀림헤지블랙3부팬츠 여성바지 스판,37890,30700,-7190
2018-06-01,194998561,C013010,점퍼,남자 항공점퍼 야구점퍼 남성점퍼 자켓 잠바,40800,39800,-1000
2018-06-01,838300373,C013050,운동복,빅사이즈/신상 55~120사이즈/최저가,6900,6900,0
2018-06-01,1465271194,I053030,복사용지,밀크 A4 복사용지(A4용지) 85g 2500매 2BOX/더블에이,47000,40890,-6110
2018-06-01,620023951,C013020,티셔츠,30%쿠폰! 그랜피니 반팔/반바지/긴팔/오버핏/배색티,9900,9900,0
2018-06-01,1353931735,E061100,습기제거제,물먹는하마 옷장용 18개/제습제/습기제거제,22900,22900,0
2018-06-01,766926926,A018090,잼,트라피스트수녀원 유기포도잼 410g 포도잼 과일잼,17590,17590,0
2018-06-01,2057318956,C013010,점퍼,[a.t.corner][18SS]나일론 혼방 칠부소매 점퍼(ATJU8B502)[갤러리아],139000,118150,-20850
2018-06-01,1735721923,A022020,두유,[20%쿠폰할인] 연세 고소한두유 1L 검은콩 아몬드잣,18900,18900,0
2018-06-01,631173625,A017120,고구마,하루한끼 아이스 따근따끈 한끼 군고구마 130g 15봉 /,57100,48540,-8560
2018-06-01,2104180379,C013010,점퍼,남자 바람막이 야상 JM12 WS바람막이점퍼야상남자 바,96580,96580,0
2018-06-01,1688507691,E011030,거실장,[디모토] 브릭 원목 TV다이 거실장,329000,249000,-80000
2018-06-01,110428784,A016030,복숭아,솜 후르츠 냉동 복숭아 슬라이스 1kg/10개/과일/빙수,75000,75000,0
2018-06-01,2004318811,A019060,된장,진미 순창 재래식 콩된장 14kg 대용량말통 식자재업소,21000,21000,0
2018-06-01,777751489,C013010,점퍼,아디다스 유소년 콘디보16 스타디움자켓 (AB3152 ),151820,135120,-16700
2018-06-01,1966870476,A014010,우유,파스퇴르 전용목장 저지방 우유 190mlx24팩,17400,16620,-780
2018-06-01,1793600315,F012010,종이기저귀,[에코제네시스 밴드형2팩]뉴본/인펀트/토들러/주니어,38500,38500,0
2018-06-01,384997566,C013010,점퍼,여성 후드 롱자켓 KK 버켄훌 CT 심플롱자켓 긴팔롱자,83830,83830,0
2018-06-01,1486264761,A018100,꿀,베니폼 파워 토닉(로얄제리) 15ml*30앰플/ 파워토닉,92790,92790,0
2018-06-01,1536477638,A015010,참기름,당일착유/국산 참기름/들기름/생들기름/들깨가루/참깨,15000,15000,0
2018-06-01,693849202,C011030,남자학생복,여름 7부 리넨 셔츠 남성 편안한 케쥬얼남방 40여종,16700,16700,0
2018-06-01,693825239,C011030,남자학생복,여름신상 솔리드남방 7부 스판 반팔셔츠 50여종 체크,14700,14700,0
2018-06-01,537193016,C011030,남자학생복,오투웜발열자켓-프리미엄]발열조끼 등산,77600,77600,0
2018-06-01,816060651,A022050,탄산음료,해태 코코팜 340mlx24캔 자몽소다/콜라/사이다/음료수,11400,11400,0
2018-06-01,327277905,L021030,가방,KINMAC 버티칼 노트북파우치 가방 13.3 15.6인치11~17,12400,12400,0
2018-06-01,211836392,I012010,컴퓨터,최대할인시125만/ 삼성 북9 NT900X5V-GD5A,1579000,1349000,-230000
2018-06-01,229881293,E031080,선풍기,신일 벽걸이 근적외선히터 SEH-M70WR,116800,116800,0
2018-06-01,229881292,E031080,선풍기,신일 석유 팬히터 SFH-C337MVP(실버),352900,352900,0
2018-06-01,229881291,E031080,선풍기,홍진 석영관히터 2단바닥형 DES-902,21700,21700,0
2018-06-01,229881290,E031080,선풍기,신일 14 벽걸이 원세라믹히터 SEH-900WST(900W),49400,49400,0
2018-06-01,1319535947,A022010,주스,롯데 코코망고 340ml x 24캔,11900,11900,0
2018-06-01,1767983671,E061040,부엌용세제,e울트라조이 고농축주방세제 887ml x 1개/375ml x 4개,3100,3100,0
2018-06-01,1536693346,C021040,실내화,[리복] 남성 플로트라이드 런 CM9056,151200,128520,-22680
2018-06-01,450599217,C013030,스웨터,MJ_1200 아이보리 양면 양털 집업 남성집업 여성집업,65980,65980,0
2018-06-01,250262559,C012060,여자내의,[체리코코]hour shy  jumpsuit(C805MSOP17)/점프수트/플라워/패턴/롱(G2-4-3),30000,30000,0
2018-06-01,1092328421,C012040,여자학생복,8B-BL935 인견무지왕단추블라우스/ 데드라,27400,20550,-6850
2018-06-01,1240685331,E011060,의자,등받이 쿠션의자 접이식의자 간이 보조 식탁의자 스툴,12900,11610,-1290
2018-06-01,1108773176,C012060,여자내의,로엠 사선절개 치마바지 RMTW74TR22,29000,26680,-2320
2018-06-01,1011126190,L021050,우산,(이븐플로)라이트이지 휴대용 유모차 / 4.3kg 초경량 / 레드,59000,39000,-20000
2018-06-01,1406126506,A011020,현미,냉동대학찰옥수수 특 (10팩) - 진공포장 명절 추석 선,68920,61340,-7580
2018-06-01,1793398712,A011050,콩,[맘쿠킹] 햇 땅콩1kg/볶음땅콩/양념땅콩,5500,5500,0
2018-06-01,1991726992,E061010,세탁세제,[무궁화]브라이트 10kg 2개/스파크20kg/비트가루세제P,17500,17200,-300
2018-06-01,561873971,E051030,디지털도어록,무료설치 삼성 SHP-DP710 푸시풀 도어락 /구 SHS-P710,205000,184500,-20500
2018-06-01,1519071512,C013030,스웨터,여름 니트 남자 남성 브이넥 V넥 집업 무지 커플 옷,15800,15800,0
2018-06-01,443575610,A011180,파스타면,스파게티면(11번 데체코 1K)X12,112130,112130,0
2018-06-01,1962024219,E011050,책상,이지심플 100 콘솔 / 다용도책상 / 조립,27700,27700,0
2018-06-01,1062438576,C012020,원피스,SS/정장/여성정장/여자정장/단체복/결혼/면접/봄/가을,52000,52000,0
2018-06-01,428622024,A011140,부침가루,[삼립] 삼립 스위트 고구마 72g 3개 케이크 조각케익,6840,6840,0
2018-06-01,281107472,C021040,실내화,PJM2/조던/아동화/뉴발란스/맥스/나이키/키즈/농구화,93900,93900,0
2018-06-01,1215712284,A016040,포도,[거북농산]칠레산 적포도(크림슨) 거봉 8.2kg,38500,38500,0
2018-06-01,1895949714,A019110,드레싱,폰타나 이탈리안 드레싱(270G),2580,2580,0
2018-06-01,1954067091,C011050,남자내의,[나쁜남자] P2266 닐 조거팬츠 밴딩슬랙스 배기팬츠,25900,25900,0
2018-06-01,1535476189,E011020,침대,스텐경락스포츠베드/BS-105/경락베드/마사지침대,175000,175000,0
2018-06-01,1418542676,E021020,커튼,[에반스 원터치 대형 자동모기장] 5-6인용 7-8인용  9-10인용/중형 대형 스피드 퀵모기,22500,21500,-1000
2018-06-01,981604303,A019040,소금,백설 천일염으로 만든 맛소금 (300G),2190,2190,0
2018-06-01,1132790606,I012010,컴퓨터,N)CTO주문가능/애플정품/아이맥/MNE92KH/A,2079850,2079850,0
2018-06-01,321874225,C012030,여자상의,DBE1730 아리 배색 프릴 원피스 804S 여성원피스 여성,41730,41730,0
2018-06-01,2041847177,E011020,침대,파로마 전국무배 100%고무나무 피칸/몬드 원목침대 퀸,349000,349000,0
2018-06-01,2073075546,I053010,공책,당일출고 1000 칸이넓은 수학노트(랜덤발송) 수학 노,1000,860,-140
2018-06-01,2106389860,C014020,유아복,[해피랜드F&C] 앨리6부레깅스 HS3543P4 레이스레깅스 NC아울렛,11000,6600,-4400
2018-06-01,1525577312,C013020,티셔츠,[나이키골프] 나이키골프 빅토리 모던핏 반팔폴로 3종 816341무배,39900,35520,-4380
2018-06-01,1607982594,A019180,즉석식품,우동재료 모음/우동면/우동소스/건더기스프/사누끼,5800,5800,0
2018-06-01,643600652,F012010,종이기저귀,18년형군기저귀/오리지널/프리미엄/윈터팬티,38900,38900,0
2018-06-01,1644625523,E061030,전구,두영 볼삼파장램프 20W EFB20EX-D EFB20EX-L 볼구,4300,4300,0
2018-06-01,1236957577,C012040,여자학생복,아이스 니트 조끼 LRT094 니트조끼 여자조끼 (YA02004,54200,48780,-5420
2018-06-01,797598626,A019080,고추장,ⓒ 해찬들 태양초골드 고추장(2KG),19000,19000,0
2018-06-01,1010288937,A013020,명태,[포항 구룡포 과메기]포과메기 350g내외(10미/20쪽)-박스포장,18900,15900,-3000
2018-06-01,58583181,A018080,설탕,비정제원당 3kgx3봉/설탕 매실 천연당 과일청 효소,17900,17900,0
2018-06-01,1012886183,E061040,부엌용세제,액큐 식기세척기 1종고농축 친환경세제 유독물0% 린스,21000,20790,-210
2018-06-01,1010347712,E041040,프라이팬,라체나블랙점보웍36cm(찜솥포험),34900,34900,0
2018-06-01,2045187834,A021010,커피,쟈뎅 까페리얼1.5Lx6개/ 아이스커피 헤이즐넛 커피,10900,10900,0
2018-06-01,309722963,C011030,남자학생복,[제이제이옴므]제이제이옴므 정장핏 코디용 베스트 9종택1,21800,20060,-1740
2018-06-01,1180626704,C012040,여자학생복,[모다아울렛][멜로디가든]아크릴가디건,19000,17100,-1900
2018-06-01,921357315,L021030,가방,보정 속옷 올인원 컨트롤바디 코튼,47500,47500,0
2018-06-01,84950201,A016110,딸기,(냉동)국내산 딸기1kg,12730,12730,0
2018-06-01,355067464,I031040,생화,하프로 트랙서4.6- 짧고 넓은 대용량 루프박스  캠핑용품 유모차 수납용이  캐러반 지,750000,675000,-75000
2018-06-01,1599204280,E011050,책상,위너 컴퓨터책상/테이블/책상/L자 책상/일자책상,22900,22900,0
2018-06-01,431082557,F011150,건강기능식품,알유21 24갑 2박스/RU21/컨디션/여명808/알유,51000,51000,0
2018-06-01,61378207,A017230,마늘,단단하고 아삭한 2018년 햇양파 10kg 6400,6900,6400,-500
2018-06-01,1366456140,E021010,침구,지금부터 여름까지 차렵이불+베개세트/1+1줄누빔세트,14900,14900,0
2018-06-01,717847692,A013100,마른멸치,[유진수산]국내산 전복내장 1kg / 전복 / 전복죽/업소,29900,29900,0
2018-06-01,136507674,A021010,커피,무료배송 500gx2 총1kg사은품증정 갓볶은 원두커피,9900,9900,0
2018-06-01,887597602,E061040,부엌용세제,써보고 대용량 1종 주방세제 4L 1+1 퐁퐁 트리오,10000,9900,-100
2018-06-01,1010262314,E041040,프라이팬,라체나)싱글테이블쿡웨어세트(16+20),29800,29800,0
2018-06-01,410646570,A012010,국산쇠고기,효도 견과세트 5호(고품격 웰빙 선물세트),84850,84850,0
2018-06-01,1250831401,A017300,미역,삼각김밥김 100매(50매X2봉),14800,14800,0
2018-06-01,28993013,I031070,애완동물관리비,단체줄넘기/줄넘기줄/전략줄다리기줄/체육대회/운동회,14500,14500,0
2018-06-01,631293132,C012040,여자학생복,5부소매골지니트 (J11PNT173)/ 매그제이(MAGJAY),23000,20700,-2300
2018-06-01,407439282,C012040,여자학생복,[나인스텝](18S/S) 로렌 레이스 배색나시 N18NW8202R[갤러리아],39000,33540,-5460
2018-06-01,1068586330,E031080,선풍기,굿프렌드_스마트 욕실난방기 실버 (HR1-022),37500,37500,0
2018-06-01,2009725210,A013020,명태,명태포[통포/슬라이스]선택 명태전 제수용 해물전,3300,3300,0
2018-06-01,1011442660,F012010,종이기저귀,마미포코 쿨썸머그린 밴드/팬티 3팩,36900,36900,0
2018-06-01,84949270,A016110,딸기,23311307/ 냉동가당딸기(1kgX15개)-청솔,88490,88490,0
2018-06-01,627346000,I011010,TV,32인치TV 삼성패널 커브드 LED 티비 텔레비전TV모니터,153610,149000,-4610
2018-06-01,897615570,A012060,햄및베이컨,[동원]동원 순닭가슴살 (135G),3100,3100,0
2018-06-01,979264082,E061060,살충제,(일본직수입)천연고추쌀벌레퇴치/쌀벌레약/쌀벌레,10900,10900,0
2018-06-01,36076564,E031120,믹서,테팔 블렌더 믹서기 블렌드포스 BL311E 초강력 모터,52000,52000,0
2018-06-01,500988665,C012020,원피스,슬림핏 모직코트 RKJWHJ010/ 리안뉴욕,99000,89100,-9900
2018-06-01,253226429,E061010,세탁세제,테크 간편시트10매/한입세제/한장세제/간편시트/세제,1200,1200,0
2018-06-01,1525144410,C011030,남자학생복,[모다아울렛][지이크F]지이크파렌하이트 FQVAD4225 베스트,59000,56050,-2950
2018-06-01,692899236,C011020,남자상의,S/S신상 인기 슬랙스/정장바지/무료배송/슬림/와이드,20900,18900,-2000
2018-06-01,1541892908,C013010,점퍼,아둘 패밀리룩 조던 민소매 메쉬 상하의 나시세트 52,15900,15900,0
2018-06-01,1612986864,C013010,점퍼,민트버클퍼무스탕,144900,144900,0
2018-06-01,565957829,C013040,청바지,[가바] COOLMAX STRETCH 데님 여자 2종,49000,49000,0
2018-06-01,1805267494,A014010,우유,상하목장 유기농우유 멸균우유 200ml 24팩,19900,19900,0
2018-06-01,684892973,C013020,티셔츠,[엠폴햄] 모던 오픈 카라 파자마 반팔 셔츠 EPY2TT1106A,39900,33920,-5980
2018-06-01,1806421103,L021020,장신구,[바보사랑]지그재그 꽃송이 드롭귀걸이,10320,10320,0
2018-06-01,735089758,A019050,간장,테라오카 계란간장 7종 버터 저당 김맛 낫또 명란마요,3300,3300,0
2018-06-01,574720961,C014020,유아복,[압소바] 피터나염상하복 AO3512P2 반팔상하복 NC아울렛,36000,7200,-28800
2018-06-01,1806421107,L021020,장신구,[바보사랑]데일리 귀걸이 6종 세트 24번,6320,6320,0
2018-06-01,1479003835,A011170,떡,국내산 쌀 떡국 떡 떡볶이 1kg+1kg 총 2kg 가래떡,6000,5900,-100
2018-06-01,1806421105,L021020,장신구,[바보사랑]큐빅 자개 드롭귀걸이,11920,11920,0
2018-06-01,1172596165,C013050,운동복,[정품] 아디다스 티로17 트레이닝 팬츠 유소년 (BQ2726),30500,30500,0
2018-06-01,1606126363,E061020,섬유유연제,다우니 대용량 섬유유연제 3Lx6개 총18L 1박스,41400,41400,0
2018-06-01,1181546413,C011050,남자내의,남자 신상 밴딩팬츠 린넨팬츠 조거 밴딩슬렉스 청밴딩,18800,18800,0
2018-06-01,722476368,E061100,습기제거제,[생활공작소] 제습제 520ml x 32입 습기제거제/장마,21900,21900,0
2018-06-01,808186028,A016100,수박,(1+1) 꿀수박 여름수박 8~11kg,9900,9900,0
2018-06-01,379335380,L021010,손목시계,로제타 여성 손목시계 FW-26 손목시계 이쁜시계 시계,12990,12990,0
2018-06-01,899521225,A013130,오징어채,올리브유로 구운 쥐포채 (110G),5990,5990,0
2018-06-01,674538740,C013020,티셔츠,따뜻한 목폴라 티셔츠/기모목폴라/ 터틀넥[긴목/반목],6000,5900,-100
2018-06-01,895745549,L012010,면도기,[도루코]도루코 일회용 면도 (10입),2600,2600,0
2018-06-01,1015229346,C012040,여자학생복,[비씨비지] 조엘 프릴 모직니트 B8A1K404 (2001중계),264000,158000,-106000
2018-06-01,1379473340,A014020,분유,일동 산양분유1단계 400g 1캔,23900,20900,-3000
2018-06-01,518332295,F012010,종이기저귀,리베로 기저귀 팬티6단계40매x4팩/ 리베로,69900,69900,0
2018-06-01,113801191,E051030,디지털도어록,디지털도어락 SHP-DS700 삼성스마트도어록O!/번호키,122450,110000,-12450
2018-06-01,1248770573,A013070,굴,[대게직거래장터]3kg 5kg 러시아대게 스노우크랩 대게,108000,108000,0
2018-06-01,959612681,A011010,쌀,예산 내포쌀(포)/20KG,49900,49900,0
2018-06-01,1804466056,A016020,배,신고배 대용량특가~8kg(9900원) 가정용 신고배~,9900,9900,0
2018-06-01,2037182407,A022010,주스,상쾌한 맛 코카 미닛메이드 포도 350ml x 24페트 착한가격 좋은 음료(묶음가능개수 :,50060,50060,0
2018-06-01,451922106,E031130,보온매트,한일 무자계약돌매트 싱글전기매트 1난방 무전자전기,155490,155490,0
2018-06-01,1120409633,A013170,생선통조림,[동원]라이트스탠다드참치135g*10캔+고추참치85g*3캔,18900,18900,0
2018-06-01,653714029,L021030,가방,[사계절용/국산] 신사 비지니스 정장양말 7족/10족 [고급 손봉조/사계절용][KJC/피에르,25300,25300,0
2018-06-01,434444203,A016150,아몬드,생 캐슈넛 500gx2/볶음 캐슈넛/양념캐슈넛,15900,15900,0
2018-06-01,2044597146,A011110,당면,[(주)하늘찬]구 덕상식품 하늘찬 연두부 300g×40개,24640,24640,0
2018-06-01,895745557,A021010,커피,동서 맥심 모카골드믹스 20T*12G,3790,3790,0
2018-06-01,895745556,A021010,커피,[동서]동서 맥심 모카골드리필 170G,7990,6990,-1000
2018-06-01,132982048,A014020,분유,트루맘 슈퍼프리미엄퀸 1단계  4 단계 - 3캔 800,86000,86000,0
2018-06-01,58088095,A012010,국산쇠고기,효도 견과세트 2호(고품격 웰빙 선물세트)사은품 답례,87700,87700,0
2018-06-01,2124328457,C013020,티셔츠,L~3XL/빅사이즈티셔츠/큰티/라운드티/티/남자,24900,24900,0
2018-06-01,318832339,C012020,원피스,여성정장 투피스 자켓 치마 바지 유니폼 오피스1,59000,59000,0
2018-06-01,1196804278,E031010,전기밥솥,쿠첸 6인용 전기압력밥솥/전기밥솥/밥솥 CJS-FC0605F,101000,101000,0
2018-06-01,1801974863,C013040,청바지,[클라이드] 여성 테이퍼드 워싱 데님팬츠_FIBDP763F_NC아울렛,89800,44900,-44900
2018-06-01,2056554320,C013030,스웨터,오렌지 양털 후드 캐주얼후드티 캐쥬얼후드티 남성용,38210,38210,0
2018-06-01,1592259661,C011050,남자내의,미노갤러리/남성 카고 바지모음/골덴배색/작업복카고,6900,6900,0
2018-06-01,1818375962,A013170,생선통조림,오뚜기참치1.88kg 동원참치1.88kg/꽁치1.8kg,16900,16900,0
2018-06-01,1326660357,C021040,실내화,[푸마] (SIZE : 255) 플레어 2(18951701) 신발 러닝,85190,85190,0
2018-06-01,895745553,A021010,커피,[동서]동서 맥스웰하우스 화인(리필/500g),9900,9900,0
2018-06-01,1724200626,C013020,티셔츠,여자티 여성티 반팔티 브이넥티 기본티 롱티 무지티,8800,8800,0
2018-06-01,1216691904,L021030,가방,30%쿠폰! 쉬즈라루즈 PVC백/여성가방/숄더/크로스백,19900,19900,0
2018-06-01,1163861898,F012010,종이기저귀,슈베스기저귀 밴드 팬티 1+1 총2팩 썸머여름 체험특가,9800,9800,0
2018-06-01,1856687690,L012010,면도기,깜짝할인/질레트 퓨전파워/프로글라이드 면도날 4입,15900,14900,-1000
2018-06-01,1488380389,A016150,아몬드,아몬드/호두/아몬드슬라이스/견과류/아몬드분말,12600,12600,0
2018-06-01,229881268,E031080,선풍기,신일 16 벽걸이 원세라믹히터 SEH-1250WOH(1250W),52500,52500,0
2018-06-01,229881267,E031080,선풍기,홍진 원통형 근적외선 히터 DD-2500/카본 2.5K(루비램프),63700,63700,0
2018-06-01,987318406,A013140,북어채,[바다원]오족 (가문어다리) 170g,6000,6000,0
2018-06-01,1822021157,E031120,믹서,[사은품 증정]한일전기 대용량믹서기 HMF-3260S,89000,89000,0
2018-06-01,907917580,I012010,컴퓨터,삼성노트북 렌탈/미사용 전시품 최대70% 할인판매,257000,257000,0
2018-06-01,960267965,E061090,방향제,페브리즈 비치형 다우니(5.5ML),6800,6800,0
2018-06-01,1541855901,D031010,주택수선재료,[던에드워드]워싱페인트 SPMA20 VELVET 200ml- 저광의,4600,4240,-360
2018-06-01,1276454943,I031040,생화,등산/무릎보호대/스프링4개/기능성극대화/세트상품/,21800,19800,-2000
2018-06-01,1616302309,E031120,믹서,한일믹서기 핸드블랜더 미니믹서기 분쇄기 핸드믹서기,39800,39800,0
2018-06-01,1025713173,C012060,여자내의,타미힐피거여성 스트라이프 플레어 스커트TFMS3SSE21A0,175500,175500,0
2018-06-01,987318403,A013140,북어채,[바다원]꼬마 미니 한치 150g (약 10마리),8600,8600,0
2018-06-01,962049185,A019080,고추장,순창 태양초 고추장3kg 재래식 된장 쌈장/해찬들/청정,9900,9900,0
2018-06-01,1466646993,A011010,쌀,추청경기미 안성쌀5kg 밥선생,16900,16900,0
2018-06-01,987318404,A013140,북어채,[바다원]오징어실채 200g,6000,4900,-1100
2018-06-01,1550537784,A017170,풋고추,충남 공주 GAP인증 백오이 30개/50개/백다다기오이,17300,17300,0
2018-06-01,59897787,C013040,청바지,0340_고구마베이비 베이직 연청/청 스키니 진 청바지,28970,28970,0
2018-06-01,982434449,A017020,상추,SF)돌나물(팩),990,990,0
2018-06-01,245889111,C011030,남자학생복,뉴욕 집업가디건 sj174-002 남성캐쥬얼.캐쥬얼가디건.,39300,38520,-780
2018-06-01,209751706,C021040,실내화,[게스슈즈] (SH2K5A52 BLK) 17SS 스퀘어중창의 스트랩샌들,59000,50150,-8850
2018-06-01,1191598755,L021030,가방,::예쁜 국내제작 20종!!::무료배송!!/플라워백/에코백/크로스백/숄더백/캐쥬얼백,17400,15900,-1500
2018-06-01,550551424,C012040,여자학생복,[밸리걸]자수 포인트 프릴소매 블라우스(971730)(인천점),24900,22230,-2670
2018-06-01,1733796685,E031010,전기밥솥,(추천)쿠첸10인용 명품철정 IH압력밥솥 CJH-PF1010ID,199000,199000,0
2018-06-01,152156895,A013090,전복,부경 냉동반가리비 2.1kg(210gx10),65490,65490,0
2018-06-01,1068586353,E031080,선풍기,굿프렌드_프리미엄 욕실난방기 실버 (HR1-023),59500,59500,0
2018-06-01,627735918,A013100,마른멸치,[일촌일품] 완도 활 전복 大 세트 1kg 14-15미,30850,30850,0
2018-06-01,1068586352,E031080,선풍기,굿프렌드_스마트 욕실난방기 골드 (HR1-022),39500,39500,0
2018-06-01,616246607,A014010,우유,델릭우유/멸균우유/도브레우유 1Lx12팩/우유/두유,23900,23900,0
2018-06-01,1985965679,A012010,국산쇠고기,정남진 장흥한牛 장흥한우 국거리용 500g /(참고) 한,60400,53160,-7240
2018-06-01,619438037,A013100,마른멸치,(전남오픈마켓/민우수산)꼬마전복 35~50미 1kg,27900,27900,0
2018-06-01,1088290591,A018110,물엿,물엿/식초/뉴크린/락스/석쇠크린/불판/퐁퐁/물엿/석쇠크리너/불판/주방세제/조청/설탕,9500,9500,0
2018-06-01,800470184,A021010,커피,ESE 파드커피 모음 일리 라바짜 킴보 트롬베타 이쪼,11000,11000,0
2018-06-01,1685529453,C014010,아동복,카라멜플라츠 이야이야오 플레이펀 초경량 점퍼 3종택1 78L0336,29610,29610,0
2018-06-01,1805424424,A022030,생수,트레비/500mlx20/플레인 탄산수/라임/레몬/자몽/,14200,14200,0
2018-06-01,2012324905,F011150,건강기능식품,국산헛개차 CJ 헛개수 340ml x 20병 컨디션 헛개수,9020,8390,-630
2018-06-01,524063496,A018060,스낵과자,자색고구마튀김 칩 500g 고구마스틱 대용량 옛날과자,3900,3900,0
2018-06-01,1577471629,C012060,여자내의,푸조 워테레깅스 ( S26-3 ),28550,24270,-4280
2018-06-01,1154362791,C014010,아동복,[아이러브제이]OT1. 품질.색감.소재 역시 J 브이넥 티 JPFTO33-DA1C,8200,7420,-780
2018-06-01,172256792,C013020,티셔츠,반하이넥망사이너티/시스루티/섹시티/레이어드/반폴.,7900,7900,0
2018-06-01,2007886380,L012110,색조화장품,[만족도100%]No끈적임/입소문 썬크림(SPF50+/PA+++),9900,9900,0
2018-06-01,985354960,A013130,오징어채,왕쥐치포 150G/봉,6990,6990,0
2018-06-01,1137214582,C011030,남자학생복,[제이에이치스타일]유럽 아가일 니트조끼 JHVS052.[DS],38800,36860,-1940
2018-06-01,797598692,A019080,고추장,해찬들 태양초골드 고추장(1KG),12780,12780,0
2018-06-01,985354961,A013130,오징어채,왕꼬마 쥐포 120G/봉,8990,8990,0
2018-06-01,440319637,A018090,잼,오뚜기 후루츠잼500gX12개(1박스)포도잼 후루츠잼 딸,95100,83690,-11410
2018-06-01,1378246964,C013040,청바지,[시에로][18S/S]빈티지 워싱 구제 연청 세미 붓컷 데님(SE2DPF248)[갤러리아],159000,122430,-36570
2018-06-01,1959018509,L012090,기초화장품,참존 징코 내추럴 클린싱크림 200g,6200,6200,0
2018-06-01,985268589,A013110,마른오징어,웰빙 뱅어포( 5장/봉),6990,6990,0
2018-06-01,1884856045,A014040,발효유,대상 요거트 파우더 1kg / 요거트 분말 음료수 커피몰,9000,9000,0
2018-06-01,2027606344,C013010,점퍼,봄여름 마이/자켓/콤비/남자/최고급소제/린넨/95-110,62800,62800,0
2018-06-01,429175232,A019020,참깨,들깨가루 (산들샘 1k) X10,330580,294220,-36360
2018-06-01,277012108,A022050,탄산음료,썬키스트음료/멜론/자몽소다/칵테일/모히또(340mlx24),12500,12500,0
2018-06-01,1116610642,C021040,실내화,아키클래식 프리미엄 부띠끄 스니커즈 9종,92000,92000,0
2018-06-01,1786514092,A016110,딸기,세미원 냉동 딸기 1kg 2개,25480,25480,0
2018-06-01,1245575487,A011180,파스타면,(덤 10+1)오뚜기 스파게티면 500g /마카로니/파스타면,790,790,0
2018-06-01,1527326103,A019160,밑반찬,종가집반찬 된장깻잎지 150g /공식대리점,3000,3000,0
2018-06-01,1633926365,E011020,침대,무료배송 레이디가구 스칸딕 원목 침대(SS/Q),199000,199000,0
2018-06-01,663494095,A016100,수박,델리참_국산가당 딸기 1kg x 5개입 / (주)남양냉동식,58100,49390,-8710
2018-06-01,78677377,E021010,침구,[슈에뜨룸]사계절침구세트/이불패드세트/차렵이불세트,32900,32900,0
2018-06-01,1676356001,A022050,탄산음료,[동아오츠카] 동아오츠카 오로나민C 120ml x 50병 비타민음료,28600,28600,0
2018-06-01,878870334,A019060,된장,ⓒ 해찬들 재래식된장(500G),1650,1650,0
2018-06-01,434926470,C012060,여자내의,에어 와이드 팬츠 LRP022 통바지 와이드팬츠 (YA02004,40510,35650,-4860
2018-06-01,124724351,I031040,생화,새총 새총총알 쇠구슬-1550알+ 새총가죽 1장,10000,9200,-800
2018-06-01,582759564,L021020,장신구,스피도미터 오피셜 ] 스피도미터 반지 실버링,154000,154000,0
2018-06-01,1991006209,C013050,운동복,(정빈산업) 앵글포유 LED 삼각대 경광봉형 차량안전삼,40140,40140,0
2018-06-01,1761031320,C013040,청바지,[PLAC Jeans]여성 [PLAC]플랙Pony 98V raw (PJOE1PO98V198V)(강남점),69000,60240,-8760
2018-06-01,149238345,C012040,여자학생복,여성의류! 셔츠/블라우스/원피스/가디건/팬츠,9900,9900,0
2018-06-01,1385828196,A011160,빵,안흥찐빵마을 우리밀우리팥 수제 흑미찐빵 (500g 10입,36920,36920,0
2018-06-01,592322872,A011040,보리쌀,2017년산 국내산 햇 서리태 2kg/약콩(서목태)2kg,29500,29500,0
2018-06-01,1704726451,L021020,장신구,1부다이아 남성반지/14k골드/곡선라인/예물/4731,309000,309000,0
2018-06-01,1010347690,E041040,프라이팬,라체나스톤마블프라이팬30cm,15900,15900,0
2018-06-01,762177534,C013050,운동복,주차금지표지판 주차금지 주차표지판 강철 철재 주차,19500,19300,-200
2018-06-01,1311468872,C012030,여자상의,리본디테일원피스 RI1710 라운드넥라인 리본원피스 원,44060,44060,0
2018-06-01,140126588,C011030,남자학생복,팝아이즈 컬러 블록 패딩베스트_PPOIIPV01U,59000,50150,-8850
2018-06-01,984461134,A021010,커피,[동서]동서 카누 디카페인 아메리카노 10T*1.6G,3890,3890,0
2018-06-01,697086760,F012010,종이기저귀,사은품+하기스매직팬티 3~6단계/3팩/4팩/밴드1~5,56500,56500,0
2018-06-01,892158354,E011030,거실장,린넨 더블 와이드 2단 서랍장,52900,52900,0
2018-06-01,1623384856,A015020,식용유,트레드키 NON-GMO 콩기름 18L 업소용 식용유,25500,25500,0
2018-06-01,1349370212,C012030,여자상의,땡땡이 언발 뷔스티에원피스,26500,26500,0
2018-06-01,984461131,A021010,커피,[네슬레]네스카페수프리모리필150G,8900,8900,0
2018-06-01,895804206,A014010,우유,[매일]매일 소화가잘되는우유 (930ML),3200,2950,-250
2018-06-01,895804209,A019110,드레싱,CJ 오리엔탈 드레싱(260G),3580,3580,0
2018-06-01,1196784941,C013010,점퍼,[대구백화점 II관] [르피타]썸머후드P점퍼(L182CJP551),79800,75020,-4780
2018-06-01,895804208,A019110,드레싱,CJ 키위 드레싱 (250G),3580,3580,0
2018-06-01,367062995,C012040,여자학생복,FREE 뒷목하찌여자긴팔니트티,12970,12970,0
2018-06-01,668488687,C021040,실내화,아디다스/나이키 슬리퍼/운동화/반팔티셔츠/반바지,16500,16500,0
2018-06-01,1202598985,C013020,티셔츠,엄마옷 주름라운드반팔티셔츠-XTE804078-/ 마담4060,27900,25950,-1950
2018-06-01,631714358,E061030,전구,삼파장전구/삼파장램프/EL램프/PL/형광등,890,810,-80
2018-06-01,484251860,C013050,운동복,야간 안전 삼각대 안전 지시봉 /접이식 비상 삼각뿔 비상등/4가지 기능의 고급 경광봉,6000,6000,0
2018-06-01,1454899652,A017200,토마토,무농약 가지 자색가지 특품 4개/봉 볶음조림,3700,3700,0
2018-06-01,565605497,C011030,남자학생복,PBM3401 데님스판청자켓,59770,59770,0
2018-06-01,2051313294,C013010,점퍼,[푸마] (사이즈 : XL(105)) 아스널 컵 롱 벤치 자,206530,206530,0
2018-06-01,1153996595,A022010,주스,코코씸 코코넛 워터 오리지널 330ml 1박스(12개입),11200,10820,-380
2018-06-01,895804204,A011090,국수,[오뚜기]오뚜기 매콤한맛 컵누들(37.8G),1050,1050,0
2018-06-01,1998179796,A019030,생강,하지카미 (생강순 605g) X10,282880,251770,-31110
2018-06-01,955202771,L021030,가방,수제가방 이니셜새겨드립니다.,178000,178000,0
2018-06-01,396078012,I031040,생화,캠핑의자 릴렉스체어 야전침대 야외 접이식 침대의자,27900,24840,-3060
2018-06-01,1054227468,C012020,원피스,부천) 몽고진간장13L,28100,28100,0
2018-06-01,802628191,A012060,햄및베이컨,사조 베이컨 1kg/햄버거/토스트/소시지/햄/브런치,13900,13900,0
2018-06-01,528739920,E031010,전기밥솥,쿠쿠고무패킹 CRP-DHR067FS/CRP-DHR0610FS,8500,8400,-100
2018-06-01,451025560,A013150,어묵,에프에스 꼬치어묵 700g2개 어묵 꼬치어묵 냉동식품,20640,18580,-2060
2018-06-01,1570269323,C021010,아동화,[르까프] 키즈 보아다이얼 아동화 테라 1117 KS201 3종택1,54500,45420,-9080
2018-06-01,1010286178,A011160,빵,[중앙일보 농마드] 안흥찐빵 3종세트 (안흥찐빵+흑미찐빵+단호박찐빵 각 10개입 1팩씩),19900,18200,-1700
2018-06-01,1010286179,A011160,빵,[중앙일보 농마드] 우리밀 안흥찐빵 3종세트 (안흥찐빵+흑미찐빵+단호박찐빵 각 10개입 1팩씩),21500,20500,-1000
2018-06-01,1395404786,C013030,스웨터,매그넘 하찌 언발 롱니트 여성티셔츠DM-5244,41700,39620,-2080
2018-06-01,987791828,C012030,여자상의,홀복/레이스원피스/섹시원피스/미니원피스/오프숄더,28900,28900,0
2018-06-01,1126376427,A016070,귤,싱싱몰 제주서귀포하우스감귤5kg 꼬마,39900,39900,0
2018-06-01,829405456,E031110,청소기,FC6144/01 필립스 핸디형청소기 2중필터시스템 ens,56500,52460,-4040
2018-06-01,2018819339,A014020,분유,액상분유 20/24입 1-3단계 180/240ml,29900,29900,0
2018-06-01,525664378,A018090,잼,[메가마트] 복음자리 딸기쨈 380g,4680,4680,0
2018-06-01,1262614750,C012060,여자내의,[멋진큰옷 빅댄디] 멋진걸32-40 카고 느낌으로/슬림포켓카고팬츠/빅사이즈여성카고바지,32800,32800,0
2018-06-01,1212376755,C012020,원피스,[예쎄]예쎄_ 루즈핏트렌치코트_YP10BY02,39000,32370,-6630
2018-06-01,447478354,C012030,여자상의,[무료배송]빅사이즈 DBR1267 벨 타이 원피스 802S 큰,77380,77380,0
2018-06-01,555048137,C013020,티셔츠,빅사이즈민짱/심쿵 신상티모음/롱/루즈핏/무지,9900,9900,0
2018-06-01,440319451,A018090,잼,오뚜기 사과잼300gX15개(1박스)포도잼 후루츠잼 잼 딸,80500,70840,-9660
2018-06-01,1073720010,E031010,전기밥솥,쿠첸 리홈 정품 패킹/ 밥솥패킹/ IH패킹/ 압력밥솥/SY,8500,8500,0
2018-06-01,1405267708,E021010,침구,W호텔 코마사 트윌면 이불커버 패드 S Q K LK 36컬러,38900,38500,-400
2018-06-01,1326635277,C021040,실내화,[푸마] (SIZE : 265) 플레어 2(18951701) 신발 러닝,85190,85190,0
2018-06-01,895591841,C012060,여자내의,여성 기모청레깅스/여자기모레깅스/여자레깅스/레깅스바지/여자쫄바지/여성쫄바지/여자,5670,5670,0
2018-06-01,741438054,C012040,여자학생복,[ab.f.z][17여름] [가격인하] 러블리 골지 가디건(AFR3GK11E)[갤러리아],19000,15200,-3800
2018-06-01,229795017,A017160,오이,[가온애]깨끗한 목이버섯 대용량 표고버섯 건표고 버섯 표고 건버섯 나물 건나물 건조,6000,5800,-200
2018-06-01,793054266,I031040,생화,헬리녹스 Helinox 체어원 캠핑의자/초경량/등산용의자,102380,90000,-12380
2018-06-01,1345950639,L021020,장신구,듀얼 큐빅 초커 목걸이 화사한 초커 2줄 큰 목걸이 네,24080,24080,0
2018-06-01,895804232,A021010,커피,[동서]동서 맥심모카믹스 180T + 20T증정,25400,21900,-3500
2018-06-01,1002016650,A017020,상추,[2018 햇마늘 출하!] 해남밭마늘 반접(50개),10000,10000,0
2018-06-01,586053120,I031040,생화,용성 바다 릴낚시대 나이아드기 1호 1.7호 2호-530,117000,97300,-19700
2018-06-01,1058592799,A013090,전복,청정남해 자연산가리 통영가리비1kg,5850,5850,0
2018-06-01,466537397,E041010,식기,라인 멜라민그릇 면기 라면그릇 우동그릇 라면기 볼,600,550,-50
2018-06-01,511246328,E061100,습기제거제,[무료배송]습기쏙쏙/참숯함유/장마철제습제/물먹는하,17400,17400,0
2018-06-01,1302004415,L012040,치약,(CMIT/MIT 無) 덴티스테 치약 대용량 1+1 묶음구성,23800,17900,-5900
2018-06-01,1301044896,C012060,여자내의,[올리비아하슬러](올리비아하슬러) 스티치 디테일 7부 팬츠 (OH6MDP104),42300,36810,-5490
2018-06-01,1999972176,C014010,아동복,아둘 가족티 쥬니어 옐로우 팔라스 반팔티셔츠 28,11100,11100,0
2018-06-01,1631676237,A022030,생수,롯데칠성몰 생수 아이시스 8.0 2L/1L/500ml/300ml,8900,8900,0
2018-06-01,955887014,A018040,아이스크림,찰떡아이스 (10개),12000,9600,-2400
2018-06-01,1535985714,C013020,티셔츠,국내 슈프림 남여 반팔티 반바지 장우산 모자,12900,12900,0
2018-06-01,1688231700,L021020,장신구,은 엥게지 링반지 커플반지 애끼반지 은팔찌 은목걸이,5000,5000,0
2018-06-01,2075506905,E011060,의자,땅콩의자/키높이/식탁의자/컴퓨터의자/플라스틱/보조/간이/카페/식당/학원/공부방/원형,19900,19900,0
2018-06-01,582186390,L021020,장신구,[1부현대감정]14k/18k 천연다이아몬드 락테아 귀걸이,456000,456000,0
2018-06-01,1934004765,E021010,침구,순면 폴더 놀이방매트커버/패드 요매트 유아매트/토퍼,29800,27420,-2380
2018-06-01,1999729064,L021020,장신구,925 순은 팔찌 실버 DIY 판도라 참 패션팔찌 실버팔찌,9900,9410,-490
2018-06-01,1826452830,C013040,청바지,[게스키즈] 게스키즈블링스키니진G81KCP921,83000,66400,-16600
2018-06-01,1306800202,A019040,소금,[개암죽염] 3회 알칼리 죽염 150g 생활 죽염소금,9000,9000,0
2018-06-01,1265893544,L021010,손목시계,로제타 여성 손목시계 FW-15 시계 손목시계 팔찌 팔찌,13630,13630,0
2018-06-01,1927470867,C015040,장갑,GC바우데 라이크라등산장갑(남성용/여성용)신축성,8900,7970,-930
2018-06-01,154581599,C021040,실내화,나이키 특가 다운쉬프터 탄준 여성 남성 운동화 신발,24800,24800,0
2018-06-01,186714270,E011050,책상,컴퓨터책상 원목책상 다용도책상 좌식책상,49000,49000,0
2018-06-01,1855355214,A016070,귤,42516/ 화남-밀감(850gX12캔),48790,48790,0
2018-06-01,1347957340,E011020,침대,정품 단면매트리스 하포스침대/슈퍼싱글/더블/퀸,74900,66670,-8230
2018-06-01,817795906,A019080,고추장,해찬들 알찬 고추장(4.5K),19180,19180,0
2018-06-01,1441521570,C013010,점퍼,15%단골할인 갠소 개인몰 인기상품 셔츠/맨투맨/후드,22100,19900,-2200
2018-06-01,562353995,E041070,밀폐용기,총알배송/생수병/맥주병/공병/페트병/플라스틱용기,1000,920,-80
2018-06-01,1137491179,A012060,햄및베이컨,초리조 이베리코 데 베요타 100g 하몽/팔레타,10900,10900,0
2018-06-01,832335899,C012040,여자학생복,[막스까르띠지오]시스루 플라워 자수레이어드 SET,69000,57960,-11040
2018-06-01,2004005739,C012040,여자학생복,케네스레이디 플라워 블라우스 EGBLHG98,35620,35620,0
2018-06-01,895828234,A014010,우유,빙그레 바나나라이트 (240ML*4입),4280,3600,-680
2018-06-01,1073868909,A014020,분유,(48입) 2/3단계 6~24개월 베비언스 액상분유 240ml,69900,69900,0
2018-06-01,1484115824,C013020,티셔츠,최고급 면셔츠/중장년용 카라넥 긴팔셔츠/골프셔츠,19800,19800,0
2018-06-01,895828233,A014010,우유,빙그레 바나나라이트 (240ML),1070,900,-170
2018-06-01,891756050,C013020,티셔츠,슬림실켓스판티/라운드티/남자티셔츠/면티/긴팔티셔츠,9900,9900,0
2018-06-01,397476489,E061020,섬유유연제,샤프란 섬유유연제 용기 3.1L x 4개 외,12900,12900,0
2018-06-01,1468562093,A012010,국산쇠고기,[무항생제] 불고기샤브샤브 500g 1등급,25900,25900,0
2018-06-01,2081903038,C013050,운동복,클레이바/성애제거제/낙진제거제/물제거/타르/철분,6000,2480,-3520
2018-06-01,1862227086,A022010,주스,박스[청솔]진매실청1.5리터x6개(6 900),41400,41400,0
2018-06-01,223336912,I011010,TV,삼성전자 UN55K5110BF 초이스 Full-HD TV,701780,681780,-20000
2018-06-01,1790003689,A013070,굴,◈TV홈쇼핑정품!!◈조선대가 전통 간장 꽃게장 2.4Kg 간장게장/ 젓갈/게뚜껑/전통방식,49310,49310,0
2018-06-01,726321829,C012040,여자학생복,클리어런스세일 폴로POLO002여성니트티 브이넥니트,38900,38900,0
2018-06-01,571859067,C015040,장갑,양가죽 무스탕 벙어리 여성장갑 따뜻한장갑 양가죽장,26920,26920,0
2018-06-01,2068276517,C012020,원피스,빅사이즈/아이스/포켓/가디건 / 참고 아이스포켓가디,50200,42670,-7530
2018-06-01,895804262,A014030,치즈,매일 상하더블업치즈 360G,6800,4200,-2600
2018-06-01,696428292,C011030,남자학생복,폴로카라티 가디건 반집업니트 빅포니 주니어 스웨터,64900,64900,0
2018-06-01,2145028224,I053040,기타문구,3M 포스트잇 인덱스탭/메모지/플래그/모양노트/모음전,1100,1100,0
2018-06-01,961433689,A011180,파스타면,[농심]농심 생생우동 봉지 3입 멀티 (253G*3),4900,4900,0
2018-06-01,428622058,A011140,부침가루,[삼립] 삼립 까망베르 62g 3개 케이크 조각케익,6840,6840,0
2018-06-01,1699998915,L021030,가방,삼성노트북 13인치 15인치 노트북 파우치 케이스 가방,13900,13900,0
2018-06-01,451204240,C012040,여자학생복,[더미니][3color]체코 나시BL린넨후레아,27600,26500,-1100
2018-06-01,1462490957,E031110,청소기,미국 1위 BISSELL 비쎌 슬림 스팀청소기,249000,249000,0
2018-06-01,367637285,I053020,스케치북,캐릭터 8절 스케치북 5권 10권 종합장 물감 뽀로로,3400,3400,0
2018-06-01,1575142641,C014010,아동복,[빈]BS27TS03WT/BS27PT03GY 화이트댕깡 티셔츠 다이마루팬츠 세트,44000,36520,-7480
2018-06-01,1025933779,C012060,여자내의,핫팬츠 면바지 P 6612 하이웨스트워싱면스판3부 3부,14820,14820,0
2018-06-01,1293628119,C012060,여자내의,스커트를 입은듯한 큐롯반바지 숏팬츠 치마바지,8100,7700,-400
2018-06-01,895804271,A019130,스프,[CJ]CJ 맛밤 패밀리팩 80g*3입,8950,5490,-3460
2018-06-01,950655557,C011050,남자내의,[바이더알]ByTheR 블랙 크로스 송치 트레이닝 배기 반바지,53130,50480,-2650
2018-06-01,1231568905,E051020,건전지,18650배터리 페어맨 3500 리튬 충전지 배터리 건전지,9900,9900,0
2018-06-01,1449154654,A021020,차,알뜰 동서 프리마 1.6kg/맥스웰 화인 네스카페,5420,5100,-320
2018-06-01,1424080523,C021020,구두,토즈 고미노 드라이빙슈즈/모카신 XXW00G00010 모음전,375000,327080,-47920
2018-06-01,827851814,C012060,여자내의,캐서린 쉬폰바지 SD-6288 마바지 통바지 밴드바지 린,12180,12180,0
2018-06-01,1207745605,C013010,점퍼,아디다스 트레이닝 니트 트랙탑(B05273) 트레이닝점퍼,61960,61960,0
2018-06-01,989020302,A019150,김치,[종가집]종가집 포기김치 900G,9800,9800,0
2018-06-01,989020301,A019150,김치,종가집 맛김치 900G,9500,9500,0
2018-06-01,5416225,A022030,생수,생수 500ml 40개입 삼다수 스파클 석수 천연수 물,9900,9900,0
2018-06-01,989020303,A019150,김치,[종가집]종가집 시원깔끔포기김치 1.7KG,17800,17800,0
2018-06-01,895828259,A022050,탄산음료,코카콜라 제로(PET/1.5L),2890,1900,-990
2018-06-01,2061316686,C013010,점퍼,여성쉬폰망사가디건/후드집업/여름비취조끼/바람막이,30000,27000,-3000
2018-06-01,1873115638,A014040,발효유,서울 짜요짜요 복숭아 딸기 포도 (냉장배송) 짜요포도,1900,1850,-50
2018-06-01,1019895614,E031050,냉장고,LG전자 K337W11 스탠드형 김치냉장고 사은품행사,1150000,1070000,-80000
2018-06-01,427861699,E021010,침구,동물원 매트커버세트 아동침구 아동이불 아동매트 매,92920,84640,-8280
2018-06-01,215475563,C011030,남자학생복,[메이드]셔츠/남방/반팔/7부/린넨/체크/남자남성/데님,10000,9800,-200
2018-06-01,167740249,C013020,티셔츠,4계절 필수 기본나시모음!/끈나시/롱나시/여성나시,3000,2900,-100
2018-06-01,1962063912,C011050,남자내의,[게스]GUESS 여성 아이스 숏 데님 팬츠(YG2D9956),29000,23780,-5220
2018-06-01,213394532,E011030,거실장,[오드리 모던 거실장]tv다이/티비다이/tv장/거실장,98000,98000,0
2018-06-01,1622400106,E011060,의자,(무료배송) 의자부품 의자바퀴 의자다리 의자팔걸이,10000,10000,0
2018-06-01,1246529186,C012040,여자학생복,[로렌즈앤]로렌즈앤 마들렌롱니트가디건,27800,26410,-1390
2018-06-01,1469705388,A017050,미나리,(맛나)#양배추(국산)1통,7700,6930,-770
2018-06-01,1246529182,C012040,여자학생복,[로렌즈앤]로렌즈앤 DK롱니트가디건,19800,18810,-990
2018-06-01,1867401130,C012040,여자학생복,블루페페 가디건(P172KSL806),35700,30350,-5350
2018-06-01,1182413888,I031040,생화,충전식 센서 헤드랜턴 캡라이트 방수랜턴 수중후레쉬,9900,8800,-1100
2018-06-01,720425584,A017170,풋고추,(전남오픈마켓/남도농산)덖음여주50g/여주/국내산여주/국내산/여주100%/남도농산/여주,10000,10000,0
2018-06-01,4743026,E011050,책상,베스트리빙 딜)베이직 철재 컴퓨터책상/조립식책상,20900,20900,0
2018-06-01,1542935397,C013040,청바지,여름신상 청바지/남자청바지/카고바지조거/스판/남성,17900,17900,0
2018-06-01,1129862961,C011030,남자학생복,ACC(필골드) PT718 꽈베기 가디건 8종중 택일 긴팔남,25930,25930,0
2018-06-01,520454244,C014010,아동복,[로리앤콜린]신상상하복업뎃반값세일!!국내생산,8900,8900,0
2018-06-01,1967592762,A018070,파이,카스타드/마가렛트/초코파이/몽쉘/오예스/빅파이,35000,35000,0
2018-06-01,2115573607,E031030,전자레인지,SK매직 20L 실속형 전자렌지 MWO-18M2[1년 무상A/S],58400,58400,0
2018-06-01,1994400149,A018100,꿀,잡화꿀 (다드림 2K),30350,27020,-3330
2018-06-01,2008199817,L021020,장신구,[패션플러스][호림쥬얼리]실버92.5정품)히트)순은(HR)실버 남성용 태왕 목걸이,39000,37050,-1950
2018-06-01,1046584198,F012020,생리대,바디피트 중형 50매/순수한면100매/생리대/팬티라이너,7900,7900,0
2018-06-01,2054341651,C013020,티셔츠,T1912-여성 데일리 코제트 프릴 티셔츠 반팔티셔츠 라,44500,42280,-2220
2018-06-01,895804293,A012050,소시지,CJ 정말맛있는소시지 (160G),1300,990,-310
2018-06-01,654786282,A015020,식용유,백설 포도씨유 500mlx12개,78000,77220,-780
2018-06-01,635232220,A013070,굴,(장군수산) 검증받은 박달홍게_5마리/ 수율90%내외,34900,34900,0
2018-06-01,1042703064,A019160,밑반찬,[대천김]대천김 조미구이 재래김 20gx10봉,13900,13900,0
2018-06-01,574340882,A016090,참외,성주꿀참외 8kg이내 (크기랜덤),13900,12900,-1000
2018-06-01,1231843208,A019040,소금,인산가 3회 생활죽염 과립 1kg,36000,30960,-5040
2018-06-01,268065792,L021030,가방,여성가방 숄더백 미니백 미니크로스백 핸드백 토트백,16900,16900,0
2018-06-01,1036940778,E011030,거실장,[PookShuim] 푹쉼 마닐라 인조가죽 3인용 카우치 소파,450000,450000,0
2018-06-01,1444184084,C012060,여자내의,미시옷 플리츠롱스커트_MAR_1708 빅사이즈 여성의류,70690,63630,-7060
2018-06-01,297419231,F012020,생리대,[파우치증정] 좋은느낌 생리대 특가 구성 모음전,10500,10500,0
2018-06-01,7552091,E021020,커튼,버티컬160종/버티칼/블라인드/롤스크린,3890,3890,0
2018-06-01,931148326,C012060,여자내의,LAP 슬림 A라인 버튼스커트 (AH4DS961),25000,22500,-2500
2018-06-01,1945986198,A019080,고추장,[CJ] 해찬들 우리쌀로만든 태양초 고추장 2kg,12500,12500,0
2018-06-01,914285191,C013050,운동복,M~4XL 빅사이즈 트레이닝팬츠/츄리닝/운동복바지,10100,7900,-2200
2018-06-01,245854,D031010,주택수선재료,[물에빠진 벽지]홈쇼핑정품 조각벽지 60장 12종택1,49800,49800,0
2018-06-01,2078004018,C012040,여자학생복,[로렌즈앤]로렌즈앤 야자로브가디건,25800,24510,-1290
2018-06-01,26008960,A014010,우유,멸균우유 매일우유 서울우유 상하목장유기농우유,10530,10530,0
2018-06-01,895684080,A013070,굴,흰다리새우살(냉/태국),2890,2000,-890
2018-06-01,2078004023,C012040,여자학생복,[로렌즈앤]로렌즈앤 룩킹로브가디건,27800,26410,-1390
2018-06-01,1283992995,C013010,점퍼,[올리비아하슬러]캐쥬얼카라집업자켓_O3Q4,26900,25560,-1340
2018-06-01,552969161,A014020,분유,순산양분유 800g x 3캔 / 400gx6캔 특가[사은품 증정],87790,87790,0
2018-06-01,1357532479,A013090,전복,국산 여수 건홍합/건굴 1kg 미역국/해물탕요리재료,33900,33900,0
2018-06-01,1036940781,E011030,거실장,[PookShuim] 푹쉼 마닐라 인조가죽 대형 스툴,120000,120000,0
2018-06-01,988038167,A019120,혼합조미료,[오뚜기]향이 생생한 직접 갈아먹는 통후추 50G,5850,5850,0
2018-06-01,332519597,C012040,여자학생복,[디어제인][디어제인]세로줄베이직가디건M4526,9900,9410,-490
2018-06-01,1036940780,E011030,거실장,[PookShuim] 푹쉼 하노이 FPL가죽 3인용 카우치 소파,430000,430000,0
2018-06-01,1857299506,E041030,솥,풍년 압력밥솥 통5중 하이파이브 / 가우퍼 압력솥,92000,92000,0
2018-06-01,971235426,A013140,북어채,용대리 황태포/통황태 10미 특왕 자연건조 황태풍년,27800,27800,0
2018-06-01,138244214,A012030,돼지고기,에스푸드 불고기탑핑 1kg 2개,46000,44620,-1380
2018-06-01,1153103555,A017210,파,(특A급)산지직송 대저토마토 2.5-5KG 짭짤이토마토,29800,29800,0
2018-06-01,598577428,I012010,컴퓨터,(행사129.3만)삼성 노트북9 Always NT900X5N-X58WS,1499000,1419000,-80000
2018-06-01,1066084823,A013170,생선통조림,유동 번데기캔 280g X 24EA_1BOX 번데기 번데기통조림,51480,51480,0
2018-06-01,613075448,I031010,장난감,어린이 물고기 잡기 족대 뜰채 물놀이 채집 학습,5400,5400,0
2018-06-01,548832255,C013020,티셔츠,[밀레]여성 쿨UV2 폴라 티셔츠[MXLUT603],33000,28050,-4950
2018-06-01,1218727536,E011040,소파,국내 최고 보니타 대형 P202 야외용테라스방수빈백,82900,82900,0
2018-06-01,1996608377,E021020,커튼,[BHF]암막커튼2장+레이스커튼2장세트/봄여름 예쁜커튼,36900,36900,0
2018-06-01,1358426186,E061060,살충제,쌀벌레퇴치제x5개 인체무해 쌀벌레약 쌀벌레 제거제,7300,7200,-100
2018-06-01,203011466,A017020,상추,반찬단지 간장깻잎 4kg 2개,64780,64780,0
2018-06-01,1998128112,C012060,여자내의,랩스타일치마바지(RMTW637RQ6)/ 로엠,10000,9000,-1000
2018-06-01,2041928826,C013010,점퍼,땡..추가금없는 무조건 이가격.마지막 선착순 주문,18900,18900,0
2018-06-01,728083586,C013010,점퍼,MRBOB 신상 기모 후드티 후드집업 빅사이즈 M~3XL,24800,24800,0
2018-06-01,1265868558,L021010,손목시계,로제타 메탈 손목시계 FW-13 시계 손목시계 팔찌 팔찌,15940,15940,0
2018-06-01,883393810,L021030,가방,사계절용 정장양말/캐주얼양말/스포츠발가락,28500,27300,-1200
2018-06-01,1377597582,A021010,커피,타시모 캡슐 커피 16캡슐,7900,7900,0
2018-06-01,140806331,A012010,국산쇠고기,정남진 장흥한牛 장흥한우 꽃등심 500g 안심 500g 채,275510,245210,-30300
2018-06-01,562133224,F012020,생리대,[동아제약] 템포 10Px5팩= 총 50P /체내형 생리대/탐폰/ 템포,23500,20920,-2580
2018-06-01,693791544,C011030,남자학생복,여름신상 솔리드남방 7부 스판 반팔셔츠 50여종 체크,14700,14700,0
2018-06-01,235949740,A017210,파,국내산 대저 토마토 5kg 오직 정품 선별,25900,25900,0
2018-06-01,196337352,C013040,청바지,[바지킹]프리미엄/봄신상/당일출고/청바지/슬랙스,26900,26900,0
2018-06-01,550920864,A014010,우유,엿기름(신화 15K )/대용량 엿기름가루 식혜재료,48450,47000,-1450
2018-06-01,370126493,I031040,생화,코스모스 낚시용 아이스박스 24L 스티로폼 쿨러백,34200,30520,-3680
2018-06-01,1405666963,C014010,아동복,여름/아동/아동옷/아동의류/아동복/상하복/남아반팔,14400,14400,0
2018-06-01,581712467,I012010,컴퓨터,LG총판 LG데스크탑 Z71EV-AX7P16 펜티엄500G Free-Dos,445740,419000,-26740
2018-06-01,522119441,E011060,의자,606 하이팩의자/호국/등판대/회전형/학생의자/600,39900,39900,0
2018-06-01,551731555,I031040,생화,캠핑 테이블/피크닉/접이/바베큐/야외/레져/키친/용품,16000,14150,-1850
2018-06-01,1379688009,E041010,식기,안성/방짜/유기/수공예/손조각/매화/반상기/세트/셋트/혼수/예단/선물/외국인/식기/추,598000,598000,0
2018-06-01,667218844,C013020,티셔츠,여름 남성 보카시 남성 Y카라 반팔 티셔츠 /넉넉한 품,14800,14800,0
2018-06-01,1285016633,A013070,굴,제주 부채새우 1kg  한국판 랍스터,25000,25000,0
2018-06-01,293458776,I031070,애완동물관리비,키모니 중량테입 알파플러스(KBN261) 6개입 중량테이,14330,14330,0
2018-06-01,2078004054,C012040,여자학생복,[로렌즈앤]로렌즈앤 비잔틴로브가디건,27800,26410,-1390
2018-06-01,1851125172,C013020,티셔츠,데상트 반팔티 남자 메쉬 하계티,29000,29000,0
2018-06-01,2017206471,F012020,생리대,좋은느낌슬림날개대형생리대 32px10팩/좋은느낌대형,89900,89900,0
2018-06-01,2078004050,C012040,여자학생복,[로렌즈앤]로렌즈앤 이지로브가디건,27800,26410,-1390
2018-06-01,1893832967,L012040,치약,센소다인 멀티케어치약100gx5개/시린이/글락소스미스,18900,18900,0
2018-06-01,1133358381,E031120,믹서,[신일산업] 신일 티타늄 미니 믹서기 블렌더 SFM-7700JJH,29900,29000,-900
2018-06-01,1520609621,C015040,장갑,커스커즈/쿨토시A/B/C/쿨버프스카프/자외선차단/등산,1900,1750,-150
2018-06-01,1233013006,F012020,생리대,예지미인 롱 라이너 20개입 x 60,140930,125430,-15500
2018-06-01,1017590280,L021010,손목시계,크로노그래프 클래식 정장 메탈 손목시계,54900,54900,0
2018-06-01,1301250932,D031010,주택수선재료,숲으로방균/듀제로 3.78L 결로방지 곰팡이방지 페인트,22000,22000,0
2018-06-01,989019379,A014030,치즈,동원 체다치즈 클래식 204G,4000,2000,-2000
2018-06-01,992733729,A013070,굴,랍스타테일 3oz~4oz / 10마리 바다가재 꼬리,69000,69000,0
2018-06-01,1806421074,L021020,장신구,[바보사랑]귀걸이 141632013_PMNAPC14003,59000,59000,0
2018-06-01,69347107,A019140,이유식,[짱죽]바른 이유식 12+2/배달이유식/죽 아기반찬 실온,2820,2820,0
2018-06-01,1806421072,L021020,장신구,[바보사랑]귀걸이 261522053_PMMSPC26004,75000,75000,0
2018-06-01,989019373,A019040,소금,초L 구운소금 500G,1990,1990,0
2018-06-01,400651732,E041070,밀폐용기,키친아트 스텐레스 대형 김치통 5종 특가행사,89000,81880,-7120
2018-06-01,1883884606,C013010,점퍼,엑스톤즈 N3B 항공점퍼,196000,194040,-1960
2018-06-01,1806421077,L021020,장신구,[바보사랑]목걸이 111624001_PMNSPC11002,159000,159000,0
2018-06-01,801591714,L012030,칫솔,유아용 실리콘칫솔/단계별/손가락칫솔/아기칫솔,6000,5900,-100
2018-06-01,1806421075,L021020,장신구,[바보사랑]귀걸이 111624003_PMNSPC11002,49000,49000,0
2018-06-01,1063057635,A016030,복숭아,산초가루(움트리 50g)X10개/산초 산초가루 산초분말,36760,34560,-2200
2018-06-01,895828195,E061090,방향제,[P&G]페브리즈 에어 꽃향기 (275G),6280,6280,0
2018-06-01,451554094,C013020,티셔츠,[아디다스골프]아디다스 SS 쿨맥스 남성 마스터 반팔 셔츠 CI1457 CI1458 CI1459 골프,41100,37880,-3220
2018-06-01,380384980,L012090,기초화장품,진설 아이 에센스 20ml 1개 아이케어 눈가케어 기초케,335660,325600,-10060
2018-06-01,1806421079,L021020,장신구,[바보사랑]블루 팬던트 드롭 은침귀걸이,11920,11920,0
2018-06-01,988038129,A017280,김,초L) 김밥 단무지 170G,1780,1290,-490
2018-06-01,255258153,C013020,티셔츠,여름신상 반팔 티 레터링 루즈핏 기본티 단가라 나염,9900,9800,-100
2018-06-01,431613959,C011050,남자내의,레노마맨 S S 단독가 품절임박 캐주얼 정장바지 RHAMSP18A71A72AWS 3종택1,24070,24070,0
2018-06-01,428382109,A011030,찹쌀,(아리찬) 국산 보리쌀10kg/늘보리/쌀보리/쌀찰보리,19800,19800,0
2018-06-01,1948074867,C012020,원피스,김발 겉대x2,3330,3330,0
2018-06-01,171578875,C013040,청바지,[PLAC Jeans][PLAC]Slender 93T WSHD (PJOE3SL93T593T),149000,144530,-4470
2018-06-01,988038128,A017280,김,초L) 쌈무 새콤한맛 270G,1780,1780,0
2018-06-01,989019371,A019040,소금,초L 국산천일염 1KG,2290,2290,0
2018-06-01,1171536045,C011030,남자학생복,[스파오] 여성 와플가디건-SPCK521G21/ 스파오,15900,14310,-1590
2018-06-01,1963216620,C012060,여자내의,미시옷 망언발스커트_WB_1702 빅사이즈 여성의류 망언,31880,31880,0
2018-06-01,515945264,E041050,냄비,키친아트 키친프랜드 라면냄비18CM(인덕션겸용),18720,18720,0
2018-06-01,169770955,C012030,여자상의,nn66 스트랩 베이직 린넨원피스 - 네이비 여성패션원,35550,34490,-1060
2018-06-01,985447278,A018080,설탕,CJ헤이즐럿향 시럽_280ML,5000,5000,0
2018-06-01,985447277,A018080,설탕,CJ바닐라향 시럽_280ML,5000,5000,0
2018-06-01,314869732,A021010,커피,맥심 모카골드 커피믹스 1kg 자판기용커피 마일드모카,7450,6900,-550
2018-06-01,1121565557,F012020,생리대,엘리스 생리대 초안심 슈퍼롱 12P x 2팩/ 엘리스,12500,11880,-620
2018-06-01,1905526328,C011030,남자학생복,꾸제꾸제/FUBU 집업 니트 가디건/size L/울혼방/스웨터/자켓/세일/브랜드/빈티지/중고,18900,18900,0
2018-06-01,500494525,L021050,우산,[카르닉] 프리미엄 레인코트/판초우의/우비/비옷,17900,17900,0
2018-06-01,1619028792,C013010,점퍼,벨로크 패딩무스탕점퍼 남성의류 캐주얼의류 캐쥬 무스탕 가죽점퍼 가죽자켓 남성의류,223120,198580,-24540
2018-06-01,1397034712,C011030,남자학생복,꾸제꾸제/BOY LONDON 집업 니트/size L/면혼방/스웨터/자켓/세일/브랜드/빈티지/중고/,17900,17900,0
2018-06-01,1218571423,A012050,소시지,[진주햄] 천하장사 1+1 특가행사 더블링 소세지 간식,9500,9500,0
2018-06-01,427059752,E031080,선풍기,나노카본 터보 온풍기 FU-4055 - 온풍기 터보온풍기,705770,628140,-77630
2018-06-01,2045851967,A012010,국산쇠고기,LA갈비세트 구이용 3kg 미국산 초이스등급 /(참고) LA,182000,154700,-27300
2018-06-01,1191537962,E011050,책상,자이너스 원목 노트북테이블 공부상 책상 NT001,30900,26900,-4000
2018-06-01,611746265,C013040,청바지,[게스키즈] G61KBP31셀비지원워싱 스키니진,129000,64500,-64500
2018-06-01,1806421050,L021020,장신구,[바보사랑]귀걸이 281612053_PMNPPC28004,39000,39000,0
2018-06-01,1054132652,E051020,건전지,3S10P 26Ah 리튬이온 12V (11.1V) 18650 배터리팩,152000,152000,0
2018-06-01,984367950,A016060,감,씨없는 청도 반시로 만든 아이스홍시(100gX24개/탈피/개별포장),47600,38100,-9500
2018-06-01,984367951,A016060,감,씨없는 청도 반시로 만든 아이스홍시(6개X5팩/개당75g/미탈피/팩포장),47600,38100,-9500
2018-06-01,380406872,C013050,운동복,그린텍 뷰익 안전벨트 경고음제거 클립 (벨트레-2pcs),18000,17820,-180
2018-06-01,533006648,A019180,즉석식품,오뚜기 김말이 1kg/고추김말이/매콤김말이/튀김/분식,4900,4900,0
2018-06-01,506904070,C013020,티셔츠,샤크후드점퍼 (48314-110-01)/ 블루독베이비,94400,79300,-15100
2018-06-01,2092352706,E031070,에어컨,스카이실링팬/선풍기/냉풍기/천정형/에어컨/52인치,188000,188000,0
2018-06-01,686348194,C012060,여자내의,[핫핑] 빅사이즈 슬랙스 정장바지 면바지 밴딩,27800,23800,-4000
2018-06-01,2084635469,C013010,점퍼,안감양털 박시 오버사이즈 코트 DM-4043-이쁜코트 오,74970,66730,-8240
2018-06-01,686652720,C014020,유아복,아둘 유아 쥬니어 조던 로고 볼캡 야구모자 11,14300,14300,0
2018-06-01,1725752032,C011030,남자학생복,2018레노마 유니크한 드레스셔츠슬림&일반핏40종(선물포장가능)/ 레노마(셔츠),30000,24900,-5100
2018-06-01,1089719232,C013020,티셔츠,[샐리] 여름 데일리룩 시원한 가격!,9400,9400,0
2018-06-01,1806421045,L021020,장신구,[바보사랑]귀걸이141623013_PMNSPC14005,69000,69000,0
2018-06-01,1806421043,L021020,장신구,[바보사랑]귀걸이 181546103_PMMWPC18001,95000,95000,0
2018-06-01,1806421042,L021020,장신구,[바보사랑]귀걸이 281513023_PMMPPC28008,75000,75000,0
2018-06-01,1806421049,L021020,장신구,[바보사랑]귀걸이 601534063_PMMAPC60012,45000,45000,0
2018-06-01,989019349,A019040,소금,초L 국산천일염 3KG,6400,6400,0
2018-06-01,1890918360,D031010,주택수선재료,국산 데코타일 접착식데코타일 바닥재 장판 우드타일,15800,15800,0
2018-06-01,1806421047,L021020,장신구,[바보사랑]귀걸이 111613003_PMNPPC11003,49000,49000,0
2018-06-01,989019348,A019040,소금,초L 꽃소금 1KG,1750,1750,0
2018-06-01,692491481,L012040,치약,[특가판매] 애터미 치약 200g 5개,17000,17000,0
2018-06-01,446553751,C012030,여자상의,[무료배송]빅사이즈 DWW015R 보카 미니포켓 원피스 80,38980,38980,0
2018-06-01,1304594513,C014010,아동복,[게스키즈] 숄더홀스트라이프롱티 G65KAT090-R1,29000,23200,-5800
2018-06-01,686652715,C014020,유아복,아둘 유아 쥬니어 조던 로고 볼캡 야구모자 12,14300,14300,0
2018-06-01,1303436122,C011030,남자학생복,투앤영/디자이너핏/대박 베스트/원버튼/슬림간지핏/면/마/정장/턱시도/자켓/가디건/수,19800,19800,0
2018-06-01,178975123,I031070,애완동물관리비,에이치원 미니 당구 탁구 에어하키 게임 모음전,14000,12150,-1850
2018-06-01,693355241,A022030,생수,네슬레 퓨어라이프 500mlx40 /풀무원/샘물/생수/특가,5200,5200,0
2018-06-01,1416237741,C015020,모자,엠블럭[3층x4칸 12칸형]야구모자 스냅백 수납 정리함,49000,46550,-2450
2018-06-01,2102793646,C013050,운동복,[OMT] OMT 차량용 컵홀더 송풍구거치 자동차 컵홀더 SD-1003,1800,1500,-300
2018-06-01,894311000,A013060,게,[새우몰] 국산 손질오징어 4kg 18미내외 한마리씩 개별급랭,47700,47700,0
2018-06-01,1480393568,A017250,고사리,무배 포루투칼 업소용 대용량 냉동 브로콜리 1kg,11980,11980,0
2018-06-01,1160626000,A019090,카레,청정원 우리쌀 카레여왕 분말 1kg (대용량 카레여왕),12900,12900,0
2018-06-01,1214859324,L012060,샴푸,엔오가니스 딥슬립아로마 천연샴푸/트리트먼트1000ml,11900,11900,0
2018-06-01,909903643,F012020,생리대,화이트 입는 오버나이트 팬티형 생리대 10개입x2,17980,17980,0
2018-06-01,492506345,A021010,커피,아이스 커피믹스 1kg/냉커피/아이스커피,5200,5200,0
2018-06-01,1914198153,F011120,인삼,(장생농산장수산삼 10년근 5주(5뿌리) 산삼 산양산삼,452580,439010,-13570
2018-06-01,514200666,A017020,상추,반찬단지 간장깻잎 4kg 2개,57000,55290,-1710
2018-06-01,214897032,A013070,굴,[유진수산] 한성크래미 1kg 프리미엄 게맛살 / 대게 /,10500,10500,0
2018-06-01,2058677201,C021040,실내화,크루셜 아이돌 스니커즈 - 5color,29930,29930,0
2018-06-01,2012189001,A012040,닭고기,올품 IQF 닭가슴살 슬라이스 5kg,29900,29900,0
2018-06-01,2124461323,C013050,운동복,DDM커스커즈 3D 루프백 차량루프박스 캠핑용루프박스,186010,169420,-16590
2018-06-01,389170472,C021010,아동화,W월드컵 아동화 운동화 농구화 특가전,21800,21800,0
2018-06-01,1228073588,C011030,남자학생복,오마샤리프 빅사이즈 긴팔 와이셔츠 정장 체크 셔츠,13800,10800,-3000
2018-06-01,2058594448,A011170,떡,명미당 45년전통 제주오메기 떡세트 2호,54780,54780,0
2018-06-01,446019039,C012030,여자상의,[화이트폭스] 여름 신상 원피스/린넨/반팔/민소매,13000,13000,0
2018-06-01,1130070953,A011120,두부,[당일출고/무료배송]포스트 오레오오즈 500g+증정,7900,7900,0
2018-06-01,1413342078,A021020,차,빅트레인 빅트레인 혼합 파우더(1세트/2봉)할인판매,55000,55000,0
2018-06-01,1857576516,A017020,상추,용천유기영농 유기농 쌈채소 600g  800g  1kg,9000,9000,0
2018-06-01,1497964958,I012060,저장장치,ABKO K1000 게이밍 기계식 키보드 청축,31900,31900,0
2018-06-01,1239016071,C011030,남자학생복,[더리스]더리스 남성 숄카라 원버튼 베스트 조끼 (NKTNC804),21500,17850,-3650
2018-06-01,826700514,A019110,드레싱,상큼상큼~ 입안을 즐겁게 해주는 드레싱,2880,2880,0
2018-06-01,1286304739,E061020,섬유유연제,샤프란 아로마시트 30매 x3 / 테크간편시트36매x3,12800,12800,0
2018-06-01,739066921,E061010,세탁세제,비트 액체세제 2Lx5개+300g증정 세탁세제,26900,18900,-8000
2018-06-01,324142764,L012030,칫솔,피터래빗미세모아동칫솔12개/민들레종유아/어린이치약,5000,5000,0
2018-06-01,1719673375,L021060,유모차,2018 타보 유모차 타보베이직엣지 기내반입 휴대용,210000,185000,-25000
2018-06-01,2139515468,C012060,여자내의,무료배송 오프라 맥시 롱스커트 DM 3800,13370,13370,0
2018-06-01,1314589486,C021010,아동화,공룡메카드 모티브운동화(DM01),26100,26100,0
2018-06-01,2042051153,D031010,주택수선재료,KCC 속건방청하도 16L 광명단 사비 녹막이 방청하도,48000,48000,0
2018-06-01,1382010885,L021030,가방,윈드 플라워 번치 쇼퍼 폴드 어웨이 백 네이비 (CK-BT723183)/ 캐스키드슨(잡화),37900,34110,-3790
2018-06-01,1326809285,C012040,여자학생복,BL228-반오픈 스트라이프 블라우스 캐주얼셔츠 여성셔,18720,18720,0
2018-06-01,1943841996,C012030,여자상의,원피스 블라우스 남방 꽃나염 쉬폰 플라워 레이스롱,9800,9800,0
2018-06-01,1033902962,I053030,복사용지,HP A4 복사용지(A4용지) 75g 2500매 1BOX/더블에이,18350,15970,-2380
2018-06-01,499275688,C021040,실내화,[리복] 클럽C 85 VINTAGE V69406/ 리복,65000,61750,-3250
2018-06-01,321355123,C012020,원피스,(해외직배송)여성 꽃프린트 트렌치 코트 프린팅코트,77220,67960,-9260
2018-06-01,1324102462,E021020,커튼,에쿠스 암막 콤비블라인드 대형 1 플러스 1 암막커튼,147860,143430,-4430
2018-06-01,2034194999,C012030,여자상의,[체리빌레]썸남생기는 레이스+펀칭원피스/셀프웨딩,24000,19900,-4100
2018-06-01,228821288,E011040,소파,이지프리백/특대형/빈백/1인용소파/방석/의자/쿠션,42900,42900,0
2018-06-01,166234169,A019060,된장,Cj 해찬들 장류!,3880,3880,0
2018-06-01,1506278788,C013060,등산복,마운티스트 아이스엣지 남성 기능성 냉감 라운드 긴팔 티셔츠(AI92LT034M)/등산복/아웃,5900,5900,0
2018-06-01,2106571949,A011160,빵,천연발효종 치아바타3종(110gX4개)/샌드위치/빵,4900,4900,0
2018-06-01,810489124,C013020,티셔츠,유니 미키 포인트 카라 티셔츠 (JW2ZTN341UD)/ 애스크 주니어,10000,9500,-500
2018-06-01,2057675913,E041070,밀폐용기,밧드/받드/밧트/스텐/바트/반찬/통/보관/용기/급식,9900,9900,0
2018-06-01,1186019471,E021020,커튼,데일리 화이트 창문암막커튼 가리개커튼 작은창커튼,17700,14630,-3070
2018-06-01,2046701086,E041020,컵,뮬랭 예쁜 커피잔세트 찻잔 에스프레소잔 라떼잔,3400,3230,-170
2018-06-01,1267641150,A012030,돼지고기,(고기천국)쫄깃고소한삼겹살500g/삼겹/목살/돼지고기,3900,3900,0
2018-06-01,763054197,F012020,생리대,[위스퍼]코스모 메모리폼 생리대 3 4팩 모음전,27900,27900,0
2018-06-01,1289474303,E061030,전구,금호전기 LED FPL 형광등/램프/호환형/전구/삼파장/등,14900,14900,0
2018-06-01,1267679727,C012060,여자내의,페이즐리 롱 스커트 MIWWH8671J/ 미쏘,39900,37910,-1990
2018-06-01,808414143,C021020,구두,[레페토] 레페토 릴리 유광 발레리나 플랫슈즈 V1790VLUX_410,295000,233050,-61950
2018-06-01,1475208943,I012010,컴퓨터,특가 114만!/NT900X5Y-A58A/i5 NVM256 980G,1262100,1199000,-63100
2018-06-01,1267679725,C012040,여자학생복,리본 배색 니트 MIWKA8663T/ 미쏘,39900,37910,-1990
2018-06-01,1197424485,C012040,여자학생복,[조이너스][조이너스] 플라워프인트 롱 블라우스 JA7U6-WRB880_393 (P000340721),38100,34290,-3810
2018-06-01,985268628,E061050,청소용세제,한입 베이킹 소다1KG,2990,2990,0
2018-06-01,321609653,C012040,여자학생복,[에꼴][18년도 여름]심플 숏 가디건(C84KRB061Z),79000,65570,-13430
2018-06-01,207433302,E061010,세탁세제,[담구어서흔들기만해도되는]그린잇 운동화세제/세탁,3500,3300,-200
2018-06-01,1720664349,I011030,사진기,(특가) OM-D E-M10 Mark II + 14-42mm EZ Kit,578000,531760,-46240
2018-06-01,1311322553,C011050,남자내의,남성 연청 슬림 스키니 팬츠 남자청바지 편한청바지,128880,128880,0
2018-06-01,1890815121,A017220,양파,충남서천/다듬은깐쪽파/2kg박스포장최상급/총백파뿌리,9900,9900,0
2018-06-01,556001968,C013040,청바지,[컨셉원] 쿨 슬림핏 워터클린 슬랙스 118505/10118505,59800,49040,-10760
2018-06-01,2066081549,C013050,운동복,[마운틴리서치]아동 주니어 봄가을 트레이닝바지 모음,7900,7900,0
2018-06-01,444224771,D031010,주택수선재료,제비표 페인트 아크레탄 자동차 보수용 상도 4L,51700,51700,0
2018-06-01,679240200,A019060,된장,[뚝배기식품]뚝배기식품 - 재래식된장 1.8kg,31500,30560,-940
2018-06-01,1161348260,A015010,참기름,고소한 참기름 350ml(500ml) 2개-3개 참기름 식용유,8200,8200,0
2018-06-01,1065295392,C013050,운동복,캉가루 스프레이체인 모음전/카렉스 스프레이체인/ 3M 스프레이체인/ 불스원 스프레이,2300,2190,-110
2018-06-01,440319544,A018090,잼,오뚜기 후루츠잼850gX8개(1박스)포도잼 딸기잼 후루츠,105500,92840,-12660
2018-06-01,749806230,C014010,아동복,남아패딩자켓 남자아이롱패딩 아동후드점퍼 아동코트,30000,26800,-3200
2018-06-01,1196831766,I031070,애완동물관리비,탑프로 초보 및 연습용 테니스라켓,29900,29900,0
2018-06-01,1378246870,C012040,여자학생복,[JEIKEI]알리 프릴 블라우스 [JH5BL014B][갤러리아],39000,33930,-5070
2018-06-01,1199060308,G011070,자전거,[라레이] 18년 RLB7 시마노 알루미늄 26 여성용자전거,223250,205390,-17860
2018-06-01,1716829994,E021010,침구,[이브수] 순면 차렵이불 침구세트(이불+패드+베개커버,62600,62600,0
2018-06-01,1348515243,E051020,건전지,도시바 임펄스 AA2550mAh/AAA950mAh 2/4알 니켈충전지,11400,11400,0
2018-06-01,1582612510,L021020,장신구,사은품 판촉용 진주모양 귀걸이 100쌍 플라스틱,32400,27540,-4860
2018-06-01,490216940,F012020,생리대,화이트 생리대 32+10매/시크릿홀/울트라/슬림/오버,7900,7900,0
2018-06-01,207386549,C021040,실내화,슬레진저 신상 운동화 스니커즈/런닝화/신발/캔버스화,12800,12800,0
2018-06-01,1094424967,C013050,운동복,바지특가/반바지/5부/7부/10부/팬츠/트레이닝바지,2000,1900,-100
2018-06-01,1101820570,I031040,생화,3폴딩 BBQ테이블/캠핑테이블/바베큐/화로대/야외용,59800,59800,0
2018-06-01,1854478597,C013020,티셔츠,v넥오프숄더x끈티/쫄티/라운드티/프린트티/와이드넥.,7900,7900,0
2018-06-01,1710618178,E031090,공기청정기,인증점 삼성 공기청정기 AX60N5580WDD 전국무료배송,588000,479000,-109000
2018-06-01,237465835,D031010,주택수선재료,국산 본드식 데코타일,18800,18800,0
2018-06-01,1302055994,C021020,구두,[레페토] [레페토] 루(LOU) 유광 발레리나 레드 V080VLUX_1154,368000,290720,-77280
2018-06-01,507939100,E041050,냄비,키친아트 글라스 통주물 세라믹냄비 4종세트 편수전골,60900,57800,-3100
2018-06-01,167223840,C011030,남자학생복,MNC 여름셔츠 반팔/린넨/스트라이프/체크/오버핏/남자,14800,14800,0
2018-06-01,1161566370,C013050,운동복,맥과이어스 에탄올 워셔액2LX2개+3M 유리발수코팅제,15000,12900,-2100
2018-06-01,1908697272,A013050,오징어,펭귄 꽁치캔 (400g) x24,70700,70700,0
2018-06-01,1192011841,C012040,여자학생복,[체리코코][CHERRYKOKO] vneck lovely  cardigan,27000,27000,0
2018-06-01,1533030998,C013010,점퍼,[아메리칸트위스트] Twist Rooy 남성 사파리점퍼/야상,39800,19900,-19900
2018-06-01,311311211,A019180,즉석식품,미스타셰프 육개장 600g 외 즉석탕 모음 / 갈비탕,2690,2690,0
2018-06-01,1626310134,L021030,가방,남성가방 서류가방 캐쥬얼 브리프케이스 C6071,15400,15400,0
2018-06-01,529521866,C012060,여자내의,스판 블랙 교복치마 교복 예쁜교복 교복쇼핑몰 중학교,37070,35960,-1110
2018-06-01,1001408349,A017280,김,초생강(적색 참존 1.2k)X10,33120,33120,0
2018-06-01,1086923268,E031070,에어컨,신일 리모컨 벽걸이선풍기 SIF-16HWKR 가정용 사무실,64000,60520,-3480
2018-06-01,300488885,A013060,게,[기담은] 바로먹는 반건조 오징어(대7미/가정용) 700g,41000,41000,0
2018-06-01,1008019679,C013020,티셔츠,[톰보이]레터링프린트라운드반팔티셔츠(9108222998),39000,39000,0
2018-06-01,475637424,C013010,점퍼,빅사이즈 DWW143 나그랑 박시 롱 후드 집업 801 임부,58170,52360,-5810
2018-06-01,331508503,E031110,청소기,700W+헤파필터 SMF 싸이클론 청소기/진공/핸디/스틱,23100,21500,-1600
2018-06-01,383105479,A013040,고등어,저염순살고등어 국산고등어 노르웨이고등어,10400,10400,0
2018-06-01,2043031157,C013010,점퍼,땡..추가금없는 무조건 이가격 마지막 선착순 주문..,19900,19900,0
2018-06-01,1613267879,L021010,손목시계,[방수 전자시계]스포츠 손목시계 방수시계 군용 군인,28800,28800,0
2018-06-01,1271582623,C012040,여자학생복,cc90 투포켓 니트조끼 민트 겨울니트베스트 따뜻한베,13680,13680,0
2018-06-01,1320536461,E011020,침대,프리미엄 패밀리침대 Q+SS 밸런스 포켓양면 매트리스,712400,691030,-21370
2018-06-01,1319171188,A011140,부침가루,베이킹 아크릴 스텐실도안 어린이날 케익용스켄실 제,10360,10360,0
2018-06-01,1303052469,C013010,점퍼,가죽자켓 라이더자켓 가죽점퍼 P173가죽가죽점퍼가죽,95390,95390,0
2018-06-01,1903742705,C013010,점퍼,[PLAC]Uni V-neckline Blouson_NV (PWOG2JPL02U0B7),99000,69000,-30000
2018-06-01,393632401,C011030,남자학생복,[인디안][인디안(INDIAN)]배색스퀘어퀼팅베스트점퍼_MIGCLPS1151_33,16000,15200,-800
2018-06-01,2088719573,C012060,여자내의,SK1428 머메이드라인 코튼 밴딩 스커트 이지룩 루즈핏,29440,29440,0
2018-06-01,891732170,A019160,밑반찬,[소보꼬] 한우가 소복한 소고기 볶음고추장 250g,15000,13900,-1100
2018-06-01,1319944746,C011050,남자내의,남자바지 베이직 슬림핏 카고팬츠 BX0717005 작업복바,39680,39680,0
2018-06-01,989115115,C012060,여자내의,국내생산 시원한 3부5부 밴딩 면/마소재 반바지,15900,15900,0
2018-06-01,379704786,C013010,점퍼,바이에른 뮌헨 UCL 프리젠테이션 자켓 운동복 후드자,125160,125160,0
2018-06-01,432375363,A011130,시리얼,오뚜기 바삭하고 고소한 부침가루 1kg X 10EA,42980,38260,-4720
2018-06-01,599812926,L021010,손목시계,패션시계/스포츠시계/알람시계/전자시계/군인시계/SD6,6000,6000,0
2018-06-01,48238754,C013020,티셔츠,~99까지 여름빅사이즈원피스/냉장고티/아이스티/쿨론,9800,9800,0
2018-06-01,440199333,C013010,점퍼,USD361_5208_OR 남성점퍼 바람막이점퍼 남자등산복 남,61140,61140,0
2018-06-01,370785744,C013010,점퍼,(냉동)양념숙성돼지막창1kg2개,57920,57920,0
2018-06-01,787494573,E031020,가스레인지,SK매직 고화력 Eco버너 2구 가스렌지 GRA-820SR,145000,137750,-7250
2018-06-01,1200635678,C013050,운동복,루즈핏 66 77 빅사이즈 반팔티 반바지 트레이닝 세트,23900,23900,0
2018-06-01,2073364565,C013060,등산복,여름 신상 등산바지/작업복바지/등산복/남성/아웃도어,16800,16800,0
2018-06-01,1544021000,C013010,점퍼,[리틀그라운드]데님인더박스 레인보우점퍼(77311-110-02),57000,51300,-5700
2018-06-01,2034420329,A013070,굴,친환경 대하(왕새우) 특대1kg(30~45미) 당일조업 발송,27000,26700,-300
2018-06-01,1308492624,C013030,스웨터,MJ_1200 아이보리 양면 양털 집업 여성집업 남자집업,62180,62180,0
2018-06-01,1010262245,A019180,즉석식품,CP)로스트핫윙(날개)1KG,16000,16000,0
2018-06-01,358008781,C013050,운동복,올뉴스포티지 리무진 콘솔박스 팔걸이 쿠션 팔걸이쿠,61430,55960,-5470
2018-06-01,1901787618,A013070,굴,상품평 8 000건 세일 자숙/생물/홍게/대게/꽃게 선물,35500,34500,-1000
2018-06-01,529521842,C012060,여자내의,백합주름치마 그레이체크 전체 주름 교복치마 교복 예,55060,53410,-1650
2018-06-01,2016830580,I031010,장난감,PS4 PRO 1TB /플스4 프로/화이트/블랙 국내정발새제품,650000,650000,0
2018-06-01,578568729,L021030,가방,특가 (비비안/피에르가르뎅) 80데니아 팬티스타킹/레깅스/기모타이즈/기모레깅스,3900,3800,-100
2018-06-01,2107470033,C013050,운동복,jsi/자동차삼각대/후레쉬/led점멸등/비상등/랜턴/램프,32180,32180,0
2018-06-01,788961123,L012060,샴푸,무료/댕기머리 명품/뉴골드 샴푸 500ml+145ml 세트,11900,11900,0
2018-06-01,1437890164,A022050,탄산음료,스프라이트 210ml × 30개/탄산음료/사이다,10800,10800,0
2018-06-01,567465631,I031070,애완동물관리비,낫소 테니스라켓 옵티멈 프로 투어 교재용 테니스채,20000,19800,-200
2018-06-01,1803829112,F011150,건강기능식품,여명808 119mlX24캔/숙취해소/음주전후/숙취음료/해장,68700,68700,0
2018-06-01,1347083074,L012090,기초화장품,1+1 폰즈 대용량 클렌징 크림 간편한 워시오프 클렌징,14900,14900,0
2018-06-01,1181546505,C011030,남자학생복,남자셔츠 패턴 포켓 반팔셔츠 J0417022 남자셔츠 셔츠,23310,22620,-690
2018-06-01,856473953,L021020,장신구,원석sale/천연시츄린/황수정/21.2캐럿/큼직/Sichyurin,100000,100000,0
2018-06-01,1318003306,C021020,구두,마틴안경 4.0cm 남성로퍼 남성구두 남성로퍼 4.0cm 마,53130,53130,0
2018-06-01,349637423,C012040,여자학생복,[이앤씨]나팔소매루즈핏니트 ENKT72303B,89500,71600,-17900
2018-06-01,855232721,E031130,보온매트,아랫목 보료매트 1인용,120000,120000,0
2018-06-01,855232722,E031130,보온매트,아랫목 보료매트 2인용,148000,148000,0
2018-06-01,478019983,C012020,원피스,[엄마옷 데드라] 8B-PT130 밑단언발트임팬츠,38900,32680,-6220
2018-06-01,984402733,L012070,바디워시,LG 온더바디 올리브 바디워시 순한촉촉 500ML,3000,3000,0
2018-06-01,984402734,L012070,바디워시,LG 온더바디 올리브 바디워시 순한산뜻 500ML,3000,3000,0
2018-06-01,1456065869,E061030,전구,두영 / 장수 삼파장 램프 박스판매 /FPL36W /FPL55W /,31000,31000,0
2018-06-01,1161108724,I011030,사진기,캐논 정품 EOS M3 본체 + 22mm 명품마을,630000,579510,-50490
2018-06-01,16324284,C013040,청바지,여름 청바지 남자 남성 밴딩 스키니진 스판 찢어진,17800,17800,0
2018-06-01,1269736725,C012040,여자학생복,cc90 투포켓 니트조끼 베이지 따뜻한니트조끼 겨울니,13680,13680,0
2018-06-01,2137852882,I031040,생화,SOS 지진 재난대비 구조 응급 생존 용품 서바이벌키트,12500,12500,0
2018-06-01,299450873,A016110,딸기,동결건조 딸기가루 60g 4개 딸기분말,39600,38420,-1180
2018-06-01,929340331,C021020,구두,[금강제화] 리갈 6CM의 자신감 남성 키높이 스트레이트팁 정장구두 MMX7830KR11(본점),190400,166220,-24180
2018-06-01,1544263175,C013020,티셔츠,[아메리칸웨스트] Moroco 터틀넥티/목폴라/후드티,16800,8400,-8400
2018-06-01,362121386,L021030,가방,남성 서류가방 미니크로스백 가죽 메신저백 남자숄더,65800,65800,0
2018-06-01,1909527687,E041060,수저,어린이수저세트 숟가락 포크 스푼 수저 성인 국산,1100,1000,-100
2018-06-01,1457422054,E011050,책상,GT 철제책상/사무용책상/사무실책상/컴퓨터책상/책상,76900,76900,0
2018-06-01,547701485,F012010,종이기저귀,(수량비교)팸퍼스 베이비드라이 팬티 XL 5단계 144매,49900,48900,-1000
2018-06-01,1806421012,L021020,장신구,[바보사랑]귀걸이 281616103_PMNPPC28031,39000,39000,0
2018-06-01,984402762,A014030,치즈,렘노스 살구&아몬드 과일치즈 125G,7410,7410,0
2018-06-01,1586027502,A012040,닭고기,마이닭 닭가슴살 소세지 핫바 스팀 스테이크 10+1팩,9900,9900,0
2018-06-01,655177656,E061050,청소용세제,몽블 화이트 2.5L 500ml 화장실 욕실 타일 락스세제,3400,3400,0
2018-06-01,1122532241,C011030,남자학생복,여성 블루 디스트로이드 슬리브리스 트러커 데님 재킷 (358436WP1P)/ 에잇세컨즈,49900,46410,-3490
2018-06-01,1850906869,F012010,종이기저귀,군기저귀 밴드형 M 중형 64매 2팩,27900,27900,0
2018-06-01,819290248,C011050,남자내의,(805/레이스자수꽃)밑단레이스 스프사 8부파자마,11700,10420,-1280
2018-06-01,1806421016,L021020,장신구,[바보사랑]귀걸이 281613053_PMNPPC28014,39000,39000,0
2018-06-01,1907471624,E061010,세탁세제,아이마망 젖병&주방세제 500ml  3개 [1종/액상형],22500,19180,-3320
2018-06-01,1806421015,L021020,장신구,[바보사랑]귀걸이 601534063_PMMAPC60012,45000,45000,0
2018-06-01,393607416,C011030,남자학생복,[인디안][인디안(INDIAN)]다이아자수패턴니트베스트_MITBVPS1201_33,13900,13210,-690
2018-06-01,1806421013,L021020,장신구,[바보사랑]귀걸이 281612503_PMNPPC28037,39000,39000,0
2018-06-01,1017602788,E061020,섬유유연제,[다우니]퍼퓸 초고농축 섬유유연제 1Lx6개,29900,26900,-3000
2018-06-01,1806421019,L021020,장신구,[바보사랑]귀걸이 281516013_PMMPPC28004,95000,95000,0
2018-06-01,1806421018,L021020,장신구,[바보사랑]귀걸이 281536003_PMMAPC28001,95000,95000,0
2018-06-01,1340174702,C013030,스웨터,[아미]여름신상UP! 가디건/니트/로브/조끼,9900,9900,0
2018-06-01,1012394842,C012040,여자학생복,[메롱샵] 레이스뷔스티에/조끼,5900,5900,0
2018-06-01,983506892,A014040,발효유,초L)요구르트(65ML*20),1990,1990,0
2018-06-01,984402759,A014030,치즈,뉴월드 한스 크림치즈 112G,2980,2980,0
2018-06-01,194112698,I011030,사진기,정품 니콘 D5600 BODY DSLR 카메라 4종 사은품 증정,610050,538340,-71710
2018-06-01,1918174116,C012020,원피스,SS/정장세트/여성정장/정장스커트/면접/단체복/오피스,50000,50000,0
2018-06-01,672944408,A019080,고추장,청정원 순창 찰고추장(200G),1950,1950,0
2018-06-01,1134333521,L012090,기초화장품,2017 /헤라 화이트프로그램 하이드레이팅 워터 에멀젼,62170,62170,0
2018-06-01,974950877,C011030,남자학생복,빅사이즈 와이셔츠/남자/남성/체크/긴팔/헨리넥/남방,13000,12800,-200
2018-06-01,1101876984,A011120,두부,포스트 크랜베리 그래놀라 700g+증정[시리얼/씨리얼],8900,8900,0
2018-06-01,1929328433,A017300,미역,[사조해표] 더 고소한 재래김 96봉 1박스 조미김 광천김 도시락김,16800,16800,0
2018-06-01,395371169,I031040,생화,페어맨 리튬이온 26650 배터리 충전지 5200mAh 건전지,20000,17900,-2100
2018-06-01,1010349759,L012030,칫솔,오랄비스테이지스2단계행사팩,8900,8900,0
2018-06-01,1092322100,E031080,선풍기,대동해모로_ 온풍겸용 욕실난방기 2구 DD-1004H,179000,179000,0
2018-06-01,441898379,A015020,식용유,오뚜기 옛날고추맛기름1.5L,16480,16480,0
2018-06-01,794327756,I012010,컴퓨터,Apple 공인판매점 2017 iMac [MNEA2KH/A] 27형,2248000,2135600,-112400
2018-06-01,441959848,A017180,호박,[친환경팔도]함평 무농약 미니 단호박(밤호박) 4kg,35400,35400,0
2018-06-01,1431979476,C012030,여자상의,[세이스타일] 롱원피스/겨울신상/기모원피스/루즈핏,12900,12900,0
2018-06-01,382050178,L021020,장신구,[티르리르] 다즐링(W오닉스) 팔찌TBSVW10636M-9,59000,50150,-8850
2018-06-01,1262225652,C011050,남자내의,신상모음전/스판신축/흡습속건/스판바지/반바지/팀복,30800,29000,-1800
2018-06-01,500557970,E011020,침대,M5 골든 메달리스트 퀸 매트리스 Q/ 베스트슬립,444900,387070,-57830
2018-06-01,1748973269,I031010,장난감,[해피store][와우토이즈 맥스 모터바이크] 자동차장난감 장난감자동차 장난감 완구,28270,28270,0
2018-06-01,1136752327,C012040,여자학생복,[코코애비뉴][코코애비뉴]레이스시스루가디건_80403,18700,17960,-740
2018-06-01,2089977747,A022010,주스,무료배송 태평마트 필리핀 수입 망고 퓨레 스위트 1kg 4개 농축 망고 쥬스 주스 과즙,66100,66100,0
2018-06-01,958399529,C012040,여자학생복,스트라이프 7부가디건 봄 여름 가을 미니 볼레로 국산 가디건,13000,12870,-130
2018-06-01,1150442120,E021020,커튼,아로마향 낙엽문발 파리문발 파리발 목각비즈발,7850,7850,0
2018-06-01,445740911,E061040,부엌용세제,자연퐁 주방세제 리필 1.2kg x 4개 (택일),9900,9900,0
2018-06-01,1802965608,A011010,쌀,17년 햅쌀추청 진품 경기미10kg 아끼바레 고품격 쌀,27500,27500,0
2018-06-01,1597058972,F011130,홍삼,정관장 홍삼비타민(700MG*120정),90000,90000,0
2018-06-01,950100824,E011030,거실장,콜린쇼파,159900,159900,0
2018-06-01,1946008387,I031040,생화,국산 고밀도 고급형 거위털침낭/캠핑침낭/사계절침낭,19800,19800,0
2018-06-01,427207063,A014020,분유,트루맘프리미엄1. 2 .3 .4 단계3캔/기한20년2월이상,63000,63000,0
2018-06-01,395965092,C011030,남자학생복,[2001 OUTLET] [PAT] 피에이티 여름선발주 메쉬 MIX 베스트 (1D 31481 820),57000,55290,-1710
2018-06-01,950100822,E011030,거실장,몽스쇼파세트,202900,202900,0
2018-06-01,721587601,C011030,남자학생복,덕다운 빅사이즈 패딩조끼 LM306 빅사이즈,56160,54480,-1680
2018-06-01,950100820,E011030,거실장,루리쇼파,194900,194900,0
2018-06-01,101204817,F011150,건강기능식품,[세노비스]Advanced 트리플러스 (90캡슐/45일분)x2개,63900,63900,0
2018-06-01,1206817088,C013040,청바지,[루미씨] 클린 코튼 슬림 팬츠,17800,17800,0
2018-06-01,321039052,C011030,남자학생복,[ANDZ] 정장 베스트 BZX1SV1105,39000,35100,-3900
2018-06-01,339962985,L021020,장신구,12월탄생석 3mm 천연터키석 티아라 원터치귀걸이,142000,142000,0
2018-06-01,672832248,C013030,스웨터,여성 시스루니트/빈티지/헤짐/망사/롱/루즈핏/커버업,24800,24800,0
2018-06-01,1299969358,I031040,생화,에버라스트 에버 쿨 헤드기어,141300,138480,-2820
2018-06-01,223676132,L012010,면도기,질레트 스킨쉐이빙젤 195mlX3개/면도젤/퓨어스포츠,12900,12900,0
2018-06-01,1597211084,F011130,홍삼,정관장 아이패스 주니어(40ML*30),130000,130000,0
2018-06-01,1179706264,C011030,남자학생복,[메이드]와이셔츠/반팔/솔리드/체크/남방/남자/남성,10800,10800,0
2018-06-01,1054376141,I031010,장난감,(스텝2 사파리웨곤(new))대형완구 푸시카 지붕차 승용,526090,515570,-10520
2018-06-01,950100818,E011030,거실장,헤밍쇼파,149900,149900,0
2018-06-01,1163777777,D031010,주택수선재료,아이생각수성목재1L/방문용페인트/반광/가구용/몰딩,15500,12500,-3000
2018-06-01,1185299890,C012040,여자학생복,[블루종][블루종]베이직 쿨링 숄가디건_[B1806CD030B],14800,14060,-740
2018-06-01,1370556196,C012040,여자학생복,수지네 일본 빈티지 라코스테 네이비 울 조끼 여성 S,26440,26440,0
2018-06-01,1806498352,A013090,전복,부경 냉동반가리비 2.1kg(210gx10개),65500,65500,0
2018-06-01,1295048652,L012060,샴푸,케라시스/미장센 해피바스 대용량 샴푸린스바디,11900,11900,0
2018-06-01,134916791,E051020,건전지,산요 파나소닉 소니 렉셀 충전용건전지(4알) 에네루프/라이트 AA AAA 9V 충전지 필립,8490,8490,0
2018-06-01,445451759,C011030,남자학생복,짚업 후드 조끼 베스트 면조끼 특면 후드집업 R161600,32170,32170,0
2018-06-01,1905943006,A014020,분유,[20%쿠폰]베비언스 액상분유 2/3단계 25입 1단계 24입,35900,35900,0
2018-06-01,1675730458,E061040,부엌용세제,EM활성액x2/원액 당밀 발효액/친환경 천연건강 효소,4500,4500,0
2018-06-01,1793295691,A012040,닭고기,[굽네] 닭가슴살 20종! 골라담기 무배! 오늘만 990원!,990,990,0
2018-06-01,1589883975,C013050,운동복,자동차 승용차 외장용품 순정 도어 가드 모비스 자동차용품 차량외장용품 도어가드 도,5920,5270,-650
2018-06-01,1975479443,A017170,풋고추,[홈플러스]다다기오이_봉,2490,2370,-120
2018-06-01,1233879416,L021020,장신구,사은품 판촉용 진주모양 귀걸이 100쌍 악세서리 악세,37810,37810,0
2018-06-01,2069261611,C013020,티셔츠,베이직 후드티 LTT003 여성티셔츠 여성후드티(YA02004,32100,28250,-3850
2018-06-01,739007398,L012040,치약,작트 미백치약 150g x 4개 구강청결,11900,11900,0
2018-06-01,1060139214,A013020,명태,두레생협 대구전부침용(400g 러시아산) 부침용냉동대,29970,29970,0
2018-06-01,2017310458,C011050,남자내의,벤티브 M~4XL 남성 면 반바지 7부 5부 린넨 트레이닝,9800,9800,0
2018-06-01,362092257,C012040,여자학생복,밍크털오픈조끼 BR1712 여자베스트 털조끼 여성조끼,141070,141070,0
2018-06-01,1125245140,C011030,남자학생복,남자남방 스트라이프 루즈핏 파자마 셔츠 캐주얼셔츠,34840,34840,0
2018-06-01,23612779,L021030,가방,[리틀파머스] Natural/Indigo TOTE 1L7FHB5355,41400,37260,-4140
2018-06-01,1008264746,C012030,여자상의,엠짱_신혼여행룩 /봄 여름 빅사이즈 원피스/휴양지,22800,22800,0
2018-06-01,937433575,F012020,생리대,릴리안 순수한면중형16+4px10팩+쌤플4p 총204p,22900,22900,0
2018-06-01,332632734,F012010,종이기저귀,팸퍼스 베이비드라이 기저귀 파우더향 1~6단계,54900,54900,0
2018-06-01,205053663,E041050,냄비,Rhiox & 키친아트 통주물 세라믹코팅 냄비 18편수 외,9900,9900,0
2018-06-01,1840372857,E031120,믹서,신일 푸드프로세서 믹서기 핸드블렌더,29900,29900,0
2018-06-01,1748973274,I031010,장난감,[해피store][와우토이즈 찰리 경찰차] 자동차장난감 장난감자동차 장난감 완구,28270,28270,0
2018-06-01,1748973272,I031010,장난감,[해피store][와우토이즈 프랭키 레이싱카] 자동차장난감 장난감자동차 장난감 완구,18580,18580,0
2018-06-01,469544770,A011010,쌀,2017년 햅쌀 / 화천 물빛누리 오대쌀 10kg,36900,35900,-1000
2018-06-01,950100858,E011030,거실장,에인세쇼파,64900,64900,0
2018-06-01,950100856,E011030,거실장,네이쳐쇼파1인,69900,69900,0
2018-06-01,714889795,F012030,안경,안경테/안경/메탈/금속테/뿔테/패션/남자/여자,8900,8900,0
2018-06-01,950100854,E011030,거실장,네이쳐쇼파2인,109900,109900,0
2018-06-01,950100852,E011030,거실장,코레트쇼파베드,143900,143900,0
2018-06-01,950100850,E011030,거실장,코쿤쇼파,147900,147900,0
2018-06-01,1895034876,A013170,생선통조림,유동 번데기캔 280g X 24EA_1BOX 번데기통조림 번데기,52750,52750,0
2018-06-01,209470462,A012030,돼지고기,(왕목살 벌집삼겹살 오겹살 오돌뼈)돼지고기구이모듬,2900,2900,0
2018-06-01,1604782746,E061040,부엌용세제,자연퐁 주방세제 용기 3kgx2개 (택일),12900,9900,-3000
2018-06-01,1010291881,A011160,빵,[아레바로스] 밀또띠아9인치,13000,10000,-3000
2018-06-01,1010291888,A011160,빵,[아레바로스] 밀또띠아8인치,13000,10000,-3000
2018-06-01,355604704,A022010,주스,델몬트꼬마병 180ml (12병x4세트)=48병 썬키스트 쥬스,19100,19100,0
2018-06-01,386588461,C015020,모자,(컬러:사이즈 : 네이비:FREE) ACC-CAP101 찡,19630,19630,0
2018-06-01,1075737097,C013010,점퍼,웰론 패딩 점퍼 MK 3011_3014 마크 패딩 패딩점퍼 점퍼 패딩점퍼 빅사이즈,135990,121040,-14950
2018-06-01,1107420273,E041020,컵,리자인 뮬랭 커피잔 찻잔세트 카페 머그컵 60종 모음,1200,1070,-130
2018-06-01,449033960,E031020,가스레인지,GOR-B5T01V/동양매직 빌트인 가스오븐레인지+4구 가스렌지 일체형 제품/화재예방/안심,738000,738000,0
2018-06-01,942153102,E041050,냄비,양머리뚝배기 전골냄비 보쌈접시 수육그릇 도자기워머,19900,19310,-590
2018-06-01,1010288227,A013020,명태,[통영앞바다]자연산 냉동전어(회무침용) 1Kg,21900,20000,-1900
2018-06-01,952575380,D031010,주택수선재료,노루페인트 순앤수 항균 친환경 수성페인트 올인원 !!,12100,11000,-1100
2018-06-01,591020672,C012040,여자학생복,빅사이즈/무지/셔츠/기본/유니폼/카라/여성/교복/긴팔,12900,12900,0
2018-06-01,1613432651,A014020,분유,[아이배냇] NEW 순 산양분유 1~4단계(800gX2캔),65800,65800,0
2018-06-01,751865768,C011050,남자내의,아디다스 여성 에센셜 리니어 타이츠 ( BR2523 ),51730,48110,-3620
2018-06-01,666824911,C013020,티셔츠,빅사이즈 여름 남자 반팔 티셔츠 박스티 나시 커플티,6900,6900,0
2018-06-01,1444184815,C013020,티셔츠,[무지개나무] 귀여운아동복,22400,21400,-1000
2018-06-01,1241789671,C011030,남자학생복,(남자옷도매)MCD-910 겉배색 가디건 (FREE) 3COLOR 패,27230,27230,0
2018-06-01,321039019,C011030,남자학생복,[ANDZ] 정장 베스트 BZX1SV1107,39000,35100,-3900
2018-06-01,986128630,A017130,도라지,시원한 아이스 군고구마 120gx10 /총 1 200g 이상,24900,17500,-7400
2018-06-01,445860798,L012040,치약,페리오/ 2080크린케어치약 150Gx20개 대용량(최저가),6900,6900,0
2018-06-01,1010288231,A013100,마른멸치,[통영앞바다]자연산 뿔소라 1kg,24900,18600,-6300
2018-06-01,402893884,D031010,주택수선재료,[균열보수제]CMW7B/칠만방수/균열/간단시공/균열보수,32000,32000,0
2018-06-01,1041790340,A018080,설탕,할인특가 에리스리톨 스테비아500g 자일리톨가루1kg,14900,14900,0
2018-06-01,1761045648,A021010,커피,맥스웰 아로마 마일드 커피믹스 900g/자판기용/커피,3930,3700,-230
2018-06-01,1238125670,I031010,장난감,씨투엠 벤츠 유아 붕붕카 아기자동차 USB음악재생,49000,49000,0
2018-06-01,572592790,C013040,청바지,[블루독](NY)핀턱데님숏팬츠(27315-4145-53),46000,35420,-10580
2018-06-01,2080314225,C012060,여자내의,쿨팬츠/몸빼바지/9부 바지 쿨원단 냉장고 시원시원,2500,2500,0
2018-06-01,928681642,C013050,운동복,불스원 레인OK 유막제거/발수코팅 이지그립/유막제거제/발수코팅제/유리세정/클리너/크,6900,6350,-550
2018-06-01,300569690,C012060,여자내의,[카라]KARRA 랩스타일린넨큐롯팬츠_KBI6PT214A,33500,31830,-1670
2018-06-01,1949972054,E061100,습기제거제,(초특가) 참숯 제습제 24개 (물먹는 하마/습기제거제),15000,14800,-200
2018-06-01,1834809370,L021020,장신구,천연에메랄드 귀걸이/14k골드/총1.3캐럿/4031,240000,240000,0
2018-06-01,911146524,C012060,여자내의,[리스트][LIST] 플레어 스커트 TWWSKH50040 (2가지 색상),26000,21580,-4420
2018-06-01,1672062566,C021020,구두,[토리버치][유니코] 17SS 여성 펀칭 로고 에스파듀 슈즈 (37518_100_17S),318000,254400,-63600
2018-06-01,1241608822,A022010,주스,봉봉 238ML 24캔 과즙음료 캔음료 과일주스 음료수 쥬,20560,20560,0
2018-06-01,1408386065,C012060,여자내의,프릴 린넨 와이드 점프슈트 (AJGWO097)[예약상품 2018.06.07 부터 발송]/ 랩,47000,39950,-7050
2018-06-01,360874988,L021020,장신구,14K 정품 Gold 슬림큐빅스틱 반지 오하나 스타일,240410,213970,-26440
2018-06-01,240478549,A012010,국산쇠고기,(제주어가 실속 세트)제주 은갈치(대) 1마리 x 제주,73900,65780,-8120
2018-06-01,941646525,C012020,원피스,[르틸다]본딩 울코트,59800,56810,-2990
2018-06-01,1656893520,C012020,원피스,[여성홈쇼핑(더휴컴퍼니)](리챠드차이) 여성 텐셀 라인업 코트(EAHY710C),25900,20980,-4920
2018-06-01,882037003,C013020,티셔츠,[포스트릿]S~4XL 반팔티/티셔츠/커플티/남자/면티/티,10000,9900,-100
2018-06-01,1471589073,F012020,생리대,좋은느낌 입는 오버 나이트 중형/대형 8매 견본증정,13500,9900,-3600
2018-06-01,94711428,A012030,돼지고기,프리미엄 삼겹살 500g 대패/수육용/구이,5200,5200,0
2018-06-01,2097457117,C014010,아동복,[노스페이스] 키즈 엣지 워터 그래픽 반팔 라운드 티 NT7UJ26 5종 택1,25600,22020,-3580
2018-06-01,682245670,C013020,티셔츠,퍼플스완 너에게 가는길 웨이 롱원피스 티셔츠,14900,14900,0
2018-06-01,967671905,F012020,생리대,에리에르 엘리스 순수감촉생리대 신규런칭(날개/일반),7900,7900,0
2018-06-01,680512144,C013020,티셔츠,베스트핏 반팔티 M(95)~XXL(120),19000,9900,-9100
2018-06-01,950100827,E011030,거실장,슈에나쇼파,185900,185900,0
2018-06-01,1533390760,C012020,원피스,미국 브랜드 퍼자켓 퍼조끼 털자켓 여성자켓 여성조끼 여성코트 겨울코트 털코트 MELO,26000,26000,0
2018-06-01,1720701002,C013020,티셔츠,폴로 보이즈 랄프로렌 후드집업 후드티,65900,65900,0
2018-06-01,1886500133,E031010,전기밥솥,쿠첸 밥솥 고무 패킹/패킹/압력밥솥/IH밥솥/전기밥솥,5430,5110,-320
2018-06-01,848609028,A018090,잼,베리업 딸기 992g/딸기베이스/딸기스무디/딸기음료,14200,14200,0
2018-06-01,539357291,C021040,실내화,니트 여성 키높이 하이탑 스니커즈 통굽 웨지운동화,38500,38500,0
2018-06-01,1234700779,I031040,생화,다용도 접이식 야전삽 휴대용 캠핑삽 곡갱이 모종삽,5300,4880,-420
2018-06-01,1366409535,C013010,점퍼,항공점퍼 블루종 바람막이 야상 남자 남성 점퍼 자켓,25000,23900,-1100
2018-06-01,631114282,C011030,남자학생복,오블릭 빅사이즈 STJ 니트 가디건 빅사이즈,69470,67390,-2080
2018-06-01,256375765,E061040,부엌용세제,퐁퐁 안심설거지 주방세제 용기 3000ml x 2개 외,9500,9500,0
2018-06-01,1143036673,A013050,오징어,펭귄 꽁치캔 (1.8K) x6,79070,79070,0
2018-06-01,984432091,C013040,청바지,신상특가 28~40 청반바지/면반바지/남자/카고,15800,15800,0
2018-06-01,492643607,C012040,여자학생복,[바이너리원]라운드 러프 반팔니트/ 바이너리원,12200,11590,-610
2018-06-01,217693834,E031050,냉장고,[삼성전자] 인증점 삼성 김치 냉장고 김치 플러스 RQ57M9361M1,3976900,3976900,0
2018-06-01,1437623823,E061010,세탁세제,퍼실 2.7Lx2 3개 특가 리큐 액츠 액체 세탁세제 비트,23800,23800,0
2018-06-01,1197634106,A019020,참깨,볶음참깨 (정도 1K) X10,113800,101290,-12510
2018-06-01,1875250828,L021060,유모차,킨즈무브2 유아웨건 킨즈웨건 쌍둥이유모차,368000,368000,0
2018-06-01,1353355821,C013020,티셔츠,베이직 후드티 LTT0035 여성티셔츠 여성후드티,26120,25600,-520
2018-06-01,986128653,A017130,도라지,시원한 아이스 군고구마 120gx20 /총 2 400g 이상,41900,32900,-9000
2018-06-01,382050120,L021020,장신구,[티르리르] 다즐링(터키석) 팔찌TBSSVW10636M-8,59000,50150,-8850
2018-06-01,986128652,A017130,도라지,시원한 아이스 군고구마 120gx15 /총 1 800g 이상,34900,29900,-5000
2018-06-01,956811309,A013050,오징어,갈치(대/마리),22900,22900,0
2018-06-01,956811305,A022010,주스,[코카콜라]코카콜라 미닛 종합세트(오렌지+포도+알로에) (180ML*12),9900,9900,0
2018-06-01,1921305401,E011050,책상,무료배송 1인용컴퓨터책상/학생책상/서재/좌식책상,19900,19900,0
2018-06-01,1435163039,C011020,남자상의,블랙 체크 밍크털 코트 털코트 남성코트 퍼코트 남성,109100,109100,0
2018-06-01,2002620630,A022010,주스,오렌지음료(탑씨 1.5L)X12 식자재 음료 식당 오렌지음,17740,17740,0
2018-06-01,348888508,F012010,종이기저귀,하기스굿나이트 중형24px2팩/대형20px2팩 안심팬티,33900,33900,0
2018-06-01,578556016,C011030,남자학생복,FS078 카모 패턴 데님 셔츠 프린트셔츠 패션셔츠 프린,18670,18670,0
2018-06-01,1496043915,L021030,가방,균일가 여름신상 핸드백 여성가방 숄더백 토드백,19900,17900,-2000
2018-06-01,1435187009,C011020,남자상의,아이보리 체크 밍크털 코트 코트 털코트 남성코트 남,109100,109100,0
2018-06-01,712640320,C011050,남자내의,여름신상 슬랙스/면바지/스판/정장바지/마바지/남자,17700,17700,0
2018-06-01,1988032824,C021020,구두,[MOODA] 남성/남자/구두/로퍼/단화/신사화/정장,29800,29800,0
2018-06-01,1130099182,C013050,운동복,GGD (핑크돼지)뿅망치수납박스 차량용수납박스 다용도,25950,23650,-2300
2018-06-01,1063909142,A019060,된장,[CJ직배송] 다담 우렁강된장500g X2개,10800,10800,0
2018-06-01,622682742,C013010,점퍼,유아 반바지-데이린넨/ 릴헤븐,38000,26600,-11400
2018-06-01,1544042891,C013020,티셔츠,[대구백화점 II관] [베네통키즈]베네통레터링반팔티셔츠(3I1XC13HD),21000,17850,-3150
2018-06-01,2030862938,A018090,잼,무농약딸기쨈 딸기가좋아 땅사랑딸기쨈,12400,12200,-200
2018-06-01,1460719068,G022020,자동차타이어,금호타이어 마제스티 솔루스 KU50 225/45R18 무료배송,121600,103360,-18240
2018-06-01,1631869221,F012010,종이기저귀,[보솜이] 액티브 팬티형 (남/여) 기저귀 4팩,33900,33900,0
2018-06-01,1051671677,I031040,생화,2400루멘 캠핑등 LED 랜턴 + 충전식 /후레쉬/캠핑조명,31000,23190,-7810
2018-06-01,112912181,C011030,남자학생복,빅사이즈 베이직 가디건UN921-001 / 라운드넥니트 빅사이즈 남성가디건 직장인패션 남,57600,44930,-12670
2018-06-01,283048393,C012040,여자학생복,베니토 코드 블라우스/네이비/스트라이프/카라/기본,32000,32000,0
2018-06-01,689013213,A017300,미역,본사직송 달인 광천김 재래김9봉/파래김9봉,9900,9900,0
2018-06-01,1695428028,I031010,장난감,PC/PS3 EX3 ALPS 프리미엄 듀얼컨트롤러,24900,24900,0
2018-06-01,571896366,C013010,점퍼,T2137-여성 데일리 보송 후리스 반 집업 양털집업 포,40670,40670,0
2018-06-01,1392084109,E021010,침구,20%쿠폰! 올리비아데코 순면/아사 차렵이불(Q) 27종택,24900,24900,0
2018-06-01,890995598,E011030,거실장,린넨 다용도 서랍장,64900,64900,0
2018-06-01,1679894023,L021030,가방,히마와리 백팩 가방 나들이 수납가방 가방추천,29000,29000,0
2018-06-01,728249999,E041050,냄비,국산 뚜껑포함 전골냄비/냄비/찜냄비/경질냄비,10900,9900,-1000
2018-06-01,311557355,C013050,운동복,소형 차량커버 외장커버 차량용커버 세차 황사 차커버,55250,55250,0
2018-06-01,781464727,I031010,장난감,레고 호환 브릭조아 ye77001 신 쥬라기월드 공룡 8종,14900,14900,0
2018-06-01,1830307068,L021030,가방,오후5시 이전 결제시 당일출고 서류가방 브리프케이스,58000,58000,0
2018-06-01,497977705,C013010,점퍼,[게스키즈]G64KAJ020-W1 전판로고메쉬점퍼,45000,36000,-9000
2018-06-01,2025051274,C011050,남자내의,WS107 28부터38까지 슬림일자바지 - 남성의류 티셔츠,52980,47160,-5820
2018-06-01,2064246849,A014050,달걀,하림 즉석 삼계탕 800g/즉석/간편/초복/영계,7500,7500,0
2018-06-01,1161133899,I011030,사진기,캐논 정품 EOS M3 본체 + 22mm + 15-45mm 명품마을,730000,671510,-58490
2018-06-01,2125055850,A017210,파,GAP 인증받은 이동열님의 흑토마토 3kg/5kg 당일수확,13900,13900,0
2018-06-01,415095627,C013020,티셔츠,T1401-엔젤 라운드 셔링 티셔츠 여성라운드넥티 여성,22100,22100,0
2018-06-01,227016030,A014050,달걀,[상하농원] 순백색 동물복지 유정란 20구,13000,13000,0
2018-06-01,2062611824,C013020,티셔츠,[MLB키즈](신상품) 뉴욕 양키스 소매 배색 반팔 티셔츠(71TS61831-50U)[갤러리아],34300,29160,-5140
2018-06-01,1194529051,L021030,가방,[피에르가르뎅] 학생양말/팬티스타킹/선물세트/ KJC국제양말 모음전,22370,22370,0
2018-06-01,410813938,E011050,책상,책상책상의자/테이블/컴퓨터책상/입식책상/좌식책상/책꽂이/다용도테이블/의자/책상다,41000,40590,-410
2018-06-01,192099058,E011050,책상,OMT 접이식 높이조절 좌식 테이블 책상 거실 ONA-S1,28000,27000,-1000
2018-06-01,1718328437,E041020,컵,스텔라머그 6P세트/머그컵/찻잔/커피잔/머그잔컵,12380,12380,0
2018-06-01,1947095416,A014030,치즈,[동원]덴마크 유기농 우리아기 치즈 스텝 1 176g*8(총64매입),28900,28900,0
2018-06-01,1832339170,C013050,운동복,KS인증 식물성 에탄올 워셔액 발수코팅 1.8L 자동차,1140,1050,-90
2018-06-01,1142417,A011160,빵,무배 [코알라] 모듬빵 50개 1박스/간식빵 /단체간식,19900,19900,0
2018-06-01,1153042351,C011030,남자학생복,여름신상 M~2XL 고퀄리티/빅사이즈/린넨셔츠/여름코디,13900,13900,0
2018-06-01,297623760,C013020,티셔츠,폴로빅포니 카라티 반팔티 가디건 성인남여사이즈,69000,69000,0
2018-06-01,899405920,F011150,건강기능식품,우리아이유산균 드롭스/베이비유산균/아기유산균/액상,30550,30550,0
2018-06-01,1390272968,C013020,티셔츠,[MLB키즈](신상품) 뉴욕 양키스 티셔츠(71TSD1831-50G/71TSD1831-50L/71TSD1831-50M/7,29000,24650,-4350
2018-06-01,950100883,E011030,거실장,PU다니쇼파베드,76900,76900,0
2018-06-01,961283926,L012090,기초화장품,그린핑거 촉촉한 자연보습 울트라 크림 (300G),16500,16500,0
2018-06-01,950100881,E011030,거실장,패브릭다니쇼파베드,79900,79900,0
2018-06-01,1962178910,E061010,세탁세제,화미 식소다1kg x 24,75380,67090,-8290
2018-06-01,1268471846,F011150,건강기능식품,#MD추천정품# 장유산균/생유산균/배변관리/장건강관리/장이튼튼 생 유산균 1개월/프로,29510,29510,0
2018-06-01,371708086,E061060,살충제,레인보우에어 휘산기 용액 - 비바크린 블루 5Lx4 탈취,82850,82850,0
2018-06-01,1219178208,E061050,청소용세제,초강력 곰팡이제거제 욕실 벽지 화장실 곰팡이박멸 끝,9600,9600,0
2018-06-01,2083923277,C011050,남자내의,(SR)MHA531 남자빅사이즈조거스판면바지 /(참고)빅사,67800,59670,-8130
2018-06-01,143921387,L021050,우산,우산만들기/투명우산/유아우산/어린이우산/우산꾸미기,3100,3100,0
2018-06-01,574453489,C013020,티셔츠,*유아아동내의실내복 신상 이불수면조끼,8000,6900,-1100
2018-06-01,2109933616,C012040,여자학생복,[진저브리짓] 시크 골드링 롱조끼 여름 니트조끼 롱베스트 오피스룩,27000,27000,0
2018-06-01,1313285102,C011030,남자학생복,밀란시아 베이직 원버튼 블랙조끼 sh171-004 남성캐쥬,45500,44590,-910
2018-06-01,660639734,E031130,보온매트,한일의료기 거실용 카페트매트 전기매트 전자파차단,68000,55900,-12100
2018-06-01,2140026178,E011010,장롱,나비 틈새장/이불장/옷장/투서랍/장농/원룸가구/장롱,49000,47530,-1470
2018-06-01,1096045972,E031080,선풍기,홍진_ 사파이어 전기라디에이터 SF-005 (5핀),39000,39000,0
2018-06-01,962045028,E011050,책상,코너책상/책장세트/L형책상/책상/학생책상/컴퓨터책상,84000,79900,-4100
2018-06-01,835771058,E041010,식기,티타늄 이중 스텐냉면기 공기 국그릇 밥그릇 면기,11000,9920,-1080
2018-06-01,370633808,C021020,구두,VA-455 남성 클래식 로퍼끈 구두 정장화 남자구두 남,54290,54290,0
2018-06-01,2025459324,F012050,의료측정기,*브라운/피부체온계/비접촉/NTF-3000/굿40,80100,74400,-5700
2018-06-01,1322784116,C013020,티셔츠,제이린드버그 정품/2018 최신상 투어테크 KV 골프웨어,109000,97010,-11990
2018-06-01,900680202,E011070,식탁,하이그로시 접이식식탁/아일랜드식탁/뉴 헤드폴딩,89900,89900,0
2018-06-01,896815054,A021010,커피,[동서]동서 맥심 디카페인 (병/100g),7300,7300,0
2018-06-01,1005806248,L021020,장신구,1.2ct 천연루비반지/14k골드/환갑/어머님선물/H,420000,420000,0
2018-06-01,502927002,L021010,손목시계,라인 엠보 라운드 White 손목 시계 캐주얼손목시계 패,104090,104090,0
2018-06-01,496952525,C011020,남자상의,레드 체크 밍크털 코트 남성용코트 퍼코트 남성용털코,107100,107100,0
2018-06-01,339962925,L021020,장신구,11월탄생석 3mm 천연블루토파즈 티아라 원터치귀걸이,142000,142000,0
2018-06-01,1804574068,L021020,장신구,[바보사랑]liho 앤틱 자개석 미니귀걸이,8750,8750,0
2018-06-01,1804574066,L021020,장신구,[바보사랑]leso 진주포인트 드롭귀걸이,9450,9450,0
2018-06-01,1901120847,I012060,저장장치,커세어 K68 적축 방수 게이밍 기계식 키보드,137230,129000,-8230
2018-06-01,655618938,C021020,구두,남성구두 MA97 천연가죽 4cm 남성정장 신사화 /(참고),60800,49860,-10940
2018-06-01,1523736608,L012060,샴푸,려 자양윤모 샴푸 9개 2280ml/린스/려샴푸/한방샴푸,32900,26900,-6000
2018-06-01,162417642,E061010,세탁세제,레더클린 올인원1000/홈드라이/가죽 물세탁세제크리너,29800,26800,-3000
2018-06-01,1219538331,A011140,부침가루,프레디/부온돌체 250gx3개/수입과자/간식/빵/케익,8900,8900,0
2018-06-01,195348496,A017170,풋고추,백오이 10kg / 백다다기오이 / 국내산 / 최상품 / 팜,24500,24500,0
2018-06-01,341891625,A015010,참기름,참기름1.8L 들기름1.8L 고추기름 맛기름,7200,7200,0
2018-06-01,1261344397,A017220,양파,대파분태 100g,3740,3740,0
2018-06-01,317015806,A019100,식초,[하인즈공식몰] 하인즈 인기소스 4종,10900,10900,0
2018-06-01,381909764,C013010,점퍼,여성 카키 야상 여자 봄 공항 핫 패션 항공 점퍼 자켓,14900,14900,0
2018-06-01,807525552,I031010,장난감,물놀이완구 물고기잡기족대 다슬기쏙쏙 /어린이족대,8400,8400,0
2018-06-01,1124505997,A013010,갈치,제주어가 프리미엄 옥돔 02호(6마리 선물포장) 탐라의,211500,205160,-6340
2018-06-01,1123781549,A019060,된장,[박종필농가] 논산 전통 재래식 메주 3kg (2개입/참숯 건고추증정),35000,35000,0
2018-06-01,2046950809,C012020,원피스,[모조에스핀]하이넥 오버핏 코트_S174MSG405(GG1),299000,284050,-14950
2018-06-01,349900561,A022050,탄산음료,코카콜라 185mlx30캔 칠성사이다/콜라/사이다/음료수,13400,13400,0
2018-06-01,1312333494,C013030,스웨터,MTSSF18012 스쿨 반폴라 티셔츠 반목티셔츠 반폴라티,14800,14800,0
2018-06-01,1804574070,L021020,장신구,[바보사랑]lina 샹들리에 포인트 드롭귀걸이,9450,9450,0
2018-06-01,452237332,A013090,전복,(KBS6시내고향)방영2018통영싱싱(활)가리비1Kg초특가,2900,2900,0
2018-06-01,1320159799,E031110,청소기,벨로닉스 IoT 물걸레로봇청소기 SHRV-017,349000,349000,0
2018-06-01,1001032974,C013020,티셔츠,셀라소프트집업 티셔츠 여름 등산티 셔츠 여자 등산복,15900,15900,0
2018-06-01,1142076040,C012060,여자내의,[스튜디오 럭스]라이크라퍼펙트핏데님팬츠2종세트 28213,29900,26910,-2990
2018-06-01,1577500553,C012060,여자내의,푸조 여성 워테레깅스 ( S26-2 ),28550,24270,-4280
2018-06-01,1439268287,E021010,침구,특가[국산100% 순면정품 사계절 이불커버]/침구/이불,14900,14900,0
2018-06-01,1123781550,A019060,된장,[박종필농가] 논산 전통 재래식 메주 6kg (4개입/참숯 건고추증정),66000,66000,0
2018-06-01,999096752,E061010,세탁세제,[EM 살리미 발효 세탁세제 1000ml]3배고농축 천연세제 이엠 액체세제 유아용 베이비 드,16500,14950,-1550
2018-06-01,351420199,C013010,점퍼,18 FW 신상 카이로스 다운자켓 KEF2005/ 네파키즈,179000,152150,-26850
2018-06-01,918449186,C013020,티셔츠,[MLB키즈](이월상품) LA 다저스 반팔 티셔츠(71TS73731-07U)[갤러리아],34300,29160,-5140
2018-06-01,888332760,I031040,생화,♣충전식 캠핑랜턴♣멀티형/랜턴/후레쉬/손전등/LED/캠핑등/텐트등/등산용품/캠핑용품,22230,18710,-3520
2018-06-01,1505279341,C011030,남자학생복,[체이스컬트]남성용 매쉬조직 레터링 집업-DBAK4322D10,9900,9410,-490
2018-06-01,412289041,A018110,물엿,한성 참깨향기름1.8L2개,50620,50620,0
2018-06-01,951747054,F012010,종이기저귀,군기저귀 엑셀런트 소프트 팬티형[공용] XXL 36매x1팩,14400,14400,0
2018-06-01,2025207652,F012050,의료측정기,마이크로라이프 자동전자 혈압계/혈압측정기/혈압기,39800,39800,0
2018-06-01,352830357,A016030,복숭아,백도처럼 달콤한 맛 신비복숭아,49900,49900,0
2018-06-01,385563377,C011030,남자학생복,오투_쿨링타올 비치타올,42400,39860,-2540
2018-06-01,1127957630,E011070,식탁,스테이 테이블 의자set/ 식탁 컴퓨터책상/ 거실 벤치,108810,108810,0
2018-06-01,580318523,C015040,장갑,스마트폰 터치 영국국기 니트 여성장갑 디자인장갑 방,11840,11840,0
2018-06-01,839950841,C014010,아동복,꽃패턴민소매팬츠set/반바지/나시상하세트/민소매,9900,9900,0
2018-06-01,1063909172,A019080,고추장,[CJ직배송] 해찬들 약고추장 1kg + 태양초골드 매운고추장 900g,18200,18200,0
2018-06-01,1009865613,C021040,실내화,리복 ROYAL EC RID CM9367/D 커플 운동화 스니커즈,50000,44670,-5330
2018-06-01,1349071969,A016120,바나나,고당도 바나나 3.5kg내외(2손),20000,19320,-680
2018-06-01,1464538721,E051030,디지털도어록,[특가]자물쇠 보조키 열쇠 자물쇠고리 열쇠고리 번호열쇠 사물함열쇠 자전거열쇠 현관,1100,970,-130
2018-06-01,1439736128,C013010,점퍼,[대구백화점 II관] [레코브]체크 후드점퍼(L12182JP801X),64000,60800,-3200
2018-06-01,1804574093,L021020,장신구,[바보사랑]lita 포인트 볼드 드롭귀걸이,11550,11550,0
2018-06-01,1804574097,L021020,장신구,[바보사랑]loca 태슬포인트 앤틱 드롭귀걸이,17150,17150,0
2018-06-01,1366086481,A018090,잼,[복음자리]과일잼3개 무료배송 사은품증정,13500,13500,0
2018-06-01,1804574095,L021020,장신구,[바보사랑]loa 핑크 미니 앤틱귀걸이,6650,6650,0
2018-06-01,308821907,F012050,의료측정기,오므론 자동혈압계 HEM-7322+퍼포마난 혈당측정기,165000,153000,-12000
2018-06-01,550563185,C014010,아동복,로하스 한지 여아 고양이 캐미솔 셋트 닥나무 원료의,28420,28420,0
2018-06-01,1804574099,L021020,장신구,[바보사랑]lolol N 깃털 장식 드롭귀걸이,10150,10150,0
2018-06-01,90331659,A019060,된장,[CJ직배송] 명품집된장(900G) x 2개,10980,10980,0
2018-06-01,1804743449,E031040,전기레인지,데이킵스 냉장고정리 42P,122210,122210,0
2018-06-01,1149221934,A013160,맛살,한성 크래미(F2)1kg 한성크래미 게맛살 맛살 크래미,30100,30100,0
2018-06-01,1317079851,C021020,구두,VA-232 캐주얼화 로퍼 구두 남성신발 슬립온 구두 남,29390,29390,0
2018-06-01,804386508,C013020,티셔츠,특반팔V넥YV/Lㅡ4XL/2018신상품/빅사이즈/반팔티/큰옷,5000,4900,-100
2018-06-01,1860905598,A012010,국산쇠고기,이로운한우 한우양지500g 양지머리 국거리 장조림,27300,27300,0
2018-06-01,1134107418,C013010,점퍼,30%쿠폰!신상 남여공용 항공점퍼/청자켓/코치자켓,18800,18800,0
2018-06-01,767448853,E061060,살충제,새집증후군제거제(8평형)+압축분무기 세트 새집/새가구/인테리어/페인트 증후군제거(4,43000,38700,-4300
2018-06-01,138222850,A013170,생선통조림,동원참치 100g 150g/살코기/고추참치/리챔/4캔~10캔,13900,13900,0
2018-06-01,448940873,L021030,가방,[내셔널지오그래픽] 에코백 베이직 로고 에코백 BLACK,39000,33150,-5850
2018-06-01,66662090,A022010,주스,[대구백화점 II관] [포도한송이]경북대 포도한송이 120ml 50팩/포도즙,40800,39990,-810
2018-06-01,983741845,C013020,티셔츠,[빈폴아웃도어]Unisex 네이비 베이직 헨리넥 티셔츠 (BO8342S04R),69000,54510,-14490
2018-06-01,989972595,E061100,습기제거제,초L세이브)습기제거제(8입),6900,5990,-910
2018-06-01,2145782339,C013050,운동복,차량 실내용품/수납/차량/컵홀더/자동차/사이드/홀더,5900,5900,0
2018-06-01,1302777216,C012060,여자내의,샤인 멜빵 데님 스커트-M1057 와이드 힙합청바지 데님팬츠 멜빵청바지 데님스커트,30420,27080,-3340
2018-06-01,702081189,A015020,식용유,[사조해표]해표 카놀라유 900mlx4병,10900,10900,0
2018-06-01,958568914,A013070,굴,흰다리 새우(특/냉/마리),950,700,-250
2018-06-01,1024863551,C013010,점퍼,[에프엔에스]아동 패딩자켓 주니어패딩 웰론패딩 8927,19800,19800,0
2018-06-01,1984658242,L021050,우산,자전거 레져스포츠용 우의/우비/장마대비/전동휠체어,12000,11500,-500
2018-06-01,1272263758,F012010,종이기저귀,[보솜이] 리얼코튼 썸머팬티 XL 특대형 남아 30매 3팩,34900,34900,0
2018-06-01,1492206307,I031040,생화,[콜맨] 50쿼터 익스트림5 휠드쿨러 블랙 3000002003/국내당일출고,78000,75660,-2340
2018-06-01,1489278737,C014010,아동복,아둘 쥬니어 커플룩 엄마랑 도날트덕 롱 티셔츠 28,14300,14300,0
2018-06-01,370728652,E011040,소파,[에보니아] 티파니 2인벤치의자/방수패브릭/3인소파,100000,65000,-35000
2018-06-01,2012236740,A021020,차,S&B골든커리220g/바몬드카레/골든카레/토로케로카레,2600,2600,0
2018-06-01,1709348908,F012020,생리대,[릴리안] 숨쉬다 중형 36p x 3팩 총108p,9900,9900,0
2018-06-01,563272416,E061040,부엌용세제,그라인더세정제 퓨로그라인더클리너 - 그라인더세정제,52650,46860,-5790
2018-06-01,1375884036,C013040,청바지,데님a점프수트/여아/청바지/멜빵바지/36개월이상,9900,9900,0
2018-06-01,1949648572,F012050,의료측정기,비타그램 자동전자 혈압계 PG800B11/혈압측정기/혈압,39800,37810,-1990
2018-06-01,1598682173,C011050,남자내의,아디다스 여성 에센셜 리니어 타이츠(BR2523),51730,47600,-4130
2018-06-01,517274912,C012020,원피스,[플리츠미] 썸머 컬러 8부 통팬츠,39000,31200,-7800
2018-06-01,1804574030,L021020,장신구,[바보사랑]언발란스 달과 별 은침귀걸이,8720,8720,0
2018-06-01,1657821772,E031090,공기청정기,[삼성전자] [인증점]삼성 블루스카이 공기청정기 AX80N7580WFD,899000,719000,-180000
2018-06-01,2053628682,L021010,손목시계,클래식 크로노그래프 정장 남자 남성 메탈시계,43900,43900,0
2018-06-01,1967966333,C013050,운동복,[모비스] 크루저 루프백 차량용루프백 캠핑루프백 차량용캠핑용,291340,259300,-32040
2018-06-01,9377991,A013140,북어채,자연건조 황태채 500g / 황태포 먹태 안주 간식,14900,14900,0
2018-06-01,866606879,L012040,치약,페리오 토탈7 치약 120gx5개/46cm/100g베이킹소다치약,6900,6900,0
2018-06-01,1540490565,F012020,생리대,좋은느낌 생리대 중형 대형 18x6팩 여성용품,15500,15500,0
2018-06-01,632898682,A011170,떡,전북고창 울어매 모시잎송편 100개(25개 4팩) / 삼경,84000,73920,-10080
2018-06-01,1994084564,E041070,밀폐용기,플라스틱밀폐용기 죽그릇 도시락 탕 포장 일회용 배달,23000,21070,-1930
2018-06-01,958568944,A014010,우유,덴마크 대니쉬우유 900ML*2입기획,4500,3790,-710
2018-06-01,1911693911,C011030,남자학생복,MCD-917 빈티지 스타일 롱가디건 남성가디건 남성롱가,51160,45540,-5620
2018-06-01,2055962945,A016030,복숭아,산초가루맷돌 50g/산초,3530,3320,-210
2018-06-01,1205739187,C013040,청바지,[1+1이벤트]쫀쫀스판 고무줄 카고 블랙진밴딩빅사이즈,22800,12800,-10000
2018-06-01,1242681361,A016070,귤,제주직송 고당도 햇하우스귤 1kg 대과 /맛보기용,12900,12900,0
2018-06-01,1628207911,I011020,영상음향기기,단독특가행사 LG U+ 레이저 빔프로젝터 포켓빔 미니빔,319000,319000,0
2018-06-01,1126199473,C012040,여자학생복,[모다아울렛][코인코즈]스트라이프 펄 티셔츠(MIK8MP654),46400,44080,-2320
2018-06-01,1182278663,E031010,전기밥솥,쿠쿠 특가전 전기/압력/보온/밥솥/6인용/10인용/밥솥,125000,108700,-16300
2018-06-01,1864791955,F012020,생리대,무료배송 숲속이야기 텐셀 소형 16P X 4팩 + [순한순면중형1팩(2개입)증정]/ 예지미인,9900,9410,-490
2018-06-01,857511980,C013060,등산복,[블랙야크] 남성 등산 기능성 캐주얼 여름 반팔 L사이먼 티셔츠S 2종 택1,59000,47200,-11800
2018-06-01,794219861,E031080,선풍기,[시슬리] 온풍기히터 ENE-PHM1811 /겨울/난방/,39000,39000,0
2018-06-01,681755629,I031040,생화,소형 캠핑테이블/좌식테이블/미니테이블/캠핑용품,11900,11900,0
2018-06-01,1269734616,C012060,여자내의,jj42 꽈배기니트 미디스커트_라이트그레이 패션스커트,14830,14830,0
2018-06-01,1304983310,C012040,여자학생복,멀티 스트라이프 나시 풀오버(AJ2KH680)/ 랩,39000,33150,-5850
2018-06-01,391862498,C015040,장갑,버튼예식장갑 M 10개입 예식장갑 결혼식장갑 남자장갑,18240,18240,0
2018-06-01,1269685054,E061050,청소용세제,락스2LX6개(GB/유한락스)화장실/살균/소독/세정제,8000,7900,-100
2018-06-01,171556762,E041060,수저,(국산)아동 수저세트 1벌(딸기)/스푼 포크 유아 식기,5000,5000,0
2018-06-01,2047079851,F012010,종이기저귀,new 치쿨기저귀 프리미엄 팬티형 4팩 /밴드형,16200,16200,0
2018-06-01,1147142980,C013010,점퍼,[세여자몰][세여자몰]터들숏무스탕[YE-02097],109890,105500,-4390
2018-06-01,1171470692,C015040,장갑,스포츠장갑 남성여성 헬스반장갑 등산 낚시 운동 아령,4000,3680,-320
2018-06-01,794219854,E031080,선풍기,[신일] 라디에이터 5핀 SER-TP10CT/SER-DJ10CT_타이머(랜덤발송),73900,73900,0
2018-06-01,215541934,C013040,청바지,[홈런]청바지/일자/워싱/데님/스판/면바지/남자/남성,12800,12800,0
2018-06-01,1086943143,E031120,믹서,쿠진아트 스마트파워 미니믹서기 CPB-300WKR,80100,80100,0
2018-06-01,2046029738,C014010,아동복,[더루비]여아/맨투맨/롱티셔츠/티셔츠/원피스/아동,11800,11800,0
2018-06-01,733944937,A014030,치즈,아메리칸 싱글즈 슬라이스 치즈 72개입 (1.36kg),20900,20900,0
2018-06-01,786322622,A018030,껌,롯데제과 자일리톨 매스틱 리필 73gX3개+25gX3개/알파,10700,10700,0
2018-06-01,414549466,A019080,고추장,해찬들 / 된장 2kg+300g / 고추장4.5kg 6.5kg/ 된장,8900,8900,0
2018-06-01,262794789,C011050,남자내의,[컨셉원] 워시드 코튼 버뮤다 팬츠 10107501/107501(의정부점),20000,16150,-3850
2018-06-01,502465025,A013140,북어채,황태채 1kg 무료배송,15400,15400,0
2018-06-01,1093276372,E031080,선풍기,동일_9핀 타이머 라디에이터 TKR-T90S,63700,63700,0
2018-06-01,496388872,A012010,국산쇠고기,(제주어가 실속 세트)제주 은갈치 2마리 x 제주 옥돔,79100,70400,-8700
2018-06-01,556003826,C013050,운동복,프론트 리어 범퍼 가드 보호대 몰딩 블랙 보호대 범퍼,22340,20360,-1980
2018-06-01,1319829394,E061060,살충제,강력한 연쇄 효과 크린베이트 파워 200g - 바퀴벌레약,23080,23080,0
2018-06-01,1093276373,E031080,선풍기,동일_7핀 타이머 라디에이터 TKR-T70S,56200,56200,0
2018-06-01,866983029,E011030,거실장,[풀씨]루트 그리드핑크 720x480 다용도 상 중 하이글로시,20000,20000,0
2018-06-01,1093276370,E031080,선풍기,아이앤에스_ 스탠드형 할로겐히터 HP-916H,68000,68000,0
2018-06-01,1788123838,A017040,양배추,(면)(냉동)청학 부추1kg,7730,7730,0
2018-06-01,230129846,C012020,원피스,[막스까르띠지오]스웨이드패치 자수 하이넥코트,133000,97090,-35910
2018-06-01,1637128577,A019160,밑반찬,돌핀 폴라레티 후르츠 아이스바 40ML 70개 / 트로피칼,14290,14290,0
2018-06-01,990033010,A016150,아몬드,Onlyprice)믹스넛 180G,2000,2000,0
2018-06-01,183929634,A017150,버섯,[원하프]국산숙주나물270g/풀무원[총알배송!,2660,2660,0
2018-06-01,1215873155,C011030,남자학생복,[홈런]가디건/니트/숄/롱/하프/집업/셔츠/남성/남자,12800,12800,0
2018-06-01,180502816,I012010,컴퓨터,NEW신상.특별한이벤트.최다판매/삼성DM500S7A~고속SSD,688420,654000,-34420
2018-06-01,640591514,E041070,밀폐용기,네오플램 내열유리 밀폐용기/반찬통/글라스락,2900,2670,-230
2018-06-01,1955880018,C013010,점퍼,J94-2 다이스 빅사이즈여성의류 스트링 롱자켓 44~120,29900,29900,0
2018-06-01,701855276,F011130,홍삼,정관장 천녹정 에브리타임(10G*30입),240000,240000,0
2018-06-01,4067702,A015020,식용유,CJ 카놀라유 900mL*6입 포도씨유/식용유,17400,17400,0
2018-06-01,1872397422,C014010,아동복,11/초등학교체육복/체육복/학생체육복/크레용체육복,16000,16000,0
2018-06-01,1311542106,C015040,장갑,고급 모던 가죽장갑(남성) 겨울장갑 겨울가죽장갑 남,29420,29420,0
2018-06-01,1010171981,E061100,습기제거제,[P&G]P&G)페브리즈은은한향370ML,5900,5900,0
2018-06-01,1432048464,C013010,점퍼,여성자켓 정장자켓 하객룩 결혼식원피스 테일러드자켓,66500,56500,-10000
2018-06-01,1777020999,E031120,믹서,딤채 믹서기 25500RPM 고속믹서기 뉴트리불렛 NB1000P,159000,159000,0
2018-06-01,189121305,A018020,사탕,엑스오 XO사탕 커피맛 캔디 1.5kg/커피사탕/버터사탕,9390,9390,0
2018-06-01,1523710055,C011030,남자학생복,초특가 名品 긴팔 와이셔츠 정장 남자 남성 체크 셔츠,13800,10800,-3000
2018-06-01,1531573271,A012060,햄및베이컨,SPAM 스팸 클래식/마일드 340g 할인특가,20900,20900,0
2018-06-01,2113803651,C012060,여자내의,[하프클럽/ab.plus]W ab.plus 댄디슬랙스 LSR3GP05F,34000,34000,0
2018-06-01,1233990833,A011130,시리얼,파프리카시즈닝(청우 400g)X12 식자재용 spices 분말,93860,93860,0
2018-06-01,1667940025,A017010,배추,오병이어농산[특가]국산 양배추3개(5~8kg)/3통,14900,14900,0
2018-06-01,1597152252,F011130,홍삼,정관장 기운민세트(SET),60000,60000,0
2018-06-01,183930629,A017150,버섯,[원하프]국산무농약안심콩나물340g/풀무원[총알배송!,3060,3060,0
2018-06-01,389992068,A019180,즉석식품,고추튀김1kg 오징어채 오징어링 김말이튀김 순대,9900,9900,0
2018-06-01,585551629,C011050,남자내의,30%쿠폰! 원플 남여공용 면마바지/면마반바지/여름팬,10900,10900,0
2018-06-01,732581103,E011050,책상,좌식책상 시리즈10종/컴퓨터책상/공부방/학생/테이블,19000,17500,-1500
2018-06-01,369804473,C015040,장갑,방한장갑 뱅키블랙 보드장갑 눈썰매장갑 스키장갑 방,11260,11260,0
2018-06-01,1599015547,A011170,떡,[떡장인 황대규옹] 수능찰떡 5종혼합 영양세트 大 (45Gx20개) /수능떡,26000,23400,-2600
2018-06-01,958544914,A011110,당면,맑은물에청국장(200G),1490,1490,0
2018-06-01,1056313871,L012060,샴푸,리엔샴푸 대용량950mlx2개~3개/백단향/서향/엘라스틴,14900,14900,0
2018-06-01,1228053601,A011130,시리얼,통감자 부침가루 (백설 1K) X10,48010,42730,-5280
2018-06-01,387392666,C015040,장갑,[프로스펙스] (SIZE : LXL) 핑거 메이저 2 니트 글러브(GR,8740,8740,0
2018-06-01,1712528300,I031040,생화,캠핑샤워기/차량용 휴대용 샤워용품/야외 등산 낚시,21800,20060,-1740
2018-06-01,866983005,E011030,거실장,[풀씨]루트 화이트가든 720x480 다용도 상 중 하이글로시,20000,20000,0
2018-06-01,1247457971,E061020,섬유유연제,피죤 섬유유연제 2100mlx5개 용기 액츠 세제,12800,12800,0
2018-06-01,866983004,E011030,거실장,[풀씨]루트 화이트가든 800x600 다용도 상 대 하이글로시,22400,22400,0
2018-06-01,866983007,E011030,거실장,[풀씨]루트 그리드핑크 800x600 다용도 상 대 하이글로시,22400,22400,0
2018-06-01,2116954038,A019180,즉석식품,CJ 비비고 미역국/육개장/스팸부대찌개/사골곰탕 14종,1090,1090,0
2018-06-01,866983006,E011030,거실장,[풀씨]루트 화이트가든 600x400 다용도 상 소 하이글로시,17400,17400,0
2018-06-01,309122282,C011030,남자학생복,[체이스컬트]여성용 쉬폰 배색 야상 베스트-DBRG7301CF0,9900,9410,-490
2018-06-01,985327990,L012030,칫솔,[P&G]P&G오랄비 고탄력 초미세모 틈새케어_4입,10900,10900,0
2018-06-01,1753369254,L021010,손목시계,AILANG 정품 남자 선물 오토매틱 명품 손목 메탈 시계,282000,275000,-7000
2018-06-01,895833004,E061040,부엌용세제,[LG]LG 자연퐁 오렌지 1.2KG(리필),6300,2990,-3310
2018-06-01,866983001,E011030,거실장,[풀씨]루트 라임가든 800x600 다용도 상 대 하이글로시,22400,22400,0
2018-06-01,866983000,E011030,거실장,[풀씨]루트 로즈와인 600x400 다용도 상 소 하이글로시,17400,17400,0
2018-06-01,1353860744,C013020,티셔츠,디스커버리 반팔티 DWTS74731 여자 카라티 에리포인트 PQ 티셔츠,34500,31050,-3450
2018-06-01,866983003,E011030,거실장,[풀씨]루트 라임가든 600x400 다용도 상 소 하이글로시,17400,17400,0
2018-06-01,866983002,E011030,거실장,[풀씨]루트 라임가든 720x480 다용도 상 중 하이글로시,20000,20000,0
2018-06-01,839264627,E031110,청소기,정품.삼성 진공청소기 VC33M2110LP 가정용청소기,119800,119800,0
2018-06-01,2144457524,A014030,치즈,코리원/모짜렐라치즈 1kg/치즈/피자치즈/간식/피자,7600,7500,-100
2018-06-01,442633115,A014010,우유,[정기배달] 헬리코박터 프로젝트 윌 - (90개)/ 한국야쿠르트,126000,126000,0
2018-06-01,610786181,E011060,의자,레이디가구 침대형 중역 리클라이닝 사무용 의자,127950,115160,-12790
2018-06-01,1804574002,L021020,장신구,[바보사랑]3중 레이어드 체인 목걸이,10320,10320,0
2018-06-01,727080494,F012010,종이기저귀,[하기스] 보송보송 2~6단계(팬티4팩/밴드3팩),38900,38900,0
2018-06-01,948541138,C012060,여자내의,[반에이크]고방롱체크SK(VA85SKQ329Z),39800,35820,-3980
2018-06-01,1804574000,L021020,장신구,[바보사랑]나뭇잎 큐빅 은침귀걸이,9520,9520,0
2018-06-01,514121966,A011170,떡,쌀떡국떡1kg/떡국떡/떡국/쌀떡볶이떡/떡볶이떡/쌀떡,1680,1680,0
2018-06-01,762672186,A016090,참외,최고과일 - 게르마늄기능성참외 3K,19900,14900,-5000
2018-06-01,1804574004,L021020,장신구,[바보사랑]이자르크로스,106000,106000,0
2018-06-01,544513901,C012040,여자학생복,[리스트][리스트] 18 여름신상 레드라벨 노카라 롱 포켓 가디건_TSKCDI62010_MG,59000,54870,-4130
2018-06-01,750071598,A016120,바나나,[ 무료배송] 맛있는 돌바나나 / 6kg 대용량,22900,22400,-500
2018-06-01,1665454796,L012060,샴푸,미쟝센 퍼펙트세럼 샴푸/린스 680ml /트리트먼트,3200,3200,0
2018-06-01,1401974943,C013020,티셔츠,[MLB] 남여공용 와펜로고 반팔 티셔츠(31TSD1831),33000,27390,-5610
2018-06-01,1092322098,E031080,선풍기,유니맥스_ 탁상용 미니 온풍팬히터 UMH-400S,17950,17950,0
2018-06-01,1257877681,C013010,점퍼,[무료배송] 세젤예 블루종 항공점퍼,25210,21690,-3520
2018-06-01,1092322095,E031080,선풍기,신일_ 휴대용 가스히터 SCG-1700JW(주황),45300,45300,0
2018-06-01,998791113,C013050,운동복,RainOK에탄올워셔액/발수코팅워셔액/12개이상무료배송,2900,2900,0
2018-06-01,1093276366,E031080,선풍기,BTI 카본히터 BTI-1200C,45700,45700,0
2018-06-01,973013926,C012060,여자내의,[포에버21]하이웨스트 우븐 반바지/FOREVER21/바지/팬츠/핫팬츠,22900,18320,-4580
2018-06-01,1092322091,E031080,선풍기,신일_ 세라믹 벽걸이형 히터 SEH-900WST,50000,50000,0
2018-06-01,228823352,I031040,생화,컬러풀 꺾임파라솔 21종/파라솔/낚시파라솔/그늘/비치,22800,20980,-1820
2018-06-01,1092322093,E031080,선풍기,신일_ 세라믹 벽걸이형 히터 SEH-1250WOH,51300,51300,0
2018-06-01,1622082029,C013010,점퍼,[까르뜨블랑슈]CMM7WJ82 CP 린넨 스트레치 자켓 - 3종,159000,127200,-31800
2018-06-01,451843080,C013020,티셔츠,(2+1양말)국산 끈나시/캡 롱나시/스포츠브라탑/런닝,4900,4900,0
2018-06-01,525493079,C012020,원피스,[보브]체크 패턴 린넨 코트(7127216056)/ 보브(의류),138000,110400,-27600
2018-06-01,913449956,A019080,고추장,캠핑갈때 딱!! 장류 균일가 상품,1950,1950,0
2018-06-01,1939545257,C013050,운동복,차량용소화기 월드프로 119 자동차소화기 휴대용 차량용 소화기 구난용품 비상용품 캠,9300,8530,-770
2018-06-01,986307337,E061090,방향제,페브리즈 화장실용 비치형 숲속향 5.5ML,6500,6500,0
2018-06-01,357773275,C013010,점퍼,라운드넥 집업점퍼 SU4UJ02　/ 숲,99000,89100,-9900
2018-06-01,900476647,A016050,밤,건대추 500G,7990,7990,0
2018-06-01,1049487108,E031010,전기밥솥,쿠첸 2017년 출시! 3인용 미니밥솥 CJE-A0306,48900,48900,0
2018-06-01,893943857,E031130,보온매트,[바보사랑]숯 황토볼온열매트(더블),550000,550000,0
2018-06-01,446386804,C013050,운동복,카미리 다용도 우산걸이/루어낚시태/등산지팡이/클립/정리함/홀더/SM3/SM5/그랜져xG/그,4850,4430,-420
2018-06-01,382049219,L021020,장신구,[티르리르] 다즐링(장미수정64cut)팔찌TBSSVW10636M-5,59000,50150,-8850
2018-06-01,1176185739,C011050,남자내의,카멜 푸딩바지/배기바지/밴딩바지/면바지/냉장고바지,7900,7900,0
2018-06-01,1600412848,C011050,남자내의,[뉴에라] 반바지 (11760933) 2018 신 NE 테크 숏 팬츠 그레이 (AP NE TECH SHORT PANT,89000,77700,-11300
2018-06-01,1521567514,E011050,책상,리바트 프렌즈 소호 1800 ㄷ자 책상,95400,95400,0
2018-06-01,81387906,E061020,섬유유연제,소프트빈스 용기 4Lx1개+2Lx1개 섬유유연제 세탁,15900,15900,0
2018-06-01,1299485804,C013010,점퍼,신상 후드집업/후드티/맨투맨/티셔츠/여성/빅사이즈,22800,19800,-3000
2018-06-01,915335677,C011020,남자상의,(추동용신상)빅사이즈 st 댄디 자켓 sun1710-001 빅사,100330,95320,-5010
2018-06-01,559288686,C015040,장갑,아놀드파마_APGW-BY1221(여성가죽장갑) 장갑 가죽장갑,26000,26000,0
2018-06-01,470450873,E031110,청소기,[LG전자] LG판매점(JS) 파워싸이킹 C40SGY 진공청소기 헤파필터,181720,169000,-12720
2018-06-01,127075173,L012060,샴푸,더플러스 샴푸/식물성계면활성제.초저자극 천연샴푸/비듬.각질.가려움.지루성두피염,34000,32000,-2000
2018-06-01,1915535281,A015020,식용유,청정원 올리브유 500ml X 15EA(Hanworld),171300,145610,-25690
2018-06-01,991284983,A012040,닭고기,국내산100% IQF 닭가슴살 5kg/체리부로/CSK 가슴살,24900,24900,0
2018-06-01,1292137913,F012020,생리대,좋은느낌 유기농/순면/중형/대형/오버나이트/라이너,7900,7900,0
2018-06-01,1351404022,E021010,침구,[키즈 세사]루카스 인견 홑이불 베개세트 S(강남점),79000,67440,-11560
2018-06-01,2147417879,C012020,원피스,김발 겉대x20,20160,20160,0
2018-06-01,996195276,C013050,운동복,싼타모-미르웨이 후사경/4WD/RV용품/사각지대/후진주차/현대/기아/대우/쌍용,27000,24600,-2400
2018-06-01,146467460,A012040,닭고기,[신선애] 냉동 생 닭가슴살 1팩 구성,850,850,0
2018-06-01,439788463,E041010,식기,방짜유기/방짜/그릇/부부/반상기/세트/예단/조각매화/,770000,750000,-20000
2018-06-01,1412888283,C014010,아동복,어린이 방한 마스크 FL0146 플라이봇패턴마스크,8720,8720,0
2018-06-01,450567467,C013030,스웨터,MTSSF18014 크랙 후드 남자후드티 남성용후드티 캐주,40400,40400,0
2018-06-01,175334224,A019080,고추장,청정원 (쌀)초고추장 170g사각 1+1,6500,6500,0
2018-06-01,849226212,A019080,고추장,해찬들 우리쌀 태양초 고추장(1KG),12780,12780,0
2018-06-01,1093276395,E031080,선풍기,동일_5핀 타이머 라디에이터 TKR-T50S,50900,50900,0
2018-06-01,496388812,A012010,국산쇠고기,(제주어가 실속 세트)제주 은갈치(대) 1마리 x 제주,77000,68530,-8470
2018-06-01,999287539,A011080,밀가루,오뚜기 가쓰오부시 국수장국 360ml 소면 국수 비빔장,2000,2000,0
2018-06-01,242391775,C015030,넥타이,(색상 : 연핑크) BTIE_062 파스텔 유광 보타,12740,12740,0
2018-06-01,373798988,A019080,고추장,팔도 만능비빔장(40G*10입),4800,4800,0
2018-06-01,699238826,A013030,조기,특가판매[국내산 서해 참조기]100 마리(5마리x20팩),39800,39800,0
2018-06-01,1821580291,C013010,점퍼,[올리비아로렌][올리비아로렌]캐주얼 밴딩 주름 롱 점퍼 VOCCLRS2331_53,20000,19000,-1000
2018-06-01,955799340,E061020,섬유유연제,[아토세이프] 오투겔 표백 세탁세제 2.5L 4개 /오투크린/표백/세탁세제/액상세제/표백세제,10900,10500,-400
2018-06-01,707415871,C013040,청바지,S~5XL 여름 청바지/면반바지/7부바지/5부/빅사이즈,13900,13900,0
2018-06-01,1726660699,I011030,사진기,정품 니콘 A300 2005만화소 디카 카메라 사은품증정,148000,126040,-21960
2018-06-01,985349344,A013130,오징어채,참진미 오징어기획 150G*2봉,15900,9900,-6000
2018-06-01,985349343,A013130,오징어채,백진미 오징어(국산) 120G/봉,10900,10900,0
2018-06-01,1391824799,C013010,점퍼,[모다아울렛][ENC]파스텔롱야구점퍼(ENJJ81221OLL),111500,104810,-6690
2018-06-01,1913963700,F011120,인삼,(장생농산장수산삼 7년근 5주(5뿌리) 7년근 10년근 산,215930,209460,-6470
2018-06-01,442789073,C013040,청바지,키즈 여아 라이트 워시 데님 미디 쇼츠 5218232531051/ 갭 키즈,39000,33150,-5850
2018-06-01,739007436,L021060,유모차,페도라 S9 앨리스 유모차+필수 사은품 5종 증정!,225000,225000,0
2018-06-01,2003132187,L012060,샴푸,2018년형/려 화윤/ 화윤생 뷰티풀에이징 샴푸액 350ml,19300,19300,0
2018-06-01,474707206,C012040,여자학생복,가디건 숄 어깨 머플러 스카프 실내 사무실 여성 패션,32710,32710,0
2018-06-01,990033046,A019180,즉석식품,CJ 비비고 삼계탕 800G,10980,8990,-1990
2018-06-01,1122444820,C012040,여자학생복,린넨옆트임뒷벨트베스트_KL1VT142A/ 쿠기,30800,27720,-3080
2018-06-01,2125018876,C013010,점퍼,[제이콤마][제이콤마]시크 레더 자켓,74800,71810,-2990
2018-06-01,2111188126,C013010,점퍼,[에꼴리에] B 사이클 홑겹 바람막이17B1101,22000,22000,0
2018-06-01,1122444824,C012040,여자학생복,노카라옆트임롱베스트_KL1VT143A/ 쿠기,26800,24120,-2680
2018-06-01,229946858,A017160,오이,[가온애]특가 건표고 모음 표고버섯 마른표고 표고 버섯 표고슬라이스 목이버섯 건나물,6000,5800,-200
2018-06-01,1950326878,C012040,여자학생복,[악녀일기][악녀일기]쿨링롱가디건,24640,22670,-1970
2018-06-01,423410168,C013010,점퍼,헌팅자켓 사파리 BW 남성자켓 점퍼 야상 남자야상 헌,85280,85280,0
2018-06-01,428005462,E031080,선풍기,한빛 공기청정슬림형 전기온풍기hv-5000(5.0kw) - 전,697330,620630,-76700
2018-06-01,895798287,L021050,우산,[3M]3M천연펄프망사수세미(타원형),2190,2190,0
2018-06-01,1953742683,F012010,종이기저귀,베이비위크/ 물티슈2팩증정 모나리자 키비 기저귀 4팩,27900,27900,0
2018-06-01,1199571416,C013010,점퍼,[올리비아로렌] 펀칭 짜임 시스루 가디건 4VOCBCQM4431,26900,25290,-1610
2018-06-01,2051134337,C012030,여자상의,[땡스메리] 30%쿠폰! 시원한 썸머특가전/ 원피스 외,15900,15900,0
2018-06-01,375922154,A014050,달걀,[농장직송] 백봉오골계 부화용 종란 10구,14000,14000,0
2018-06-01,958627746,A018060,스낵과자,프링글스 오리지날110G,2730,2730,0
2018-06-01,1459637747,A016160,과일가공품,블루베리안주 (소울 350g) X6,130530,116180,-14350
2018-06-01,1152173185,C013040,청바지,[미아마스빈] 넘나예쁜 여름신상! 티셔츠/팬츠/원피스,18000,18000,0
2018-06-01,1114803340,E061030,전구,[유니온엘이디] LED공장등 100W 천장등기구 체인형 LED모듈 유니온LED,99000,99000,0
2018-06-01,482402657,C012020,원피스,허리스트링 트렌치코트VU4BB91,63200,63200,0
2018-06-01,988212108,E061030,전구,[GE]GE) 컴팩트 30W 주광색 2입 12*7*19,15900,15900,0
2018-06-01,1173441741,C014010,아동복,[MLB키즈] 여름 반팔 티셔츠(택1)71TS64831,34300,29160,-5140
2018-06-01,899344493,A018060,스낵과자,[크라운]크라운 화이트하임 (142G),2750,1990,-760
2018-06-01,988212107,E061030,전구,[GE]GE) 12W주광색 2입 9.5*5*12.5,12500,12500,0
2018-06-01,353454966,A012010,국산쇠고기,대관령한우 스페셜 5호,334310,334310,0
2018-06-01,1319051941,C011050,남자내의,보풀방지 브라운화이트라인 교복조끼 공용 코스프레,28560,28560,0
2018-06-01,1610234,C013050,운동복,툴마트백업패드변환아답터 M14 M16용,4900,4330,-570
2018-06-01,2127531912,E031140,비데,아메리칸스탠다드 전자식 센스웰비데 KF-8327 KF-8331,307000,153500,-153500
2018-06-01,388163445,C015030,넥타이,(색상 : 네이비) BTIE_112 땡땡이 두꺼운 니,15140,15140,0
2018-06-01,1399377315,E011020,침대,다하스 1000S /맥반석 싱글침대/ 장수돌침대,1688700,1469170,-219530
2018-06-01,1374464485,C013040,청바지,[제이알주니어] 4부청팬츠(연청),29900,23920,-5980
2018-06-01,1297198052,C011020,남자상의,MJ-924 미니멀 컬러링 투버튼 자켓 남성캐주얼자켓 남,139000,137610,-1390
2018-06-01,1054883641,C013020,티셔츠,플라워바코드크롭티/라운드티/프린트티/반팔티.,4900,4900,0
2018-06-01,320508314,C011030,남자학생복,남성셔츠 반팔셔츠 와이셔츠 남방 봄 여름 남자셔츠,19800,19800,0
2018-06-01,1549921634,A011050,콩,삼덕식품 2017년 가을에 수확한 국산 생땅콩 2kg,23900,23900,0
2018-06-01,1047078471,A011140,부침가루,2단으로 쌓을수있는 크라운 2단 케이크스탠드 도자기,32450,32450,0
2018-06-01,682869358,A013090,전복,관자슬라이스250g 냉동/키조개슬라이스/냉동관자,8900,8900,0
2018-06-01,986307307,E061040,부엌용세제,참그린 순수 발효곡물 리필 1.2L,4900,4900,0
2018-06-01,1622167474,L021030,가방,력셔리 백팩 도심 심플형 노트북가방 넷북 맥북가방,29000,29000,0
2018-06-01,1010291914,A011160,빵,[아레바로스] 밀또띠아6인치,11700,9000,-2700
2018-06-01,1010291915,A011160,빵,[아레바로스] 콘또띠아6인치,16900,13000,-3900
2018-06-01,428668899,I031070,애완동물관리비,스타 족구네트(경기용/보급형)/스타 공식판매점,16000,13280,-2720
2018-06-01,1371120648,A017250,고사리,동결건조 유기농 브로콜리 가루 분말 60g x 4개 녹즙,38800,38800,0
2018-06-01,1899678441,C013020,티셔츠,[필골드] SLKN501n502 글라데이션 오버핏라운드니트,37800,37800,0
2018-06-01,1353379874,C013020,티셔츠,베이직 후드티 LTT003 여성티셔츠 여성후드티,26120,25600,-520
2018-06-01,1890536940,I031010,장난감,경찰 전동 오토바이 유아 스쿠터 바이크 사이클 선물,85800,83230,-2570
2018-06-01,632284273,C012060,여자내의,벨벳 기모 몸빼 바지 일바지 편한 고무줄 밴딩 팬츠,6500,6400,-100
2018-06-01,1123036803,E011030,거실장,레테 골프 1인소파,140000,140000,0
2018-06-01,1123036802,E011030,거실장,레테 골프 2인소파,220000,220000,0
2018-06-01,1123036805,E011030,거실장,레테 레이 1인소파,76000,76000,0
2018-06-01,1123036804,E011030,거실장,레테 레이 2인소파,135000,135000,0
2018-06-01,457313571,C011030,남자학생복,[2018 남자 여름코디] 사카리바 가디건,22500,22500,0
2018-06-01,1123036806,E011030,거실장,레테 카니발 1인소파,76000,76000,0
2018-06-01,1901636682,F012020,생리대,깨끗한나라 릴리안 . 순수한면 정품 생리대 인기 SET,12900,12900,0
2018-06-01,2074713233,C012020,원피스,브로치장식 심플자켓 Z181MSF002/ 쥬크,179000,152150,-26850
2018-06-01,1713114167,C013050,운동복,롤타입 휠바란스 붙이는납 케이스 5g 1000ea 강재납,18900,18900,0
2018-06-01,288089781,C011030,남자학생복,신상품 풍기인견 인견 반팔남방C / 인견남방 여름남방 비치남방 poong5,55150,55150,0
2018-06-01,1199630230,A011030,찹쌀,보리쌀 (7K),37130,33050,-4080
2018-06-01,1690007890,A022010,주스,[제주직송] 참좋은 알로에겔(즙) 30팩(알로에 90%/팩당 100ml),49900,47660,-2240
2018-06-01,949031233,I012010,컴퓨터,삼성 LG 중고컴퓨터 브랜드 데스크탑PC 모음전,270000,135000,-135000
2018-06-01,1153872494,L012090,기초화장품,(4중 기능성 올인원 크림) 그라펜 에너지포인원 크림,21000,21000,0
2018-06-01,37031458,A016120,바나나,대용량 고당도 바나나 13kg 1박스 6손/8손,28500,28500,0
2018-06-01,2058765911,E011050,책상,무료배송 1인용컴퓨터책상/좌식컴퓨터책상/일자형책상,19900,19900,0
2018-06-01,153660804,E031010,전기밥솥,쿠첸 6인용 CJE-NB0601// 원터치 취사.보온 전기밥솥,32500,30550,-1950
2018-06-01,1945244602,E031110,청소기,한경희 듀얼(스틱+핸디) 무선 진공청소기 VS-1000WT,116120,99900,-16220
2018-06-01,300570716,C012040,여자학생복,[카라]KARRA 레이어드배색자수블라우스_KBI6BL231C,32500,30880,-1620
2018-06-01,1225695795,C011030,남자학생복,[지오다노] 048515 에어 쿨 셔츠/ 지오다노,39800,32240,-7560
2018-06-01,1326161105,L021010,손목시계,버버리 시계 남성 여성 크로노그래프 기능 풀구성,138000,138000,0
2018-06-01,1010291946,A011160,빵,[다이애나] 멕시코 콘또띠아6인치,16900,13000,-3900
2018-06-01,802492147,A016030,복숭아,황도캔(2절 화남820g)/황도캔 복숭아캔 황도 과일통조,4470,4210,-260
2018-06-01,1690979156,A013010,갈치,잔가시없는 어린이 순살 갈치팩 500g/ HACCP인증,12900,12900,0
2018-06-01,175385834,A019080,고추장,[1+1]청정원 (쌀)초고추장 170g+170g(사각),2600,2600,0
2018-06-01,2056539388,A013080,조개,굴철철 냉동굴5kg~10kg/건조굴/무료배송/공장직송,45700,45700,0
2018-06-01,549851327,C012060,여자내의,[스파오][스파오] 남성 린넨바지-SPTC526M10,13900,13210,-690
2018-06-01,607579032,F012010,종이기저귀,[네띠] 스웨덴 친환경 네띠 기저귀 팬티형 5단계 4팩,54000,54000,0
2018-06-01,1563309278,C013010,점퍼,봄 여름 남성 바람막이 점퍼 자켓 등산 경량 아웃도어,16800,16800,0
2018-06-01,218799180,L021050,우산,도롱이/우비/우의/비옷/낚시복/오토바이우의/레인코트,33800,33800,0
2018-06-01,442789035,C013040,청바지,키즈 여아 다크 워시 데님 쇼츠 5218232571051/ 갭 키즈,39000,33150,-5850
2018-06-01,1418759310,A016160,과일가공품,칠레산 A등급 냉동 블루베리 1kg/망고/라즈베리,5800,5800,0
2018-06-01,1311760448,A011170,떡,[블루탐] 블루탐 오메기떡(60/80개입) 무료배송!!!,45000,45000,0
2018-06-01,981692614,A018060,스낵과자,농심 매운 새우깡 400G,3600,2890,-710
2018-06-01,175385832,A019080,고추장,[1+1]청정원 (쌀)초고추장 300g+300g(튜브),4400,4400,0
2018-06-01,819294719,E011040,소파,[에보니아] 뉴피닉스 3인소파/PU/방수패브릭/3인쇼파,249000,249000,0
2018-06-01,761991364,E041020,컵,el.크리스탈 손잡이 뚜껑머그 2조 (선택) 물컵 유리컵,8420,8420,0
2018-06-01,794219892,E031080,선풍기,[신일] 히터벽걸이 SEH-1800WR/SEH-880WR _ 근적외선 /겨울/난방/,123000,123000,0
2018-06-01,1567132144,A011080,밀가루,방울이표 구포국수 1.4kg/오색국수,2300,2300,0
2018-06-01,1313909297,C013010,점퍼,[드넬]파스텔봄버점퍼DJ81944A,16900,15210,-1690
2018-06-01,1796399885,L021020,장신구,핫쎄일/8mm 담수비드/광택칼라aa급/14k장식,140000,140000,0
2018-06-01,1010350719,A019180,즉석식품,동원 떡볶이의신 달콤바삭떡강정 402G,4490,4490,0
2018-06-01,1010349639,A022050,탄산음료,롯데 수박스파클링 190ML*6,4280,2100,-2180
2018-06-01,987972725,A011060,땅콩,[맛있는 잡곡] 풍경소리 발아현미19곡 3kg + 사은품 !! 찰흑미 200g 증정,13900,10300,-3600
2018-06-01,1247514396,F012020,생리대,시크릿데이 생리대 NEW라이너 일반20PX15팩,11700,11120,-580
2018-06-01,1188475978,C012060,여자내의,[리스트] 프론트 슬릿 컷아웃 데님 스커트_TSMSKH10010_BL,39000,31200,-7800
2018-06-01,1989608691,L012040,치약,EM 치약세트/천연건강 친환경/무불소 무파라벤/어린이,13100,12950,-150
2018-06-01,559201295,A014030,치즈,DS090/서울체다 멀티슬라이스치즈 1800g 가공식품 조,41430,41430,0
2018-06-01,262202366,C012040,여자학생복,단추 포인트 가디건 가디건 라운드가디건 볼레로 단추가디건 미니가디건,170920,107680,-63240
2018-06-01,382050058,L021020,장신구,[티르리르] 다즐링(프레나이트) 팔찌TBSSVW10636M-7,59000,50150,-8850
2018-06-01,1010288161,A016150,아몬드,브라질넛 120G,5990,5990,0
2018-06-01,1385741553,A011160,빵,안흥찐빵마을 국산팥 수제 안흥찐빵 3종세트 빵 팥찐,70420,70420,0
2018-06-01,1026718506,E031090,공기청정기,(공식)샤오미공기청정기 미에어2/국내AS/가정 사무실,148000,142000,-6000
2018-06-01,1148167921,E031130,보온매트,한일 카페트매트 온돌마루 전기장판 전기매트 전기요,90000,49900,-40100
2018-06-01,468651596,C013010,점퍼,빅사이즈 쥬리 후드점퍼 후드집업 집업점퍼 후드집업,92120,92120,0
2018-06-01,955680391,E061020,섬유유연제,[아토세이프] 유아 섬유세제 2L 3개 + 섬유유연제 2L 1개/세제/아기세제/아기유연제/유아세제/유아유연제/유아섬유유연제/유아용세제,21900,7900,-14000
2018-06-01,793267609,C013020,티셔츠,[대구백화점 I관] [톰보이](기존가:19 000원)레이어드롱민소매티셔츠(9107223111),19000,16340,-2660
2018-06-01,942936739,L021060,유모차,프라메떼 - 디럭스사륜 180도차양 170도등받이조절 유,776330,690940,-85390
2018-06-01,989852589,A011180,파스타면,오뚜기 프레스코 번들스파게티 500G,2780,2780,0
2018-06-01,574964378,A012050,소시지,렉커 햄소시지 비어슁켄(600g)/국산돈육/손으로만든독일전통수제햄소시지/반찬술안주간,5300,5300,0
2018-06-01,1061973932,L021010,손목시계,CASIO 카시오 LQ-139EMV-1ALDF여성 우레탄밴드 패션시계,25000,25000,0
2018-06-01,1061973931,L021010,손목시계,CASIO 카시오 LQ-139EMV-7ALDF여성 우레탄밴드 패션시계,25000,25000,0
2018-06-01,1061973930,L021010,손목시계,CASIO 카시오 LQ-139EMV-9ALDF여성 우레탄밴드 패션시계,25000,25000,0
2018-06-01,1209310508,A016070,귤,자연농부고냉지 거창한사과 선물세트2호 5kg14-16과/,60480,60480,0
2018-06-01,2016592219,C013010,점퍼,배색퍼가죽무스탕,164700,164700,0
2018-06-01,1427886416,E031120,믹서,이유식믹서기 곡식도 갈리는 초고속 타우루스 블렌더,89000,83990,-5010
2018-06-01,2047449234,F011150,건강기능식품,데일리베스트종합비타민+선물박스+휴대용기/180정*2병,28310,28310,0
2018-06-01,1690150136,A013040,고등어,이동삼 안동 간고등어 순살 80g 100g 150g 300g,33000,32000,-1000
2018-06-01,1061973929,L021010,손목시계,CASIO 카시오 LQ-139L-9BDF여성 가죽밴드 패션시계,32000,32000,0
2018-06-01,700800498,C013050,운동복,아디다스/트레이닝/자켓/저지/유로파/슈퍼스타/25종,38900,38900,0
2018-06-01,1061973928,L021010,손목시계,CASIO 카시오 LQ-139LB-1BDF여성 가죽패브릭밴드 패션시계,30000,30000,0
2018-06-01,87834950,L012110,색조화장품,2018년 신상 시즌4 AHC 내추럴 퍼펙션 선스틱 썬스틱,8900,8900,0
2018-06-01,1880437438,L021060,유모차,타보 이노베이션 절충 휴대용유모차+5종 사은품 증정,272000,272000,0
2018-06-01,1957057129,E031110,청소기,한경희 올인원 메가스팀 청소기 HCS-1000 민박집청소,159000,151050,-7950
2018-06-01,140855906,C012040,여자학생복,[레트로걸즈]여성남방/셔츠/화이트/스트라이프/체크,29900,29900,0
2018-06-01,2077107349,C012060,여자내의,빅사이즈/제이스타일 일상팬츠 Vol.24 슬림트 반밴딩 9부 와이드 슬랙스,40500,36450,-4050
2018-06-01,264741760,A013060,게,쫄깃한~국내산 총알오징어/백골뱅이/반건조오징어 1kg,13900,13900,0
2018-06-01,1778592622,L021010,손목시계,[바보사랑][공식  백화점AS가능]리고 남성시계(메탈)_W0218G4,298000,298000,0
2018-06-01,265629009,C013020,티셔츠,신상 브이넥/빅사이즈/루즈핏/티셔츠/여성의류/롱티,10800,9800,-1000
2018-06-01,1108313657,L021050,우산,VIP 의전용 고급 대형 장우산 골프우산 15종 모음,13000,11800,-1200
2018-06-01,1778592621,L021010,손목시계,[바보사랑][공식  백화점AS가능]FIERCE 여성시계(메탈)_W0001L2,258000,258000,0
2018-06-01,1778592620,L021010,손목시계,[바보사랑][공식  백화점AS가능]HORIZON 남성시계(가죽)_W0380G5,248000,248000,0
2018-06-01,1167112905,A017250,고사리,브로컬리 플로릿 2.27kg/코스트코 냉동브로콜리,19490,19490,0
2018-06-01,1061973901,L021010,손목시계,CASIO 카시오 LTP-1094Q-7B5RDF여성 가죽밴드 패션시계,36000,36000,0
2018-06-01,1807833076,C012040,여자학생복,센존 구제매니아 여 S 브이넥 울 니트 기장짧음 추동,28690,28690,0
2018-06-01,1061973900,L021010,손목시계,CASIO 카시오 LTP-1094Q-9BRDF여성 가죽밴드 패션시계,36000,36000,0
2018-06-01,439632426,F011120,인삼,야생산삼 산양산삼 자연산 5-6년근 10뿌리홍삼 더좋은,142000,124960,-17040
2018-06-01,1216705655,A016060,감,달콤샤르르 자연그대로 만든 아이스 왕 홍시 30개(컵),49560,44610,-4950
2018-06-01,1276090112,F012020,생리대,순수한면 대형 14px 4팩/ 소형/중형/대형/오버나이트/생리대/깨끗한나라생리대/여성용,12500,12500,0
2018-06-01,1138441575,C013040,청바지,[버커루] B162PT470P 남여공용 면마 밴딩 배기 팬츠 바지,30000,24900,-5100
2018-06-01,404020460,A019170,냉동식품,CJ 푹신한 왕만두 왕빠오즈 100g*10봉,10800,10800,0
2018-06-01,1778592623,L021010,손목시계,[바보사랑][공식  백화점AS가능]빅센 남녀공용시계(메탈)_W0425L3,288000,288000,0
2018-06-01,1778592629,L021010,손목시계,[바보사랑][공식  백화점AS가능]포스 남성시계(가죽)_W0674G6,268000,268000,0
2018-06-01,1778592628,L021010,손목시계,[바보사랑][공식  백화점AS가능]포스 남성시계(메탈)_W0674G3,238000,238000,0
2018-06-01,1571425821,A022030,생수,롯데칠성몰 생수 에비앙/볼빅 구매시 드링크팡팡 증정,16000,16000,0
2018-06-01,1778592627,L021010,손목시계,[바보사랑][공식  백화점AS가능]소호 여성시계(메탈)_W0638L1,238000,238000,0
2018-06-01,1442103600,C011020,남자상의,남성 슬랙스 28~40 정장바지/울/스판/일자/면/팬츠,19800,19800,0
2018-06-01,988212075,L012040,치약,초L프라임) 프로폴리스 잇몸케어 치약 120G,2990,1650,-1340
2018-06-01,988212074,L012040,치약,초L프라임) 프로폴리스 시린이케어 치약 120G,2490,1650,-840
2018-06-01,383651121,A019090,카레,수입커리모음전/일본카레/인도커리/태국/페이스트/카레라이스/매운맛/순한맛/골든카레,4550,4550,0
2018-06-01,451128241,C013020,티셔츠,빅사이즈여성의류/티셔츠원피스블라우스/가오리/쉬폰,20200,14900,-5300
2018-06-01,1448525175,F012050,의료측정기,브라운 써모스캔 귀체온계 IRT-6520 (총 필터 21개),80000,80000,0
2018-06-01,349106582,C013010,점퍼,[대구백화점 II관] [레코브]텐텐 점퍼(LU3185JP504X),86400,79490,-6910
2018-06-01,1691104923,C013010,점퍼,[드레스날다]랜버 배색 절개 시보리 무스탕 자켓(outer903),37800,34020,-3780
2018-06-01,1266725419,C013040,청바지,[블루독](BL)베이직 5부 데님팬츠(27315-414-54),53000,40810,-12190
2018-06-01,1061973906,L021010,손목시계,CASIO 카시오 LQ-139LB-4BDF여성 가죽패브릭밴드 패션시계,30000,30000,0
2018-06-01,1061973905,L021010,손목시계,CASIO 카시오 LTP-1094E-7ARDF여성 가죽밴드 패션시계,32000,32000,0
2018-06-01,157736095,C011030,남자학생복,[엠씨옴므] 빅사이즈 후드 단추 면 패딩조끼 [MH15S37_B],78000,61700,-16300
2018-06-01,1061973904,L021010,손목시계,CASIO 카시오 LTP-1094Q-7B2RDF여성 가죽밴드 패션시계,36000,36000,0
2018-06-01,1705739166,E041010,식기,처음도자기식기(공기/대접/찬기/면기/접시),6300,4940,-1360
2018-06-01,1061973903,L021010,손목시계,CASIO 카시오 LTP-1094Q-7B1RDF여성 가죽밴드 패션시계,36000,36000,0
2018-06-01,1572334150,C014010,아동복,[젤리스푼][젤리스푼] 야옹샤프릴7부스커트레깅스_MG,14900,13410,-1490
2018-06-01,1061973902,L021010,손목시계,CASIO 카시오 LTP-1094Q-7B7RDF여성 가죽밴드 패션시계,36000,36000,0
2018-06-01,655256173,C012060,여자내의,데님 멜방 원피스,28000,25800,-2200
2018-06-01,2046950997,C012020,원피스,[모조에스핀]털장식포인트 오버핏 코트_S174MSG419(SA1),299000,284050,-14950
2018-06-01,1789291102,A021010,커피,네스카페 쿨피스 아이스커피.네스티 아이스티 복숭아,4000,4000,0
2018-06-01,1796271061,A011040,보리쌀,엄지의제왕 방영 프리미엄 흰강낭콩 6kg,29900,29900,0
2018-06-01,1049620469,C012030,여자상의,미키정품/냉장고/쿨원피스/여름바지/나시/미시,7900,7900,0
2018-06-01,1222277290,C013020,티셔츠,[에스티아]빅사이즈no상관/원피스/티셔츠/롱후드,12900,12900,0
2018-06-01,1347247557,A018020,사탕,미츠야 사이다향 캔디 3봉 일본사탕 아사히 수입캔디,8900,7900,-1000
2018-06-01,2082070059,C012040,여자학생복,엄마옷 마담4060 오픈레이스조끼-XVE803011-,23900,19840,-4060
2018-06-01,1949516785,C012020,원피스,파스텔 체크 더블자켓(C181MSF011)/ 씨씨콜렉트,179100,143280,-35820
2018-06-01,2110263923,C011050,남자내의,[슬림핏] 다니엘크레뮤 18SS 쿨맥스 라이크라 슬랙스 3종,78000,78000,0
2018-06-01,1940567985,A017120,고구마,2018년 햇감자 속노란 홍감자 자색감자 5kg,29000,29000,0
2018-06-01,280282574,A019080,고추장,해찬들 우리쌀로만든 태양초 골드 고추장 500g /된장,4500,4500,0
2018-06-01,1256748290,C012060,여자내의,[JEIKEI]베이직 반바지 [JH6PT005Z][갤러리아],10000,8700,-1300
2018-06-01,2133010132,C013010,점퍼,봄여름 기능성 아웃도어자켓 경량 바람막이점퍼 단체,17800,17800,0
2018-06-01,1823252681,C011020,남자상의,남자 여름 콤비 자켓 남성 정장 마이 중년 아저씨,59800,59800,0
2018-06-01,415994067,C013040,청바지,EX 1635 밴드 청반바지 청반바지 청5부 청 반바지 남,62260,61020,-1240
2018-06-01,1454340835,C013050,운동복,차량용 틈새쿠션 틈새커버 분실방지,1100,1100,0
2018-06-01,2124962626,D031010,주택수선재료,항균페인트 숲속향기 5kg/기능성페인트,85000,76500,-8500
2018-06-01,986332207,A013170,생선통조림,CJ 알레스카 연어 100G*3입,10400,6990,-3410
2018-06-01,1804743507,E031040,전기레인지,데이킵스 냉장고정리 풀세트,139770,139770,0
2018-06-01,53583430,C012030,여자상의,원피스/봄원피스/롱원피스/민소매원피스/미니원피스,9900,9900,0
2018-06-01,37981365,A012030,돼지고기,[무항생제] 국내산 한돈(韓豚) 냉장 목살(구이용) 1kg,36900,36900,0
2018-06-01,1153872561,C014020,유아복,[앤디애플][앤디애플] 트윙클번아웃점퍼_W,17900,16830,-1070
2018-06-01,1266072404,C012040,여자학생복,[아덴] 코로스 롱가디건/ 아덴,27000,20520,-6480
2018-06-01,284047012,A019110,드레싱,고기엔 참소스 20g (1박스200개입) 증정용,15900,15900,0
2018-06-01,1270326411,C012040,여자학생복,[헬로시스터]빅사이즈/헬로시스터 멜랑[스트라이프남방],36900,34440,-2460
2018-06-01,620655520,C011030,남자학생복,폴로 남성 여성 주니어 카라티 셔츠 반팔티 라운드티,34900,34900,0
2018-06-01,1137153873,I031010,장난감,랜드로버 붕붕카 벤츠붕붕카 벤틀리붕붕카 유아붕붕카,33400,33400,0
2018-06-01,1382408502,C011030,남자학생복,[폴햄] 남성 스트라이프 린넨 7부 셔츠(PHY2WC1942),29900,24220,-5680
2018-06-01,2005820787,C013020,티셔츠,[샵코드] 여성티셔츠 데일리 캐릭터 무지 스판티_WTS,5900,5900,0
2018-06-01,188907453,C011030,남자학생복,당일발송 반팔/긴팔 슬림 솔리드 캐주얼 체크 셔츠,16800,14800,-2000
2018-06-01,1064906833,C013040,청바지,[CAMBRIDGE] 트윌 S/T 조직 스트레치 팬츠 MYPNS17103BEX,69000,58650,-10350
2018-06-01,974636366,E061060,살충제,잡스개미약/잡스정품/미친개미/유령개미/애집개미/맥스포스퀀텀/바퀴벌레약/개미퇴치/,7600,7500,-100
2018-06-01,2046950972,C012020,원피스,[모조에스핀]털장식포인트 오버핏 코트_S174MSG419(MT1),299000,284050,-14950
2018-06-01,988212045,A018060,스낵과자,[크라운]콘치 66G,1250,1250,0
2018-06-01,1058866327,C012060,여자내의,[쥬시쥬디]플라워나염숏기장점프수트 JROP323D,49000,41650,-7350
2018-06-01,988212043,A018060,스낵과자,크라운 콘초 66G,1250,1250,0
2018-06-01,804470509,I031040,생화,캠핑해먹 풀세트/캠핑/스탠드/그네/해먹/야전침대,14500,14500,0
2018-06-01,1120255477,C013020,티셔츠,[CAMBRIDGE] 이태리 직수입 브이넥 티셔츠 MYTAM17900DGY,49000,41650,-7350
2018-06-01,1951927997,F012030,안경,특가찬스 안경테 뿔테안경 패션 뿔테 공용,8900,8900,0
2018-06-01,989852594,A016100,수박,깔라만시자몽청 500G,9900,9900,0
2018-06-01,1247514330,F012020,생리대,시크릿데이 생리대 NEW코튼라이너 롱20PX8팩,11700,11120,-580
2018-06-01,240190483,F012010,종이기저귀,[15%쿠폰] 치쿨 가성비짱 여름용 울트라씬 기저귀 4팩,15900,15900,0
2018-06-01,1059787029,E011070,식탁,라미에스 원목 6인 식탁 세트 제이수,583000,583000,0
2018-06-01,193198709,E031130,보온매트,[TV홈쇼핑정품!!] 명품 일월매트 온돌마루 모노륨,258000,255420,-2580
2018-06-01,814434771,C014010,아동복,체크팬츠나시세트/반바지/나시/여름복/여아/봄신상,9900,9900,0
2018-06-01,1465090952,F012010,종이기저귀,유럽 친환경 리베로 기저귀 팬티형/밴드형 1팩,19800,19800,0
2018-06-01,1398724150,E041050,냄비,델키 미니 코팅 냄비 인덕션 편수 16cm 인덕션사용가,31780,31780,0
2018-06-01,606548053,A012010,국산쇠고기,강진착한한우 1등급 불고기/국거리/장조림용 400g,19900,19900,0
2018-06-01,963445921,A017220,양파,국내산 홍화씨 600g,10500,10500,0
2018-06-01,1740139747,C012040,여자학생복,리앤비 봄 여름 조끼 베스트 여성골프웨어 골프조끼,42900,42900,0
2018-06-01,2079619357,I031040,생화,데이타임 몬스터 프리미엄 손목 발목 무릎 보호대,15000,13340,-1660
2018-06-01,1939210685,E061020,섬유유연제,FC 베이비전용 세탁세제 refill 유아용 신생아세제 유,20800,20800,0
2018-06-01,382049039,L021020,장신구,[티르리르] 다즐링(수정) 팔찌TBSSVW10636M-4,59000,50150,-8850
2018-06-01,1248623350,C011020,남자상의,(색상 : 네이비 | 사이즈 : XL) WMJ-009,88300,88300,0
2018-06-01,1104295730,C013020,티셔츠,학생티 라운드티 반팔 긴팔 무지티 20수 30수 단체티,3500,3500,0
2018-06-01,1774082090,C012060,여자내의,[쉬즈넘버나인]쿨러닝 7부 배기팬츠,8900,8460,-440
2018-06-01,1672951600,C011030,남자학생복,니트/가디건/스웨터/모음/짚업가디건/짚업자켓/목폴라,35000,35000,0
2018-06-01,1805522605,L021020,장신구,[바보사랑][E+N+R] [실버] 앰버 세트,51000,51000,0
2018-06-01,1805522606,L021020,장신구,[바보사랑][실버] 앰버 반지,17000,17000,0
2018-06-01,1805522603,L021020,장신구,[바보사랑]소니아 롱 귀걸이,10000,10000,0
2018-06-01,716889528,L021060,유모차,2018 리안(RYAN) 레오 유모차,293000,293000,0
2018-06-01,1805522604,L021020,장신구,[바보사랑]키에넌 큐빅 팔찌,22000,22000,0
2018-06-01,530477040,C012060,여자내의,백합주름치마 베이지 전체 주름 교복치마 교복 예쁜교,55060,53410,-1650
2018-06-01,599138685,C013020,티셔츠,남성 빅사이즈 속옷 드로즈 팬티 삼각 트렁크 롱 쿨,4900,4900,0
2018-06-01,1458469865,C013030,스웨터,남자니트 꽈배기 커플 폴라티 스웨터 오버핏 2XL 3XL,12700,12700,0
2018-06-01,1805522607,L021020,장신구,[바보사랑][실버] 롤랜드 큐빅 반지,17000,17000,0
2018-06-01,369794603,C014010,아동복,네파키즈 피스타 트레이닝세트 KE35920,31200,31200,0
2018-06-01,1805522608,L021020,장신구,[바보사랑]로제 라운드 롱 귀걸이,10000,10000,0
2018-06-01,1240860202,C013050,운동복,아스토레 쉘 4 우븐자켓(AB)-레인자켓 트레이닝운동복,58250,58250,0
2018-06-01,357083336,C012040,여자학생복,[매그제이(MAGJAY)]그물라운드니트 (J11PNT209),44900,42210,-2690
2018-06-01,505938822,C011030,남자학생복,신상/셔츠/남방/와이셔츠/슬림/루즈핏/스판/체크/남성,17000,9800,-7200
2018-06-01,1061848040,E011030,거실장,[채우리] 옴브레 3인 소파베드,310000,310000,0
2018-06-01,552457466,E011020,침대,최저가보장! 느웰베드 15cm 천연라텍스 침대,738000,738000,0
2018-06-01,1795675900,C013040,청바지,[대구백화점 II관] [프렌치캣]해지 프릴 숏 PT(Q83DKP020),35100,28080,-7020
2018-06-01,1104342658,I011030,사진기,소니 알파 A6300 본체 + 16-50mm 정품 명품,1195930,1195930,0
2018-06-01,1166145111,C013050,운동복,츄리닝 운동복 트레이닝 빅사이즈 바지 반바지,9900,9900,0
2018-06-01,1299969294,I031040,생화,컨텐더 화이트투명헤드기어CHG-740,113000,110740,-2260
2018-06-01,966981428,I031040,생화,[카르닉] 캠핑 해먹 20종 풀세트/캠핑용품,16900,15130,-1770
2018-06-01,1922409769,L012010,면도기,굳은살제거기 10개1세트 각질제거기 굳은살제거면도기 발뒤굼치 굳 풋케어 발각질제거,9800,9800,0
2018-06-01,1805522602,L021020,장신구,[바보사랑]피셔 태슬 귀걸이,12000,12000,0
2018-06-01,1247514338,F012020,생리대,시크릿데이 생리대 NEW라이너 일반20PX10팩,7800,7410,-390
2018-06-01,1805522600,L021020,장신구,[바보사랑][은침] 트윈 링 태슬 귀걸이,16000,16000,0
2018-06-01,1809951470,C014010,아동복,[아이러브제이] 여름 포엘 라벤더 티셔츠 JPUTO72-DA1C,13440,12160,-1280
2018-06-01,1805522638,L021020,장신구,[바보사랑]My Bloom Blue Flower Earrings,12000,12000,0
2018-06-01,1805522636,L021020,장신구,[바보사랑]테사 귀걸이,9000,9000,0
2018-06-01,1805522637,L021020,장신구,[바보사랑]매티 트리플 스타 반지,11000,11000,0
2018-06-01,1350072863,E011020,침대,필우드가구 로제 원목 침대 슈퍼싱글 SS,149000,149000,0
2018-06-01,767485645,C015020,모자,한글모자/한글글씨모자/사장님모자/스탭모자/식당모자,11900,11900,0
2018-06-01,1317508210,C021020,구두,[탠디]파격특가 남성 패션구두/캐주얼화 19종,99840,99840,0
2018-06-01,1726104099,C014010,아동복,스타민소매ops/할로윈 파티/발표복/연주복/행사/생일,9900,9900,0
2018-06-01,1092322061,E031080,선풍기,퀸센스_ 원적외선 14 벽걸이형 히터 QSH-404K,28700,28700,0
2018-06-01,1777666100,E011030,거실장,[PookShuim]푹쉼 도하 FPL가죽 전동 리클라이너 6인소파 접이식컵홀더포함,1604000,1604000,0
2018-06-01,1967917438,F012010,종이기저귀,마미포코360핏 대형/특대형/점보 마미포코팬티기저귀,24900,24900,0
2018-06-01,84333799,E041030,솥,누룽지이중압력돌솥/압력밥솥/삼성화재가입/가마솥,103000,101970,-1030
2018-06-01,425515897,E061040,부엌용세제,퐁퐁 안심설거지 주방세제 리필 1200ml x 10개,19900,19900,0
2018-06-01,1777666101,E011030,거실장,[PookShuim]푹쉼 도하 FPL가죽 전동 리클라이너 4인소파 접이식컵홀더포함,1332000,1332000,0
2018-06-01,735504344,C012030,여자상의,[여름신상]XL까지/여름신상/하객룩/오피스/쉬폰원피스,19800,19800,0
2018-06-01,1036262156,E011030,거실장,[채우리] 브런트 스틸 사각 소파 테이블,79900,79900,0
2018-06-01,2047655763,A019050,간장,해표 옹가네 진간장 1.8Lx2개/양조간장/국간장/조림,8800,7900,-900
2018-06-01,1036262157,E011030,거실장,[채우리] 브런트 스틸 사각 사이드 테이블 협탁,69900,69900,0
2018-06-01,1016184458,C013010,점퍼,안감양털 박시 오버사이즈 코트 예쁜여성코트 DM-4043,61320,58260,-3060
2018-06-01,1805522630,L021020,장신구,[바보사랑][E+B] [은침] 루이르 티어 세트,20500,20500,0
2018-06-01,1805522631,L021020,장신구,[바보사랑]루이르 티어 팔찌,9000,9000,0
2018-06-01,467011043,C013010,점퍼,[GGPX]링 프릴 라운드넥 점퍼(의정부점),119000,96540,-22460
2018-06-01,1036262158,E011030,거실장,[채우리] 브런트 스틸 2단 사이드 테이블,59900,59900,0
2018-06-01,1036262159,E011030,거실장,[채우리] 브런트 스틸 원형 사이드 테이블 협탁,29900,29900,0
2018-06-01,1829351431,C011020,남자상의,[renoma]18 S/S 심플한 다크네이비 슬림 스판 정장 KAISJ71AKSW,158000,142200,-15800
2018-06-01,1805522635,L021020,장신구,[바보사랑]린코 그래인 귀걸이,9000,9000,0
2018-06-01,1287212882,C013060,등산복,[컬럼비아][역시즌특가]남녀공용 러시안 대쉬 구스 다운 자켓 CX4-YM3779,179000,143200,-35800
2018-06-01,828406531,A017140,콩나물,국내산 약도라지3kg 도라지가루 도라지분말 도라지환,8000,7900,-100
2018-06-01,1805522632,L021020,장신구,[바보사랑][은침] 루이르 티어 귀걸이,11500,11500,0
2018-06-01,1805522633,L021020,장신구,[바보사랑][은침] 웨인 스타 귀걸이,15500,15500,0
2018-06-01,439632490,F011120,인삼,야생산삼 산양산삼 자연산 5-6년근 5뿌리산양삼 홍삼,86900,76480,-10420
2018-06-01,1385645454,A018020,사탕,멜랜드 캔디 45종 더블믹스/레몬씨/헬로키니미니/사탕,3600,3500,-100
2018-06-01,950100788,E011030,거실장,브리쉘3인모던쇼파,169900,169900,0
2018-06-01,419534261,E061020,섬유유연제,펠체아주라 퍼퓸 섬유유연제 3Lx2개,12900,12900,0
2018-06-01,1136988943,A013020,명태,두레생협 대구전부침용(400g 러시아산) 대구전 부침개,30350,30350,0
2018-06-01,28722265,C014020,유아복,아둘 패밀리룩 봄 점퍼 조던 블루종 유아잠바 11,25500,25500,0
2018-06-01,1010374689,E021010,침구,소프트침낭(18s) (색상랜덤배송),29900,29900,0
2018-06-01,1663657818,A017280,김,초생강(백색 참존 1.2k)X10,33120,33120,0
2018-06-01,1300686416,C015040,장갑,[프로스펙스] (SIZE : LXL) 슬리브 메이저 2 니트 글러브(,8740,8740,0
2018-06-01,2088817227,A016150,아몬드,산과들에 17년 캘리포니아산 당일가공 구운 햇 아몬드,11900,11900,0
2018-06-01,570273912,A017140,콩나물,도라지배즙 기관지에 좋은 음식/배즙만들기/도라지차,45900,45900,0
2018-06-01,116358641,F012020,생리대,{무료배송}동아제약 템포 총50p 레귤러/슈퍼/탑폰/,23800,23800,0
2018-06-01,1372637862,A021010,커피,자판기용 커피믹스 믹스커피 율무차 핫초코 국산차,2600,2600,0
2018-06-01,164299651,F012010,종이기저귀,리베로기저귀 밴드형/팬티형 4팩,61900,61900,0
2018-06-01,1120389977,F012010,종이기저귀,하기스 매직팬티 4~5단계x4팩/매직팬티 6단계x2팩,28500,28500,0
2018-06-01,244751404,C013010,점퍼,AGC빅사이즈 카치온 자켓 MC 1500 빅사이즈점퍼 빅사,83440,83440,0
2018-06-01,1608376857,L021020,장신구,실버체인)버블 눈꽃 목걸이(Whit Gold)20대 30대 여자,19300,19300,0
2018-06-01,583638237,C015030,넥타이,단체자동넥타이/학생슬림니트넥타이/남성패션부토니에,2900,2900,0
2018-06-01,1338139478,F012020,생리대,순수한면 제로(ZERO) 4팩_안전인증 안심생리대,14900,14900,0
2018-06-01,653657256,C014010,아동복,[월튼키즈] 빠삐용마린상하복,14900,13410,-1490
2018-06-01,658613669,E041050,냄비,샤브샤브냄비 전골냄비 무쇠냄비 오뎅탕 샤브냄비,15000,14250,-750
2018-06-01,1575451200,I031040,생화,인스타/7발/5발/ 8400루멘 /L2 /캠핑랜턴/ 헤드랜턴/,56900,50900,-6000
2018-06-01,652441473,C012060,여자내의,매킷 헤지 청반바지 데님반바지 패션파지 여성반바지,18250,18250,0
2018-06-01,373082624,C012040,여자학생복,(2XL-5XL)보테 블라우스-1777/ 레이디플러스,40900,36810,-4090
2018-06-01,378776620,C011050,남자내의,MP-227 네이비 고무줄 슬랙스 고무줄슬랙스 바지 후면,45040,45040,0
2018-06-01,1651479028,E031110,청소기,듀플렉스 진공청소기/무선청소기/DP-606VCB/DP-605VC,24000,24000,0
2018-06-01,873304894,A022030,생수,정식품 심천수 샘물 2L X 12본 / 500mlx40/ 생수 /물,5900,5900,0
2018-06-01,1716406947,A018010,초콜릿,츄엣2.5kg/미니바/초코바/땅콩바/스니커즈/대용량,27700,27700,0
2018-06-01,2046949976,C012020,원피스,[모조에스핀]노카라 루즈핏 코트_S174MSF044(NY1),169000,160550,-8450
2018-06-01,1597152280,F011130,홍삼,정관장 밝을윤세트(SET),87000,87000,0
2018-06-01,1204741796,C013020,티셔츠,터닝메카드R 카봇 아이언 스파이더맨 번개맨 캐리 옷,11500,11500,0
2018-06-01,1335397643,F011150,건강기능식품,네이처스비타민샵 밀크씨슬옥타플러스60정4개,92880,92880,0
2018-06-01,685756101,C014010,아동복,아둘 쥬니어 여름 면 청반바지 청해지 팬츠 15,15900,15900,0
2018-06-01,1753658333,E011030,거실장,한샘 EURO 9000 프라 화이트_오크(기본형/ㅡ자형/∼1.7m이하),1935000,1935000,0
2018-06-01,1062467791,E011050,책상,[파란들]스마트 책장&h형 책상세트/학생가구 ch,79900,79900,0
2018-06-01,954017771,A012040,닭고기,무항생제 닭안심 350G(점포마다 브랜드가 상이할수 있습니다),6990,6990,0
2018-06-01,512094028,A019110,드레싱,다인 식용 금분(금가루) 300mg식용금 식용금가루 박,39600,39600,0
2018-06-01,668227219,L021020,장신구,이서진 남자 여자 실버 체인 은팔찌 커플 선물 아이템,80000,80000,0
2018-06-01,1143775252,I031010,장난감,더뻔뻔 레고놀이판 듀플로 밑판 조립판 30종 레고판,5200,5200,0
2018-06-01,417571731,C012060,여자내의,빅사이즈 헬로시스터 위니[밴딩팬츠]/ 헬로시스터,21800,17010,-4790
2018-06-01,425060900,C011030,남자학생복,[모다아울렛][지오송지오]지오송지오 18SS 화이트 셔츠 ZTS31222,64000,64000,0
2018-06-01,753187511,E011060,의자,체어센스 24종 학생용 사무용의자,19900,19900,0
2018-06-01,1061973967,L021010,손목시계,TIMEX 타이맥스 T2N954 여성 가죽밴드 패션시계,79500,79500,0
2018-06-01,311570470,E011050,책상,[블루밍홈] 심플H형입식책상/컴퓨터/사무용/학생/책장,40900,33930,-6970
2018-06-01,1061973966,L021010,손목시계,TIMEX 타이맥스 T2N869 여성 가죽밴드 패션시계,62000,62000,0
2018-06-01,1068253394,A013050,오징어,꽁치캔(동원400g)X24/꽁치캔/꽁치찌개통조림찌개,61490,61490,0
2018-06-01,1318811537,C012060,여자내의,라잇 와이드 밴딩 팬츠- 밴딩반바지 치마바지 벨트세,22590,22590,0
2018-06-01,1384797979,C011030,남자학생복,[빈폴] 네이비 라운드넥 니트 베스트 (BC8151C24R),178000,142400,-35600
2018-06-01,1061973965,L021010,손목시계,TIMEX 타이맥스 T20441 여성 가죽밴드 패션시계,64000,64000,0
2018-06-01,1185454680,L021020,장신구,ICU 옐로우골드 트리플 반지/ 리타모니카,19000,17100,-1900
2018-06-01,1061973964,L021010,손목시계,TIMEX 타이맥스 T20433 여성 가죽밴드 패션시계,64000,64000,0
2018-06-01,1061973963,L021010,손목시계,TIMEX 타이맥스 T2P564 여성 가죽밴드 패션시계,79000,79000,0
2018-06-01,1843582319,C013010,점퍼,초겨울 라이더 자켓 가죽점퍼 15_6 K2/레쟈가죽,119800,119800,0
2018-06-01,1061973962,L021010,손목시계,TIMEX 타이맥스 TW2P69800 여성 가죽밴드 패션시계,95000,95000,0
2018-06-01,1843582318,C013010,점퍼,가죽점퍼 레쟈점퍼 라이더자켓 PU12 WS/레쟈가죽자켓,122400,122400,0
2018-06-01,189027994,E041020,컵,leah 바로크 커피잔세트 2인조 / 찻잔 머그컵 머그잔,28220,28220,0
2018-06-01,1292593315,A013070,굴,[동해홍게나라] 생물 홍게 일반형 3kg / 대게.꽃게,31900,31900,0
2018-06-01,1458815363,D031010,주택수선재료,KCC 숲으로 웰빙 3.78L/벽지페인트/최고급/친환경/누구나/집단장/DIY/수성/미세크랙방,28000,28000,0
2018-06-01,1032494042,A018050,비스킷,무배) 대용량 마가렛트 오리지널 396g*8갑 고구마,33800,33800,0
2018-06-01,282167238,L021050,우산,슈퍼렉스 남자 여자 레인코트 비옷 우비 판초의 우의,9900,9800,-100
2018-06-01,540444852,E021010,침구,퓨어슬립 진드기방지 기능성 누빔패드 2장+누빔베개커버2장 Q,74900,74900,0
2018-06-01,982438475,A013140,북어채,동해안 건오징어(2마리/110G),12900,12900,0
2018-06-01,1964839952,C013010,점퍼,[홈런]가죽자켓/레더자켓/점퍼/야상/라이더/남성/남자,39800,39800,0
2018-06-01,466981409,C013050,운동복,IT 에보트레이닝 라이트 우븐 자켓(65472347) 남자자,95390,95390,0
2018-06-01,619668960,A016160,과일가공품,미국 GNL 냉동블루베리 1kg 블루베리 아이스블루베리,15350,15350,0
2018-06-01,321064165,C011030,남자학생복,[ANDZ] 솔리드 스퀘어 니트 BLX1ER1005,49000,44100,-4900
2018-06-01,2013451142,L021020,장신구,귀걸이 이어링 귀고리 스와로브스키스톤 패션악세사리 실버침귀걸이 유색귀걸이 은침귀,11500,11160,-340
2018-06-01,326369533,E051020,건전지,무료배송[2100회 신형] 산요/파나소닉정품 에네루프 AA/AAA [eneloop 4알] 에네루프전,14000,13070,-930
2018-06-01,1356301345,C011020,남자상의,남자아우터 유니크 체크 울 하프코트 / 참고 남자아우,230500,195930,-34570
2018-06-01,1873482546,C013040,청바지,린넨드레스/유아아동청바지/일자/스키니/주니어/구제,20000,16000,-4000
2018-06-01,625759114,A012030,돼지고기,정성온 뚝불고기 410g 2개,16000,15520,-480
2018-06-01,1195730488,I031070,애완동물관리비,탑프로 주니어 테니스라켓/주니어라켓/아동용라켓,15000,15000,0
2018-06-01,1492505014,C013020,티셔츠,[블루독][블루독](NV)어벤져스2종티셔츠(28901-670-08)[갤러리아],52000,41600,-10400
2018-06-01,1229713468,E031110,청소기,(공식판매)한경희강력스팀청소기슬림&라이트 SI-3700R,89000,81800,-7200
2018-06-01,787467564,E061040,부엌용세제,트리오 곡물 설거지 3L x2개/대용량/주방세제,16900,9900,-7000
2018-06-01,947625504,C011030,남자학생복,교복몰 기본 후드집업 다양한 컬러(남자) 교복 교복바,20090,19490,-600
2018-06-01,448229825,C013020,티셔츠,[무료배송]캐미후드티 레이어드후드티 긴팔티셔츠 박,22570,22570,0
2018-06-01,2068438334,A018020,사탕,하오리위안 밀크츄 70g x 1봉 5가지맛 카라멜,1000,1000,0
2018-06-01,193497381,C013020,티셔츠,[이솝]반팔티/아동티/단체티/유치원티/어린이날선물,3900,3900,0
2018-06-01,916814278,A018030,껌,푸른농장 자일리톨껌리필87g+25g/알파민트/후레쉬민트,2800,2800,0
2018-06-01,511122107,C013010,점퍼,#NAME?,44260,44260,0
2018-06-01,1061973968,L021010,손목시계,TIMEX 타이맥스 T5K840 여성 우레탄밴드 패션시계,92000,92000,0
2018-06-01,983449237,A011010,쌀,[맛있는 잡곡] 풍경소리 발아현미19곡 3kg + 사은품 !! 발아현미23곡 200g,12900,9800,-3100
2018-06-01,510945198,E041050,냄비,[해피콜] 통3중 스텐냄비 4 5종세트 모음전,143000,143000,0
2018-06-01,83926319,A022030,생수,[동원] 샘물 미네마인 300ml×60병,11610,11610,0
2018-06-01,339962836,L021020,장신구,11월탄생석 5mm 천연블루토파즈 티아라 원터치귀걸이,213000,213000,0
2018-06-01,327753206,I031040,생화,빈슨메시프 히프노스 침낭-극 동계~사계절 캠핑 12종,34800,31150,-3650
2018-06-01,1209407813,C013040,청바지,[Blouson]화이트 워싱 컷팅 데님 5부팬츠_[B1806PT059B],37000,32890,-4110
2018-06-01,325627760,C012060,여자내의,[로즈맘]벤츄리단추아이스7부바지,15470,13930,-1540
2018-06-01,950100794,E011030,거실장,루카쇼파,193900,193900,0
2018-06-01,1898207163,A018080,설탕,비정제설탕 원당(천연당) 1~15Kg 고그린원당 매실원당,12800,12800,0
2018-06-01,950100792,E011030,거실장,모모쇼파,147900,147900,0
2018-06-01,655210965,C013010,점퍼,[샤트렌]빅버튼 셔링장식 야상 점퍼,27900,26510,-1390
2018-06-01,1209491145,L021030,가방,블랙 라이닝 홑겹 가터벨트EBFC71C21SRE/ 에블린,9000,7380,-1620
2018-06-01,2011758620,C013040,청바지,아동반바지/남아청바지/여아청바지/공용청바지/무배,20000,17900,-2100
2018-06-01,950100790,E011030,거실장,마운트쇼파,147900,147900,0
2018-06-01,897503156,E061050,청소용세제,[피죤]무균무때 주방레몬용기 500G,6000,3000,-3000
2018-06-01,911024254,I031040,생화,보조배터리겸용-충전식 LED 캠핑랜턴 작업등 후레쉬,11000,9760,-1240
2018-06-01,5835379,L012040,치약,2080 베이킹소다 치약 120g x10개/레몬/민트,9900,9900,0
2018-06-01,371708177,E031130,보온매트,한일 한화 골드륨 전기매트 싱글 전기매트 겨울매트,114190,114190,0
2018-06-01,594197838,A011110,당면,웅부도토리 묵말랭이 250g-국내산 도토리,35840,35840,0
2018-06-01,1036262134,E011030,거실장,[채우리] 브런트 스틸 2단 소파 테이블,149000,149000,0
2018-06-01,1168552750,C013050,운동복,아디다스 여성 ZNE 후드자켓(BR1933)운동복상의 남성,152460,152460,0
2018-06-01,2084677171,E021020,커튼,[로즈퀸]초특가/촘촘 실커튼/심플무지/스팽글실커텐,3500,3500,0
2018-06-01,1347489623,A011020,현미,한입만 국산 찹쌀 10kg /찹쌀 (5kg x 2개),27300,27300,0
2018-06-01,1253159695,C013050,운동복,여름신상 트레이닝세트44-99빅사이즈 반바지 라운드,23800,23800,0
2018-06-01,392728229,A012030,돼지고기,전통웰빙음식 독일산 볏짚삼겹살 2018년 행사합니다,3900,3900,0
2018-06-01,2113160387,C015030,넥타이,나비넥타이 보타이 이벤트 축제 행사용 어린이 어른용,3970,3780,-190
2018-06-01,1755389330,A019100,식초,[하인즈공식몰] 하인즈 인기소스 3종 골라담기,9900,9900,0
2018-06-01,1382528373,C012060,여자내의,큐니걸스 울적한마음 데님숏팬츠/ 큐니걸스,28200,23130,-5070
2018-06-01,2042506313,C013010,점퍼,네오프렌 누빔점퍼 남성누빔점퍼 남성용누빔점퍼 남자,73820,73820,0
2018-06-01,1653115820,I031040,생화,[단품] 한국파라솔 국산 2단 8각 파라솔 테이블 의자,35000,31330,-3670
2018-06-01,125153386,C012030,여자상의,린넨 롱 원피스 레이스 셔츠 쉬폰 플라워 하객 여름,31800,28800,-3000
2018-06-01,1346035214,C013050,운동복,VIP 삼선띠 자동차 바디 커버,38900,38900,0
2018-06-01,534351853,C012060,여자내의,[루코루코]망고 팬츠 2color(RSC4PT007),26000,24700,-1300
2018-06-01,145629799,I031040,생화,[코베아] 코베아 써니 해먹3 간이침대 캠핑용품 KECT9DM-01,30000,26680,-3320
2018-06-01,10244742,A022010,주스,포도원액(참존 835ml)X12/ 식자재 전문,58900,58900,0
2018-06-01,1716960767,C012040,여자학생복,피핀 벨라덴 썸머 가디건 #20469/ 피핀,34400,27180,-7220
2018-06-01,447483992,C012030,여자상의,[무료배송]빅사이즈 DGM1282 프리멜 원피스 802S 빅사,54270,54270,0
2018-06-01,1130909250,C012060,여자내의,[LAP][LAP] AF2WP564. 페플럼 큐롯팬츠,36360,34550,-1810
2018-06-01,895678438,A016100,수박,수박 7호 (8kg미만/통),16900,16900,0
2018-06-01,431513533,C013050,운동복,프론트 리어 범퍼 가드 보호대 몰딩 화이트 범퍼가드,22610,20600,-2010
2018-06-01,1966076182,I031040,생화,용성 카본 파트너 원투용세트구성195-360/원투낚시대,22900,16260,-6640
2018-06-01,611450000,C012040,여자학생복,홈쇼핑 엘리스블루 여성가디건 반팔 블라우스 모음,14800,14800,0
2018-06-01,502834896,C013050,운동복,SET068-피그먼트 트레이닝 세트 여름츄리닝 여름운동,27670,27670,0
2018-06-01,828962949,A022010,주스,초록매실 (180mlX30캔),9900,9900,0
2018-06-01,1914201967,F011120,인삼,(장생농산장수산삼 8년근 7주(7뿌리) 산양산삼 선물세,313740,304330,-9410
2018-06-01,1771927334,A019040,소금,2018년 신안 화산수 천일염 소금 선물세트 5p,25800,15800,-10000
2018-06-01,1233015882,F012020,생리대,예지미인 슈퍼롱 오버나이트 10개입 x 24,91310,81270,-10040
2018-06-01,1356301313,C011020,남자상의,남자아우터 빅카라 더블코트 / 참고 남자아우터 남자,249000,211650,-37350
2018-06-01,1741070930,E011010,장롱,닐스퍼니 2단서랍 장롱 옷장 수납장 싱글장,103000,100000,-3000
2018-06-01,1777666070,E011030,거실장,[PookShuim]푹쉼 폴리 패브릭 소파매트,144000,144000,0
2018-06-01,1301817359,C013030,스웨터,(사이즈 : 95) MNT_123 배색 니트 라운드,45090,45090,0
2018-06-01,450460396,A013090,전복,신선도 육질만점 가리비살 껍질반가리선택,3500,3500,0
2018-06-01,1723266508,C011050,남자내의,[I.M.Z PREMIUM] 남성 스트랩밴딩 원턱 린넨팬츠 62PC205 98 다크그레이,69000,62100,-6900
2018-06-01,989111384,A019010,고춧가루,초L 국내산고춧가루 500G,25900,25900,0
2018-06-01,1460443029,C013020,티셔츠,[피핀] 에이프릴 배색 반팔니트 105477,19900,18580,-1320
2018-06-01,989111385,A019010,고춧가루,초L 국내산고춧가루 1KG,49900,49900,0
2018-06-01,501556616,A016160,과일가공품,브라질산 아사이베리 파우더100 75g 아싸이베리 분말,31190,31190,0
2018-06-01,673444780,E011070,식탁,쿠킹 홈바/대리석홈바 아일랜드홈바 식탁 조리대,125800,125800,0
2018-06-01,1777666069,E011030,거실장,[PookShuim]푹쉼 폴리 MPL 소파매트,178000,178000,0
2018-06-01,1809591627,L012040,치약,(CMIT/MIT 無) 덴티스테 플러스화이트 치약 4~8개 set,25400,19900,-5500
2018-06-01,1777666068,E011030,거실장,[PookShuim]푹쉼 킨샤 2인용 침대 그네,638000,638000,0
2018-06-01,989111387,A019110,드레싱,CJ 오리엔탈드레싱 620G,5980,5980,0
2018-06-01,365994005,L021010,손목시계,84%할인/코구 기계식 오토매틱 자동 남성손목시계,54900,54900,0
2018-06-01,451177180,C012060,여자내의,잇걸 멜빵청롱스커트 SD-9106,40090,40090,0
2018-06-01,1023712820,F012010,종이기저귀,국내/빠른배송) 미국산 팸퍼스 스와들러 3단계 기저귀,75700,75700,0
2018-06-01,1530562660,C012020,원피스,MELODY F3 블랙/코트/여자코트/겨울코디/겨울코트/자켓/점퍼 미국 여성토탈브랜드 멜로,54700,54700,0
2018-06-01,479785478,A017210,파,탱글탱글 토마토 3kg(중과)/5kg산지당일발송,6900,6900,0
2018-06-01,616094280,F012050,의료측정기,오므론 프리미엄 자동혈압계 HEM-7322 (아답터 포함),130500,130500,0
2018-06-01,266812589,A013150,어묵,부산어묵 어육90% 쌀어묵 26종 700g,9900,9900,0
2018-06-01,1975538162,C013010,점퍼,[르샵] 숏기장 항공점퍼 LGAJP202A_nc아울렛,179000,30000,-149000
2018-06-01,972690227,C013020,티셔츠,[람스트리]여름 아동복 원피스 티 팬츠,8900,8900,0
2018-06-01,1446639587,C013040,청바지,여름여성청바지/빅사이즈여성청바지/린넨팬츠,24800,24800,0
2018-06-01,2120087599,C015020,모자,고품질 스냅백 힙합 캡 남자 여성 모자 연예인모자,7000,6900,-100
2018-06-01,118317780,A017170,풋고추,국내산 건여주 대용량특가 여주분말 여주즙 여주환,24000,22900,-1100
2018-06-01,1003367197,A017200,토마토,가지 100g 국내산 마른 가지나물 건조가지 건가지,6000,6000,0
2018-06-01,1597152336,F011130,홍삼,정관장 감사예세트(SET),160000,160000,0
2018-06-01,1171048749,L012030,칫솔,오랄비 초미세모 벨벳 잇몸케어 칫솔 10개 외 12개,15900,15900,0
2018-06-01,654270579,A016040,포도,칠레 씨없는적포도/청포도/거봉 대용량 6kg,34000,34000,0
2018-06-01,893389432,C013020,티셔츠,[베네통키즈](18 여름신상품) 캔디스트라이프티셔츠(3XB1C13H8)[갤러리아],25000,19250,-5750
2018-06-01,1495107873,A018010,초콜릿,[대용량]트윅스/스니커즈 미니스/펀사이즈/미니스믹스,17490,17490,0
2018-06-01,620344841,E061050,청소용세제,미라클곰팡이젤120gx3팩/욕실 실리콘 곰팡이제거제,12000,11400,-600
2018-06-01,401650271,A022040,기능성음료,롯데칠성몰 건강 비타코코 코코넛워터 200ml/1.0L팩,16900,16900,0
2018-06-01,1093276431,E031080,선풍기,[나비아] Nabia 휴대용 야외 가스히터 SGH-200 (레져 등산 낚시 휴대용 부탄가스히터),50040,50040,0
2018-06-01,1093276432,E031080,선풍기,나비아_ 휴대용 야외 가스히터 SGH-100 (레져 등산 낚시 캠핑),44640,44640,0
2018-06-01,1938418441,C013010,점퍼,세로영문바람막이/롱점퍼/야구점퍼/레인점퍼..,16900,16900,0
2018-06-01,1876014375,L021030,가방,여성백팩/가죽/미니/대학생/직장인/여자/가방/연예인,19800,19800,0
2018-06-01,2030674295,C012020,원피스,[윈][린넨]컬러체크린넨오픈코트,149000,141550,-7450
2018-06-01,1375176306,E011060,의자,200한정초특가/5월의자.컴퓨터의자.학생의자[그랜드],91000,80100,-10900
2018-06-01,1928041591,A017280,김,일가집 김밥용 치자 단무지 240g X 20EA_1BOX 반찬류,63210,63210,0
2018-06-01,2013357966,F011150,건강기능식품,오양식품 미숫가루/선식/천마차/선물세트/추천,26900,26900,0
2018-06-01,1207593516,C013040,청바지,[디어제인][디어제인]여름청바지기획SXL엠디입어보고셀렉썸머데님팬츠6종택1,12700,12070,-630
2018-06-01,7013516,E031040,전기레인지,(Coms) 2캔용 USB 미니 냉온기 (WH1202),57410,55690,-1720
2018-06-01,2123731276,I012010,컴퓨터,LG데스크탑 Z70EV-AR7316 코어i3 4G 500G 윈도우10,690420,649000,-41420
2018-06-01,1163858184,C013050,운동복,김포 로드스타 370 코토/박스캐리어/루프박스/캠핑,669500,575690,-93810
2018-06-01,1843582255,C013010,점퍼,초겨울 라이더 자켓 가죽점퍼 14_2 K2/레쟈가죽,89200,89200,0
2018-06-01,1992774658,A014020,분유,일동 산양분유 1/2/3/4단계 800g(뽁뽁이 이중포장),130000,130000,0
2018-06-01,1541861220,C013040,청바지,아둘 패밀리룩 메쉬 조던 민소매 상하의 나시세트 64,15900,15900,0
2018-06-01,163850061,C013020,티셔츠,[앙투] 여름신상 티셔츠44~110빅사이즈 반팔티 박시,9900,9900,0
2018-06-01,396396228,C013010,점퍼,절개 바람막이점퍼 HKJA82304A NC아울렛,29900,19900,-10000
2018-06-01,215685779,C012060,여자내의,쿨팬츠/몸빼바지/7부 반바지/바지 쿨원단 냉장고,2500,2500,0
2018-06-01,1783179318,E011030,거실장,로덴 제시카 대리석 4인세트,700000,700000,0
2018-06-01,212064885,C012030,여자상의,nn66 스트랩 베이직 린넨원피스 - 소라 여성원피스 여,35130,35130,0
2018-06-01,1109444061,A017140,콩나물,[종근당건강] 종근당/도라지청/도라지진액고/도라지농축액/도라지즙,42000,42000,0
2018-06-01,2083174595,C013010,점퍼,스테판조셉 프린티드 레인코트 페이즐리 (택1) /(참고,86800,76390,-10410
2018-06-01,1286414455,A011130,시리얼,오뚜기 부침가루 1kg X 10EA 찹쌀부침분말 부침가루,33720,33720,0
2018-06-01,82648085,E041030,솥,홈쇼핑 원쿡 미니밥솥 3인용 1인용 전기 국민 밥솥,29800,29800,0
2018-06-01,2064219310,C011050,남자내의,남자 면바지 스판 남성 팬츠 캐주얼 디자인 심플 패션,28840,28840,0
2018-06-01,108967,L021030,가방,보정속옷 압박팬티,23800,23800,0
2018-06-01,989514637,F012020,생리대,(심쿵특가)중형 화이트 최대70매/생리대/좋은느낌,8900,8900,0
2018-06-01,187918275,A014010,우유,매일우유 멸균우유 200mlX24팩/1000mlx4팩/저지방우유,9900,9900,0
2018-06-01,1709033160,E041050,냄비,판다 경질 전골냄비-18cm~32cm/경질냄비/뚜껑별도,5550,5550,0
2018-06-01,685998346,E061040,부엌용세제,그라인더세정제 퓨로그라인더클리너 - 그라인더세정제,52650,46860,-5790
2018-06-01,1339790329,C013050,운동복,그랜드카니발 콘솔보이 화물차.승합차 콘솔박스 포터2,119100,109580,-9520
2018-06-01,293302823,C012040,여자학생복,[모다아울렛][탑걸]스티치 가디건(TIZ4GD707F),29000,26100,-2900
2018-06-01,619328402,A021010,커피,뉴트리디데이 디카페 다이어트 아메리카노맛 100포,19800,19800,0
2018-06-01,345001239,F012010,종이기저귀,[+썸머비치가운] 보솜이 리얼코튼 기저귀 4팩,40900,40900,0
2018-06-01,1969443078,C013050,운동복,[이큐브] 에어 샌다기 5 샌딩작업/광택작업/밸크로방식/샌딩기/,281300,281300,0
2018-06-01,1720750050,E011060,의자,편안한 게이밍 컴퓨터 사무용 학생 공부 책상 의자,33300,33300,0
2018-06-01,1074667546,A013170,생선통조림,업소용 번데기 4kg 구수한맛이 일품인 북방 뻔데기,18900,18900,0
2018-06-01,1068253304,A013050,오징어,꽁치캔(유동1.88K)X6/꽁치캔/RhdclxhdwhflaWlro,73000,72270,-730
2018-06-01,1234856601,A013050,오징어,밀감캔(삼도 3k)X6 식당용 통조림 업소용 밀감통조림,60420,60420,0
2018-06-01,6271348,E031140,비데,대림도비도스 일체형비데/제품+시공비포함/서울경기,740000,740000,0
2018-06-01,1401237250,I012010,컴퓨터,최대할인시144만+2종사은품/ 삼성 북9 NT900X5T-X58A,1799000,1549000,-250000
2018-06-01,756524591,E011060,의자,[비즈니스보루네오]로니 사무용/학생용 의자모음전,38900,35010,-3890
2018-06-01,749043095,A011030,찹쌀,2017년 햇 국산 찰보리 5kg+5kg / 찰보리 / 보리쌀,22900,22900,0
2018-06-01,1448405014,A021010,커피,[택일] 맥심 오리지날 커피 500g 모카 초이스오리지널,13720,12900,-820
2018-06-01,1049020772,C012030,여자상의,KD 제임스 반가다 롱가디건 니트 여성 니트,106320,104200,-2120
2018-06-01,2104365537,A018040,아이스크림,업소용/프리미엄/아이스크림/녹차/요거트/카페/후식,30000,30000,0
2018-06-01,271558587,A013170,생선통조림,기획 유동/삼미 번데기 130g (10캔)2종중 택 무료배송,10300,10300,0
2018-06-01,794219917,E031080,선풍기,[돌핀] 충전식손난로 HWD3600M _ 손난로 /난방/겨울/핫팩/,31720,31720,0
2018-06-01,988153270,L021050,우산,초L)어린이밴드40매,1600,1600,0
2018-06-01,1552322440,F012010,종이기저귀,올뉴숨앤숨/WE/코튼에어 기저귀 국내제작,24800,24800,0
2018-06-01,1327499216,C013010,점퍼,케빈 트렌디 점퍼 (블랙 카키) 커플 항공 롱 점퍼 남,25450,25450,0
2018-06-01,1843582264,C013010,점퍼,초겨울 라이더 자켓 가죽점퍼 15_5 K2/레쟈가죽,119800,119800,0
2018-06-01,1843582263,C013010,점퍼,초겨울 라이더 자켓 가죽점퍼 15_2 K2/레쟈가죽,119800,119800,0
2018-06-01,751731208,A017230,마늘,2018년 경남 합천 햇양파 - 5kg/3kg,4900,4900,0
2018-06-01,1843582260,C013010,점퍼,초겨울 라이더 자켓 가죽점퍼 15_2 K2/레쟈가죽,119800,119800,0
2018-06-01,974685287,C011030,남자학생복,[게스(진유니)]남성 가로본능 린넨셔츠(MI1W1254),69100,58740,-10360
2018-06-01,2065576329,C013010,점퍼,[에고이스트] 브로치 후드 항공 점퍼(EJ2EZ405)(김해점),169000,137100,-31900
2018-06-01,283494387,C013040,청바지,흑청 블랙 워싱 스판 스키니진 데님 팬츠 남자 청바지,23900,23900,0
2018-06-01,1236634534,E031010,전기밥솥,쿠첸 10인용 전기압력밥솥/전기밥솥/밥솥 CJS-FB1002V,111000,111000,0
2018-06-01,1770062042,A019180,즉석식품,전국최대분식체인점판매 프리미엄 김말이튀김1kg,6900,6900,0
2018-06-01,457942026,I031010,장난감,벤틀리붕붕카/벤츠붕붕카/디럭스붕붕카/유아붕붕카/아,22800,22800,0
2018-06-01,365123377,A022020,두유,[매일유업]뼈로가는칼슘두유/검은콩(64/72팩)box포장,23800,23800,0
2018-06-01,1319636007,C013010,점퍼,[큰옷 세종대왕]MO82SK여름빅사이즈자켓/빅자켓,83600,83600,0
2018-06-01,1705729715,A011140,부침가루,[무료배송]박스과자/1BOX/초코파이/카스타드,36000,36000,0
2018-06-01,442442657,E041060,수저,(국내산)윙크 수저세트/숟가락 젓가락 포크 나이프 통,2000,1400,-600
2018-06-01,325650025,C012060,여자내의,[모다아울렛][지컷]체크스커트 7217335083,79500,75530,-3970
2018-06-01,962835854,E031140,비데,KN/노비타 방수비데 BD-N431 (물청소가능 IPX5인증),249000,229000,-20000
2018-06-01,1941997058,L021030,가방,[비너스] 슈퍼볼륨 업 메모리 패드_왕뽕 (VAC3750),12000,9960,-2040
2018-06-01,1321433027,A017020,상추,새론흑치마상추씨앗 3g,2000,2000,0
2018-06-01,1172336392,C011030,남자학생복,[예작셔츠]남성 반소매 슬림핏 슬럽 솔리드 YJ8MBS970,30000,23700,-6300
2018-06-01,1015779623,A021010,커피,카카오닙스/카테킨/폴리페놀/식이섬유/카카오닙/페루,18900,18900,0
2018-06-01,978357608,C011050,남자내의,[지오다노] 117525 남 라이트웨이트 펜슬핏 치노/ 지오다노,25000,20250,-4750
2018-06-01,545898703,C013010,점퍼,프리미엄 무스탕코트 하로 여성후드무스탕코트,1688500,1688500,0
2018-06-01,1380680617,C012040,여자학생복,리스트 여름 컷아웃 리본 슬리브 풀오버_TSKPOH60090/ 리스트 레드라벨,19000,15390,-3610
2018-06-01,1035910323,C013020,티셔츠,반폴라 스튜디오 티셔츠 남아폴라티 어린이겨울폴라티,10530,10530,0
2018-06-01,1867689680,E011050,책상,이지심플/우드책상/선반책상/L형책상/컴퓨터책상,25900,25900,0
2018-06-01,1397003377,I031010,장난감,스텝2 사파리웨곤 new 대형완구 아기자동차 유아자동,597080,597080,0
2018-06-01,952937942,F011130,홍삼,[김포파주인삼농협/산지직송] 홍삼양갱 50g*12,25100,25100,0
2018-06-01,1712651754,C013020,티셔츠,[스위트바니]데일리룩!여름신상 브이넥/반팔,6900,6900,0
2018-06-01,1843582289,C013010,점퍼,초겨울 라이더 자켓 가죽점퍼 15_6 K2/레쟈가죽,119800,119800,0
2018-06-01,1843582287,C013010,점퍼,초겨울 라이더 자켓 가죽점퍼 15_5 K2/레쟈가죽,119800,119800,0
2018-06-01,708037721,F012010,종이기저귀,[2018년형]폴라리스 울트라씬 팬티형(4팩),28000,28000,0
2018-06-01,989937998,L012030,칫솔,[페리오] 키즈 스텝3 치약 아이엠스타 75g X2 X2,7000,4770,-2230
2018-06-01,1821614133,C011050,남자내의,모든상사/형님마바지/30-40사이즈/여름바지/정장,9800,9800,0
2018-06-01,508348217,C012030,여자상의,퍼플스완 무드베이지 카라 린넨 원피스,46800,46800,0
2018-06-01,410379326,E061010,세탁세제,수퍼타이 액체세제 14L /슈퍼타이 14kg 액츠 세탁세제,16500,16500,0
2018-06-01,1131821254,F012010,종이기저귀,[바바랩]울트라씬 팬티형 L XL XXL/3팩모음전,30900,30900,0
2018-06-01,444655865,A019100,식초,더진한 토마토케찹 300g 토마토케첩 토마토소스 케？y,14400,14400,0
2018-06-01,1541922636,C014020,유아복,아둘 패밀리룩 메쉬 조던 민소매 상하의세트 18,15900,15900,0
2018-06-01,545898757,C013010,점퍼,스페인산 천연무스탕코트 소리아 무스탕코트,1779500,1779500,0
2018-06-01,1061848038,E011030,거실장,[채우리] 타이니 2인용 소파,260000,260000,0
2018-06-01,430571054,A019030,생강,백초생강 (참존 1.2k) X10,45560,40550,-5010
2018-06-01,300570621,C012040,여자학생복,[카라]KARRA 디테일펀칭자수블라우스_KBI6BL233C,27800,26410,-1390
2018-06-01,2081416270,E021020,커튼,아이방 순면 캐노피 지붕 침대 유치원 텐트 어린이집,39800,39800,0
2018-06-01,1061848039,E011030,거실장,[채우리] 베리타 2인 접이식 소파베드,260000,260000,0
2018-06-01,898512429,A022010,주스,[풀무원]풀무원 아임리얼 스트로베리 190ML,2900,2900,0
2018-06-01,186576353,A019140,이유식,[엘빈즈]클래식 아기국 반찬 볶음밥 간식 골라담기,3380,3380,0
2018-06-01,1184644248,A019040,소금,우이당의 솔잎 양치소금 30개입,12000,12000,0
2018-06-01,1297955175,C012040,여자학생복,위니걸/ 야상 조끼/빅사이즈/점퍼,29800,29800,0
2018-06-01,555983717,A017280,김,[더마트] 일가집 사각단무지550g,1980,1980,0
2018-06-01,2022211445,C011050,남자내의,여름카고바지 남자작업복 청면바지 골프웨어 린넨바지,19800,19800,0
2018-06-01,1541861284,C013040,청바지,아둘 패밀리룩 메쉬 조던 민소매 상하의 나시세트 54,15900,15900,0
2018-06-01,623292727,E061010,세탁세제,와이셔츠 약 부분세제 스틱형세제 세탁보조제 와이셔,6770,6770,0
2018-06-01,2141269773,C021040,실내화,와이컨셉베어파우k720001KB,53940,53940,0
2018-06-01,447338820,A017230,마늘,2018년 햇양파(3kg)중/대/특,5400,5400,0
2018-06-01,549875215,C013010,점퍼,[Wilson]윈드자켓/바람막이/아웃도어자켓/단체복/팀복,42500,39000,-3500
2018-06-01,648937410,I011020,영상음향기기,CnK 빔프로젝터 GMM1 GM80A 스마트미니빔 실수4탄,269000,269000,0
2018-06-01,1047854931,L021010,손목시계,로제타 여성 손목시계 FW-16 아날로그시계 팔목시계,13910,13910,0
2018-06-01,1737011841,I031040,생화,해수욕장 비치 꺽임 파라솔 야외용 낚시 우산 파라솔,6400,5890,-510
2018-06-01,582730960,C013050,운동복,안전봉 비상경광봉 LED 경광등 안전신호 교통안전,4000,3500,-500
2018-06-01,1146735542,C013020,티셔츠,[네파키즈] 더블팩 세트 - KEG5307(본점),21000,19360,-1640
2018-06-01,1513928778,C013040,청바지,JMM9979 기획기본진청남자스판청바지-빅사이즈까지 남,27000,27000,0
2018-06-01,2097669780,E051030,디지털도어록,[빠른배송] 밀레 디지털 도어락 큐브/번호키/번호전용,45000,40500,-4500
2018-06-01,575248040,A019140,이유식,[아이배냇] 간편 레시피 죽 만들기/햅쌀 아기 이유식,5530,5530,0
2018-06-01,1723266572,C011050,남자내의,[I.M.Z PREMIUM] 남성 스트랩밴딩 원턱 린넨팬츠 62PC205 44 카키그레이,69000,62100,-6900
2018-06-01,1584398540,C012030,여자상의,특가세일9900원/트레이닝st미니원피스/니트/롱셔츠,9900,9900,0
2018-06-01,998671202,C012020,원피스,김발 겉대x2,3290,3290,0
2018-06-01,1090497289,C012020,원피스,[플리츠미] 와이드 8부 팬츠 PPTS915007,29000,23200,-5800
2018-06-01,880705791,C012040,여자학생복,여름신상 고급면남방 유니폼셔츠카라여자빅사이즈기본,11900,11900,0
2018-06-01,801390359,L021020,장신구,실리콘귀걸이1쌍/귀막힘방지 피어싱 악세사리 진주,650,650,0
2018-06-01,1076655196,C011050,남자내의,여름/배기/팬츠/바지/조거/카고/남자/남성/빅사이즈,26800,26800,0
2018-06-01,1380258953,C021040,실내화,아디다스 운동화 CF 얼티메이트 블랙 (BC0018),57000,57000,0
2018-06-01,57867422,A011010,쌀,경기미 씻어나온쌀 5kg/국내산/백미,14900,14900,0
2018-06-01,955799467,A019180,즉석식품,CJ 햇반 210G*10입 기획,11200,11200,0
2018-06-01,1914555824,C021020,구두,[토리버치] 토리버치 리나 슬라이드 샌들 45518_001,215000,169850,-45150
2018-06-01,2051220818,E061080,키친타월,[모나리자]키친타올160매X16롤+70매증정/화장지/티슈,10000,8900,-1100
2018-06-01,467908869,I053010,공책,묶음상품 플라스틱링(51mm)흑색 50개입x3개 제본기스,78430,78430,0
2018-06-01,958914358,E031070,에어컨,신일 벽걸이형 선풍기 모음 벽걸이선풍기 SIF-M16KRD,48800,47800,-1000
2018-06-01,1003103675,C013040,청바지,JMM8870 기획밴드중청남자스판청바지-빅사이즈까지 남,26400,26400,0
2018-06-01,1194067188,C013020,티셔츠,엄마옷 마담4060 사선나염블라우스-XABL805006-,14900,12370,-2530
2018-06-01,1250430921,C013050,운동복,콜라보배색집업 MS1710 여자이쁜집업 트레이닝상의 운,51510,51510,0
2018-06-01,808784213,E011020,침대,퍼스트레이디가구 힐링 본넬 스프링 침대_S/SS/D/Q,71000,67440,-3560
2018-06-01,1833392738,E051020,건전지,KC인증-파나소닉 정품 3400 18650 충전지 건전지 랜턴,8600,8500,-100
2018-06-01,713702777,F012020,생리대,[릴리안]생리대 골라담기/순수한면/라이너/오버나이트,1900,1900,0
2018-06-01,1874224807,C013010,점퍼,[펀쇼] 싱글롱자켓 빅사이즈 여성의류 55~100,39700,39700,0
2018-06-01,1822198761,E021010,침구,국산 올바른 순면 차렵이불+패드+베개 3종이불세트,27900,27900,0
2018-06-01,880249899,A012060,햄및베이컨,미니이지칠리300g/ 비첸향,25500,23970,-1530
2018-06-01,1124635290,C015020,모자,기사미 엑스비어 모자 타투스타일 3종 특별기획,24900,24900,0
2018-06-01,1920583789,E061100,습기제거제,물먹는하마 옷장용 525ml x 16개 제습제 습기제거제,17800,17800,0
2018-06-01,444655893,C012020,원피스,캐시미어혼방코트(Z174MSG507)/ 쥬크,229000,194650,-34350
2018-06-01,2085739807,C012040,여자학생복,[앙투] 여름신상 블라우스44~110빅사이즈 루즈핏 린넨,19800,19800,0
2018-06-01,1440673422,C012040,여자학생복,캐리스노트 여름 니트가디건CN8MSW810,56960,56960,0
2018-06-01,1541861289,C013010,점퍼,아둘 패밀리룩 메쉬 조던 민소매 상하의 나시세트 52,15900,15900,0
2018-06-01,1540095935,A021010,커피,[특가]맥심 모카골드 1kg/ 커피믹스/자판기커피,7340,6900,-440
2018-06-01,394232496,C012030,여자상의,[샵코드] 원피스 블라우스 티셔츠 여성의류 모음전,9900,9900,0
2018-06-01,247639985,C013020,티셔츠,남성 여름린넨 반팔 티셔츠 시원한 기본핏 오버핏 부,11700,11700,0
2018-06-01,1353294149,E061060,살충제,알델리트]새집증후군 원인해결/알데히드 원천 제거제,35000,35000,0
2018-06-01,197329196,C014010,아동복,젠키하프정장/어린이정장/정장대여정장바지주니어정장,44900,44900,0
2018-06-01,1010291855,A019170,냉동식품,CJ 고메 미트볼토마토파스타 300G,4990,4990,0
2018-06-01,1158467879,F012010,종이기저귀,마미포코 특대형/대형/점보혼합/마미포코팬티형기저귀,34900,34900,0
2018-06-01,1916178772,A015020,식용유,오뚜기 프레스코 포도씨유 500ml X 20EA 포도씨유기름,148000,148000,0
2018-06-01,185746857,C013010,점퍼,코오롱 클럽캠브리지 3종세트(CZJCM17120)캐주얼 이중 포켓 자켓 택1,99000,82170,-16830
2018-06-01,1010291856,A019170,냉동식품,CJ 비비고 한양식불고기덮밥 327G,4990,4990,0
2018-06-01,1234614129,C021040,실내화,나이키 코르테즈 클래식 레더 3종,63900,63900,0
2018-06-01,1511160975,D031010,주택수선재료,[BIOFA] 비오파 천연 향기 왁스(2060) 200ml,15000,13500,-1500
2018-06-01,1879943770,I031040,생화,피아누라 마이티 해머 캠핑망치 캠핑해머/크롬강 헤드,20000,16020,-3980
2018-06-01,2029433931,L021020,장신구,플러그 피어싱/UV 후레쉬 터널/플러그/확장기/아크릴,5000,5000,0
2018-06-01,134471111,E011010,장롱,MF 윈도우 커버 옷장/비키니 옷장 옷걸이 행거 조립식,29900,29900,0
2018-06-01,59922285,I031040,생화,단조팩망치/캠핑망치/망치/캠핑용품/단조팩/펙/공구,10000,8060,-1940
2018-06-01,1362156887,C012060,여자내의,스커트를 입은듯한 큐롯반바지 치마바지 숏팬츠,11500,10700,-800
2018-06-01,1812988118,F012020,생리대,숲속이야기 텐셀 생리대 16p x5팩 +마스크팩증정/ 예지미인,11500,11500,0
2018-06-01,1266186762,E021020,커튼,/롤러블라인드 베이지 스콕스클뢰베르 140x195 cm/ 블,78720,70070,-8650
2018-06-01,545898793,C013010,점퍼,스페인산 명품후드무스탕 하로 여성후드무스탕코트,1688500,1688500,0
2018-06-01,564621714,E011050,책상,[동서가구/착불]클레버B 1200 모던 H형책상 DF905629,119000,79900,-39100
2018-06-01,1515997755,C013050,운동복,아우디 다용도 선글라스 카드클립 안경거치 명함 홀더,19000,16720,-2280
2018-06-01,830398738,C015020,모자,무료배송!!야구모자/볼캡/베이스볼캡/스판캡/캡모자,16900,16900,0
2018-06-01,264415836,E031130,보온매트,온도리아 접착식강화마루/DIY전기판넬/붙히는강화마루,76000,50000,-26000
2018-06-01,1603120925,C013050,운동복,3M 에탄올 워셔액 2L 프로 (1+1+안심스티커),8000,8000,0
2018-06-01,664383489,A011180,파스타면,볼로네이즈/까르보나라/뽀모도로 스파게티 220g x 5개,11900,11900,0
2018-06-01,1239016232,C011050,남자내의,[베스티스]베스티스 아이스 쿨링 스트라이프 팬츠,69000,65550,-3450
2018-06-01,1597152308,F011130,홍삼,정관장 은혜은세트(SET),100000,100000,0
2018-06-01,1004922750,L021020,장신구,스위트 서클 목걸이 WG 목걸이 선물 기념일 써클 주얼,13620,13620,0
2018-06-01,1492015724,C014010,아동복,블루테일 여아 보헤미안 크래프트 블루 4부 트레이닝팬츠 ASB2PT,30720,30720,0
2018-06-01,1015099424,A019170,냉동식품,줄서서먹는 만두의신 신영왕만두,12900,12900,0
2018-06-01,1255640199,C012040,여자학생복,[스타일빅걸]오픈 가오리 자켓 OKI138/ 스타일빅걸,52670,46880,-5790
2018-06-01,387839212,C013030,스웨터,[젬마월드]Cherry-보트넥7부니트,24000,24000,0
2018-06-01,2033139101,C013020,티셔츠,나로 아동복 여름신상 아동티셔츠 아동반팔티,9900,9900,0
2018-06-01,1402623250,C012060,여자내의,앞 트임 포켓 롱 데님 스커트 A라인 청스커트 데님스,34640,34640,0
2018-06-01,1538619564,I011030,사진기,캐논총판 캐논 1Dx BODY,6690000,6355500,-334500
2018-06-01,18772704,C013050,운동복,5p 도어가드 EVA 블록/카센타판매용 세차장납품,3830,3530,-300
2018-06-01,406150738,E061010,세탁세제,대용량/울샴푸 고급면800ml+1.3L리필6개/ 애경,25200,25200,0
2018-06-01,1311050303,L021020,장신구,다우니 초커 목걸이 가을 악세사리 기념품 밍크 기념,27570,27570,0
2018-06-01,1777666092,E011030,거실장,[PookShuim]푹쉼 블럭 패브릭 1인용 소파,169000,169000,0
2018-06-01,1777666094,E011030,거실장,[PookShuim]푹쉼 제네바 FPL가죽 3인용 소파,364000,364000,0
2018-06-01,491245264,A022050,탄산음료,달달하게 술마신 다음날 갈배 사이다 355ml 24캔,24500,24500,0
2018-06-01,121629219,C012040,여자학생복,[로렌즈앤]로렌즈앤 린넨니트롱가디건,35800,32220,-3580
2018-06-01,1777666093,E011030,거실장,[PookShuim]푹쉼 제네바 패브릭 3인용 소파,340000,340000,0
2018-06-01,1777666096,E011030,거실장,[PookShuim]푹쉼 듀스 FPL가죽 전동 리클라이너 6인소파 컵홀더포함,1794000,1794000,0
2018-06-01,391225713,C013040,청바지,정품 리바이스 엔진 ☆ 정품 아베크롬비 카고 ☆ 리바이스청바지 무료배송 1주일 초특,49800,39350,-10450
2018-06-01,1777666095,E011030,거실장,[PookShuim]푹쉼 제네바 패브릭 2인용 소파,226000,226000,0
2018-06-01,1777666098,E011030,거실장,[PookShuim]푹쉼 듀스 FPL가죽 전동 리클라이너 6인소파,1594000,1594000,0
2018-06-01,1762536212,A017110,감자,장흥표고_흑화고세트300g건강식품 명절선물세트 특산품 추석선물세트 효도선물 표고세,88070,88070,0
2018-06-01,1777666097,E011030,거실장,[PookShuim]푹쉼 듀스 FPL가죽 전동 리클라이너 4인소파 컵홀더포함,1512000,1512000,0
2018-06-01,1582991124,A018020,사탕,비타하임 포도당캔디[15정X20롤]/먹는포도당 캔디,27900,27900,0
2018-06-01,1354403660,C012040,여자학생복,[로즈맘][로즈맘]썸머가디건,11570,10420,-1150
2018-06-01,1269734778,C012060,여자내의,jj42 꽈배기니트 미디스커트_진그레이 여성패션스커트,14830,14830,0
2018-06-01,1323120996,C013040,청바지,(색상 : 진청 | 사이즈 : 30) MPS18033 에,49740,49740,0
2018-06-01,1656893481,C012020,원피스,[여성홈쇼핑(더휴컴퍼니)](어포스트로피) 여성 폰테 스프링 코트(NAHY500C),19900,16120,-3780
2018-06-01,1088265083,E011060,의자,게이밍Z 컴퓨터책상 게이밍의자 학생책상 PC방의자,119000,119000,0
2018-06-01,499271912,C012040,여자학생복,[루코루코]8095 가디건 2color(RSC4CD008)[갤러리아],24000,20400,-3600
2018-06-01,431261651,A016100,수박,[참예과] 아삭아삭 하우스 꿀 수박 4~5kg,9500,9500,0
2018-06-01,1080136862,E031010,전기밥솥,CRP-P0610FD/쿠쿠/6인용/압력/Full스텐/GH,164000,144970,-19030
2018-06-01,1152090040,E061030,전구,[안정기모음전] FPL 36w 55w FL32w 안전기 직관등기구,4000,4000,0
2018-06-01,1213222218,C011030,남자학생복,ACCMD852 3G 롱가디건 면바지코디 남자니트가디건 롱,62920,62920,0
2018-06-01,1435410513,E011040,소파,[동서가구]토니 패브릭 2인 소파 DF903642 /2인용,112000,99000,-13000
2018-06-01,377954287,A019160,밑반찬,매일 매일 직접 만드는 프리미엄 수제반찬 72종,1900,1900,0
2018-06-01,1404810249,E031140,비데,아이젠비데 설치비무료/의료기기인증/관장기능 비데,459000,410000,-49000
2018-06-01,443609521,C015020,모자,(컬러:사이즈 : 카키:FREE) ACC-CAP102 베이,19630,19630,0
2018-06-01,277525689,A016120,바나나,동결건조 바나나가루 80g 바나나 바나나분말,10000,10000,0
2018-06-01,692474721,A018080,설탕,고이아사 유기농 갈색설탕 20kg,51000,51000,0
2018-06-01,1777666099,E011030,거실장,[PookShuim]푹쉼 듀스 FPL가죽 전동 리클라이너 4인소파,1312000,1312000,0
2018-06-01,393257750,A017210,파,[싱싱특가] 정품 완숙 찰토마토 5kg/10kg,9900,9900,0
2018-06-01,903701831,C013020,티셔츠,레프트자수반팔티/망사티/레이스티/크루넥/코디필수.,7900,7900,0
2018-06-01,1233601278,E021010,침구,나르는 양탄자40수 누비면 매트 커버(황토색-퀸) 쿨매,81290,81290,0
2018-06-01,1268539307,C013020,티셔츠,30%쿠폰! BEZY 남여 단가라/반팔/스트라이프/반바지,6900,6900,0
2018-06-01,852433363,E031080,선풍기,[태서전기] Alpaca 석유히터 TS-780 /석유히터/석유난로/석유곤로/,130300,130300,0
2018-06-01,430646787,C013010,점퍼,남아 나시 상하복-레이먼 네이비/ 릴헤븐,40000,28000,-12000
2018-06-01,1997962130,L021030,가방,맨스댄디 서류가방 브리프케이스 남성가방,46000,36000,-10000
2018-06-01,326492877,A019020,참깨,깐뜰개가루 200g 볶은들깨가루 국산들깨가루 곡물가루,19900,19900,0
2018-06-01,985350153,A019180,즉석식품,CJ햇반 컵반 순두부찌개국밥 173G,2580,2380,-200
2018-06-01,985350155,A019180,즉석식품,CJ햇반 컵반 황태국밥 169.2G,2580,2380,-200
2018-06-01,1155867345,C012040,여자학생복,[타미힐피거여성]여성 골지 슬릿디테일 니트(TFMS1WOE05A0G60),136500,122850,-13650
2018-06-01,985350154,A019180,즉석식품,CJ햇반 컵반 미역국밥 167G,2580,2380,-200
2018-06-01,1251441896,C012060,여자내의,시크폭스 도트페리 와이드점프수트/ 시크폭스,22500,17550,-4950
2018-06-01,1266463981,C011030,남자학생복,95~130 남방/체크남방/와이셔츠/솔리드/셔츠/빅사이즈,12900,12900,0
2018-06-01,1240884122,A016150,아몬드,팜앤팜 17년 캘리포니아산 당일가공 볶음 구운 아몬드,9900,9900,0
2018-06-01,697554562,C011030,남자학생복,[멘샤 가슴밑 실단가라 티셔츠103]/남성티셔츠/남자티셔츠/남성의류/직장인티셔츠/남성,88750,61240,-27510
2018-06-01,2141688235,C011020,남자상의,쉐도우 롱 패딩 코트 스포츠패딩 남자스포츠패딩 롱패,280810,280810,0
2018-06-01,349468805,A014010,우유,서울 매일 상하 바른목장 멸균우유 1000ml 200ml,12880,12880,0
2018-06-01,1453754587,A019180,즉석식품,[CJ제일제당] 햇반 흑미밥(210gx6입),4980,4770,-210
2018-06-01,1408748507,A019060,된장,[CJ] 그대로 된장찌개450g(바지락+쇠고기+청양),9900,9900,0
2018-06-01,958662312,A011070,혼식곡,[우리밀]우리밀 백밀가루(1KG),3990,3990,0
2018-06-01,958662313,A011070,혼식곡,[우리밀]우리밀 통밀 가루 1KG,3990,3990,0
2018-06-01,619654228,L021020,장신구,스와로브스키스톤 귀걸이 이어링 귀고리 은침 유색 비즈 실버 패션귀걸이 악세사리귀걸,16800,16300,-500
2018-06-01,1675970393,A014010,우유,상하목장 유기농우유 멸균우유 125ml 200ml 24팩,19900,19900,0
2018-06-01,1789146604,I012060,저장장치,[레이저(RAZER)] Razer Naga Trinity 웨이코스 정품 게이밍마우스,153000,129000,-24000
2018-06-01,2026772202,C012040,여자학생복,[로렌즈앤]로렌즈앤 이브로브가디건,19800,16830,-2970
2018-06-01,378943683,A016020,배,달콤시원 나주배 15kg (큰크기행사),15900,15900,0
2018-06-01,1397117779,A013020,명태,두레생협 대구전부침용(400g 러시아산) 대구전 부침개,29970,29970,0
2018-06-01,1608376794,L021020,장신구,핸드메이드)(실버)피칸 목걸이 레브라도 라브라도라이,33250,33250,0
2018-06-01,852433361,E031080,선풍기,[테라썬] 복사 난방기 LTH-170 /난로/전기히터/인테리어/,94100,94100,0
2018-06-01,265656717,L021020,장신구,[해리메이슨] 프리사이즈 반지 (LER-006),49000,43610,-5390
2018-06-01,1713650464,L012040,치약,암웨이 글리스터 치약 200g / 여행용 (65g) 최신제품,18000,18000,0
2018-06-01,292836445,C015040,장갑,양가죽 무스탕 벙어리 여성장갑 워머장갑 장갑 따뜻한,25010,25010,0
2018-06-01,483993966,C011030,남자학생복,밀란시아 3버튼 클래식조끼 sh1201-002 남성캐쥬얼 캐,46750,45820,-930
2018-06-01,511342716,C012040,여자학생복,[레코브][18여름]스트라이프 로브 가디건(LU3185CD507X)[갤러리아],39800,33830,-5970
2018-06-01,1061973808,E011030,거실장,[채우리] 레디 원목 파티션,113000,113000,0
2018-06-01,1471352732,C021040,실내화,아디다스 인기 운동화 스니커즈 단화 런닝화 모음,39800,39800,0
2018-06-01,1061973807,E011030,거실장,[채우리] 레디 원목 파티션+패브릭추가,124000,124000,0
2018-06-01,848394068,A014010,우유,[파스퇴르] 전용목장우유 1급A 우유 200mlx24팩/우유,15900,15900,0
2018-06-01,1041598873,I031010,장난감,(Razor)(정품)레이저 미니모드-전동오토바이/전동차/,83990,83990,0
2018-06-01,1185334524,C012040,여자학생복,[빅앤빅]베이직 쿨비침 가디건 7color 빅사이즈 55100까지,25500,24230,-1270
2018-06-01,700026931,E021010,침구,피그먼트 차렵이불 여름이불 워싱스프레드 침대패드,36800,33860,-2940
2018-06-01,1778592501,L021010,손목시계,[바보사랑][공식  백화점AS가능]사우스 햄튼 남녀공용시계(메탈)_W0831L1,218000,218000,0
2018-06-01,1778592500,L021010,손목시계,[바보사랑][공식  백화점AS가능]사우스 햄튼 남녀공용시계(메탈)_W0831L3,248000,248000,0
2018-06-01,55552087,C013010,점퍼,득템찬스..무조건 이가격..44-120사이즈,17900,17900,0
2018-06-01,243568219,A013010,갈치,두툼한 갈치 4-5토막 다양한 사이즈,5500,5500,0
2018-06-01,1244617893,E031010,전기밥솥,쿠쿠 보온밥솥 CR-1413G 전기밥솥 보온밥솥 쿠쿠전기,98060,98060,0
2018-06-01,985349188,A019170,냉동식품,CJ밀당의 고수 김말이_700G,7990,6990,-1000
2018-06-01,2085499205,E061030,전구,산쿄 필립스 자외선 살균 램프 4W 6W 8W 10W 15W 20W,3000,3000,0
2018-06-01,1972845627,C014010,아동복,아동 긴팔남방/ 아동 긴팔셔츠/ 아동 옥스포드셔츠/ 아동 옥스포드 남방/ 기본남방/ 화,21800,21800,0
2018-06-01,1011179106,A013060,게,민어조기(130G내외/마리),1390,1290,-100
2018-06-01,1524368164,A013070,굴,국내산100% 박달홍게 속초홍게 5마리,27800,23700,-4100
2018-06-01,500555579,A019050,간장,[샘표] 진간장 금F3 150ml/ 샘표,1050,1000,-50
2018-06-01,1778592505,L021010,손목시계,[바보사랑][공식  백화점AS가능]메트로폴리탄 남성시계(가죽)_W0792G8,168000,168000,0
2018-06-01,1745655801,C012040,여자학생복,신상 최저특가 청남방 레이어드 빈티지 워싱데님/청,9800,9800,0
2018-06-01,1778592504,L021010,손목시계,[바보사랑][공식  백화점AS가능]GLITTERATI 남녀공용시계(실리콘)_W0818L2,198000,198000,0
2018-06-01,389656372,C014010,아동복,[갭키즈] 5218126231001 키즈 남아 반팔 리믹스 로고 티셔츠 CH,15000,14250,-750
2018-06-01,1778592503,L021010,손목시계,[바보사랑][공식  백화점AS가능]윌로우 여성시계(메탈)_W0822L4,328000,328000,0
2018-06-01,137347410,A012030,돼지고기,그린쉘 오삼불고기 450g 2개,21000,20370,-630
2018-06-01,1775125252,F011130,홍삼,정관장 홍삼정캡슐(SET),44000,44000,0
2018-06-01,265656741,L021020,장신구,[해리메이슨]LUNA EDITION반지 (LER-005),55000,48950,-6050
2018-06-01,1474006019,I031040,생화,소이어 아웃도어 휴대용 Sawyer mini 재난대비 캠핑용,43000,39560,-3440
2018-06-01,244895583,C011020,남자상의,봄신상 정장바지/남자옷/스판슬랙스/빅사이즈바지,17800,17800,0
2018-06-01,1388448748,C013010,점퍼,AGC후드 집업점퍼 BBB 오픈 CC집업점퍼후드점퍼후드집,49050,49050,0
2018-06-01,509543733,I012060,저장장치,무료배송/플레오맥스/삼성정품마우스 모음/USB/게이밍,6500,5880,-620
2018-06-01,2124306685,C012040,여자학생복,수지네 구제 exr 네이비패턴 패딩조끼 여성 M 17-40,13770,13770,0
2018-06-01,385742216,C012020,원피스,히든 밴딩 칠부 팬츠 RIN0363RM805 빅사이즈,53780,50560,-3220
2018-06-01,1700432345,A015020,식용유,백설 올리브유 900ml x2/ 3개 / 포도씨유 카놀라유,13900,13900,0
2018-06-01,2106013890,E031110,청소기,(공식)한경희 스팀청소기 SlimLight XST-100B/XST-100,89000,81500,-7500
2018-06-01,488026227,E041010,식기,문창탑/풍수지리/인테리어/소품/용품/합격기원/선물,220000,215600,-4400
2018-06-01,451141563,A019010,고춧가루,A고운 보통맛 고추가루 1kg2개 가루 고추가루 고운고,41520,37370,-4150
2018-06-01,1782315472,E011030,거실장,로딘 오로라 4인 식탁세트,270000,270000,0
2018-06-01,570126819,A017140,콩나물,도라지즙 아기배즙 생강즙 도라지 배 생강 탄닌성분,42900,42900,0
2018-06-01,1782315473,E011030,거실장,로딘 메이 4인 식탁세트,287000,287000,0
2018-06-01,631427670,C013050,운동복,여름 추가 트레이닝바지 츄리닝/운동복/져지/남성,12700,12700,0
2018-06-01,990057190,E041030,솥,PN풍년 캠킷 아웃도어 압력솥 2인용/캠핑용/코펠/밥짓기,120000,74500,-45500
2018-06-01,1896356139,C013010,점퍼,[르젠]시즌오프특가 롱패딩/헤비패딩/초경량/모직코트,23000,18800,-4200
2018-06-01,781439559,C013040,청바지,여름 청바지 남자 남성 밴딩 스키니진 스판 찢어진,17800,17800,0
2018-06-01,1801085179,E031090,공기청정기,[엔보우]퓨어에이지 미니 공기청정기 3중복합헤파필터,58000,58000,0
2018-06-01,771270468,I031010,장난감,레고10704 크리에이티브박스/클래식/정품/빠른배송,45700,41130,-4570
2018-06-01,897650254,A014030,치즈,덴마크 파마산 치즈 (85G),4100,4100,0
2018-06-01,1782315446,E011030,거실장,로딘 케빈 대리석 4인 식탁세트,380000,380000,0
2018-06-01,899523334,A012060,햄및베이컨,[대림]대림 구운 마늘햄 (140G),1250,1250,0
2018-06-01,1556930234,A012050,소시지,(롯데) 빅팜 소시지 1200g(60gx20개) / 소시지,8900,8900,0
2018-06-01,450966815,A012060,햄및베이컨,청정원 고소하고 바삭한 베이컨 1kg2개 베이컨 청정원,57660,51900,-5760
2018-06-01,499669216,A018040,아이스크림,설레임/월드콘/찰떡아이스 7 종 모음,15900,15900,0
2018-06-01,1153137465,E051030,디지털도어록,삼성SDS스마트도어록 SHS-H511(자가설치 카드키4개),155000,134140,-20860
2018-06-01,1241726249,C011030,남자학생복,[무료배송](SR)KHM768-770 남성빅사이즈차이나ST긴팔,58170,58170,0
2018-06-01,427914852,E031080,선풍기,한빛 원적외선 전기온풍기 hv-4800(3.5kw) - 전기히터,643050,572320,-70730
2018-06-01,1778592527,L021010,손목시계,[바보사랑][공식  백화점AS가능]라임라이트 남녀공용시계(가죽)_W0775L9,278000,278000,0
2018-06-01,619629237,L021020,장신구,스와로브스키스톤 귀걸이 이어링 귀고리 유색보석 비즈 은침 실버 악세사리 패션귀걸,11700,11350,-350
2018-06-01,1634288362,A019110,드레싱,(참소당 샤브샤브소스1.8L) 샤브전골육수 유자폰쯔유,12900,12900,0
2018-06-01,450602006,C012040,여자학생복,MJ_1220 브라운 양털 조끼 남성털조끼 털조끼 남성조,31080,31080,0
2018-06-01,1742345802,F012020,생리대,시크릿데이 생리대 러브대형14PX8팩,18900,17950,-950
2018-06-01,1778592528,L021010,손목시계,[바보사랑][공식  백화점AS가능]라임라이트 여성시계(가죽)_W0775L7,278000,278000,0
2018-06-01,2083054570,C013010,점퍼,코스 셔링 오버핏 썸머자켓- 간절기자켓 썸머자켓 셔,80000,70400,-9600
2018-06-01,988128533,A022030,생수,초L)샘물 (2L*6입),3600,3300,-300
2018-06-01,988128532,A022030,생수,초L)샘물 2L,600,550,-50
2018-06-01,988128530,A022030,생수,초L)샘물 500ML,300,300,0
2018-06-01,1782315449,E011030,거실장,로딘 땅콩 4인 식탁세트,356000,356000,0
2018-06-01,552068761,A012060,햄및베이컨,사조오양 비프 불고기 토핑 1kg/소고기/불고기피자,10800,10800,0
2018-06-01,1782315447,E011030,거실장,로딘 케빈 하이그로시 4인 식탁세트,270000,270000,0
2018-06-01,1715238715,C011030,남자학생복,[홈런]셔츠/남방/린넨/체크/데님/7부/반팔/남성/남자,9700,9700,0
2018-06-01,632259468,C012060,여자내의,벨벳 기모 몸빼 바지 일바지 편한 고무줄 밴딩 팬츠,9000,8900,-100
2018-06-01,1782315448,E011030,거실장,로딘 케빈 4인 식탁세트,270000,270000,0
2018-06-01,1385680140,C013050,운동복,아디다스 베켄바우어 트랙탑 팬츠 세트 CW1250 CW1269,71200,71200,0
2018-06-01,1171168232,E011020,침대,인쏘노 9존 라텍스 탑 침대 베스트 + 매트리스 포함,264120,264120,0
2018-06-01,813075806,C011050,남자내의,라이트블루 스키니 데님 CHBDP215M/ 클라이드,17000,13600,-3400
2018-06-01,1063909358,A019080,고추장,[CJ직배송] 해찬들 사과듬뿍 비빔장 290g X3개,8900,8900,0
2018-06-01,1063909359,A019080,고추장,[CJ직배송] 해찬들 사과듬뿍 비빔장 470g X3개,13800,13800,0
2018-06-01,1703817601,A021020,차,Ligo 리고땅콩버터 462g 스키피 누텔라 땅콩쨈딸기잼,4960,4960,0
2018-06-01,1782315450,E011030,거실장,로딘 코코 4인 식탁세트,301000,301000,0
2018-06-01,1338379014,A018100,꿀,동서다화꿀600g/잡화꿀/벌꿀/아카시아꿀/토종꿀/꿀,13000,13000,0
2018-06-01,502952205,L021010,손목시계,BELCARINO 유로스타일 고품격 패션시계 MV2097032B 학,78830,78830,0
2018-06-01,992449398,C012040,여자학생복,[플래퍼]플래퍼 잔꽃쉬폰로브가디건_FBI6CD002A,13200,12540,-660
2018-06-01,1191476720,A022050,탄산음료,음료수 175mlx30캔 캔커피/레쓰비/콜라/사이다/캔음료,5900,5900,0
2018-06-01,823607798,A019080,고추장,진미 우리쌀 한우볶음 고추장(60G*3입),5000,5000,0
2018-06-01,1395856870,C013020,티셔츠,[루나샵] 여름신상 5900원~ 루즈핏티셔츠/기본/박스티,5900,5900,0
2018-06-01,966261506,C021040,실내화,10%단골쿠폰 [러빈슈] 슬립온 통굽 운동화 스니커즈,25700,25700,0
2018-06-01,957932564,I053040,기타문구,빅오피스 프린텍 NEW 반투명 스티키노트 8종 모음전,1200,1200,0
2018-06-01,698742422,A019060,된장,청정원 재래식된장(14KG),33000,33000,0
2018-06-01,530504814,C012060,여자내의,백합주름치마 블랙 전체 주름 교복치마 교복 예쁜교복,55060,53410,-1650
2018-06-01,1569056185,E041070,밀폐용기,글라스락 스마일캡 4P 강화유리 이유식기/밀폐용기,12900,11870,-1030
2018-06-01,1181698283,C012040,여자학생복,부루앤주디[WGKF2CD003]반팔브이가디건,19900,17910,-1990
2018-06-01,1169996184,A018050,비스킷,[청우 찰떡쿠키 60개]그랑쉘 60개/무료배송/초특가,8900,8900,0
2018-06-01,412941719,C013050,운동복,[3M 정품 광택 콤파운드 (3000방)자동차광택] 차량,35190,32060,-3130
2018-06-01,719052849,A022050,탄산음료,[모음전]음료수/미니캔음료/탄산음료/캔커피/업소용,5600,5600,0
2018-06-01,1128738077,E061100,습기제거제,(초간편100번충전)리필제습제통/염화칼슘/습기제거제,1500,1500,0
2018-06-01,1493930517,C013020,티셔츠,라코스테 맨투맨 후드티 후드집업 폴로티 반팔티,79900,79900,0
2018-06-01,1778592530,L021010,손목시계,[바보사랑][공식  백화점AS가능]컨페티 남녀공용시계(메탈)_W0774L2,298000,298000,0
2018-06-01,692900822,F012010,종이기저귀,리베로기저귀 팬티형 2팩 모음,35100,35100,0
2018-06-01,1248623478,C013050,운동복,여름 쿨링 나시세트/투피스세트/냉장고바지/민소매,12500,12500,0
2018-06-01,1778592531,L021010,손목시계,[바보사랑][공식  백화점AS가능]파크 에비뉴 여성시계(메탈)_W0767L2,218000,218000,0
2018-06-01,1341185420,E011060,의자,특가)심플메쉬의자100/학생/책상/컴퓨터/사무용,21900,19710,-2190
2018-06-01,1578856434,A017120,고구마,[새우몰] 혼합야채 볶음밥용 1kg 한알한알 IQF 급속냉동,3900,3900,0
2018-06-01,1485706178,C012040,여자학생복,더블스트랩슬리브리스 티셔츠/ 화이트폭스,12000,10080,-1920
2018-06-01,958662316,A018030,껌,[롯데]롯데 자일리톨 아이스 리필 (90G+25G),4000,4000,0
2018-06-01,702868225,A011040,보리쌀,흰강낭콩 (2KG/4KG) 볶은 가루 분말 화이트키드니빈,10000,9900,-100
2018-06-01,1898875313,C021040,실내화,[나이키/아디다스]키즈 피코 신학기 유아 아동 운동화,24900,21920,-2980
2018-06-01,1637643061,A019140,이유식,루솔 프리미엄 이유식 골고루 10팩,25900,25900,0
2018-06-01,472264467,I053010,공책,근영사)아이디얼 양장노트(라인 그린) 심플노트 미니,8700,8700,0
2018-06-01,1241812706,C013050,운동복,F1-WJK007 우븐 자켓(YE) 트레이닝자켓 남자점퍼 남성,56750,56750,0
2018-06-01,1778592536,L021010,손목시계,[바보사랑][공식  백화점AS가능]HARPER 여성시계(메탈)_W0730L3,218000,218000,0
2018-06-01,309521695,C012060,여자내의,로사W 찰랑팬츠 3종,59000,58000,-1000
2018-06-01,78736547,E051020,건전지,티웨이 USB충전용건전지 AA/AAA 듀얼충전 케이블_MS,19500,18330,-1170
2018-06-01,1778592562,L021010,손목시계,[바보사랑][공식  백화점AS가능]첼시 여성시계(가죽)_W0648L22,158000,158000,0
2018-06-01,1811064550,E031010,전기밥솥,CRP-R0610FC 쿠쿠 전기압력밥솥 6인용/음성/GH/,222800,207120,-15680
2018-06-01,1805522515,L021020,장신구,[바보사랑][N+B+A] [실버] 프리즈 스네이크 볼 세트,68000,68000,0
2018-06-01,1778592561,L021010,손목시계,[바보사랑][공식  백화점AS가능]피너클 남성시계(가죽)_W0673G4,278000,278000,0
2018-06-01,1778592560,L021010,손목시계,[바보사랑][공식  백화점AS가능]EYELET 여성시계(메탈 가죽)_W0712L2,328000,328000,0
2018-06-01,1778592567,L021010,손목시계,[바보사랑][공식  백화점AS가능]GRAMERCY 남성시계(가죽)_W0642L2,198000,198000,0
2018-06-01,1732281810,C012040,여자학생복,[패션플러스][H스타일]H스타일(GP)구름니트티여성니트티셔츠반목폴라티크롭니트스웨터,43900,39510,-4390
2018-06-01,1778592566,L021010,손목시계,[바보사랑][공식  백화점AS가능]GRAMERCY 남성시계(가죽)_W0642L3,208000,208000,0
2018-06-01,1778592565,L021010,손목시계,[바보사랑][공식  백화점AS가능]첼시 여성시계(메탈)_W0647L4,278000,278000,0
2018-06-01,1778592564,L021010,손목시계,[바보사랑][공식  백화점AS가능]첼시 여성시계(가죽)_W0648L20,138000,138000,0
2018-06-01,1212947083,C012040,여자학생복,[하프클럽/샤틴]YK 상하세트실내복 Y182C511,119000,113050,-5950
2018-06-01,1955160590,C011050,남자내의,구김없는밴딩바지/린넨바지/여름보카시/빅사이즈바지,17900,17900,0
2018-06-01,2026772294,C012040,여자학생복,[로렌즈앤]로렌즈앤 린넨로브롱가디건,32800,29520,-3280
2018-06-01,483421503,C012040,여자학생복,모달 라인 티셔츠 (J11PTT085)/ 매그제이(MAGJAY),15000,13500,-1500
2018-06-01,1483405309,E031040,전기레인지,미니바 자판기냉장고.무소음 냉장고 메가텍냉장고 자,679210,679210,0
2018-06-01,1833990206,C015020,모자,스냅백/힙합모자/야구/MLB/클럽/남자/커플/여성/볼캡,9800,9800,0
2018-06-01,770861892,A018070,파이,오리온 초코파이 1170gx6(180봉)/ 과자/간식,46900,46900,0
2018-06-01,2026772289,C012040,여자학생복,[로렌즈앤]로렌즈앤 아마존로브가디건,22800,19380,-3420
2018-06-01,208857147,C012060,여자내의,SG 301 베이직면스판3부핫팬츠 면바지 여성반바지 3부,30460,24680,-5780
2018-06-01,1103418886,C013010,점퍼,랜더스 남여공용 노르딕 헤비 패딩자켓 (JK850W ) 블,81140,72220,-8920
2018-06-01,1805522510,L021020,장신구,[바보사랑][실버] 레타 진주 목걸이,22000,22000,0
2018-06-01,1805522513,L021020,장신구,[바보사랑][E+N] 탄생화 그리고 탄생석 세트,18000,18000,0
2018-06-01,1010313958,L021050,우산,평창붙이는핫팩5입,4000,2000,-2000
2018-06-01,922779963,E031110,청소기,블랙앤데커 최고급풀셋 미세먼지스팀청소기FSMH1621CC,169000,157170,-11830
2018-06-01,1805522514,L021020,장신구,[바보사랑]탄생화 그리고 탄생석 귀걸이,7500,7500,0
2018-06-01,329809579,E031070,에어컨,국내유일/레펠 360도회전 90도각도 대형선풍기/16인치,119000,116000,-3000
2018-06-01,1805522511,L021020,장신구,[바보사랑]엘라이 큐빅 귀걸이,12000,12000,0
2018-06-01,1805522512,L021010,손목시계,[바보사랑]로만 에이치 시계,32000,32000,0
2018-06-01,1717171195,C021040,실내화,[American Eagle][여성] 매듭 슬립온 스니커즈 AFMS1KS3918A 130(센텀시티점),31920,29430,-2490
2018-06-01,1805522506,L021020,장신구,[바보사랑]언발 키이라 롱 귀걸이,6000,6000,0
2018-06-01,688310836,C011050,남자내의,(남자옷도매) DP-249 린넨마 ST팬츠 (S-XL) 연소라 밴,31830,31830,0
2018-06-01,1805522507,L021020,장신구,[바보사랑]메릴 플라워 귀걸이,7000,7000,0
2018-06-01,2119403159,A012010,국산쇠고기,[무항생제] 우족 1.5kg 1+등급,41500,41500,0
2018-06-01,1805522508,L021020,장신구,[바보사랑][은침] 테네리페 진주 귀걸이,10500,10500,0
2018-06-01,1727088067,C011030,남자학생복,아디다스패딩 RPSTP DOWN VEST 다운 베스트 조끼,149000,111750,-37250
2018-06-01,1805522509,L021020,장신구,[바보사랑][은침] 스피라레 큐빅 귀걸이,10000,10000,0
2018-06-01,489544239,A018030,껌,껌 모음전 자일리톨/후라보노/아이스브레이커스/왓따,1890,1890,0
2018-06-01,1061973899,L021010,손목시계,CASIO 카시오 LTP-1094Q-9ARDF여성 가죽밴드 패션시계,36000,36000,0
2018-06-01,1499571162,C012040,여자학생복,[대구백화점 I관] [나이스클랍]라운드블라우스(N182MSC049),127000,107950,-19050
2018-06-01,1319795763,E061060,살충제,쥐파크P1 끈끈이 20매입 - 쥐약 바퀴벌레 파리 개미,21420,21420,0
2018-06-01,1122503472,C013010,점퍼,{G2_18S0252}여아핫면바지/ 소이,7900,7430,-470
2018-06-01,1386658503,C012040,여자학생복,빅사이즈 DHG1411 배색 7부 ST 남방 803S 남방 여성용,59640,59640,0
2018-06-01,1537283305,A017170,풋고추,아삭아삭 싱싱한 취청오이 5kg/10kg (실속형/특품형),18900,18900,0
2018-06-01,1778592559,L021010,손목시계,[바보사랑][공식  백화점AS가능]HARPER 여성시계(메탈)_W0730L1,188000,188000,0
2018-06-01,1331231507,A022040,기능성음료,포카리스웨트 분말 74gx10팩+물병(증정),13510,12700,-810
2018-06-01,1778592558,L021010,손목시계,[바보사랑][공식  백화점AS가능]HARPER 여성시계(메탈)_W0730L2,198000,198000,0
2018-06-01,1999137007,E061020,섬유유연제,(FC 베이비전용 섬유유연제 bottle) 아동세탁세제 아,19950,19950,0
2018-06-01,1122503475,C013040,청바지,{G2_18S0234}남아노멀7부데님/ 소이,7900,7430,-470
2018-06-01,1595019438,C011050,남자내의,[폴햄] 남성 슬림핏 사이드밴딩 스판슬랙스 팬츠(PHY2PP1032),49900,40420,-9480
2018-06-01,1231284773,C012060,여자내의,컨택유 뒷트임 데님 스커트 #5905/ 컨택유,19500,15410,-4090
2018-06-01,635763824,C013020,티셔츠,반폴라 스튜디오 티셔츠 공용폴라티 긴팔폴라티 어린,10510,10510,0
2018-06-01,1805522539,L021020,장신구,[바보사랑][실버] 테나 반지,12000,12000,0
2018-06-01,1805522537,L021020,장신구,[바보사랑][N+E+R] [실버] 테나 세트,42000,42000,0
2018-06-01,1805522538,L021020,장신구,[바보사랑][실버] 테나 목걸이,15000,15000,0
2018-06-01,1778592589,L021010,손목시계,[바보사랑][공식  백화점AS가능]레티투드 남성시계(메탈)_W0639L2,298000,298000,0
2018-06-01,1575487502,I031040,생화,인스타/7발/5발 /8400루멘 /L2 /등산/헤드랜턴/풀셋,56900,50900,-6000
2018-06-01,645111089,C015030,넥타이,고급 실크 선염 넥타이/일반폭 슬림폭 무료배송,17900,17900,0
2018-06-01,895593017,C012060,여자내의,패션 기모청레깅스/여자기모레깅스/여자레깅스/레깅스바지/여자쫄바지/여성쫄바지/여자,5670,5670,0
2018-06-01,8232777,C013040,청바지,빈티지/구제진 청바지 여름 신상 빅사이즈 허밍퍼플,14000,12800,-1200
2018-06-01,1287077156,A019030,생강,[진도농협] 울금/울금환/강황가루 500g/1kg,22900,22900,0
2018-06-01,498681101,A012060,햄및베이컨,(냉동)SFOOD후레쉬베이컨 1kgX5개SFOOD 안주 후레쉬,160900,131940,-28960
2018-06-01,1274173292,C012060,여자내의,[데이텀]면 슬럽 3부 반바지 DATS18602,19900,19900,0
2018-06-01,1843582414,C013010,점퍼,가죽점퍼 레쟈점퍼 라이더자켓 PU15 WS/레쟈가죽자켓,112200,112200,0
2018-06-01,2065941258,C021040,실내화,최신상패션 운동화 신발 스니커즈 런닝화 남성 여성,14800,14800,0
2018-06-01,751542913,A021010,커피,동서식품 맥심 아이스블랙커피믹스 110T(100T+10T),10900,10900,0
2018-06-01,321845394,C013020,티셔츠,DWW0035A 소프트 브이넥 긴팔 804 티셔츠 패션티셔츠,13890,13890,0
2018-06-01,1843582411,C013010,점퍼,가죽점퍼 레쟈점퍼 라이더자켓 PU16 WS/레쟈가죽자켓,112200,112200,0
2018-06-01,408147191,C012040,여자학생복,[스타일베리][오가게/스타일베리]뉴벨와이드팬츠니트세트,35800,35800,0
2018-06-01,1122216926,C015040,장갑,애니멀 변신 벙어리 장갑 벙어리장갑 장갑 방한용장갑,12640,12640,0
2018-06-01,2002561560,D031010,주택수선재료,꼼지락단품디자인벽지gm-002(그레이)_1폭_100cmx240cm 풀바른水실크벽지 인테리어소품,90400,89300,-1100
2018-06-01,938468228,C013020,티셔츠,나나살롱 여름신상 원피스/린넨/반팔/청바지/치마바지,21000,21000,0
2018-06-01,1321433084,A017020,상추,싱싱여름적치마상추씨앗 3g,2000,2000,0
2018-06-01,226577715,D031010,주택수선재료,[던에드워드]덤프록 약4L- 방수 및 곰팡이방지 페인트,89000,81880,-7120
2018-06-01,625676569,L012040,치약,풀라무 EM치약 세트/시린이 안전한치약 천연이엠 샴푸,17950,17950,0
2018-06-01,1516390275,C014020,유아복,한국생산 원숭이 친구들 수면바지(5-11호) 202352,17940,17940,0
2018-06-01,1608376727,L021020,장신구,실버체인)샤프 스틱 목걸이 20대 30대 여자 여성 예쁜,17760,17760,0
2018-06-01,1644204122,F012010,종이기저귀,[+오가닉마스크]보솜이 디오가닉 밴드/팬티기저귀 4팩,44900,44900,0
2018-06-01,1637466978,C012040,여자학생복,[808 고급 보풀제거기/먼지테이프/홈스다리미] 겨울철 보풀걱정끝 집들이선물 니트스웨,8900,8900,0
2018-06-01,1678964048,C021040,실내화,알탠토 키높이운동화 에어스니커즈 7cm,27300,27300,0
2018-06-01,1811076543,A017120,고구마,2018년 햇감자 속노란 홍감자 자색감자 알감자 2kg,12000,12000,0
2018-06-01,886863023,E041010,식기,한국도자기 칠첩반상기 / 생활반상기 무료예단포장,240000,240000,0
2018-06-01,172641920,A012060,햄및베이컨,[오쿡] 그릴 닭가슴살 스테이크 [T601],14900,14240,-660
2018-06-01,1010313924,A018100,꿀,꿀모닝 12G*15T,3990,3990,0
2018-06-01,689876857,L021030,가방,독일 리바케이스8060/17.3인치 노트북가방/노트북백팩,39000,38220,-780
2018-06-01,554994783,L012010,면도기,도루코 양날면도날 100개입 /ST-300/안전면도날,9900,9900,0
2018-06-01,1010313926,A019090,카레,CJ 고메로제치킨 180G,4990,3490,-1500
2018-06-01,771149618,A017280,김,세천팜 슬라이스/반달/온달/양식/김밥 단무지 2.8kg,4900,4810,-90
2018-06-01,747772827,A018090,잼,오뚜기 일회용소스/딸기잼 케찹 버터후레시 머스타드,5900,5900,0
2018-06-01,191231059,E031030,전자레인지,대우전자 20L 전자레인지/전자렌지 KR-L202COP,67260,63900,-3360
2018-06-01,1977005395,I053030,복사용지,직배송 더블에이 복사용지 A4용지 80g 4000매(2박스),47810,41600,-6210
2018-06-01,923174761,A018070,파이,[롯데제과]몽쉘3종/초코파이/찰떡파이*4개,10200,10200,0
2018-06-01,1312653965,L021020,장신구,초커목걸이 체인초커 가죽초커 레이스초커 초커 꽃초,18600,18600,0
2018-06-01,2094768491,E031130,보온매트,TV홈쇼핑정품(주)일월매트[명품]청맥 온돌마루 카페트매트 울트라형/고급형/미끄럼방,258000,255420,-2580
2018-06-01,415876983,C013010,점퍼,바람막이 야상 WS-YSM21 바람막이 야상 점퍼 남자야상,82430,80790,-1640
2018-06-01,402761891,C011030,남자학생복,MJ-1157 시보리 패딩 조끼 / 겨울,25000,25000,0
2018-06-01,471990452,A017050,미나리,영양만점/방울양배추/500g/1kg/미니양배추/꼬마/,7000,7000,0
2018-06-01,1098802960,I012060,저장장치,NEW 오토 무한반복 자동클릭마우스 좌우 프리미엄 광,32000,32000,0
2018-06-01,632898863,A011170,떡,전북고창 울어매 모시잎송편 75개(25개 3팩) / 삼경복,66000,58080,-7920
2018-06-01,981775359,A013140,북어채,프라임L 대관령을 머금은 북어채 (120G),8990,8990,0
2018-06-01,2123106716,A017090,열무,[익산원예농협] 붉은속살 뿌리채소  비트 10kg,46900,45310,-1590
2018-06-01,992751102,I031040,생화,L2-001 CREE L2 T6 피티타임 LED후레쉬 랜턴 손전등,14000,11280,-2720
2018-06-01,1483869871,C013020,티셔츠,[GGPX][18 여름]LICHT 스팽글 7부 티셔츠(GIB4TS704F)[갤러리아],49000,39200,-9800
2018-06-01,1778592594,L021010,손목시계,[바보사랑][공식  백화점AS가능]PERRY 남녀공용시계(메탈)_W0623L4,298000,298000,0
2018-06-01,1778592593,L021010,손목시계,[바보사랑][공식  백화점AS가능]SERPENTINE 남녀공용시계(메탈)_W0624L2,298000,298000,0
2018-06-01,1701646014,A018100,꿀,100%스페인 벌화분 비폴렌 2병 프로폴리스 꿀벌 건조,46000,46000,0
2018-06-01,1778592598,L021010,손목시계,[바보사랑][공식  백화점AS가능]TEMPTRESS 여성시계(가죽)_W0455L3,198000,198000,0
2018-06-01,1510291565,C012040,여자학생복,[시슬리]하트프린트 배색 니트티(SAKP04411아이보리),33800,32110,-1690
2018-06-01,1778592592,L021010,손목시계,[바보사랑][공식  백화점AS가능]MINI MYSTICAL 여성시계(가죽)_W0626L2,188000,188000,0
2018-06-01,1778592591,L021010,손목시계,[바보사랑][공식  백화점AS가능]소호 여성시계(메탈)_W0638L3,328000,328000,0
2018-06-01,570283634,A017020,상추,당일수확 친환경 쌈채소 600g,9900,9900,0
2018-06-01,1778592590,L021010,손목시계,[바보사랑][공식  백화점AS가능]소호 여성시계(메탈)_W0638L6,328000,328000,0
2018-06-01,1215621376,C011030,남자학생복,빅사이즈 남자/남성의류/남방/셔츠/티셔츠/모음,29800,29800,0
2018-06-01,275753318,I011030,사진기,[명품]캐논 PowerShot G1X Mark III+8GB+보호필름,1064700,979440,-85260
2018-06-01,721996430,L021020,장신구,티타늄 코 피어싱 / 티타늄 코찌 / 티타늄 노즈링,4500,4500,0
2018-06-01,322763197,E031080,선풍기,#TV홈쇼핑정품#벽걸이히터/난방기/온풍히터/겨울난방/세라믹히터/LED/라디에이터/신일,128000,126720,-1280
2018-06-01,166917515,C015020,모자,1+1 남여공용 무지 볼캡 야구모자 캡모자 스냅백 군모,4900,4900,0
2018-06-01,915996163,E041010,식기,금수저 은수저 티타늄 수저세트 답례품/기념품/선물,34000,31190,-2810
2018-06-01,1036262222,E011030,거실장,[PookShuim] 푹쉼 켈트 천연가죽 전동 리클라이너 6인소파 컵홀더포함,2408000,2408000,0
2018-06-01,1036262223,E011030,거실장,[PookShuim] 푹쉼 켈트 천연가죽 전동 리클라이너 1 4인소파세트 컵홀더포함,2792000,2792000,0
2018-06-01,1036262220,E011030,거실장,[PookShuim] 푹쉼 켈트 천연가죽 전동 리클라이너 1 6인소파세트 컵홀더포함,3214000,3214000,0
2018-06-01,1036262221,E011030,거실장,[PookShuim] 푹쉼 켈트 천연가죽 전동 리클라이너 1 6인소파세트,3020000,3020000,0
2018-06-01,1036262226,E011030,거실장,[PookShuim] 푹쉼 켈트 천연가죽 전동 리클라이너 1 4인소파세트,2598000,2598000,0
2018-06-01,1805522542,L021020,장신구,[바보사랑][실버] 프리즈 스네이크 볼 발찌,20000,20000,0
2018-06-01,1036262227,E011030,거실장,[PookShuim] 푹쉼 켈트 천연가죽 전동 리클라이너 4인소파,1792000,1792000,0
2018-06-01,1805522543,L021020,장신구,[바보사랑][실버] 프리즈 스네이크 볼 팔찌,18000,18000,0
2018-06-01,1036262224,E011030,거실장,[PookShuim] 푹쉼 켈트 천연가죽 전동 리클라이너 6인소파,2214000,2214000,0
2018-06-01,1805522540,L021020,장신구,[바보사랑][실버] 빈스 반지,9000,9000,0
2018-06-01,1036262225,E011030,거실장,[PookShuim] 푹쉼 켈트 천연가죽 전동 리클라이너 4인소파 컵홀더포함,1986000,1986000,0
2018-06-01,1805522541,L021020,장신구,[바보사랑]나오미 롱 귀걸이,8000,8000,0
2018-06-01,1805522546,L021020,장신구,[바보사랑][실버] 지니퍼 반지,11000,11000,0
2018-06-01,1756785125,C015040,장갑,등산 장갑 터치 자전거 반장갑 낚시 스포츠 여름 기모,7200,6630,-570
2018-06-01,613939991,E021010,침구,국내산유아 방수패드/방수요/방수커버/아동 패드,9800,9020,-780
2018-06-01,1805522544,L021020,장신구,[바보사랑]티노 플라워 귀걸이,11000,11000,0
2018-06-01,1805522545,L021020,장신구,[바보사랑][은침] 리지 큐빅 롱 귀걸이,14000,14000,0
2018-06-01,1052051104,A011170,떡,떡보의 하루 떡케익 영양떡 인절미찰떡 세트,29900,29900,0
2018-06-01,1241631402,C021040,실내화,[아디다스][UNISEX RUNNING] 이큅먼트 10 (DA9375)(마산점),65000,53730,-11270
2018-06-01,895835947,L012030,칫솔,[LG]페리오 키즈칫솔 1단계 (2입),5990,5990,0
2018-06-01,895835948,L012030,칫솔,[LG]LG 페리오 키즈칫솔 2단계 (2입),5990,5990,0
2018-06-01,1036262251,E011030,거실장,[PookShuim] 푹쉼 켈트 천연가죽 전동 리클라이너 3인소파 컵홀더포함,1584000,1584000,0
2018-06-01,1036262252,E011030,거실장,[PookShuim] 푹쉼 켈트 천연가죽 전동 리클라이너 3인소파,1390000,1390000,0
2018-06-01,1022804131,E011020,침대,(매장동일)금성침대 모션센서 LED 퀸침대+매트리스,509400,509400,0
2018-06-01,1036262250,E011030,거실장,[PookShuim] 푹쉼 켈트 천연가죽 전동 리클라이너 1 3인소파세트,2196000,2196000,0
2018-06-01,1805522572,L021020,장신구,[바보사랑]샤라 진주 체인 귀걸이,6000,6000,0
2018-06-01,483968920,C013030,스웨터,밀란시아 빅사이즈 엑스 니트폴라 mir12-1 빅사이즈,56360,55240,-1120
2018-06-01,1036262253,E011030,거실장,[PookShuim] 푹쉼 켈트 천연가죽 전동 리클라이너 1인소파,806000,806000,0
2018-06-01,1805522570,L021020,장신구,[바보사랑]줄스 귀걸이,10000,10000,0
2018-06-01,362067020,C012040,여자학생복,오픈루즈털조끼 IR1712 베스트 털조끼 여성베스트 토,113120,113120,0
2018-06-01,1805522575,L021020,장신구,[바보사랑][은침] 레오르 리본 귀걸이,10000,10000,0
2018-06-01,2064895406,C012060,여자내의,SK1620-산드로 패턴 랩 스커트 FREE(44~66) 스트랩치,45190,45190,0
2018-06-01,1805522576,L021020,장신구,[바보사랑][은침] 보떼 진주 롱 귀걸이,10000,10000,0
2018-06-01,1010142001,F011150,건강기능식품,[올즙] 올바른 깔라만시 원액 1000ml x 2개,40000,14800,-25200
2018-06-01,1805522573,L021020,장신구,[바보사랑][은침] 쉘리 큐빅 귀걸이,9000,9000,0
2018-06-01,109856343,A013090,전복,국내산 새꼬막 1.5kg (상) 새벽조업후 발송 산지,30060,30060,0
2018-06-01,1805522574,L021010,손목시계,[바보사랑]아티 스퀘어 시계,32000,32000,0
2018-06-01,1805522577,L021020,장신구,[바보사랑]클레멘 큐빅 팔찌,12000,12000,0
2018-06-01,314578493,C013040,청바지,JMM9973 기획기본블랙남자스판청바지-빅사이즈까지 남,25830,25830,0
2018-06-01,918858003,L021020,장신구,[바보사랑][MBC 결혼계약 협찬] [3개1세트] 더퍼스트 큐빅 반지,20000,20000,0
2018-06-01,1071068260,C011050,남자내의,여름 남자 반바지/청/5부/7부/면/스판/카고/밴딩/린넨,15700,15700,0
2018-06-01,676793342,C021010,아동화,[해피키즈]라이팅 발광 LED USB충전 아동운동화캐릭터,24900,24900,0
2018-06-01,621369807,E011050,책상,1~6인용 키높이 액자테이블 좌식책상 밥상 이반가구01,19000,18800,-200
2018-06-01,1190380279,C012040,여자학생복,[스타일온미]시원한 시스루 스트라이프 블라우스,37400,33660,-3740
2018-06-01,906610410,C013010,점퍼,[TI FOR MEN] 티아이포맨 면100 패턴 자켓 M146MJK229M1NV5,25100,23260,-1840
2018-06-01,983474315,L012040,치약,[LG]페리오 46CM 롱래스팅 쿨민트 100G*3,7990,3990,-4000
2018-06-01,983474314,L012040,치약,[LG]페리오 46CM 굿스멜링 민트 100G*3,7990,3990,-4000
2018-06-01,983474313,L012040,치약,[아모레퍼시픽]메디안치석케어치약맥스120G*3입,9990,4450,-5540
2018-06-01,1337486190,I031070,애완동물관리비,3UP - 스트링업퍼 스프레이 150ml/스트링 자동정렬,13000,11510,-1490
2018-06-01,1843582446,C013010,점퍼,가죽점퍼 레쟈점퍼 라이더자켓 PU16 WS/레쟈가죽자켓,112200,112200,0
2018-06-01,1483405305,E031080,선풍기,(MIDFUJIKA 공기청정 온풍기히터 FU-408(3.5kw) 전기,619650,619650,0
2018-06-01,246418053,C012060,여자내의,헤리엇 체크남방 치마레깅스 SD-3772 치마레깅스 반바지레깅스 레깅스 면레깅스 기본레,18860,16790,-2070
2018-06-01,1346023366,E041050,냄비,(키친아트 줄리엣 세라믹 냄비 3종세트)냄비세트,34000,31900,-2100
2018-06-01,1036262249,E011030,거실장,[PookShuim] 푹쉼 켈트 천연가죽 전동 리클라이너 1 3인소파세트 컵홀더포함,2390000,2390000,0
2018-06-01,1258579960,A018080,설탕,브라질산 고이아사유기농설탕 5kg,14900,14900,0
2018-06-01,545776436,C012030,여자상의,지홍 여름신상 원피스66~빅사이즈 루즈핏 롱 린넨쉬폰,34900,34900,0
2018-06-01,545850952,C013020,티셔츠,AAA 트리플에이 무지반팔티_1301(44칼라) 오버핏반팔,5000,5000,0
2018-06-01,1366921706,E011040,소파,마리나홈/아이와비 수납형 소파베드  단독특가,199000,199000,0
2018-06-01,1538414586,C012060,여자내의,[게스]여성 L톤 스커트(OI2D7551),46400,39440,-6960
2018-06-01,1190619528,E031080,선풍기,이스페션 석영관 히터 스토브/PTC 세라믹 온풍기/난로,49200,15200,-34000
2018-06-01,1805522568,L021020,장신구,[바보사랑][은침] 피키 트라이앵글 귀걸이,14000,14000,0
2018-06-01,1805522569,L021020,장신구,[바보사랑][은침] 쉐이브 귀걸이,9000,9000,0
2018-06-01,364131852,I031040,생화,스텐레스 스포츠물병 텀블러 물통 수통 사은품 투반,3800,3800,0
2018-06-01,1321134166,E031130,보온매트,2018년형 한솔 참사랑 초절전 전기매트/전기장판,69640,69640,0
2018-06-01,983474223,L012040,치약,[아모레퍼시픽]메디안 치석케어 치약 오리지널 120G*3입,9990,4450,-5540
2018-06-01,983474222,A019150,김치,하선정 맛김치 1KG,9800,9800,0
2018-06-01,1240801734,C013020,티셔츠,아스토레 골프 반지퍼티셔츠 NA LSTM10015 골프긴팔,70920,70920,0
2018-06-01,396372109,E061060,살충제,유한양행 해피홈 에어졸x3개 에어넷 롤온 모기향,6900,6900,0
2018-06-01,983449260,A013050,오징어,[3+3 특별기획] 이동삼 안동간고등어 6마리+6마리 더! 총 12마리/6손-손당 330g,21900,18900,-3000
2018-06-01,1010203599,F011130,홍삼,정관장 홍삼원 50ml x 30포/쇼핑백 증정,45000,25900,-19100
2018-06-01,320305590,C013010,점퍼,CN054-플랩포켓 후드 퍼 코트 겨울후드퍼코트 모자털,47120,44770,-2350
2018-06-01,1939209905,E061020,섬유유연제,F C 베이비전용 섬유유연제 bottle 아기옷빨래 아동세,21300,21300,0
2018-06-01,1530562536,C012020,원피스,MELODY F1 아이보리/코트/여자코트/겨울코디/겨울코트/자켓/점퍼 미국 여성토탈브랜드,69700,69700,0
2018-06-01,1342617558,E061020,섬유유연제,다우니700ml리필x2/1L용기/퍼퓸/고농축 섬유유연제,9900,9900,0
2018-06-01,951057199,E011030,거실장,베일리쇼파,143900,143900,0
2018-06-01,895859815,A013160,맛살,CJ 안심크랩 (144G*2입),3990,3990,0
2018-06-01,719859200,C012020,원피스,[시슬리]더블 클래식 벨티드 롱코트(SACTA2411베이지),87600,83220,-4380
2018-06-01,1936697872,A017230,마늘,건강한 보랏빛 자색양파 5kg/10kg(특품),8900,8900,0
2018-06-01,1843582357,C013010,점퍼,가죽점퍼 레쟈점퍼 라이더자켓 PU17 WS/레쟈가죽자켓,112200,112200,0
2018-06-01,839746942,C013040,청바지,여름신상 날씬 블랙진 청바지 강제 보정 스키니 핏,23800,23800,0
2018-06-01,520016673,C013010,점퍼,[시에로]7부소매 등 자수 PRINT 홑겹JP(SD3JPF159),149400,122510,-26890
2018-06-01,1429786798,I031040,생화,쿨러스탠드 2개1세트 캠핑/사이드/미니/접이식/스텐드,33900,30350,-3550
2018-06-01,1843582352,C013010,점퍼,가죽점퍼 레쟈점퍼 라이더자켓 PU12 WS/레쟈가죽자켓,122400,122400,0
2018-06-01,1330657554,C011030,남자학생복,그린 멀티 체크 뱀부(BAMBOO) 반소매 셔츠/ 코디갤러리 바이 에스티코,9900,9210,-690
2018-06-01,1692098452,E041070,밀폐용기,키친아트 아트락 /국산/반찬통/김치통/스텐락/밀폐용,9900,4510,-5390
2018-06-01,1805522599,L021020,장신구,[바보사랑]안소니 큐빅 귀걸이,10000,10000,0
2018-06-01,574903669,A019180,즉석식품,CJ 비비고 국/탕/찌개 14종,990,990,0
2018-06-01,988214952,A011120,두부,[농심]켈로그 오곡첵스 쿠키앤크림 590G,8350,8350,0
2018-06-01,1942032567,A019180,즉석식품,(신송/즉석국/16종)x50인분/즉석식품/즉석밥/된장국,15000,13900,-1100
2018-06-01,1134109826,C013020,티셔츠,Special Line 헤지스레이디스 HSSH7B771C2 타탄 체크 반팔 캐주얼 셔츠,83400,65060,-18340
2018-06-01,895798469,A015020,식용유,[해표]해표 식용유 900ml,4590,4590,0
2018-06-01,895798468,A015020,식용유,[해표]해표 식용유 (500ML),2700,2700,0
2018-06-01,375429009,A013090,전복,키조개 관자 선물세트(1.7kg내외/급냉)/산지직송,68000,65000,-3000
2018-06-01,895798467,A015020,식용유,[해표]해표 식용유 1.8L,7100,7100,0
2018-06-01,1843582349,C013010,점퍼,가죽점퍼 레쟈점퍼 라이더자켓 PU17 WS/레쟈가죽자켓,112200,112200,0
2018-06-01,2135257364,C013050,운동복,가정용소화기 아이스화이어330,33580,30230,-3350
2018-06-01,1288908848,C013040,청바지,[컨셉원] 118103 TR 히든밴딩 슬림핏 스트레치 슬랙스 10118103,40000,32800,-7200
2018-06-01,1021242873,C013020,티셔츠,30%쿠폰! 레코브 백화점 단독 상품추가업뎃! ~85%,8900,8900,0
2018-06-01,294075404,C012040,여자학생복,[코코애비뉴]소매배색롱가디건_80504,49500,45310,-4190
2018-06-01,990060854,A011010,쌀,Lgrow 오대미 5KG/포,19900,15900,-4000
2018-06-01,1860895440,A022020,두유,매일유업 아몬드브리즈 오리지널 190ml 24팩,14900,14900,0
2018-06-01,1056122951,C014020,유아복,아둘 유아 여름 반팔티 랍빠 핫팬츠 미키 상하세트 12,19100,19100,0
2018-06-01,599271507,A013130,오징어채,국내가공 명엽채 200g+200g / 진미채 오징어채 건어물,5900,5900,0
2018-06-01,437709707,C011050,남자내의,슬림핏 카고팬츠 일자면팬츠 남자세미 위장지 절개 카르고 카고면바지 국산스판 얼룩,24700,24700,0
2018-06-01,1088025005,L012030,칫솔,(크리오 미세모 어린이칫솔 12개)유아칫솔/아기/아동,9900,9900,0
2018-06-01,827633414,C011050,남자내의,아로미 925 편하고 착용감 좋은 고급패턴 9부남파자마,16060,14300,-1760
2018-06-01,988897172,A018100,꿀,[백화농원] 스위트 허니 국내산 벌꿀 2.4kg+2.4kg,49900,36200,-13700
2018-06-01,951057173,E011030,거실장,숙면매트리스,69900,69900,0
2018-06-01,951057176,E011030,거실장,패브릭데이브쇼파,209900,209900,0
2018-06-01,895798438,A019040,소금,[해표]해표 꽃소금 1kg,1500,1500,0
2018-06-01,1326572462,L021020,장신구,로즈골드 커팅실반지 세트 실버925 레이어드순은반지,4900,4900,0
2018-06-01,951057177,E011030,거실장,인조가죽데이브쇼파,199900,199900,0
2018-06-01,1367805348,A017220,양파,꼬레촌조미 파(깐쪽파)최상품 1kg x 10단,62500,62500,0
2018-06-01,1772141012,E031030,전자레인지,[SK매직] 고급형 20L 버튼식 전자렌지 MWO-20EC7,77550,72900,-4650
2018-06-01,1131389229,C012060,여자내의,[제시뉴욕]무릎찢어진스키니바지_J755NSDP6581,96600,96600,0
2018-06-01,1206482158,L021020,장신구,은토우링 은반지 실버토우링 발가락반지 발가락찌,8000,8000,0
2018-06-01,845870477,C012040,여자학생복,핏좋은 롱셔츠/베이직무지남방/흰남방/체크/데님,23800,23800,0
2018-06-01,1077529235,E041050,냄비,독일 가이타이너 냄비 3종세트/곰솥/전골,48900,48900,0
2018-06-01,1843582379,C013010,점퍼,가죽점퍼 레쟈점퍼 라이더자켓 PU14 WS/레쟈가죽자켓,112200,112200,0
2018-06-01,1876621221,A015020,식용유,백설 압착올리브유 900ml,6420,6420,0
2018-06-01,951057171,E011030,거실장,제이드쇼파,83900,83900,0
2018-06-01,839671147,A016030,복숭아,[국내산]씨없는포도 델라웨어 2kg 8-12송이,52800,51000,-1800
2018-06-01,1865417851,C012040,여자학생복,[린]스트라이프 소매 셔링 블라우스[LGBLIE9800],109000,101370,-7630
2018-06-01,135700762,C012040,여자학생복,[포에버21]텍스쳐 돌먼 로브 가디건/FOREVER21/가디건/쉬폰 가디건,22900,13740,-9160
2018-06-01,1619531132,C012040,여자학생복,올포유 반폴라 니트/여성 M/울혼방/골프/중고/구제,17900,17900,0
2018-06-01,762951735,A019060,된장,[삼화식품] 삼화 콩된장 3kg [무료배송],11900,11900,0
2018-06-01,895835858,A022050,탄산음료,코카 콜라제로 500ML,1850,1200,-650
2018-06-01,627946232,L021020,장신구,원석sale/쿼츠/quartz/22.35ct,25000,25000,0
2018-06-01,423497561,A011100,라면,국수(소면 청수 포 1.5K)X10,73330,73330,0
2018-06-01,408186807,C012040,여자학생복,수지네 일본 구제 연청 데님 조끼 여성 M 20-42,14060,14060,0
2018-06-01,716902783,A022010,주스,자연은 알로에 500ml 20개알로에음료 알로에주스 알로,32370,32370,0
2018-06-01,2083174473,C013010,점퍼,스테판조셉 프린티드 레인코트 프린세스A (택1) /(참,86800,76390,-10410
2018-06-01,1740225910,C012060,여자내의,청치마 머메이드롱스커트 플레어 미디 데님 빅사이즈,47300,47300,0
2018-06-01,895798440,A019040,소금,[해표]해표 꽃소금 500g,850,850,0
2018-06-01,184133834,L012060,샴푸,[아로마티카] 유기농 로즈힙 오일 30ml,17500,15840,-1660
2018-06-01,2090099475,A017140,콩나물,강화섬 도라지환/엑기스/건도라지/백도라지 분말/100% 강화산 도라지/강화군 산림조합,22400,22400,0
2018-06-01,1766030719,C011030,남자학생복,반팔셔츠 기본반팔셔츠 반팔와이셔츠 남성반팔와이셔,19600,19600,0
2018-06-01,349997218,I031040,생화,베스트웨이 퀸 킹 더블 사이즈 캠핑매트 매트리스,27900,14630,-13270
2018-06-01,1874224537,I011030,사진기,소니 알파 A6300 + 16-50mm 정품 명품,1195940,1195940,0
2018-06-01,93110816,E031080,선풍기,세기시스템_일반형 에어커튼/히터형 CCRH-900,569600,569600,0
2018-06-01,560157746,F011150,건강기능식품,유한 종합 멀티 비타민 영양제/남성용 여성용,20000,20000,0
2018-06-01,1211649595,E011020,침대,보니 내츄럴 평상형 원목침대프레임 슈퍼싱글/퀸,103000,98800,-4200
2018-06-01,1087887833,E041050,냄비,샤브샤브냄비 전골 오뎅탕 주물냄비 무쇠솥 무쇠냄비,25900,25900,0
2018-06-01,1092833355,C011030,남자학생복,MCD-917 빈티지 스타일 롱가디건 남자롱가디건 남성후,48730,48730,0
2018-06-01,1956655760,E021020,커튼,[스마일데코] 초콜릿암막커튼 방한 방풍 냉 난방효과,34900,34900,0
2018-06-01,1103502776,A016110,딸기,DS239/뉴뜨레 냉동딸기S 1kg 신선식품 냉동딸기 냉동,12280,11060,-1220
2018-06-01,1096643233,A013130,오징어채,국내가공 진미채 가루 1kg/ 오징어채 1kg 백파 파품,7900,7900,0
2018-06-01,2091084652,F011120,인삼,(장생농산장수산삼 8년근 3주(3뿌리) 산삼 7년근 건강,148520,144070,-4450
2018-06-01,858194767,E061020,섬유유연제,[알레]힐링스토리 섬유향수 50ml/섬유탈취제/향수섬유,3000,2500,-500
2018-06-01,1184563747,F012010,종이기저귀,독일 몰텍스 네이처 기저귀 점보박스 Junior 11~25kg,41600,41600,0
2018-06-01,1380680524,C012040,여자학생복,리스트 여름 슬릿 타이 슬리브 블라우스_TWWBLH60180/ 리스트 레드라벨,30000,24900,-5100
2018-06-01,1826222109,E011070,식탁,[장인가구]아마르 대리석 식탁세트,489000,468660,-20340
2018-06-01,93110817,E031080,선풍기,세기시스템_일반형 에어커튼/히터형 CCRH-1000,597700,597700,0
2018-06-01,919233246,C012030,여자상의,유유존-맥시롱원피스/클럽의상/섹시홀복/나시/데일리,15800,15800,0
2018-06-01,1200647127,C015040,장갑,아디다스 퍼포먼스 니트글러브(BP5348),38940,34660,-4280
2018-06-01,751395375,A022030,생수,롯데아이시스 8.0 500mlx20펫x2박스/물/생수/300mlX40,12600,12600,0
2018-06-01,2143143501,A022010,주스,웅진)자연은 포도100 180ml12개입 과채음료 포도음료,16080,16080,0
2018-06-01,1204209012,E011060,의자,젤리아의자 에펠/카페/거실/주방/식탁/인테리어/학생,21600,21600,0
2018-06-01,1887381139,C012030,여자상의,[핫핑]빅사이즈 롱원피스 무지 루즈핏 체크 패턴,32800,21800,-11000
2018-06-01,416491415,A018080,설탕,고이아사 유기농설탕 vs 미트폴 비정제원당 20~25kg,54000,54000,0
2018-06-01,284517176,C012060,여자내의,여자 와이드팬츠 KAA 1613 1개 와이드팬츠 통바지 통,18390,18390,0
2018-06-01,1389376360,A013160,맛살,(냉장)한성통통맛살H(1kg)x5개,35000,34650,-350
2018-06-01,1339861434,A021010,커피,[커피빈] 캡틴 아메리카노 미니 90T 원두커피 + 커피젤리증정,17900,17900,0
2018-06-01,416731255,C015040,장갑,[카르닉]겨울 스포츠장갑/방한장갑/보드장갑/스키장갑,12900,12900,0
2018-06-01,1493364606,C021010,아동화,[소라맘] 똑똑한특가 아동운동화 아동 여아 유아 키즈,14900,14900,0
2018-06-01,410921597,C013010,점퍼,K2 S 무스탕 5 라이더점퍼 캐슈넷 간식거리 지퍼팩캐,140720,140720,0
2018-06-01,1340849464,E031070,에어컨,[한경희생활과학] 한경희 HEF-9600 타워팬 선풍기 심플디자인,119000,119000,0
2018-06-01,2026772198,C012040,여자학생복,[로렌즈앤]로렌즈앤 쉬폰로브가디건,19800,16830,-2970
2018-06-01,1909390992,E031090,공기청정기,LG 퓨리케어 공기청정기 AS112VDS 38㎡ 청정 탈취,268200,252020,-16180
2018-06-01,329401908,L012010,면도기,쉬크 인튜이션 여성 면도기/하이드로실크/면도날,7700,7700,0
2018-06-01,1948621009,C012060,여자내의,[쉬즈미스] 펀칭 디테일 플레어 스커트,14800,13320,-1480
2018-06-01,1843582387,C013010,점퍼,가죽점퍼 레쟈점퍼 라이더자켓 PU14 WS/레쟈가죽자켓,112200,112200,0
2018-06-01,1101729284,C013020,티셔츠,30%쿠폰[디플릭]반팔티/오버핏/커플티/반팔티셔츠,9800,9800,0
2018-06-01,1843582384,C013010,점퍼,가죽점퍼 레쟈점퍼 라이더자켓 PU15 WS/레쟈가죽자켓,112200,112200,0
2018-06-01,17966077,E031070,에어컨,벽걸이 선풍기/16형 기계식 선풍기/UMF-N503W,19500,18500,-1000
2018-06-01,959374266,A015010,참기름,백설 진한참기름 350ML,8500,8500,0
2018-06-01,1360479421,C012020,원피스,[패션플러스][쉬즈넘버나인]메샤 더블 오버핏 롱코트,59000,56050,-2950
2018-06-01,856150505,E031130,보온매트,힐링시대 헬시쿨매트 플라워아이스 싱글+베개1개,45000,45000,0
2018-06-01,795088920,A018070,파이,(특가) 초코파이 12개입 10곽 몽쉘 오예스 카스타드,16590,16590,0
2018-06-01,1249752527,C012060,여자내의,리즘 주름 롱스커트 SD-9028,17310,16970,-340
2018-06-01,714951966,A011010,쌀,현미5kg/백미5kg/찹쌀/찰흑미/발효현미/보리쌀,12700,12700,0
2018-06-01,635545562,C011030,남자학생복,(배드민턴마켓) 아디다스/남성다운패딩조끼/의류,169000,160550,-8450
2018-06-01,532233622,C013020,티셔츠,쿨론/기능성/민소매/나시티/스판덱스/트레이닝/반바지,6000,5900,-100
2018-06-01,1356278345,C013020,티셔츠,빅사이즈 헨리넥7부남자긴팔면티셔츠 / 참고 남자봄신,56400,49640,-6760
2018-06-01,1391163789,A013160,맛살,올리브녹차 돌자반 70gx20개 입안에서 살살녹는 고,54630,54630,0
2018-06-01,1597093464,E061030,전구,필립스 오스람 장수 두영 삼파장전구 EL램프 형광등,32300,32300,0
2018-06-01,1041550822,E031140,비데,KN[당일설치]BD-N330T 노비타비데(판매1위비데),159000,159000,0
2018-06-01,1193832967,G011070,자전거,베리벨로 프라임레이디 24인치 26인치 여성용자전거,79000,79000,0
2018-06-01,1266605301,C011030,남자학생복,라피스 린넨셔츠 BTT0186 셔츠 여름셔츠(YA02004) 남,26160,26160,0
2018-06-01,1656832847,I012010,컴퓨터,특가71만+MS오피스증/삼성노트북3 NT300E5M-K54D i5,841050,799000,-42050
2018-06-01,1385070676,C013040,청바지,[리바이스] 1744/약29 리바이스 501 그레이진 빈티지 구제청바지,17400,17400,0
2018-06-01,1250430860,C013030,스웨터,나팔골지소매니트 CM1711,50080,44580,-5500
2018-06-01,1553923543,I031040,생화,New 코멕스 아이스탱크(팩증정)아이스박스 쿨러백보냉,18900,16830,-2070
2018-06-01,1056122922,C014020,유아복,아둘 유아 여름 반팔티 랍빠 핫팬츠 미키 상하세트 11,19100,19100,0
2018-06-01,1391427663,C013060,등산복,(단체복전문)쿨론기능성등산티 반팔 긴팔,6000,5900,-100
2018-06-01,445282542,A022020,두유,황성주 국산콩 두유-190mlX100팩-삼육/연세/베지밀,49900,49900,0
2018-06-01,663489260,A016100,수박,델리참_국산무가당딸기 IQF 1kg x 5개입 / (주)남양냉,67400,57290,-10110
2018-06-01,954815496,E061050,청소용세제,[아토세이프] 세탁조 살균 세정제 400ml 3개,20900,5900,-15000
2018-06-01,126178366,A016020,배,2017 추석 미래로 프리미엄 고급배 선물세트 추석선,77050,77050,0
2018-06-01,2038085582,E031120,믹서,(공식)해피콜 아이디오 대형믹서기 HC-MX3000R,93000,86390,-6610
2018-06-01,549753120,C012040,여자학생복,MJ_1219 네이비 양털 조끼 캐주얼조끼 퍼조끼 남여공,32330,32330,0
2018-06-01,2074532295,A022050,탄산음료,롯데 칠성사이다 355ml x 24캔/펩시콜라/환타/뚱캔,12900,12900,0
2018-06-01,1482988536,A019070,양념소스,이금기 중화XO소스 220g,19900,19900,0
2018-06-01,2014726006,C013060,등산복,노마드 고어텍스 구스다운 점퍼(LMJU7D402)/ 라푸마브이아이피,220500,187430,-33070
2018-06-01,543137092,C011030,남자학생복,MCD-917 빈티지 스타일 롱가디건 남자후드가디건 가을,46840,46840,0
2018-06-01,665925964,A017010,배추,돌산갓 4kg내외 여수돌산갓 빛고을장터,17900,17900,0
2018-06-01,328369593,C012040,여자학생복,T185CD5Z001(레이스가디건)/ 토모톰스,29000,27550,-1450
2018-06-01,1604462236,F012020,생리대,[시크릿데이] 러브 오버나이트10PX3팩+샬롯 슈퍼롱5P+샬롯 슈퍼롱1P,10500,10500,0
2018-06-01,1175172442,C013020,티셔츠,웬디 박스티셔츠 (4color),13900,13900,0
2018-06-01,1982580437,C021010,아동화,쥬쥬 레몬 셔벗 운동화 아동운동화 어린이운동화 어린,45260,45260,0
2018-06-01,803324338,I012010,컴퓨터,[E]B70EV-AP77S2/7세대/i7/8G/256G+1TB/윈10프로,1240000,1178000,-62000
2018-06-01,481327379,A017100,당근,냉동 열무 사용하기 간편한! 열무 냉동야채,2800,2800,0
2018-06-01,1631845128,C013010,점퍼,푸조 집업 바람막이 레인점퍼 스판바지,18800,18430,-370
2018-06-01,1142953195,A013050,오징어,동원 꽁치캔 (400g) x24,65170,65170,0
2018-06-01,1286886804,C013050,운동복,콜라보배색집업 MS1710 편한운동집업 여자이쁜집업 운,48220,48220,0
2018-06-01,2056238472,I053010,공책,GT 모닝 초등 한문노트 10칸 여 초등과목노트 수업노,5230,5230,0
2018-06-01,413386381,C012060,여자내의,[하늘바라기]체크 와이드 점프수트,20300,19290,-1010
2018-06-01,1770615469,A013090,전복,건홍합 1kg /신선하고 고른 상품만을 선별,27000,27000,0
2018-06-01,1033762642,E031090,공기청정기,당일발송삼성 공기청정기 큐브 AX90N9880WFD 이영,1049880,1049880,0
2018-06-01,1009804853,E061040,부엌용세제,자연퐁 팝 주방세제 1300mlx3 참그린 트리오 퐁퐁,10900,10900,0
2018-06-01,403688901,A011020,현미,혼합찹쌀가루 (초야 300g) X25,49410,43980,-5430
2018-06-01,451055167,A013150,어묵,사계절 매운맛어묵 500g2개 어묵 매운맛어묵 사계절어,16790,15120,-1670
2018-06-01,1284301979,A014010,우유,매일 저지방1프로 24팩/멸균우유/베지밀/남양/두유,13900,13900,0
2018-06-01,1399640096,C011030,남자학생복,[버커루]남여공용 32수 스노우사 V넥 반팔 티셔츠(B172Z4110P),10000,8000,-2000
2018-06-01,1890512792,I031010,장난감,경찰 전동 오토바이 유아 스쿠터 바이크 사이클 선물,82700,80220,-2480
2018-06-01,1666483224,C012060,여자내의,여성 뒷트임 청롱스커트 청치마 데님 롱스커트,18000,17820,-180
2018-06-01,2144829804,C012020,원피스,[코인코즈]레이어링 시스루 레이스 롱 원피스 (IW8MO340)(영등포점A),22000,19640,-2360
2018-06-01,367774663,C012040,여자학생복,[대구백화점 II관] [레코브]사슬꽃 카디건(LU3186CD505X),31800,29260,-2540
2018-06-01,535122518,C012060,여자내의,[오빵스타일]린넨스커트치마바지슈키 린넨 트임스커트,24000,22800,-1200
2018-06-01,1460479169,E041010,식기,글라스락 라면기 전자렌지 간편쿡 강화유리용기,5590,5150,-440
2018-06-01,380380080,C012020,원피스,[대구백화점 I관] [올리비아하슬러]프린트쉬폰블라우스(OH8MBL209),109900,93420,-16480
2018-06-01,1317246681,C014020,유아복,아동바지 배기바지 은하수 KIDBOK-30 긴바지 남아바지,11050,11050,0
2018-06-01,533765749,C011030,남자학생복,w/빈폴/폴로/라코스테/버버리/해지스/아베크롬비/니트/점퍼/카라티/남방/셔츠/져지/바,19900,19900,0
2018-06-01,23276561,I031040,생화,리클라이너 의자 캠핑 낚시 무중력 안락 릴렉스 체어,43100,38490,-4610
2018-06-01,839149349,A018100,꿀,비폴렌/벌화분/스페인 비폴렌/로얄제리/비폴렌맛/화분,18400,18400,0
2018-06-01,736649763,L021030,가방,스완스 슬림라인 삼각거들/기능성언더웨어/보정속옷,15200,15200,0
2018-06-01,463661996,C012060,여자내의,T1765-지젤 나비 자수 티셔츠 브이넥티셔츠 자수티셔,57300,55590,-1710
2018-06-01,1011179078,A018060,스낵과자,꼬깔콘 고소한맛 72G,1200,1200,0
2018-06-01,1374090195,C012040,여자학생복,FREE 버튼여밈긴팔니트가디건,18320,18320,0
2018-06-01,1011179079,A018060,스낵과자,꼬깔콘 군옥수수맛 72G,1200,1200,0
2018-06-01,504675993,C012040,여자학생복,[모다아울렛][반에이크]반에이크 뒷목셔링블라우스 VA86BLM204Z-GN,39800,36220,-3580
2018-06-01,581393852,A022040,기능성음료,[무료배송] 파워에이드 마운틴블라스트 1.5Lx12입,20400,20400,0
2018-06-01,277464308,A017040,양배추,동결건조 유기농 시금치가루 60g 3개 시금치 주스,36000,36000,0
2018-06-01,1286509534,C013050,운동복,우먼스 ZNE 플러스 후드 2 여성트레이닝복 집업자켓,159020,159020,0
2018-06-01,631812298,L021030,가방,리바케이스 8455 17.3인치 노트북가방/출장/서류가방,69000,67620,-1380
2018-06-01,492246406,L012090,기초화장품,나드리 상황 수 채윤 아이크림 35ml 1개 아이케어 눈,51630,50090,-1540
2018-06-01,2022321512,C013050,운동복,프론트 리어 범퍼 가드 보호대 몰딩 화이트 범퍼 자동,22230,20250,-1980
2018-06-01,1782134179,G011070,자전거,시애틀모던F 초등학교3학년부터 하이브리드21단,118300,106470,-11830
2018-06-01,1190382938,E031080,선풍기,제너스)미니 PTC온풍기(JNH-1210P)-박스(4개입) / 참,263400,223890,-39510
2018-06-01,2014598890,C012030,여자상의,샤인 멜빵 데님 스커트-M1057,33030,33030,0
2018-06-01,55527055,F012010,종이기저귀,네이처메이드 2팩/기저귀/2~4단계밴드/팬티3~6단계,33900,33900,0
2018-06-01,959557878,A022010,주스,코카 미닛 종합세트 (감귤+알로에+토마토) (180ML*12),10200,10200,0
2018-06-01,1023166689,C013010,점퍼,[다바걸][다바걸] 레더포인퍼무스탕,125000,118750,-6250
2018-06-01,1971281652,C015040,장갑,버튼예식장갑 M 10개입 결혼장갑 장갑 다용도장갑 남,17400,17400,0
2018-06-01,89565541,C012040,여자학생복,[MLB]엠엘비 3종택1 남여공용 소매박스로고 MLB 후드집업(31TRS1811),79000,67150,-11850
2018-06-01,441864740,A015020,식용유,다양하게 쓸수있는 엑스트라버진 코코넛오일 1000ml,38860,38860,0
2018-06-01,1801063858,A016160,과일가공품,블루베리(건조 한끼 350g),20130,20130,0
2018-06-01,424156997,C011030,남자학생복,꾸제꾸제/Vintage 니트 자켓/여성 L/울/가디건/스웨터/세일/브랜드/빈티지/중고/구제,14900,14900,0
2018-06-01,1886298203,E011040,소파,윌리 원목 좌식소파 클라우드 1인용쇼파 2인 안락의자,155000,155000,0
2018-06-01,1508648328,C013020,티셔츠,하딘골프H-26 체크 카라티셔츠 코오롱 ATB-UV+원단,16800,16800,0
2018-06-01,477319669,A013090,전복,이탈리아 자로티 봉골레 바지락 조개살 육수 130g,6390,6390,0
2018-06-01,830768146,E011070,식탁,[파란들]메이든 멀바우 4인용 6인용 식탁세트 ch,69000,69000,0
2018-06-01,688248399,A011090,국수,삼양라면 120g 5+1기획 48개,23500,23500,0
2018-06-01,123747971,C013050,운동복,차량용분말소화기,30500,30500,0
2018-06-01,736649789,L021030,가방,스완스 하이웨스트 삼각거들/기능성언더웨어/보정속옷,14200,14200,0
2018-06-01,1812689786,C013050,운동복,안전벨트 클립 경고음 제거 벨트클립 카본 에폭시 벤,5000,4850,-150
2018-06-01,1176858768,C013050,운동복,아동트레이닝복세트 단체티 반팔티 반바지,23900,23900,0
2018-06-01,1395634499,C013010,점퍼,글리아 져지집업 S~3XL STLD-6616/집업점퍼 집업잠바,30000,28500,-1500
2018-06-01,898636207,E061090,방향제,[P&G]페브리즈 에어 바닐라 라벤더 (275ML),6280,6280,0
2018-06-01,1172336458,C013010,점퍼,[카라]KARRA 라운드블루종점퍼_KBI5JP203A,43800,41610,-2190
2018-06-01,898636206,E061090,방향제,[P&G]페브리즈 에어 맑은 하늘 바람 (275ML),5900,5900,0
2018-06-01,990060881,A011010,쌀,Lgrow 고시히카리 10KG,37900,37900,0
2018-06-01,276223341,A016060,감,(당도보장) 2017년산 씨없는 곶감 청도감말랭이 1kg,14700,14300,-400
2018-06-01,118724511,C011030,남자학생복,[찐링] 반팔 90~130와이셔츠 일반 슬림 빅사이즈셔츠,14800,14800,0
2018-06-01,371796526,L021020,장신구,블랙 스완 초커 목걸이 20대 주얼리 기념일 악세사리,12460,12460,0
2018-06-01,839671124,A016030,복숭아,[국내산]하우스 청포도 1kg 4-6송이,38800,37480,-1320
2018-06-01,371432079,L021050,우산,고급 일회용 우의/우비/비옷/레져/판촉/행사/콘서트/,360,360,0
2018-06-01,1779578420,L021010,손목시계,[CASIO]카시오 LA680WGA-4C 여성용 메탈밴드 패션시계,49900,49900,0
2018-06-01,898636209,E061090,방향제,[P&G]페브리즈 비치형 바닐라 라벤더 (5.5ML),6200,6200,0
2018-06-01,1779578421,L021010,손목시계,[CASIO]카시오 LA680WGA-9C 여성용 메탈밴드 패션시계,49900,49900,0
2018-06-01,1779578422,L021010,손목시계,[CASIO]카시오 LA680WA-4C 여성용 메탈밴드 패션시계,33900,33900,0
2018-06-01,1802251702,I031070,애완동물관리비,헤드 챌린지 테니스라켓 MP/LITE 풀그라파이트라켓,119000,117810,-1190
2018-06-01,1779578423,L021010,손목시계,[CASIO]카시오 LA680WA-2C 여성용 메탈밴드 패션시계,33900,33900,0
2018-06-01,53994695,A017220,양파,깔끔 손질대파1kg-알뜰구매찬스,5590,5590,0
2018-06-01,1888221977,C011020,남자상의,투버튼 체크 슬림핏슈트 세미정장 여름용 린넨 마정장,88900,88900,0
2018-06-01,658855715,C013050,운동복,로드바이저/led 랜턴 후레시 손전등 유도등 지진 재해,35000,32200,-2800
2018-06-01,1587792894,E011060,의자,모닝/땅콩/체스/클릭/큐빅/둥지/책상의자/테이블의자/원탁의자/인테리어의자/학생의자,29000,28710,-290
2018-06-01,1075678350,E041050,냄비,업소용 냄비 전골 전골냄비 경질 수육 국수 자루냄비,10000,9800,-200
2018-06-01,1304621228,C013010,점퍼,[게스키즈] 칼라번아웃점퍼 G65KBJ010,39000,30030,-8970
2018-06-01,1633086773,C013050,운동복,카타 메이저 파워핸들/보스파워/핸들봉/버스/트럭공용,8500,7670,-830
2018-06-01,1457798836,A013090,전복,제철 맛 조개 500g / 40미내외,9900,9900,0
2018-06-01,183930467,A017150,버섯,[원하프]소가살아숨쉬는콩나물300g/풀무원[총알배송!,1320,1320,0
2018-06-01,1172889048,E031030,전자레인지,인증점] 삼성 전자레인지 21L RE-C21KW,94940,89250,-5690
2018-06-01,549395207,C013010,점퍼,[바비수아][바비수아] 모노 누빔 항공점퍼,72900,69260,-3640
2018-06-01,1083070025,E021020,커튼,국산3중직/프리미엄 사계절 암막커튼/코디/아일렛커텐,21000,18310,-2690
2018-06-01,385538422,C012020,원피스,포켓버튼 5부 반바지 WW0300M805 빅사이즈,41000,38540,-2460
2018-06-01,993607439,C011050,남자내의,[하랑이플] 까실이냉장고배기바지(L XL)남성9부팬츠/빅사이즈바지,7900,7900,0
2018-06-01,654935222,A022050,탄산음료,탑씨 1.5Lx12펫 탄산음료/음료수/주스,10500,10500,0
2018-06-01,1381982926,E021010,침구,10%쿠폰! 쁘리엘르 홑겹/피치스킨/누비 매트리커버,8800,8800,0
2018-06-01,696795780,C014010,아동복,블랙야크키즈BK후크세트,30400,30400,0
2018-06-01,746085447,E041010,식기,스텐/식기/탕기/면기/그릇/진공/물컵/주방용/업소용,2300,2120,-180
2018-06-01,988153545,A012050,소시지,요리하다 브런치베이컨 90G,2980,2980,0
2018-06-01,956029494,C021040,실내화,클락스 남성 캐주얼화 Tynamo Walk MCX3105FG11H,95000,95000,0
2018-06-01,410524647,A012010,국산쇠고기,(제주어가 실속 세트)제주 은갈치 2마리 x 제주 옥돔,70180,70180,0
2018-06-01,2070152395,C012040,여자학생복,보틀팜스bottlepalms Premium 비치가디건 봄여름가디,97700,83050,-14650
2018-06-01,889394611,E031130,보온매트,삼양 전기요 大극세사(꽃무늬) (220w),38900,38900,0
2018-06-01,1775066786,F011130,홍삼,정관장 홍삼추출액(양)(90ML*30입),210000,210000,0
2018-06-01,889394612,E031130,보온매트,삼양 전기요 中극세사(꽃무늬) (220w),37700,37700,0
2018-06-01,1081292377,A012050,소시지,꼬마장사 소세지 10g x 100입 외 천하장사/키스틱,9500,9500,0
2018-06-01,1538259935,E061050,청소용세제,써보고 편백 락스 2L x6,12000,10900,-1100
2018-06-01,1209430598,C013040,청바지,[Blouson]허리밴딩 와이드 데님팬츠_[B1806PT060B],24800,22050,-2750
2018-06-01,430010922,C012040,여자학생복,[대구백화점 I관] [베이직코데즈](기존가:299 000원)앙고라아우터형가디건(BZA-HCC15W,90000,82800,-7200
2018-06-01,1145061525,E051030,디지털도어록,무료설치 WK-20 디지털 도어락 번호키 백프로도어락,85000,76410,-8590
2018-06-01,1467364304,C013050,운동복,삼항ㅁ전국총판ㅁ국산 최고급 소화기/소형/중형/ 월드프로119 액체 분사 소화기/화재/,11500,9200,-2300
2018-06-01,385937709,E011050,책상,[이스마트] 실속형 칸막이독서대 / 독서실책상,45700,45700,0
2018-06-01,1450892687,C013010,점퍼,세젤예 블루종 항공점퍼 항공자켓 여성블루종 여성자,20020,17620,-2400
2018-06-01,1180690074,E031120,믹서,믹서컵 증정/리큅 RPM 블렌더 LB-32HP/고속블렌더,272630,236480,-36150
2018-06-01,342934965,A011140,부침가루,삼립빵 소프트 케익 50g 10봉 브라운 브레드 조각케익,5500,5500,0
2018-06-01,565115463,C013010,점퍼,앙팡 래쉬가드 집엎 (네이비) 집엎 물놀이옷 물놀이용,26570,26570,0
2018-06-01,1228112252,A019030,생강,하지카미 (생강순 605g) X10,282880,251770,-31110
2018-06-01,959557815,A019110,드레싱,풀무원 오리엔탈 드레싱_115G,1750,1750,0
2018-06-01,1376242160,L012090,기초화장품,싸이닉 [7900원부터]번들거림 NO! 피지잡는 모공템,9900,9900,0
2018-06-01,432960638,A019040,소금,[CJ]천일염허브맛솔트(마늘맛+매콤한맛+순한맛)/총3개,5900,5900,0
2018-06-01,1742345860,F012020,생리대,시크릿데이 생리대 러브중형16PX4팩+러브대형14PX2팩+러브오버10PX2팩,18500,17570,-930
2018-06-01,470303731,A011040,보리쌀,수입 강낭콩 1kg 팥 완두콩 작두콩 울타리콩 깐동부,2500,2500,0
2018-06-01,1011182674,E031070,에어컨,나오테크LED핸디선풍기,9900,9900,0
2018-06-01,2026160151,L021050,우산,네파안전우의(상 하의)/NEPA/우비/방수/NRC-02/NRC-03,57100,57100,0
2018-06-01,442079020,C013010,점퍼,[구제]후부 점퍼/여성M/집업/자켓/조끼/나시/OT4583,19900,19900,0
2018-06-01,672254116,A013040,고등어,[특가행사!!][특대]/[정품노르웨이고등어2Kg/3Kg/무료,24900,24900,0
2018-06-01,1626368846,C013020,티셔츠,[반에이크]선글레옹(VA84TSQ352Z),9800,9800,0
2018-06-01,1634467134,D031010,주택수선재료,[걸레받이]인테리어몰딩/천정몰딩/평판몰딩/등박스/문선몰딩/계단몰딩/마감몰딩/데코몰,3400,3400,0
2018-06-01,439573968,A017170,풋고추,아삭아삭 맛있는 오이 4kg 10kg,9710,9710,0
2018-06-01,1013427459,A022010,주스,희창.차그림 원액/생과일/쥬스/아이스티/복숭아/매실,3000,3000,0
2018-06-01,838346112,A018030,껌,롯데제과 확 깨는 졸음 번쩍껌/자일리톨,22800,22800,0
2018-06-01,445257528,C013040,청바지,남자청바지/일자/생지/스판청바지/스키니진/빅사이즈,15900,15900,0
2018-06-01,2122864489,C015040,장갑,실버D 통기성이 좋은 성인용 매쉬 손싸게 할아버지 노,53420,53420,0
2018-06-01,663524012,A016100,수박,델리참_국산가당딸기퓨레 1kg x 6개입 / (주)남양냉동,59400,50490,-8910
2018-06-01,542185177,E051030,디지털도어록,머큐리UG-325N/전자키/유리문도어락/인체감지/마스타,66000,57960,-8040
2018-06-01,50889586,E021020,커튼,레이스 캐노피 모기장(화이트) 캐노피 가정용모기장,16730,16730,0
2018-06-01,1356122668,C011030,남자학생복,빅오버핏 롱가디건 BMD0054 남자가디건 남성가디건(YA,58400,47890,-10510
2018-06-01,985411560,A014030,치즈,동원 체다치즈_180G,3780,3350,-430
2018-06-01,1947357137,C013040,청바지,[젤리스푼] 스윗레이스프릴치마반바지_Mo,15900,14310,-1590
2018-06-01,636784219,C011050,남자내의,카고바지/빅사이즈/면바지/청바지/작업복/건빵바지,19800,13800,-6000
2018-06-01,1294889463,C015040,장갑,양가죽 무스탕 벙어리 여성장갑 킹스맨 패션장갑 양가,25070,25070,0
2018-06-01,227633903,C013010,점퍼,[R.ROBOT](YE)에센셜바람막이점퍼(18329-110-05),55200,42510,-12690
2018-06-01,1517567067,I031040,생화,[벅스링10개]유칼립투스향/낚시/썸머링/썸머패치/여름,5500,4880,-620
2018-06-01,1299970472,I031040,생화,에버라스트 스트라이크 쉴드,84800,83110,-1690
2018-06-01,604817560,L021020,장신구,SILVER 로즈 드롭 이어링 RJ0007/ 로즈몽(주얼리),45000,38250,-6750
2018-06-01,1494167700,E011030,거실장,TV장식장/TV거실장/TV다이 TV장/거실장/장식장,37900,36900,-1000
2018-06-01,1325091391,C012060,여자내의,서머리 냉감 통바지 DM 6358,11330,11330,0
2018-06-01,1805424123,A013150,어묵,가마보꼬 오뎅모듬전골430g,4900,4900,0
2018-06-01,1822304513,A021010,커피,무료배송 500g x 2 총1kg/사은품증정 신선한 원두커피,8900,8900,0
2018-06-01,603228677,A014020,분유,후디스 하이키드 밀크 600g,21000,21000,0
2018-06-01,1056927994,C014020,유아복,아둘 패밀리룩 가족티 유아 포티아노 반팔티 12,9600,9500,-100
2018-06-01,2038655733,A022010,주스,하늘샘 희석음료 과일 원액 농축 석류 블루베리 자몽,3500,3500,0
2018-06-01,1608376665,L021020,장신구,실버체인)버블 눈꽃 목걸이(Rosegold)20대 30대 여자,21360,21360,0
2018-06-01,2130159352,C012040,여자학생복,[이사베이]수술 디테일 짜임 오픈 가디건 (VMCCC2904)_G8S5,76600,72770,-3830
2018-06-01,1637234153,A019050,간장,특허받은 맛의 비밀 홍게맛장/홍게간장/사은품증정,16000,11900,-4100
2018-06-01,1326899118,E031070,에어컨,[한일] 한일 리모컨형 천장용선풍기 FCR-65,67500,64130,-3370
2018-06-01,221688179,E061050,청소용세제,파인솔 베이킹소다 표백 주방세제 욕실청소 화장실세,16690,16690,0
2018-06-01,1406885589,L012090,기초화장품,데뷰 대용량 2개 마사지크림/클렌징크림 1000ml 택2,12900,12900,0
2018-06-01,455368746,C012040,여자학생복,DBN1147 줄 배색 청남방 802S 여성체크남방 여성셔츠,58320,58320,0
2018-06-01,1301722410,C011030,남자학생복,(색상 : 블랙) MTS-560 프리 플라워 패턴,34240,34240,0
2018-06-01,957643497,A013170,생선통조림,사조 살코기참치 (안심따개)150G,2800,2800,0
2018-06-01,957643499,A013170,생선통조림,사조 살코기참치안심따개 150G*3입,7900,7900,0
2018-06-01,454473034,I053010,공책,신학기 과목노트(음악)(10개입)-랜덤 학교노트 과목공,11440,11440,0
2018-06-01,656632726,C013040,청바지,[올젠] [ZRY2DP1301-BL] 컨트라스트 워싱 인디고 데님 팬츠,59000,47200,-11800
2018-06-01,431513319,C013050,운동복,프론트 리어 범퍼 가드 보호대 몰딩 블랙 범퍼가드 차,22610,20600,-2010
2018-06-01,1692241104,E041010,식기,(맛나)이중합식기/화영(10P),43520,39650,-3870
2018-06-01,983391513,A019040,소금,청정원 1/2나트륨 솔트(220G/용기),3650,3650,0
2018-06-01,1185334641,C012040,여자학생복,[빅앤빅]팜트리 로브가디건 2color 빅사이즈 55110까지,27500,26130,-1370
2018-06-01,462635410,A011010,쌀,김포 고시히카리쌀20kg 밥선생,67900,67900,0
2018-06-01,2006008494,C011020,남자상의,(무료배송) AG 빅사이즈 자켓 시어서커 MBL 빅사이즈,150680,132600,-18080
2018-06-01,1656893607,C012020,원피스,[여성홈쇼핑(더휴컴퍼니)](어포스트로피) 여성 슬럽본떼 코트(NAHZ540C),22900,18550,-4350
2018-06-01,385538614,C012020,원피스,줄가라 칠부 팬츠 RIN0366RM805 빅사이즈,41000,38540,-2460
2018-06-01,900330418,A018080,설탕,백설 자일로스 갈색설탕 (1KG),3850,3850,0
2018-06-01,900330419,A018080,설탕,백설 자일로스 하얀설탕 (1KG),3450,3450,0
2018-06-01,629079594,C013010,점퍼,[프랜치캣]핫PK 메쉬 배색 블루종(Q62DAJ030),51000,41820,-9180
2018-06-01,898636304,A017180,호박,청양고추(봉),1990,1000,-990
2018-06-01,958147501,C013020,티셔츠,[빈폴아웃도어]Unisex 화이트 박스 로고 라운드넥 티셔츠 (BO8342S031),49000,38710,-10290
2018-06-01,1266727849,C015040,장갑,니트벙어리 프린세스 하트 방한장갑 벙어리장갑 겨울,10190,10190,0
2018-06-01,504565624,L021010,손목시계,안틱캐주얼 블랙 손목 시계 MV206152B 패션아이템 학,86870,86870,0
2018-06-01,942922347,L012090,기초화장품,싸이닉 더 심플스킨케어/크림,10900,10900,0
2018-06-01,1986479455,L012030,칫솔,콤비 릿첼 유아 단계별 칫솔/트레이닝칫솔,5400,5400,0
2018-06-01,1080293463,I012060,저장장치,정품마우스 게이밍 삼성/LG/로지텍/삼보/유선/무선,8800,8800,0
2018-06-01,478520490,E011010,장롱,[5월가정의달특가] 2m 하프갤러리 틈새장/옷장/장롱,79000,48900,-30100
2018-06-01,1121643819,C011050,남자내의,[캘빈클라인진] 남성 반팔 카라 티셔츠 (4AOKQ91),44100,37050,-7050
2018-06-01,911146438,C012060,여자내의,[리스트][LIST] 벨트 플레어 스커트 TWWSKH50020 (2가지 색상),35000,29050,-5950
2018-06-01,1371817601,A022020,두유,맛있는두유GT 190ml x 32팩 검은콩두유 두유 빙그레,10060,10060,0
2018-06-01,1180809139,C013050,운동복,22_고구마베이비 아기옷-무형광 슬라브 연핑크 민소매,19110,18540,-570
2018-06-01,959557901,A013150,어묵,CJ 안심부산어묵볼 192G,1890,1890,0
2018-06-01,1517368915,A021010,커피,(2017신상특가)편의점 아이스커피190ml/더치/냉커피,550,550,0
2018-06-01,62149468,C013010,점퍼,MJ-1077 남성 CONTINVE자켓-블랙,67110,67110,0
2018-06-01,1127211767,A013030,조기,범성포 영광 굴비 세트/20미/2.0kg/국산조기 명절선물,92000,92000,0
2018-06-01,1377108365,C013010,점퍼,PLASTIC ISLAND 야상 점퍼/여성 S/자켓/중고/구제,25000,25000,0
2018-06-01,265164510,L021010,손목시계,손목시계 남자시계 여성시계 한나마틴,29000,29000,0
2018-06-01,958625283,E011040,소파,[넥스디자인]보카시 3인용소파 PU NXS5105,280000,224640,-55360
2018-06-01,119980438,E011030,거실장,(아이잠)토토 책장 5단 1200B [오픈형],52900,52900,0
2018-06-01,2034694524,C011030,남자학생복,[YEZAC]예작(신상품)반팔와이셔츠 21종 택1 (YJ8MBS982WH 외 20종)[갤러리아],30000,22200,-7800
2018-06-01,953958251,L012080,화장지,미래생활잘풀리는집 보습 미용티슈 230매*3입,9500,6490,-3010
2018-06-01,222638373,F012050,의료측정기,3/ 병원용 자동혈압계 BP-868 /혈압측정기/혈압계,1350000,1350000,0
2018-06-01,1778592406,L021010,손목시계,[바보사랑][공식  백화점AS가능]펀페티 남녀공용시계(실리콘)_W0944L1,198000,198000,0
2018-06-01,1778592405,L021010,손목시계,[바보사랑][공식  백화점AS가능]펀페티 여성시계(실리콘)_W0944L3,228000,228000,0
2018-06-01,1562911509,C014010,아동복,(숲자람) 기능성 키즈 바람막이 유아용바람막이 유아,68940,68940,0
2018-06-01,1778592409,L021010,손목시계,[바보사랑][공식  백화점AS가능]포지 여성시계(메탈)_W0928L4,138000,138000,0
2018-06-01,1778592407,L021010,손목시계,[바보사랑][공식  백화점AS가능]스피너 여성시계(실리콘)_W0942L3,138000,138000,0
2018-06-01,2072039147,C012060,여자내의,플리츠 롱 스커트 (MIWWH8631A)/ 미쏘,39900,37910,-1990
2018-06-01,532448147,C012040,여자학생복,[대구백화점 I관] [탑걸]나뭇잎자수숏가디건(TIZ4GD707F),29000,24940,-4060
2018-06-01,520755475,C013010,점퍼,[MRBOB] 두꺼운 헤비 기모 후드티 후드집업 빅사이즈,36800,33800,-3000
2018-06-01,1395455720,C012030,여자상의,레이온 민소매 롱원피스 예쁜 스커트 DM-5736,30000,28500,-1500
2018-06-01,1288776437,E021010,침구,국산 올바른 순면 이불커버/모던이불/북유럽풍/이불,16900,16900,0
2018-06-01,1937358138,E011040,소파,[까사미아]헨트)3인소파,1790000,1632480,-157520
2018-06-01,563699683,C021020,구두,산드라 샌들 LKR273 여자샌들 여성샌들 YA02004,60690,60690,0
2018-06-01,1161251239,C011030,남자학생복,남성 긴팔셔츠 반팔셔츠 남방 빅사이즈 95-120w036,9900,9900,0
2018-06-01,441898222,A015020,식용유,해표대두식용유250mlx30개(box),50170,50170,0
2018-06-01,1252440047,A017150,버섯,[홈플러스]simplus_콩나물_600G,1100,1050,-50
2018-06-01,336238637,C011030,남자학생복,30%쿠폰/무료배송! 남성 여름 셔츠/티셔츠/팬츠,6840,6840,0
2018-06-01,961810433,D031010,주택수선재료,KCC숲으로 누구나 벽지용페인트 2L 내부 친환경 수성,25800,25800,0
2018-06-01,1200395305,E041010,식기,포트메리온 보타닉가든 수저통(대)1p수저통(소)1p,52200,52200,0
2018-06-01,119980433,E011030,거실장,(아이잠)토토 책장 5단 1200A [오픈형],47900,47900,0
2018-06-01,1149886262,E011040,소파,뉴탐 3인 패브릭소파 (웜그레이),359000,359000,0
2018-06-01,772956744,C013040,청바지,[망치키즈]봄신상/남아/의류/아동/청바지/자켓/셔츠,17800,17800,0
2018-06-01,119980432,E011030,거실장,(아이잠)토토 책장 5단 800 [오픈형],46900,46900,0
2018-06-01,1297081680,C013010,점퍼,리즈코 박시오버 코트 연청 남성연청코트 남성박시코,135200,135200,0
2018-06-01,41897960,C013050,운동복,디어포스 사슴표 페파 / 종이사포 100장 1권/페파/빼,54130,54130,0
2018-06-01,1907013596,C015030,넥타이,기본 검정넥타이 장례식 조문용 상가집 상타이 자동,5000,4800,-200
2018-06-01,251216893,C012040,여자학생복,[어스앤뎀] 어스앤뎀 여성 프릴 블라우스 기획9_NC아울렛,49800,9900,-39900
2018-06-01,1206195773,C014020,유아복,[모다아울렛][리틀밥독]M펜슬TS H172MTS03,13800,13800,0
2018-06-01,1785975560,E031120,믹서,(공식)쿠첸 다용도 믹서기 CM-M140W (분쇄/쥬서),29680,27900,-1780
2018-06-01,245762317,C012040,여자학생복,(예사랑)여성 인견 조끼 16YB18,59000,58410,-590
2018-06-01,1011155019,E041070,밀폐용기,초L세이브)과실주병15L,20900,20900,0
2018-06-01,246687851,E021020,커튼,GT 고양이 이동장 걸리버1 플라스틱문 버밀리언레드,41850,41850,0
2018-06-01,1069671596,A019040,소금,히말라야소금/식용암염/고운입자/1kg팩/흰색 핑크색,14000,14000,0
2018-06-01,1183784754,A013060,게,[새우몰] 중국 오징어 3kg 10미내외 부산선진화단지 가공,30000,30000,0
2018-06-01,638588213,A019030,생강,리얼편강 (국산 200gX2통) 선물세트,32450,32450,0
2018-06-01,1011155021,E041070,밀폐용기,PET)블루원형과실주병 15L,8000,8000,0
2018-06-01,188004111,C013050,운동복,[Easy트렁크 우산걸이]_2개1세트 차량용품 자동차용품,6850,5900,-950
2018-06-01,1011155020,E041070,밀폐용기,PET)블루원형과실주병20L,8900,8900,0
2018-06-01,1084565695,A017160,오이,러시아산 차가버섯 추출분말 100g/차가버섯 분말 가루,65000,65000,0
2018-06-01,1676814553,A022030,생수,[동원] 미네마인 스파클링 500ml x 40병,16900,16900,0
2018-06-01,955920366,A021010,커피,동서 카누미니 마일드아메리카노 100T + 사은품 증정,21900,21900,0
2018-06-01,554068749,C012040,여자학생복,아사면 기본셔츠,15900,15900,0
2018-06-01,379580685,C014020,유아복,순면 여름 민소매 나시 여아 여자 아이 반바지 세트,10440,10440,0
2018-06-01,251253802,C013020,티셔츠,로로텐 롱/루즈핏/라운드/티셔츠 빅사이즈 여성의류,17800,17800,0
2018-06-01,2034899604,A019160,밑반찬,양념깻잎1kg/여우마을,4600,4600,0
2018-06-01,1597117710,F011130,홍삼,정관장 아이패스H100일세트(5 000ML),450000,450000,0
2018-06-01,392873278,C015040,장갑,랜드스케이프_돈피세무가죽벨트장갑 선물용장갑 랜드,9740,9740,0
2018-06-01,119980408,E011030,거실장,(아이잠)토토 책장 5단 600 [오픈형],40900,40900,0
2018-06-01,119980406,E011030,거실장,(아이잠)토토 책장 5단 400 [오픈형],33900,33900,0
2018-06-01,1138243251,C012040,여자학생복,스트라이프롱셔츠원피스/롱셔츠남방/롱블라우스셔츠,21900,21900,0
2018-06-01,119980404,E011030,거실장,(아이잠)토토 책장 3단 1200 [오픈형],43900,43900,0
2018-06-01,2046950748,C012020,원피스,[모조에스핀]벨티드포인트 슬림 롱코트_S174MSG404(DN1),259000,246050,-12950
2018-06-01,1778592410,L021010,손목시계,[바보사랑][공식  백화점AS가능]머져 여성시계(가죽)_W0924G3,178000,178000,0
2018-06-01,1395634438,C013010,점퍼,로버트 초경량 바람막이 점퍼 S~3XL STLD-6626/여성바,53400,50730,-2670
2018-06-01,1806271350,A019060,된장,[풀무원]와사비 국산콩 생나또 2호(44.5gX24팩),26900,26900,0
2018-06-01,393796153,D031010,주택수선재료,노루페인트 프리미엄 팬톤페인트 멀티 0.3L/0.5L/1L,5500,5500,0
2018-06-01,1514058717,C012030,여자상의,원피스/투피스/결혼식/정장/오피스/아나운서/모임하객,43500,43500,0
2018-06-01,638867827,C012060,여자내의,[핏코치스]심리스 매직 스커트,5500,5230,-270
2018-06-01,1036164976,A013130,오징어채,백진미채 800g 홍진미채 국산참진미 오징어 건어물,19900,19900,0
2018-06-01,801992352,I031070,애완동물관리비,슬레진저 테니스라켓 테니스 연습용 입문자용,29000,25230,-3770
2018-06-01,442731384,A017080,무,[남도장터]장성 김현준님의 부자새싹인삼 모음전,14900,14900,0
2018-06-01,578064028,E021010,침구,어린이낮잠패드/차렵이불/유아이불/베개(솜포함),16900,9110,-7790
2018-06-01,977334648,E031040,전기레인지,아이엠냉장고KD-138F미니냉장고138L 소형냉장고봄특가,160000,124600,-35400
2018-06-01,1778592441,L021010,손목시계,[바보사랑][공식  백화점AS가능]허드슨 남성시계(가죽)_W0876G3,268000,268000,0
2018-06-01,1778592440,L021010,손목시계,[바보사랑][공식  백화점AS가능]스텔라 여성시계(가죽)_W0885L2,118000,118000,0
2018-06-01,1105664179,E041050,냄비,함마톤냄비 모음 / 양수 편수 밀크팬 페어 함마톤 알루미늄 냄비 업소용 가정용 냄비,3190,3190,0
2018-06-01,1752731991,E011030,거실장,러빙 삼나무원목 스틸 장식장2단,165000,165000,0
2018-06-01,1778592443,L021010,손목시계,[바보사랑][공식  백화점AS가능]칼리바 남성시계(메탈)_W0864G6,248000,248000,0
2018-06-01,2075753965,C013010,점퍼,AGC가죽자켓 라이더자켓 가죽점퍼 P173가죽가죽점퍼가,99360,99360,0
2018-06-01,1532570859,A017210,파,[경기오픈마켓/대성농장]무농약 퇴촌 찰토마토 2kg,14300,14300,0
2018-06-01,1529762017,C012060,여자내의,피핀 로베르 절개 밴딩팬츠 #71610/ 피핀,28700,22680,-6020
2018-06-01,2131555149,C015040,장갑,지맥스 반장갑 긴장갑 스포츠장갑/등산/사이클/라이딩,9900,8870,-1030
2018-06-01,422893292,L012060,샴푸,려 자양윤모 400mlX5입세트,33000,33000,0
2018-06-01,118543336,A011080,밀가루,[온라인공식판매처] 백제쌀국수/30개/멸치맛/얼큰한맛,26800,26800,0
2018-06-01,1319940719,C012060,여자내의,베이직 슬리브리스 가디건세트- 나시가디건세트 나시,27060,27060,0
2018-06-01,1010166119,A019170,냉동식품,자쿡 생면알리오올리오 260G,3580,3580,0
2018-06-01,1147840834,C013020,티셔츠,브랜드특가 브이넥반팔/반팔라운드/반팔티셔츠/단체티,24800,17500,-7300
2018-06-01,1512820416,F012030,안경,안경 남자 여자 뿔테 하금테 동그란 안경테 패션 메탈,11900,11900,0
2018-06-01,1369658335,E041010,식기,핸드페인팅 소담라면기/라면그릇/도자기라면기,5500,5060,-440
2018-06-01,688310956,C011050,남자내의,(남자옷도매) DP-247 린넨마 ST팬츠 (S-XL) 베이지 남,31830,31830,0
2018-06-01,1648405819,E061010,세탁세제,[대용량특가!] 액츠 세탁 액체세제 4.21L(4.3kg)x2개,15900,15900,0
2018-06-01,93110847,E031080,선풍기,세기시스템_일반형 에어커튼/히터형 CCRH-1200,625900,625900,0
2018-06-01,1705984619,I031010,장난감,블럭판/테이블/놀이판/레고판/레고/듀플로/미니피규어,1200,1000,-200
2018-06-01,93110846,E031080,선풍기,세기시스템_고급형 에어커튼/히터형 CGRH-1500,780600,780600,0
2018-06-01,93110845,E031080,선풍기,세기시스템_고급형 에어커튼/히터형 CGRH-1200,710300,710300,0
2018-06-01,1778592435,L021010,손목시계,[바보사랑][공식  백화점AS가능]IRIS 여성시계(메탈)_W0907L2,198000,198000,0
2018-06-01,93110844,E031080,선풍기,세기시스템_고급형 에어커튼/히터형 CGRH-1000,682100,682100,0
2018-06-01,93110843,E031080,선풍기,세기시스템_고급형 에어커튼/히터형 CGRH-900,654000,654000,0
2018-06-01,290342359,C011030,남자학생복,a003 남성 긴팔 청남방 캐주얼 데님 셔츠 단체 작업복,19900,19900,0
2018-06-01,1363136142,A013090,전복,다도해 나로도 바지락 순살(급냉) 3kg(500g×6팩)/자연산 바지락/ 깐 바지락 순살,70000,68500,-1500
2018-06-01,1990742932,C011020,남자상의,MJSF18001 블랙 코튼 베이직 코트 남성봄코트 면코트,95400,95400,0
2018-06-01,1804743386,E031040,전기레인지,데이킵스 웨딩냉장고정리 33P,97840,97840,0
2018-06-01,1752731992,E011030,거실장,푸르미 소나무원목 1200 거실장,235000,235000,0
2018-06-01,1778592439,L021010,손목시계,[바보사랑][공식  백화점AS가능]스텔라 여성시계(가죽)_W0886L2,128000,128000,0
2018-06-01,1752731993,E011030,거실장,푸르미 소나무원목 1200+1200 거실장세트,425000,425000,0
2018-06-01,1778592438,L021010,손목시계,[바보사랑][공식  백화점AS가능]STELLA 여성시계(메탈)_W0887L1,228000,228000,0
2018-06-01,448504346,F012020,생리대,릴리안 팬티라이너 슈퍼롱 40px5팩 200매+사은품2가지,12900,12900,0
2018-06-01,1752731994,E011030,거실장,푸르미 자작나무원목 1200 거실장,265000,265000,0
2018-06-01,1778592437,L021010,손목시계,[바보사랑][공식  백화점AS가능]스텔라 여성시계(가죽)_W0888L3,128000,128000,0
2018-06-01,1752731995,E011030,거실장,푸르미 자작나무원목 1200+1200 거실장세트,499000,499000,0
2018-06-01,1778592436,L021010,손목시계,[바보사랑][공식  백화점AS가능]IRIS 여성시계(메탈)_W0907L1,178000,178000,0
2018-06-01,1256930590,C013050,운동복,뉴쏘렌토R 2013년형 프론트+리어 스키드 플레이트 세트 투톤 범퍼 언더 커버 에어로파,136760,117530,-19230
2018-06-01,760221697,A019180,즉석식품,비비고 사골곰탕 500g 외 육개장/부대찌개/즉석국,1090,1090,0
2018-06-01,1028885642,C012040,여자학생복,여성 왕꽈배기 8부 고급테잎사 니트 티 긴팔 티셔츠,14170,14170,0
2018-06-01,477092562,C012040,여자학생복,지나블리스 스트라이프 워싱 단추 셔츠 1804121,29900,29900,0
2018-06-01,657158853,C021010,아동화,프로스펙스아동화 18년 S/S신상품 아동운동화,49200,47200,-2000
2018-06-01,971568432,A014030,치즈,[커클랜드] 커클랜드 스위스아메리칸 슬라이스치즈 (2.27Kg  120),28610,28610,0
2018-06-01,386491021,E021020,커튼,압축커튼봉 22mm 100x180,16700,16700,0
2018-06-01,344670830,E041060,수저,숟가락+젓가락 세트 수저세트 1인세트,990,990,0
2018-06-01,1124843818,I012060,저장장치,(정품)ABKO HACKER A660 3360 하이엔드 게이밍 마우스,35300,35300,0
2018-06-01,1485733603,C013040,청바지,[뉴비스]16신상 청반바지/청바지/빅사이즈 S~5XL,17800,12800,-5000
2018-06-01,563272005,L021020,장신구,호안석목걸이 8mm/원석목걸이/타이거아이/호안석 목걸이,38000,37620,-380
2018-06-01,1220536919,C013010,점퍼,[시에로(siero)]나그랑 레이스블루종 점퍼(SA2JPF038)(영등포점A),115150,93310,-21840
2018-06-01,357981809,C012040,여자학생복,[매그제이(MAGJAY)]양두니트나시 (J11PNT212),34900,32810,-2090
2018-06-01,1778592467,L021010,손목시계,[바보사랑][공식  백화점AS가능]스타라이트 여성시계(메탈)_W0846L7,208000,208000,0
2018-06-01,576921335,A017220,양파,믿을수 있는 우리 먹거리 간편대파 200g,2930,2930,0
2018-06-01,1778592466,L021010,손목시계,[바보사랑][공식  백화점AS가능]칼리바 남성시계(가죽)_W0864G1,258000,258000,0
2018-06-01,1247734837,C013020,티셔츠,디프니 봄신상입고 롱티셔츠/맨투맨/후드/원피스,6900,6900,0
2018-06-01,536108626,L021020,장신구,남성반지 74-0035-R/ 에디포스,83000,78850,-4150
2018-06-01,464246308,C013020,티셔츠,아스토레 골프 폴로티셔츠 GRPI LSTW10036 여자골프티,74460,74460,0
2018-06-01,358794527,A011080,밀가루,즉석 진참 쌀국수 30개/국수/멸치/김치/세연식품/백제,29900,29900,0
2018-06-01,1514129592,A013090,전복,프리미엄 해물모듬 5종 /국산 오만디 1kg 노바시새우,7900,7900,0
2018-06-01,883339050,A011070,혼식곡,백설 다목적면용 밀가루(20KG),18000,18000,0
2018-06-01,1483843198,C012020,원피스,정장세트빅사이즈면접용옷스커트한벌양장셋트바지팬츠,22900,22900,0
2018-06-01,1428871630,E041060,수저,스텐레스 수저세트-숟가락/젓가락/포크/티스푼,17000,12500,-4500
2018-06-01,1002890439,E011030,거실장,[동서가구]EDF 흑경 소파테이블 DF635971,319000,319000,0
2018-06-01,705721753,L012110,색조화장품,오늘출발 선 메이트 데일리/레포츠 선크림 선블록선밤,21900,21900,0
2018-06-01,77806394,A018010,초콜릿,[탐라원]제주보석귤 초코에퐁당 파우치세트 (35gx3봉),12000,9200,-2800
2018-06-01,1000167148,C014020,유아복,타미힐피거 여아용 후두 면 집업 점퍼 11-12세,29000,29000,0
2018-06-01,576921330,A017220,양파,믿을수 있는 우리 먹거리 대파 1단(소),4020,4020,0
2018-06-01,1778592469,L021010,손목시계,[바보사랑][공식  백화점AS가능]스타라이트 여성시계(메탈)_W0846L4,198000,198000,0
2018-06-01,1693459126,E031010,전기밥솥,쿠쿠 내솥 [E642] CRP-CHRN1010FD 밥솥 교체용,66310,66310,0
2018-06-01,1196650971,C021040,실내화,푸마 남여공용 BTS 튜린 368188-01,67150,67150,0
2018-06-01,193629437,E021020,커튼,로즈 레이스 커튼,29000,19000,-10000
2018-06-01,488802576,C012040,여자학생복,여성용 숄 화이트 머플러 목도리 스타일 패션 디자인,15600,15600,0
2018-06-01,866983038,E011030,거실장,[풀씨]루트 파인 720x480 다용도 상 중,15400,15400,0
2018-06-01,1286414606,A019130,스프,청정원 BeefSoup 우리쌀 쇠고기 크림수프 60g 3인분 X,51240,51240,0
2018-06-01,866983037,E011030,거실장,[풀씨]루트 파인 800x600 다용도 상 대,17400,17400,0
2018-06-01,2130245617,A014030,치즈,모짜렐라슬라이스 자연치즈 100%,19710,19710,0
2018-06-01,866983030,E011030,거실장,[풀씨]루트 그리드핑크 600x400 다용도 상 소 하이글로시,17400,17400,0
2018-06-01,866983032,E011030,거실장,[풀씨]루트 오크 720x480 다용도 상 중,15400,15400,0
2018-06-01,866983031,E011030,거실장,[풀씨]루트 오크 800x600 다용도 상 대,17400,17400,0
2018-06-01,415071571,C011030,남자학생복,피쉬본 패턴 파란색 블루 프린팅셔츠 남자남방 긴팔셔,34610,34610,0
2018-06-01,573723359,I031010,장난감,[노는역] PS4 아날로그 스틱커버 탐캣 16P 듀얼쇼크,6000,5940,-60
2018-06-01,866983034,E011030,거실장,[풀씨]루트 라인 800x600 다용도 상 대,17400,17400,0
2018-06-01,866983033,E011030,거실장,[풀씨]루트 오크 600x400 다용도 상 소,12400,12400,0
2018-06-01,1381666484,C013040,청바지,[UGIZ] 유지아이지 남여공용 9부 린넨 팬츠(UBPA708),15000,12450,-2550
2018-06-01,866983036,E011030,거실장,[풀씨]루트 라인 600x400 다용도 상 소,12400,12400,0
2018-06-01,22177198,E041050,냄비,키친아트 아인스 스테인레스 3중바닥냄비,10000,9800,-200
2018-06-01,866983035,E011030,거실장,[풀씨]루트 라인 720x480 다용도 상 중,15400,15400,0
2018-06-01,1308612499,C011020,남자상의,MJ_1134 그레이 래글런코트 겨울잠바 정장코트 자켓,91580,91580,0
2018-06-01,1202067692,A018060,스낵과자,과자 초코파이 몽쉘 카스타드 새우깡 젤리 초콜릿,700,700,0
2018-06-01,1002890443,E011030,거실장,[동서가구]EDF 천연가죽소파 스툴세트 DF635965,1390000,1390000,0
2018-06-01,1772395136,L021020,장신구,(실버) 크림 하트 목걸이 (RG)/주얼리 악세사리 기념,38300,32560,-5740
2018-06-01,1968481014,E011020,침대,[골든잼]잣나무 천연 생황토 싱글 돌침대/효도 흙침대,1974200,1816270,-157930
2018-06-01,1002890441,E011030,거실장,[동서가구]EDF 3인용 천연가죽소파 DF635969,1190000,1190000,0
2018-06-01,349238617,C012060,여자내의,쿠스피아 밍크퍼 밴드스키니 SD 5303,18020,18020,0
2018-06-01,572817280,C012040,여자학생복,밍크털오픈조끼 BR1712 여자조끼 여성조끼 밍크털베스,150730,150730,0
2018-06-01,1370857246,A017250,고사리,동결건조 유기농 브로콜리 가루 분말 60g 브로컬리,9800,9800,0
2018-06-01,745257331,A019040,소금,명품소금 신안천일염20kg,13900,13900,0
2018-06-01,1319120010,C012060,여자내의,[LAP] AH4WP885 레이온 와이드 팬츠,20000,18000,-2000
2018-06-01,288281370,C012060,여자내의,[바비앤펌킨]아리엘 스커트,78000,70200,-7800
2018-06-01,1576393570,C012060,여자내의,[퍼스트레인] 1st Lane Anne 숏스커트/여성스커트/니트스커트/스트라이프/캐주얼스커트,13900,6950,-6950
2018-06-01,1662274868,F012030,안경,남여 패션 뿔테 메탈테 안경 안경테 남자,8000,7900,-100
2018-06-01,1692182247,C013010,점퍼,[구김스] 1195_ 애틀래틱 삼색요꼬 트레이닝 집업,82000,57400,-24600
2018-06-01,1182350360,A017100,당근,(전남오픈마켓/풍년명가)마른시래기벌크(업소용)10kg,132900,132900,0
2018-06-01,899631126,E011010,장롱,9자/10자/12자장롱/BEST인기모음/갤럭시/갤러리/장농,399000,399000,0
2018-06-01,1320532564,E011020,침대,프리미엄 패밀리침대 Q+Q 오픈형 프레임,368200,357160,-11040
2018-06-01,170146685,C013050,운동복,득템찬스.파격특가.추가금없는 자체제작.빅사이즈,27900,27900,0
2018-06-01,1804574185,L021020,장신구,[바보사랑]style 태슬 포인트 볼드 링귀걸이,19250,19250,0
2018-06-01,1562372386,C013010,점퍼,빅사이즈도 스타일있게 입자! 지금이 딱 좋은 시기!,17800,17800,0
2018-06-01,2113318834,F012050,의료측정기,케어센스N 혈당측정기 풀세트/시험지110+침210+솜100,43000,42000,-1000
2018-06-01,1778592474,L021010,손목시계,[바보사랑][공식  백화점AS가능]파크에비뉴 사우스 여성시계(가죽)_W0838L2,168000,168000,0
2018-06-01,643441345,C012060,여자내의,[레이디플러스](2XL-5XL)스팅 데님팬츠-3399,64900,58410,-6490
2018-06-01,1778592473,L021010,손목시계,[바보사랑][공식  백화점AS가능]파크 에비뉴 사우스 여성시계(가죽)_W0838L6,168000,168000,0
2018-06-01,1980381631,C013010,점퍼,남자바람막이/남성/잠바/자켓/간절기점퍼/후드집업,5000,5000,0
2018-06-01,1778592472,L021010,손목시계,[바보사랑][공식  백화점AS가능]엔비 남녀공용시계(메탈)_W0845L1,238000,238000,0
2018-06-01,1479050492,A022030,생수,[동원] 샘물 미네마인 (500mlx40병),9200,8280,-920
2018-06-01,1547528330,C012060,여자내의,패션풀 BSK17475챠밍 언발 쉬폰 스커트/ 패션풀,16600,14110,-2490
2018-06-01,386912173,C013010,점퍼,엠폴햄 남여공용 덕다운 롱패딩 2종택1 EPX4JD1800 EPX4JD1902,46440,46440,0
2018-06-01,1997321711,E011020,침대,[골든잼]소나무 천연 생황토 카우치(고재B)/돌소파,2322000,2252340,-69660
2018-06-01,427138697,F012020,생리대,3팩 묶음 위스퍼 오버나이트/보송보송케어/좋은느낌,13400,13400,0
2018-06-01,457797916,A021010,커피,자판기용커피믹스/자판기커피/맥스웰하우스커피믹스,2600,2600,0
2018-06-01,1778592471,L021010,손목시계,[바보사랑][공식  백화점AS가능]엔비 남녀공용시계(메탈)_W0845L3,278000,278000,0
2018-06-01,1778592470,L021010,손목시계,[바보사랑][공식  백화점AS가능]스타라이트 여성시계(메탈)_W0846L2,188000,188000,0
2018-06-01,346423433,C012040,여자학생복,[무료배송]180588_시원한 롱 블라우스,17900,17900,0
2018-06-01,1270389898,C013010,점퍼,심플 항공점퍼 리즈코 남자옷도매 도매 남성의류 남자,50230,45210,-5020
2018-06-01,1350909036,C013020,티셔츠,[수입브랜드티]반팔티/남자/티셔츠/반팔티셔츠/박스티,15900,15900,0
2018-06-01,34168618,I011010,TV,DSP K5500UL 55인치TV 4K UHD IPS패널,421640,409000,-12640
2018-06-01,1081412716,A021010,커피,아이수 페루산 카카오닙스200g,12100,12100,0
2018-06-01,429885928,F012020,생리대,템포 레귤러/슈퍼 80p+60p 라이너 증정 체내형 탐폰,23900,23900,0
2018-06-01,2144864372,I012010,컴퓨터,삼성 데스크탑5 DM500S7A-A58BA i5/8GB/SSD128GB/1T,1500000,1500000,0
2018-06-01,215042495,E011070,식탁,무배 멀바우4인식탁세트(의자포함) 4인용식탁테이블,154700,139230,-15470
2018-06-01,2078601327,E021010,침구,북유럽감성 바이오워싱 순면 이불커버 S/Q/K/LK 8컬러,105000,102900,-2100
2018-06-01,1457045484,A014030,치즈,크레프트 파마산치즈 치즈가루 227g 24개,208400,208400,0
2018-06-01,1380680468,C012060,여자내의,리스트 여름 프레이드 랩오버 데님 스커트_TSMSKH20010/ 리스트 레드라벨,29000,24070,-4930
2018-06-01,1325950406,C013020,티셔츠,프렌치캣 화이트7부티셔츠 Q82DKT370 W1,26780,26780,0
2018-06-01,1338957796,A017300,미역,본사직송/10봉/15봉/도시락김30봉(2개부터 할인),13900,13900,0
2018-06-01,1394686022,C012030,여자상의,사선버튼 허리끈 청원피스 스커트 치마 STLD-3368,42600,40470,-2130
2018-06-01,1223734193,C013050,운동복,[에어워크] 신축스판/츄리닝바지/스포츠바지/단체복,35800,35800,0
2018-06-01,544087583,C013050,운동복,프론트 리어 범퍼 가드 보호대 몰딩 화이트 범퍼 자동,22660,20650,-2010
2018-06-01,1137919318,C012040,여자학생복,[화이트폭스]스트랩포인트루즈핏시스루가디건,17000,15470,-1530
2018-06-01,33383191,I011030,사진기,명품 올림푸스 Tough TG-5 정품 정품배터리 이벤트,455000,418510,-36490
2018-06-01,321078581,E021010,침구,신학기/기숙사/원룸 싱글이불세트+이불가방,42900,42900,0
2018-06-01,408654324,C012040,여자학생복,[모다아울렛][후라밍고]에스더꽃나염 블라우스(FMB82330카키 베이지),119000,104720,-14280
2018-06-01,1085464759,C012030,여자상의,봄신상 롱 체크 원피스 셔츠 니트 플라워 모임룩,21000,21000,0
2018-06-01,987318189,E061080,키친타월,코디 키친타올 인테리어 200매*4롤*6입,27000,18500,-8500
2018-06-01,1881414554,F012010,종이기저귀,[GOO.N] 군 기저귀 마시멜로/오리지널/팬티/밴드,41900,41900,0
2018-06-01,1778592497,L021010,손목시계,[바보사랑][공식  백화점AS가능]윌로우 남녀공용시계(메탈)_W0836L3,238000,238000,0
2018-06-01,231704130,A018010,초콜릿,자유시간 가나초코바 에너지바 스니커즈 초코바22종,7500,7500,0
2018-06-01,529525773,C012060,여자내의,허리조절 스판 브라운 교복치마 교복 예쁜교복 교복쇼,43580,42280,-1300
2018-06-01,1916455912,E031020,가스레인지,동우환풍기 100mm/ 가정용환풍기 일반환풍기 화장실환,12900,11800,-1100
2018-06-01,71658119,I053030,복사용지,스마티스트 A4 복사용지(A4용지) 75g 2500매 2BOX,37900,32980,-4920
2018-06-01,1778592498,L021010,손목시계,[바보사랑][공식  백화점AS가능]사우스햄튼 여성시계(가죽)_W0833L2,128000,128000,0
2018-06-01,1369406853,A017120,고구마,건돼지감자 볶은돼지감자 돼지감자즙 돼지감자환,12900,12900,0
2018-06-01,587066483,A017280,김,일가집 김밥용 치자 단무지 240g X 20EA_1BOX 맛단무,62460,62460,0
2018-06-01,393434278,C021040,실내화,운동화/런닝화/남성여성운동화/스니커즈/작업화,10000,9900,-100
2018-06-01,307645918,L021020,장신구,2월탄생석 자수정 귀걸이 핸드메이드 은,54900,54900,0
2018-06-01,1183735798,A013100,마른멸치,완도 활전복 1kg/산소포장/선물포장,29900,29900,0
2018-06-01,855329746,I012010,컴퓨터,Apple iMac 21.5형/27형 인텔i5탑재 상태좋은A급,599000,599000,0
2018-06-01,1002018896,A017120,고구마,말린 돼지감자 국내산 300g,9500,9500,0
2018-06-01,1293724426,E061050,청소용세제,벽지 곰팡이제거 베란다 곰팡이방지 실리콘 팡이제로,10500,10500,0
2018-06-01,856150483,E031130,보온매트,힐링시대 헬시쿨매트 플라워아이스 더블+베개2개,59000,59000,0
2018-06-01,293461933,I031070,애완동물관리비,키모니 중량 리드테이프(KBN263) 2개입 중량테이프 라,17440,17440,0
2018-06-01,2106358172,I031040,생화,[09피싱]시선21 파라솔 2층 50인치/53인치/대형,74000,64680,-9320
2018-06-01,898830441,A022010,주스,델몬트 매실 175ml 30캔,5900,5900,0
2018-06-01,188790253,C012060,여자내의,쿨 치마반바지 스커트 반바지 치마 바지 냉장고쿨원단,2500,2500,0
2018-06-01,1225225322,A012030,돼지고기,[홈플러스]돼지목심_100 g,1590,1520,-70
2018-06-01,1290921238,A017150,버섯,머리딴 두절 콩나물 4Kg×4개,45980,45980,0
2018-06-01,981295885,C011030,남자학생복,[필골드] SL S1TS604n605 와펜 집업트레이닝 상의 4종,39800,39800,0
2018-06-01,2133215407,A013140,북어채,국물진한 황태채300g/노가리채/북어포/먹태,6500,6500,0
2018-06-01,8459286,A012010,국산쇠고기,[무항생제 한우선물세트] 한우 갈비 2호 3.2kg,333100,333100,0
2018-06-01,282373165,C012040,여자학생복,[대구백화점 I관] [샤트렌]쉬폰소재감의 블라우스(HC8MBL104),139300,126770,-12530
2018-06-01,380380144,C012020,원피스,[대구백화점 I관] [올리비아하슬러]체크뒤지퍼블라우스(OH8MBL207),79800,67830,-11970
2018-06-01,985291405,A011010,쌀,[경주시농협] 천년고도 경주찰진쌀 10kg/당일도정,39900,39900,0
2018-06-01,1062166672,C021040,실내화,월드컵 슬레진저 운동화 런닝화 스니커즈,21900,21900,0
2018-06-01,985291407,A011010,쌀,[경주시농협] 천년고도 경주삼광쌀 10kg/당일도정,39900,39900,0
2018-06-01,985291406,A011010,쌀,[경주시농협] 천년고도 경주찰진쌀 20kg/당일도정,75900,75900,0
2018-06-01,69575027,E041020,컵,빈센트 반고흐 머그잔 5P세트/머그컵/커피잔/찻잔세트,33500,33500,0
2018-06-01,1805522477,L021020,장신구,[바보사랑]블런트 반지,10000,10000,0
2018-06-01,985291408,A011010,쌀,[경주시농협] 천년고도 경주삼광쌀 20kg/당일도정,75900,75900,0
2018-06-01,1370133832,E011050,책상,책상/컴퓨터책상/좌식책상/공부방/학생/책상/테이블,27000,24900,-2100
2018-06-01,431102054,C013020,티셔츠,엘룬/M~4XL/반팔티/티셔츠/쿨론티/빅사이즈/반바지,11900,11900,0
2018-06-01,987140524,F012020,생리대,[LG]바디피트 천연코튼 일반 무향_20P,1000,1000,0
2018-06-01,1385887721,A011170,떡,갓지은 구워먹는 치즈떡 3종세트 떡 캠핑 간식 치즈,9900,9900,0
2018-06-01,410465958,A015020,식용유,알폰스 프리미엄 해바라기씨유_500ml 2P (신형),56950,55820,-1130
2018-06-01,987115569,A013110,마른오징어,천연 새우 국물팩 60G(15G*4팩),4990,4990,0
2018-06-01,1016328916,E031110,청소기,[한경희생활과학] 한경희 멀티 스팀청소기용 3중 초극세사패드I 4장,11890,10400,-1490
2018-06-01,1151404069,C013020,티셔츠,[파파야] 봄/여름 초특가 100종! 4 900원~파격가,4900,4900,0
2018-06-01,1243205588,A021010,커피,네스프레소 정품 캡슐커피 25종 / 사은품 증정행사,5800,5800,0
2018-06-01,328369649,C012020,원피스,세련된 루즈핏 캐시미어코트(C164MSG043)/ 씨씨콜렉트,139800,118830,-20970
2018-06-01,378752376,C011050,남자내의,MP-226 블랙 고무줄 슬랙스 고무줄슬랙스 블랙슬랙스,45040,45040,0
2018-06-01,895774352,E061020,섬유유연제,[애경]애경 울샴푸 오리지널 리필1.3L,4990,2990,-2000
2018-06-01,1542052686,C012060,여자내의,JJ지고트 롱 언발란스 랩 스커트 GI3A0SKJ5 KP006,94520,94520,0
2018-06-01,1272515880,E011050,책상,모노 책상 컴퓨터책상 테이블 사무용책상 2인용책상,39900,35910,-3990
2018-06-01,2091084714,F011120,인삼,(장생농산장수산삼 8년근 10주(10뿌리) 선물세트 명절,417300,404790,-12510
2018-06-01,354705477,E011040,소파,[에보니아] 포니 2인/엔느/루비/센스/샤인/칸나/라떼,109000,65970,-43030
2018-06-01,1887682102,C013050,운동복,볼크레이싱밸브캡/타이어/구찌/밸브캡/에어캡/순정형/휠/공기캡/공기압측정기/휠캡/락,12000,11100,-900
2018-06-01,1291219978,C015040,장갑,아디다스 퍼포먼스 니트글러브(BP5348) 니트장갑 남자,34270,34270,0
2018-06-01,1804574155,L021020,장신구,[바보사랑]sidan 하트 팬던트 앤틱 귀걸이,8750,8750,0
2018-06-01,1804574154,L021020,장신구,[바보사랑]sia 앤틱 미니 드롭귀걸이,10150,10150,0
2018-06-01,1287537938,A019140,이유식,new 후디스 아기밀 순(純) 유기농 12 개월 3캔,67000,67000,0
2018-06-01,37919566,A013150,어묵,(부산 종합어묵)3kg 모듬어묵 모듬오뎅탕,11900,11900,0
2018-06-01,592285823,A021010,커피,편의점음료 편의점 아이스음료 파우치음료 파우치커피,5500,5500,0
2018-06-01,1804574159,L021020,장신구,[바보사랑]soma 체인 포인트 하트귀걸이,9450,9450,0
2018-06-01,2073256359,C015030,넥타이,신상 명품패턴 넥타이 고급넥타이 페이즐리 린넨 남성,3900,3900,0
2018-06-01,1804574157,L021020,장신구,[바보사랑]siho 심플 듀얼 링귀걸이,6650,6650,0
2018-06-01,309856184,C021040,실내화,LIVITY 논슬립창 스니커즈 캔버스화 운동화단화 CS351,10800,9800,-1000
2018-06-01,895798317,A018020,사탕,[해태]해태 연양갱 (50G*10입),6490,6490,0
2018-06-01,1924292836,A015020,식용유,[사조해표][무료배송]올리브유900mlx2병,11800,11800,0
2018-06-01,415156947,C012030,여자상의,앨리스 민소매 롱니트 KD 민소매 나시 롱니트 니트 여,33870,33200,-670
2018-06-01,1237090452,C014010,아동복,레이어드 반팔 상하복세트/맘커플/커플룩,19800,19800,0
2018-06-01,1804574163,L021020,장신구,[바보사랑]somee 블루 자개석 드롭귀걸이,8750,8750,0
2018-06-01,2008012,A017160,오이,입점기념 특가 - 경남 합천 해와인 표고버섯,5900,5900,0
2018-06-01,1804574161,L021020,장신구,[바보사랑]sope 화이트 자개석 드롭귀걸이,17150,17150,0
2018-06-01,1240091614,A021010,커피,[당일출고/무료배송]카누다크/스프링블렌드70T+사은품,18900,18900,0
2018-06-01,1215694227,C013020,티셔츠,[에스크]러블리크라운 후드 티셔츠 (AO2MTS707F)(여옐로우),2000,1900,-100
2018-06-01,1078903765,F012010,종이기저귀,군기저귀 밴드형 신생아 90매 1팩,16300,16300,0
2018-06-01,2143167655,I053030,복사용지,삼성 A4 복사용지(A4용지) 80g 2500매 2BOX/더블에이,41620,35800,-5820
2018-06-01,1155013252,C013010,점퍼,[대구백화점 I관] [지-컷]A라인롱점퍼 (7258220001),179000,159310,-19690
2018-06-01,1245252753,L012090,기초화장품,뉴트로지나 딥클린 클렌징 크림 285ml,7700,7700,0
2018-06-01,242415918,C015030,넥타이,(색상 : 브라운) BTIE_062 파스텔 유광 보타,12740,12740,0
2018-06-01,1208929779,I031040,생화,名品해먹하와이 해먹+스탠드+가방세트/간이/워터/캠핑,60000,53530,-6470
2018-06-01,987318153,A016150,아몬드,구운 캐슈넛 370G,8990,8990,0
2018-06-01,476859035,C012040,여자학생복,땡땡이 시수르 실크 77 빅사이즈 롱 남방 셔츠,23900,23900,0
2018-06-01,345784338,C012040,여자학생복,[레코브][18여름]찰랑 골지 맥시 가디건(LU3185KC916X)[갤러리아],55800,47430,-8370
2018-06-01,340033078,C013020,티셔츠,이젠더워! 눈이 가는 에이블린 봄신상 티셔츠/원피스/,6900,6900,0
2018-06-01,947300401,C013020,티셔츠,듀클라이 프리미엄 반팔티 M~3XL 빅사이즈 남여공용,7900,7900,0
2018-06-01,1485637946,A013020,명태,[마산어시장 이바다몰] 냉동 대구곤 대구알800g,6000,6000,0
2018-06-01,124230618,A022010,주스,Dole 돌 아이스 팝 4종 2박스 맛 선택,11900,11900,0
2018-06-01,706162654,I031010,장난감,(소니공식대리점) PS4 라이즈 오브 툼레이더 한글판,39800,39800,0
2018-06-01,1805522480,L021020,장신구,[바보사랑]켈리 하트 귀걸이,7000,7000,0
2018-06-01,1320532498,E011020,침대,프리미엄 패밀리침대 Q+SS 오픈형 포켓양면 매트리스,698900,677940,-20960
2018-06-01,2096906411,C013010,점퍼,오버핏 베이직 워싱 진청자켓 남성재킷 남자재킷 기본,98910,98910,0
2018-06-01,1398838677,L021050,우산,우의세트/레인코트/비옷/우비/패션/남성/EVA/성인,10000,10000,0
2018-06-01,1795781352,E061040,부엌용세제,(택1)돈 고농축 주방세제266ml/532ml/638ml/DAWN,2500,2400,-100
2018-06-01,663490163,A016100,수박,델리참_국산가당 딸기 1kg x 15개입 / (주)남양냉동식,136100,115690,-20410
2018-06-01,1805522483,L021020,장신구,[바보사랑]카리나 하트 귀걸이,6000,6000,0
2018-06-01,1805522484,L021020,장신구,[바보사랑]다렌 진주 귀걸이,16000,16000,0
2018-06-01,1805522481,L021020,장신구,[바보사랑][은침] 파바티 리본 귀걸이,10000,10000,0
2018-06-01,1805522482,L021020,장신구,[바보사랑][실버] 스쿨투라 큐빅 반지,9000,9000,0
2018-06-01,1100338726,E011010,장롱,가구스토리/실속형/9~12자세트/최저가/옷장/장롱/장농,334000,334000,0
2018-06-01,987318156,A016150,아몬드,볶음알땅콩 400G,4990,4990,0
2018-06-01,26102481,C013050,운동복,[3M] 3M 공업용수세미 7440 1박스/100장,541320,541320,0
2018-06-01,752022294,A011090,국수,오뚜기/컵라면 진짬뽕(115gx12)/참깨라면(110gx12),10600,10600,0
2018-06-01,987318158,A016150,아몬드,호두 250G,5990,5990,0
2018-06-01,48889988,A018050,비스킷,초코파이 오예스 마가렛트 카스타드 몽쉘 산도 칙촉,3100,3000,-100
2018-06-01,1570735522,C013020,티셔츠,남여공용]슬럽 V넥 티셔츠(UBTB751)/ 유지아이지,7000,6160,-840
2018-06-01,2133646298,E061080,키친타월,벨라지오 순펄프 키친타올 130매x24롤/화장지 휴지,14800,14800,0
2018-06-01,1684829131,C013010,점퍼,남성패딩점퍼 패딩점퍼 남자패딩점퍼 남자패딩 잠바,37400,33660,-3740
2018-06-01,381036095,A019060,된장,옹고집푸드 와송보리된장 800g/ PET/ 국산콩 명품된장,29000,29000,0
2018-06-01,1742850118,E031110,청소기,[LG전자] LG판매점 (JS) C40RF 파워싸이킹 진공청소기,153760,143000,-10760
2018-06-01,1899644966,C013020,티셔츠,[필골드] SLKN501 글라데이션 오버핏 라운드니트,37800,37800,0
2018-06-01,1146662327,C013020,티셔츠,[타미진][TJMS1KOE14D0]타미진 남성 오리지날 브이넥 반소매 티셔츠(강남점),33600,29340,-4260
2018-06-01,536108567,L021020,장신구,남성반지 74-0035-R/ 에디포스,83000,78850,-4150
2018-06-01,1719822405,L021020,장신구,(실버) 니트 스틱 목걸이 (Gold Rose Gold) 포인트목,25850,25850,0
2018-06-01,1198929153,C013010,점퍼,[메이드]항공점퍼/블루종/야구/점퍼/남자/남성/집업,19800,19800,0
2018-06-01,1554628472,I031070,애완동물관리비,바볼랏 2018 퓨어드라이브 팀 100(285g)16x19 테니스,230000,203550,-26450
2018-06-01,990057104,F012020,생리대,[유한킴벌리]유한킴벌리)좋은느낌순수울날중18P,2900,2900,0
2018-06-01,1302741100,C011050,남자내의,(색상:사이즈 : 네이비:XL) DON 1846 린넨,28220,28220,0
2018-06-01,497430631,A011140,부침가루,베이킹 아크릴 스텐실도안 어린이날 케이크용스텐실,7080,7080,0
2018-06-01,1386465348,A022050,탄산음료,천연사이다 355ml/콜라/사이다/밀키스/마운틴듀/일화,10000,9500,-500
2018-06-01,988958674,A015010,참기름,초L 국내산 참기름 75ML,7790,7790,0
2018-06-01,1683676490,I031040,생화,[그린비] 그린비 와이드 캠핑 체어 세트 1+1 그레이 의자,33800,31100,-2700
2018-06-01,23960292,E031120,믹서,[SK매직] 대용량 후드 믹서기 MIX-S300 (강력모터),107970,100560,-7410
2018-06-01,988958675,A015010,참기름,초L 국내산 들기름 75ML,4990,4990,0
2018-06-01,957643500,A021010,커피,칸타타 원두 드립 커피 (헤즐넛/8T*7G),5280,5280,0
2018-06-01,1804574101,L021020,장신구,[바보사랑]lota 진주 장식 링귀걸이,8750,8750,0
2018-06-01,1778836719,I031040,생화,MCF40 차량용 냉장/냉동 쿨러- 차량/220V 겸용 냉동고,550000,492170,-57830
2018-06-01,975216712,C013050,운동복,뉴카렌스-미르웨이 후사경/4WD/RV용품/사각지대/후진주차/현대/기아/대우/쌍용,27000,24600,-2400
2018-06-01,981692591,A018060,스낵과자,농심 새우깡 400G,3680,2890,-790
2018-06-01,1537686981,A017220,양파,[푸른들판]국내산/파뿌리/300 500g 총백탕 말린 대파뿌리,10000,10000,0
2018-06-01,77052822,A017110,감자,장흥표고_백화고세트400g건강식품 명절선물세트 특산품 추석선물세트 효도선물 표고세,182310,182310,0
2018-06-01,1010166056,A013160,맛살,[대림]대림 스노우크랩킹오리지널 140G*2,4580,4580,0
2018-06-01,582108378,A013120,낙지,바베큐아저씨 피데기오징어입 500g/반건조 간식 안주,23800,21800,-2000
2018-06-01,323894140,F012050,의료측정기,VT 휴비딕 혈압계 에코맥스플러스 HBP-1000+사은품,40000,36400,-3600
2018-06-01,498683894,A012060,햄및베이컨,(냉동)쉐프솔루션베이컨 1kg베이컨 식자재 식품 소시,36300,29770,-6530
2018-06-01,1279218821,I031040,생화,스톰 /5200루멘 /3발 /5발/ 초강력 /헤드랜턴/,17800,15800,-2000
2018-06-01,1347465386,C012040,여자학생복,[코데즈컴바인]여름롱가디건(CDB-CD607W5)[갤러리아],32000,28160,-3840
2018-06-01,958312366,C011050,남자내의,청반바지/데님반바지/남자반바지/5부바지/밴딩반바지,14900,14900,0
2018-06-01,423294883,C012020,원피스,탑걸 뒷밑단트임 일자정장팬츠 TIB4PT704F,44320,44320,0
2018-06-01,985325203,A021010,커피,엔제리너스 수프레모(분쇄)226G,14000,14000,0
2018-06-01,1455172330,I031040,생화,모비쿨 W40 대용량 차량용 자동차 냉장고 아이스박스,179000,149470,-29530
2018-06-01,418700190,C013040,청바지,(남자옷도매) DP-269 하이퀄리티 팬츠 (S-XL) 진청 남,24730,24730,0
2018-06-01,506967245,C012060,여자내의,빅사이즈 헬로시스터 룰루[쉬폰롱스커트]/ 헬로시스터,31000,24180,-6820
2018-06-01,1804574128,L021020,장신구,[바보사랑]luv 하트 진주 귀걸이,8750,8750,0
2018-06-01,1274299845,L012040,치약,(CMIT/MIT 無) 덴티스테 신제품 시린이치약 3~4 SET,11000,10100,-900
2018-06-01,440287922,A015020,식용유,(무)프레스코 카놀라유900mlX20개(1박스)옥수수유 식,141500,124520,-16980
2018-06-01,1374089206,C012040,여자학생복,FREE 긴팔 줄무늬니트후드집업여,13570,13570,0
2018-06-01,61322327,A017080,무,1+1 총60포 무안양파즙/빨간양파즙/양배추즙 해썹,17900,17900,0
2018-06-01,1693014414,C013010,점퍼,[구김스] 1194_ 나그랑 블루종 트레이닝 점퍼,82000,57400,-24600
2018-06-01,1288461804,A019040,소금,(면)대일 꽃소금15kg,16330,16330,0
2018-06-01,428872242,F011150,건강기능식품,[세노비스][옵션有] 트리플러스 트윈세트外 4종 모음(의정부점),63000,56770,-6230
2018-06-01,1179879943,A021010,커피,아이수 페루산 카카오닙스200g,8250,8250,0
2018-06-01,1900351046,A014010,우유,맛있는우유 GT 멸균우유 24팩 아인슈타인 베이비우유,15900,15900,0
2018-06-01,1804574126,L021020,장신구,[바보사랑]loze 십자가 언발귀걸이,19250,19250,0
2018-06-01,1034274416,E031120,믹서,[SK매직] 강력모터 다용도 믹서기 MCHB510(블랙),65000,60450,-4550
2018-06-01,1804574124,L021020,장신구,[바보사랑]loz 비즈 장식 링귀걸이,10150,10150,0
2018-06-01,345243153,E031070,에어컨,스타리온 타워형 선풍기 SF-T4021R/타워팬/LG서비스/e,158000,158000,0
2018-06-01,2135272878,E011020,침대,저상형 침대 프레임/퀸/슈퍼싱글/패밀리/매트리스,95040,95040,0
2018-06-01,658527125,F012030,안경,패션안경 뿔테 무테 동그란 금속테 안경테 남자안경,7900,7900,0
2018-06-01,862688326,C012020,원피스,[보스룸][BOSROOM]남성 천연 모피 양털 이중에리탈부착 bbr 무스탕 자켓 코트 4컬러,1050000,1050000,0
2018-06-01,1395489167,C012030,여자상의,워싱 청원피스 예쁜 스커트 STLD-5910,39000,37050,-1950
2018-06-01,981508227,E061020,섬유유연제,한입100%구연산 1KG,6990,4990,-2000
2018-06-01,1804574130,L021020,장신구,[바보사랑]sana 체인 골드 드롭귀걸이,8750,8750,0
2018-06-01,1010166027,A019150,김치,CJ 비비고썰은총각김치(용기형) 480G,9300,7990,-1310
2018-06-01,956754701,A018040,아이스크림,조안나 5리터 초코,15000,12000,-3000
2018-06-01,1010166026,F012020,생리대,좋은느낌순수팬티라이너롱18P,1490,1490,0
2018-06-01,594232498,A012050,소시지,냉장 소시지 396g 3종/ 쟌슨빌,7900,7900,0
2018-06-01,2138408167,F012010,종이기저귀,[보솜이] 리얼코튼 밴드형 대형 남아용 36매 4팩,39900,39900,0
2018-06-01,697033832,L012030,칫솔,[래디어스 칫솔]미국판매1위/토츠/어린이칫솔유아칫솔,3300,3300,0
2018-06-01,1298958416,I031040,생화,에버라스트 C3스파링 헤드기어,167100,163760,-3340
2018-06-01,1185248220,L021020,장신구,[공식수입원] 블랙스톤 반지 TR2004-051-11/ 토마스사보(주얼리),260000,234000,-26000
2018-06-01,951057231,E011030,거실장,린디베드,97900,97900,0
2018-06-01,951057230,E011030,거실장,롤리쇼파,72900,72900,0
2018-06-01,1414272501,E021010,침구,국산 새솜 이불솜/이불속통,21900,21900,0
2018-06-01,951057233,E011030,거실장,인조가죽 아이린2쇼파베드,127900,127900,0
2018-06-01,959557964,A018010,초콜릿,[롯데]롯데 가나 땅콩 초코바 50G,900,900,0
2018-06-01,570401080,E041050,냄비,키친아트 3중바닥 스텐냄비세트 2종/3종/인덕션겸용,20900,19900,-1000
2018-06-01,959557963,A018010,초콜릿,롯데 가나초코바아몬드 45G,900,900,0
2018-06-01,1327556006,C013010,점퍼,YAN2164 양털안감후드집업,17620,17270,-350
2018-06-01,1299970500,I031040,생화,에버라스트맨티스펀치미트-2개입,113000,110740,-2260
2018-06-01,11537020,I011030,사진기,소니 DSC- RX100M5 (16G 메모리포함)클락,1000000,960000,-40000
2018-06-01,870175485,C012040,여자학생복,1360 롱니트 원피스 2색상중 택 블랙 그레이,20940,20940,0
2018-06-01,1195587725,C011050,남자내의,[POLHAM(폴햄)]남여 치노 반바지 데님 반바지 10종 택1[HV201805PH1012](인천점),10900,8810,-2090
2018-06-01,1963682305,C014020,유아복,포그니 사방스판 기모레깅스 겨울아동복 아동겨울옷,7000,6790,-210
2018-06-01,119980402,E011030,거실장,(아이잠)토토 책장 3단 600 [오픈형],32900,32900,0
2018-06-01,572408575,C013020,티셔츠,[럭키567] 여름신상 파격할인+무배!! 린넨팬츠/반팔티,9800,9800,0
2018-06-01,119980400,E011030,거실장,(아이잠)토토 책장 3단 800 [오픈형],37900,37900,0
2018-06-01,580752578,C013010,점퍼,스트릿후드티 캐주얼티셔츠 긴팔티셔츠 기본후드티셔,24630,24630,0
2018-06-01,534921935,A017160,오이,[산지직송]고창 생 표고버섯 1kg/선별버섯,9500,9500,0
2018-06-01,689969125,C013050,운동복,FOCUPS국산 차량용 컵홀더 최대4개 거치대 차량용품,30000,25000,-5000
2018-06-01,642006042,C013010,점퍼,(해외직배송) 여성패딩 경량패딩 자켓 울트라라이트 패딩 경량패딩 여성패딩 이너패딩,40700,36230,-4470
2018-06-01,1481686036,E061030,전구,LED모듈/간판용LED모듈/인테리어LED모듈/광고용LED모듈.국산다용도3칩LED모듈/실내실외,390,390,0
2018-06-01,2127944671,C012030,여자상의,레이어드/레이스/원피스/치마/스커트/슬립/롱나시,7900,7900,0
2018-06-01,455799673,E031130,보온매트,전기장판 온도조절기 메이커공용 4구4핀,5100,5100,0
2018-06-01,1619830175,C012020,원피스,데시데 덧장 레이어드 쉬폰와이드 슬랙스 (DHS236),139000,111200,-27800
2018-06-01,1701109872,C013010,점퍼,[크루클린] 남녀공용 후드집업/후드티/맨투맨/오버핏,20000,14800,-5200
2018-06-01,1955422009,F011150,건강기능식품,속편한에센셜3병 위건강 속쓰림 역류개선 글라브리딘,112900,112900,0
2018-06-01,670026522,L021020,장신구,귀걸이 보다 예쁜 써지컬스틸 여자 피어싱,3000,2970,-30
2018-06-01,26846224,E021010,침구,누비지오 순면침구/면져지침구/순면이불커버/모던침구,36900,36900,0
2018-06-01,351336403,C012020,원피스,빅사이즈/힐링/가디건/세트 힐링가디건세트 빅사이즈,41870,41870,0
2018-06-01,821005207,C013040,청바지,아둘 가족티 쥬니어 상하세트 시그니처 조던 36,25500,25500,0
2018-06-01,1162489767,C021010,아동화,패턴슬립온 스카이블루 캐릭터 아동운동화 단화 유아,21200,21200,0
2018-06-01,1048197209,F012010,종이기저귀,팸퍼스/뉴/베이비드라이/팬티/밴드/기저귀/향/pampers,56900,56900,0
2018-06-01,494240196,A017020,상추,제이제이몰 화홍적축면 상추 종자 씨앗 8g 재배 쌈,5250,5250,0
2018-06-01,2064836975,C013010,점퍼,CN031-빅체크 레글런 모직코트(롱코트/오버핏코트/체,35290,35290,0
2018-06-01,1597056364,F011130,홍삼,정관장 홍삼 추출액(2 700ML),150000,150000,0
2018-06-01,509327505,C012040,여자학생복,[2ME][2ME] 레이스 패치 블라우스 TMBL72408F26,19000,16530,-2470
2018-06-01,410850677,F011150,건강기능식품,여에스더 유산균 60캡슐 6병(냉장/일반),170300,170300,0
2018-06-01,322085329,E061020,섬유유연제,샤프란 NEW 섬유유연제 3.1L x 4개,11900,11900,0
2018-06-01,1714042159,C012040,여자학생복,[치키타(CHIQUITA)]C 2017 Sweatshirts Cardigan U_Black,89000,89000,0
2018-06-01,244114988,E021020,커튼,러블리한 코디 중형 거실커튼(300cm이상)/면 창 커튼,69800,64220,-5580
2018-06-01,990383073,A013090,전복,[여수고기]자숙 피꼬막살 100gx5팩/100gx10팩/피조개,9900,9900,0
2018-06-01,119642519,C013040,청바지,신상)칩스-청바지/청바지/아동바지/아동청바지,22000,22000,0
2018-06-01,1308193070,C013050,운동복,아디다스 져지 나이키 트레이닝복 바람막이 점퍼 자켓,14900,14900,0
2018-06-01,343931303,C013020,티셔츠,[타미힐피거진][남성] 린넨 혼방 밴드넥 셔츠 TJMS2HCE05D0 N00,115000,103500,-11500
2018-06-01,574602692,C012020,원피스,IW6WH466체크더블라인 코트/ 코인코즈,47000,39950,-7050
2018-06-01,1405367469,C013010,점퍼,가을 신상 초특가 자켓 남자 블레이저 마이 코트 모직,68000,39800,-28200
2018-06-01,1619148947,C013010,점퍼,메덱스 아웃도어 자켓 아웃도어 JK190 바람막이 빅사이즈점퍼 아웃도어 등산자켓 등산,82360,73310,-9050
2018-06-01,632125008,C011030,남자학생복,누빔 빅사이즈 패딩점퍼 MK3061 빅사이즈,96030,93150,-2880
2018-06-01,1918953132,E031110,청소기,[한정수량]삼성 진공청소기 VC33M21A0L2+침구브러쉬,94900,89900,-5000
2018-06-01,593461755,A016150,아몬드,넛츠미 3+1/하루 견과류/아몬드/호두/선물세트/세트,11000,11000,0
2018-06-01,1367805292,A017220,양파,꼬레촌조미 파(깐쪽파)최상품 1kg x 5단,33900,33900,0
2018-06-01,1251441805,C012060,여자내의,시크폭스 리렌플라워 나염와이드팬츠/ 시크폭스,22800,17790,-5010
2018-06-01,720696597,C012020,원피스,빅사이즈/이중/레이스/가디건 빅사이즈,35970,34900,-1070
2018-06-01,954815337,A017020,상추,브로커리(송이/봉),3990,2490,-1500
2018-06-01,1099410314,E041050,냄비,[해피콜] 통3중 스텐냄비모음전,27880,27880,0
2018-06-01,632032875,C013010,점퍼,야상 빅사이즈 BW 피쉬 오버코트 빅사이즈,103120,100030,-3090
2018-06-01,538488239,C013020,티셔츠,쁘띠키즈 여름신상 아동복/반팔티/레깅스/티셔츠/바지,3900,3900,0
2018-06-01,1942862889,E031130,보온매트,대형온열카페트장판 한일의료기 거실전기매트온돌마루,187000,187000,0
2018-06-01,2065072653,A022050,탄산음료,맥콜355ml 음료수 코카콜라 칠성사이다 암바사 마운틴,9900,9900,0
2018-06-01,1787320311,A013020,명태,523 먹태 1kg이상10마리 속초아바이,60150,60150,0
2018-06-01,987140559,A018070,파이,롯데 엄마손파이 254G,4800,4800,0
2018-06-01,1367805287,A017220,양파,꼬레촌조미 파(깐쪽파)최상품 1kg/단,7900,7900,0
2018-06-01,736649666,L021030,가방,스완스 슬림라인 삼각거들/기능성언더웨어/보정속옷,15200,15200,0
2018-06-01,1273433979,C021010,아동화,크록스 성인/키즈/ 아동샌들/여성샌들/아쿠아슈즈,19900,19900,0
2018-06-01,1104655723,I031010,장난감,[마이리틀타이거]타이거 목욕놀이 스티커 3종(탈것/공룡/바다동물)(마산점),9900,9610,-290
2018-06-01,1397321458,E061040,부엌용세제,메소드 주방세제 1000mlx3 세이프 퐁퐁 트리오 참그린,10900,10900,0
2018-06-01,931574761,C011030,남자학생복,여름신상/반팔티/반팔카라티/7부티/티셔츠/카라티,15800,14800,-1000
2018-06-01,1745677383,L012090,기초화장품,이니스프리 그린티 로션/밸런싱/씨드/스킨/로션/크림,14100,14100,0
2018-06-01,61867978,I031070,애완동물관리비,윌슨 BLX2 6.1 라이트 테니-스라켓 테니스연습라켓 테,201700,201700,0
2018-06-01,1070798643,C014020,유아복,두툼! 백곰 패딩점퍼_유아 퍼패딩 코트_유아 패딩점퍼,34500,32780,-1720
2018-06-01,260363148,E031020,가스레인지,욕실용 환풍기 (ESV-150G)/ 환풍기 공기정화기 욕실환,18500,17400,-1100
2018-06-01,559516933,C013050,운동복,여름 트레이닝복 세트 남자 남성 츄리닝 운동복기모,34800,34800,0
2018-06-01,1981713681,A019050,간장,저염만능간장 250g 무침 절임류 조림 고기 생선회,2400,2400,0
2018-06-01,1299970540,I031040,생화,에버라스트 풀 페이스 헤드기어,84800,83110,-1690
2018-06-01,892995162,I031040,생화,해먹/캠핑해먹/그물/야전침대/해먹스탠드/캠핑용품,22000,17820,-4180
2018-06-01,209504567,A019040,소금,[개암죽염] 1회 생활용 죽염 1kg 2개,25000,25000,0
2018-06-01,951057204,E011030,거실장,PU올리비아쇼파베드,59900,59900,0
2018-06-01,951057203,E011030,거실장,패브릭올리비아쇼파베드,56900,56900,0
2018-06-01,545739627,L012030,칫솔,유아칫솔22개+치약 어린이칫솔 아기 키즈 조르단 2080,5500,5500,0
2018-06-01,1343065695,C013040,청바지,스타일J 쿨크롭 비스코스 쥬얼데님 3종,49000,45080,-3920
2018-06-01,951057206,E011030,거실장,토리노쇼파베드,129900,129900,0
2018-06-01,951057205,E011030,거실장,토리노쇼파베드2,129900,129900,0
2018-06-01,1687425418,A019090,카레,하우스 바몬드카레 약간매운맛 230g /Vermont Curry,3200,3200,0
2018-06-01,951057208,E011030,거실장,리코쇼파,82900,82900,0
2018-06-01,951057207,E011030,거실장,쉘리쇼파2,89900,89900,0
2018-06-01,392594530,I031010,장난감,스텝2 이인용밴,116200,116200,0
2018-06-01,2065990175,E061050,청소용세제,홈쇼핑정품 인기 세제 모음 곰팡이제거제 다용도세제,29800,29800,0
2018-06-01,985350220,A019180,즉석식품,CJ햇반 컵반 사골곰탕국밥 166G,2580,2380,-200
2018-06-01,739007371,L012040,치약,시스테마 치석케어 치약 120g x 5개 칫솔 구강 치석,8900,8900,0
2018-06-01,951057200,E011030,거실장,패브릭윈디소파베드3,64900,64900,0
2018-06-01,959557933,A019040,소금,백설 허브맛 솔트 매콤한맛 (55G),2990,2990,0
2018-06-01,951057202,E011030,거실장,PU윈디소파베드2,62900,62900,0
2018-06-01,49801503,A016040,포도,동원)황도 슬라이스 400g x 12개 사시사철 맛있는,41360,41360,0
2018-06-01,987237948,A011090,국수,오뚜기/진라면 매운맛/순한맛/(120gx48)/(120gx40)입,19900,19900,0
2018-06-01,964251233,I053040,기타문구,3M포스트잇/강한점착/팝업리필/플래그/카카오+사은품,1500,1500,0
2018-06-01,951057201,E011030,거실장,PU윈디소파베드3,64900,64900,0
2018-06-01,342934836,A011140,부침가루,삼립 미니다크 브라우니 25g 10봉,4460,4460,0
2018-06-01,573796246,C011050,남자내의,지오다노 여 슬림핏 슬랙스 418505,29520,29520,0
2018-06-01,1453343293,D031010,주택수선재료,[노루페인트]우레탄중도18kg/뉴싱글탄,55000,55000,0
2018-06-01,1324912648,C013030,스웨터,MTSSF18013 지구촌 후드 캐쥬얼후드티 남성용후드티셔,42040,42040,0
2018-06-01,32484233,A016160,과일가공품,슈퍼푸드 마키베리분말 150g 동결건조 칠레 마키베리,23000,22770,-230
2018-06-01,767644403,E011040,소파,[수도권무료배송]3인 인기가죽소파/3인소파,196200,196200,0
2018-06-01,483504249,A021010,커피,[맥스웰하우스] 맥스웰하우스 커피믹스 마일드플러스 800g,3560,3560,0
2018-06-01,1228464824,I031010,장난감,스마트베베 다기능 3in1 메가붕붕카-무독성,36000,36000,0
2018-06-01,1365584446,E021020,커튼,딱 좋은사이즈 중형 거실커튼(300cm이상)/면 창 커튼,58800,54100,-4700
2018-06-01,1917511198,C013020,티셔츠,[앨빈클로][앨빈클로] AST-3524 나시 후드 집업,27900,26510,-1390
2018-06-01,1885332295,I012060,저장장치,인체공학마우스 COMFI(컴피)2 유선 마우스 부활,21000,21000,0
2018-06-01,1067073274,E041070,밀폐용기,Italy 보르미올리 유리병 밀폐용기/더치커피/쨈병,1250,1150,-100
2018-06-01,988128467,F012020,생리대,본유기농본중형26P,9800,5490,-4310
2018-06-01,1185334608,C012040,여자학생복,[빅앤빅]쉬폰 비치 로브가디건 2color 빅사이즈 55120까지,52500,49880,-2620
2018-06-01,837502305,F011150,건강기능식품,미국산 RU-21/선택/72정(6정x12갑)/알유21/비타민C,30500,30500,0
2018-06-01,428597999,L021030,가방,파우치케이스/노트북파우치케이스/노트북파우치/노트북가방/노트북액세서리/11인치파우,8500,7500,-1000
2018-06-01,473084157,F012020,생리대,바디피트 볼록맞춤 22Px3팩+gift키트/생리대/라이너,8900,8900,0
2018-06-01,1172277774,C013010,점퍼,[TATE]남녀공용 루즈 핏 7부 티셔츠 KA7U4-UKS800,7000,5880,-1120
2018-06-01,1146067197,C013050,운동복,아동 우유바지/간절기/아동배기바지/여아바지/주니어,7800,7800,0
2018-06-01,560957978,C012040,여자학생복,큰옷 빅사이즈 데님롱셔츠원피스 WW-1704 빅사이즈 여,48430,48430,0
2018-06-01,988958612,A011110,당면,맑은물에 두부기획(1KG),2990,1990,-1000
2018-06-01,959557934,A019040,소금,백설 허브맛 솔트 순한맛 (55G),2990,2990,0
2018-06-01,721864884,A015020,식용유,[올리타리아] 포도씨유500ml 10병 (스티로폼),54900,54900,0
2018-06-01,1332712653,E021010,침구,국내산 순면 유아 방수패드/방수요/방수 요패드,9800,9800,0
2018-06-01,781212889,C011030,남자학생복,[티엔지티][TNGT]네이비 패턴 면혼방 니트베스트 TGSW8A773N2,63200,54990,-8210
2018-06-01,1310829037,F011150,건강기능식품,멀티비타민 종합비타민 + 칼슘 비타민D 2병총12개월분,21900,21900,0
2018-06-01,959557939,A019180,즉석식품,오뚜기 맛있는 김치찌개,3580,3580,0
2018-06-01,1037197323,C012020,원피스,오버라인 코트형자켓 NGCJIA99/ 라인어디션,179000,146780,-32220
2018-06-01,1664298798,C011050,남자내의,남성스판슬랙스팬츠/9부 10부밴딩바지/남자스판면바지,15900,15900,0
2018-06-01,987225998,A018040,아이스크림,빵뚜르(특가) 10개,12000,5000,-7000
2018-06-01,693101548,C012060,여자내의,[시슬리(SISLEY)]니트스커트 SAKS01741(경기점),99000,88350,-10650
2018-06-01,632284369,C021040,실내화,키높이운동화 하이탑 스니커즈 웨지힐 여름운동화,21800,21800,0
2018-06-01,368132448,C021020,구두,남성구두 M423 키높이 7cm 천연가죽 정장화 신사화 남,60190,60190,0
2018-06-01,1735564447,F012010,종이기저귀,[치쿨]NEW 프리미엄 기저귀 6팩 특가,32900,32900,0
2018-06-01,1597056336,F011130,홍삼,정관장 홍삼추출액_양삼(90ML*5입*6개),210000,210000,0
2018-06-01,1210359050,C013040,청바지,[오즈세컨(o2nd)][오즈세컨] 데님 하단 프릴 팬츠 2WMS2DP001C1002,318000,305640,-12360
2018-06-01,1143800845,E041030,솥,사은품 풍년 하이클래드 압력밥솥 압력솥 스텐 업소,104200,104200,0
2018-06-01,736649671,L021030,가방,스완스 하이웨스트 삼각거들/기능성언더웨어/보정속옷,14200,14200,0
2018-06-01,899439545,A011180,파스타면,[농심]농심 바릴라 스파게티 500G,3490,3490,0
2018-06-01,450193052,C015040,장갑,아놀드파마_ APGW_BY305 (여성가죽장갑) 장갑 가죽장,26560,23910,-2650
2018-06-01,738865185,E031140,비데,{본사직영점} 노비타 방수비데 BD-N443 {탈취건조},279000,279000,0
2018-06-01,750915403,C012060,여자내의,푸조 워테레깅스 ( S26-3 ),28540,26550,-1990
2018-06-01,1123878573,E011030,거실장,뷰로 초이스소파,200000,200000,0
2018-06-01,1990465809,C013050,운동복,폴리싱패드 광택기 헤드라이트복원제 세차용품 드릴,9900,8930,-970
2018-06-01,1123878575,E011030,거실장,뷰로 하비소파,285000,285000,0
2018-06-01,205197070,L021020,장신구,PA676)링스 피어싱/piercing/써지컬스틸/링귀걸이,5900,5900,0
2018-06-01,1123878574,E011030,거실장,뷰로 플러스소파,230000,230000,0
2018-06-01,1874997212,E011040,소파,[삼익가구]쏘렌토 이태리 천연가죽 라텍스 4인용 소파(스툴제외),592900,521760,-71140
2018-06-01,1123878577,E011030,거실장,뷰로 이브닝소파,355000,355000,0
2018-06-01,1123878576,E011030,거실장,뷰로 토니소파,225000,225000,0
2018-06-01,1123878579,E011030,거실장,뷰로 모닝듀소파,225000,225000,0
2018-06-01,1123878578,E011030,거실장,뷰로 서클소파,525000,525000,0
2018-06-01,986505682,C012040,여자학생복,컨택유 활용도 높은 가디건 나시 set #20776/ 컨택유,37900,28810,-9090
2018-06-01,896580693,E041040,프라이팬,바이오뚝배기3호(14CM),4990,4990,0
2018-06-01,1879035323,E011040,소파,상일리베가구 프리미엄 천연가죽 돌체 4인 소파,509000,509000,0
2018-06-01,597285034,A013160,맛살,건맛살 (차오름 1K) X10,216770,192930,-23840
2018-06-01,1095213742,A019060,된장,[한길식품]전통 재래 한된장 100g,4900,4900,0
2018-06-01,1112408859,E061020,섬유유연제,FC 베이비전용 세탁세제 refill 유아용 어린이세탁세,20550,20550,0
2018-06-01,450687655,C012040,여자학생복,롱 청자켓 띠우리V넥청훌OPS 여자청셔츠 청카바 여성,37580,37580,0
2018-06-01,1223528509,C012040,여자학생복,[모다아울렛][케이엘]스퀘어 패턴 블라우스 KWBLIF2000 [순천모다 케이엘],89000,84550,-4450
2018-06-01,1095213741,A019060,된장,[한길식품]전통 재래 한된장 450g,14000,14000,0
2018-06-01,1095213740,A019060,된장,[한길식품]전통 재래 한된장 960g,25000,25000,0
2018-06-01,1395154413,A012010,국산쇠고기,대관령한우 알뜰세트 4호,79730,79730,0
2018-06-01,1557468542,A013120,낙지,정화 해오징어 버터구이 30gx5.,22080,19660,-2420
2018-06-01,451769010,C014010,아동복,블랙야크키즈 다운점퍼 BK럭키다운자켓,104000,104000,0
2018-06-01,1315875550,C013020,티셔츠,남녀공용 레터링 롱 후드티셔츠(KA7F8-UKL100)/ 테이트,10000,8700,-1300
2018-06-01,1411676323,A013130,오징어채,버터구이 오징어 200g / 대발이 오징어 건어물 안주,7900,7900,0
2018-06-01,155822399,E061060,살충제,바퀴벌레약 맥스포스 NEW 셀렉트겔 230g/마툴키/ 바퀴,25300,16960,-8340
2018-06-01,681199868,A011010,쌀,임금님표 이천쌀 10kg,34900,34900,0
2018-06-01,421619769,C021020,구두,14 505 펀칭 6.0cm 여성 슬링백,37890,37890,0
2018-06-01,1597029174,F011130,홍삼,정관장 홍삼유산균(1.5G*60정),70000,70000,0
2018-06-01,1265861802,L021010,손목시계,로제타 여성 손목시계 FW-15 손목시계 팔찌 팔찌시계,13810,13810,0
2018-06-01,604152014,F012010,종이기저귀,[토디앙] LG 자운보본초 팬티기저귀 특대형 남아 36매x3팩,32900,32900,0
2018-06-01,1203237821,A013090,전복,정남진 장흥 장흥특산물 키조개 400g/200g 2팩 조개,66320,66320,0
2018-06-01,420731867,C012040,여자학생복,베이직폴라 긴팔니트 MQDAKU0130/ 미니멈,164000,144320,-19680
2018-06-01,1891633596,D031010,주택수선재료,국산 데코타일 접착식데코타일 장판 본드시공 사각,15800,15800,0
2018-06-01,1829040519,C021040,실내화,[아디다스오리지널스][UNISEX ORIGINALS] 튜블라 쉐도우 CK(CQ0929)(센텀시티점),59000,49220,-9780
2018-06-01,506052177,C013010,점퍼,보들 떡볶이 코트- 양털코트 양털떡볶이코트 캠퍼스룩,43640,39280,-4360
2018-06-01,539957403,G011070,자전거,18년 삼천리 하이브리드자전거 시애틀모던F 21단700C,118800,106920,-11880
2018-06-01,9104029,C013010,점퍼,[K-way] 케이웨이 바람막이 CLAUDETTE(Woman) Magenta,42900,42900,0
2018-06-01,2127956826,A018100,꿀,콤비타 UMF10 마누카꿀 500g 프로폴리스 뉴질랜드,117000,113490,-3510
2018-06-01,451118555,A019010,고춧가루,땡초 고추가루(아주매운맛)1Kg2개 가루 고추가루 땡초,41520,37370,-4150
2018-06-01,451143515,A015010,참기름,해정원 고추맛기름 1.8L2개 기름 맛기름 고추맛기름,30710,27640,-3070
2018-06-01,1401337890,C012040,여자학생복,[꼼빠니아][꼼빠니아] 펀칭레이스배색 티셔츠-IC6U5WIB130,43600,38370,-5230
2018-06-01,420731836,C012040,여자학생복,폴라넥 홀가먼트 니트 MQDAKU9290/ 미니멈,149000,131120,-17880
2018-06-01,1166642737,C011050,남자내의,남자 카고바지 청밴딩조거 스판/밀리터리 작업복 건빵,30800,29800,-1000
2018-06-01,1740923028,C013040,청바지,여름 신상 남자 밴딩청바지/빅사이즈/바지/스판/린넨,15800,15800,0
2018-06-01,1767229485,C013010,점퍼,앨빈클로 1+1 따뜻한 기모 무지 후드집업 + 맨투맨,43800,43800,0
2018-06-01,1269612577,C013050,운동복,dd98 슬림핏 트레이닝복 네이비 트레이닝복자켓 츄리,20210,20210,0
2018-06-01,1123878580,E011030,거실장,뷰로 리베소파,375000,375000,0
2018-06-01,1313900556,C012060,여자내의,SK1577-야자수 밑단프릴 스커트 FREE(44~66) A라인치,38690,38690,0
2018-06-01,1123878581,E011030,거실장,뷰로 레이크소파,255000,255000,0
2018-06-01,2056238656,I053010,공책,GT 모닝 초등 한문노트 10칸 남 초등학교노트 초등학,5230,5230,0
2018-06-01,2117987243,C012060,여자내의,워싱 기모 청레깅스 여성 데님 레깅스 청스키니 청바지 여자 쫄바지 타이즈,6500,6310,-190
2018-06-01,220621991,A019060,된장,[태평소금] 함초 재래된장 1kg,26500,26500,0
2018-06-01,1557928812,C013020,티셔츠,여자반팔티/프린트/롱원피스/탑/민소매나시티/박스,15000,14000,-1000
2018-06-01,1747626778,A011160,빵,삼립 햄버거빵 36개/핫도그빵 패티 불고기버거 피클,8700,8700,0
2018-06-01,1258793688,I012010,컴퓨터,[가온씨앤씨] 2015 NEW iMac 4K 디스플레이 MK452KH/A 21.5형/코어i5/8GB램/1TB하드/애,2070000,2070000,0
2018-06-01,444991032,C013050,운동복,타이어/밸브캡/태양광/LED바/전원불필요/배선불필요,6900,6800,-100
2018-06-01,441864585,A015010,참기름,오뚜기고소한참기름1000ml,27690,27690,0
2018-06-01,1636357307,A019040,소금,양치용 자핵죽염 50g X 2개/ 개암죽염 9회 양치 죽염 자핵죽염 자죽염 9회죽염 분말 양,36000,36000,0
2018-06-01,1695398948,E011020,침대,이노크아든 수지 모던침대 (매트리스포함가),150000,99000,-51000
2018-06-01,679531164,A019100,식초,[하인즈공식몰] 토마토 케찹 397g,2150,2150,0
2018-06-01,1354378799,C012040,여자학생복,[코코애비뉴][코코애비뉴]블라썸진주가디건_80501,53350,51220,-2130
2018-06-01,1554488645,I031040,생화,(추천)루멘코리아 에어베개 이탈방지 에어베개 차량등,19000,16380,-2620
2018-06-01,1655969872,I031040,생화,풀세트5000루멘/초광량몬스터헤드랜턴/10시간연속사용,26000,22830,-3170
2018-06-01,1305967467,C013010,점퍼,남자 바람막이 야상 JM08 WS바람막이점퍼야상남자 바,93480,93480,0
2018-06-01,560869499,C013010,점퍼,빅사이즈 라이트도트바바리 LS1704 빅사이즈 여성의류,38470,38470,0
2018-06-01,1448753195,C013020,티셔츠,펜디 구제매니아 여성 85 라운드 반팔 스판 티 얇음,49210,49210,0
2018-06-01,370596773,A015020,식용유,알폰스 프리미엄 해바라기씨유_500ml 4P (신형),107710,107710,0
2018-06-01,989911954,E061020,섬유유연제,[LG]LG) AURA섬유유연제기획 (스파클링에메랄드) 1L+1L,8900,7900,-1000
2018-06-01,1601276668,A018080,설탕,CJ 백설 하얀설탕/갈색설탕 3kg X 6개 묶음,21500,21500,0
2018-06-01,1297113482,C012040,여자학생복,스트라이프 남방 셔츠 여성 캐주얼 남방셔츠 편한여자,23700,23700,0
2018-06-01,988899099,A014030,치즈,초L)피자치즈 250G,4690,4690,0
2018-06-01,2114209424,A017170,풋고추,수분가득아삭! 광양 미니오이 12개*2팩,9900,9900,0
2018-06-01,1320933844,C013040,청바지,[TATE 테이트] KA7U4-MDP240/KA7U4-MDP250 남성 빈티지 스크래치 청반바지 2종,19000,15200,-3800
2018-06-01,975312643,C013040,청바지,[모다아울렛][까르뜨블랑슈]까르뜨블랑슈 에어매쉬스판바지경량팬츠여름바지 CMM7WP80,55300,52540,-2760
2018-06-01,261602949,A016100,수박,[홈플러스]유명산지 수박_7-8kg 통,15900,15110,-790
2018-06-01,1097007934,E031080,선풍기,신일산업 히터/리모컨/타이머/좌우회전/에코반사판 SEH-ECO170,118000,118000,0
2018-06-01,1097007935,E031080,선풍기,신일산업 히터/좌우회전/에코반사판 SEH-ECO50,65000,65000,0
2018-06-01,1496550172,E011070,식탁,아씨방 선착순특가 원목식탁/4인용식탁/벤치/식탁의자,110400,99270,-11130
2018-06-01,1284937437,F011150,건강기능식품,본사직영 카스피해 요거트 종균/6개월배양,18900,18900,0
2018-06-01,1189543090,A019160,밑반찬,사조오양 반찬/알마늘/깻잎/오복채/고추지/마늘쫑/4kg,9900,9900,0
2018-06-01,1097007936,E031080,선풍기,신일산업 히터/좌우회전/에코반사판 SEH-ECO40,61500,61500,0
2018-06-01,1069563618,A022050,탄산음료,[무료배송] 칠성사이다 250ML X 30캔,19500,19500,0
2018-06-01,532235574,L012090,기초화장품,허브 마스크팩 구매시 여행용 키트 화장품 샘플 증정,5500,5500,0
2018-06-01,2024972405,A011020,현미,가현 찹쌀 20kg 찰진찰 찹쌀20kg,57200,57200,0
2018-06-01,1726439175,C013020,티셔츠,나뭇잎 민소매 티셔츠[P163PSM057]/ 블루페페,15400,14630,-770
2018-06-01,443717617,C013030,스웨터,BIGWM-WN 612 (남) 빅사이즈아가일보카시긴팔니트티(-,53850,53850,0
2018-06-01,990153263,A012060,햄및베이컨,사조오양 베이컨1kg(파지),9900,9900,0
2018-06-01,1148643130,C014020,유아복,[대구백화점 I관] [치크]플레어롱티 레깅스(CKSM82300G),13900,12930,-970
2018-06-01,1108927462,E031080,선풍기,인테리어 벽난로 베티아/트라베/LED/ 장식장,380000,380000,0
2018-06-01,197669389,E061060,살충제,#TV홈쇼핑정품#해충퇴치제/농사/캠핑/등산/낚시/여행/위생 해충 기피제 무무스가드 4개,49310,49310,0
2018-06-01,1597030134,F011130,홍삼,정관장 당앤밸런스(20ML*30입),120000,120000,0
2018-06-01,303549160,A013070,굴,[1+1] 랍스터집게발5~6미/랍스타테일900-1Kg,69000,69000,0
2018-06-01,1541006429,I031040,생화,고급 스워드피쉬 나이프/양날/굿활용도카람빗캠핑낚시,72000,72000,0
2018-06-01,683036514,C013050,운동복,예쁜 방송댄스복 힙합패션 여자트레이닝복 [디바걸스],15000,14400,-600
2018-06-01,450964892,C013010,점퍼,가볍고 따뜻한 패션 아이템 남녀공용 루프트볼 카치온,108570,108570,0
2018-06-01,2129974361,F012050,의료측정기,케어센스2 혈당기 풀셋+스트립1통합60장+침210+솜100,22000,21350,-650
2018-06-01,2137788642,C013010,점퍼,루즈슬림절개시크자켓 IR1710 여성자켓 굴곡절개선자,112500,112500,0
2018-06-01,150431155,C013050,운동복,남여트레이닝팬츠/조거/츄리닝/트레이닝복/빅사이즈,8800,8800,0
2018-06-01,538478185,C013050,운동복,EXO 스마트폰 논슬립패드/스마트폰거치대/흡착/차량용/자동차용/넌슬립/슈프림카,7900,6900,-1000
2018-06-01,1574297691,C013050,운동복,반팔 트레이닝 세트 헬스복 조깅 남자 남성 운동복,15900,15900,0
2018-06-01,1011182954,A012010,국산쇠고기,불고기 500g (1+등급),35900,25900,-10000
2018-06-01,989911932,E061020,섬유유연제,[LG]LG) AURA섬유유연제기획 (로열웨딩데이) 1L+1L,8900,7900,-1000
2018-06-01,989911931,E061020,섬유유연제,[LG]LG) AURA섬유유연제기획 (스모키머스크) 1L+1L,8900,7900,-1000
2018-06-01,1010315913,A016150,아몬드,초이스엘프라임)프리미엄믹스넛 300G,7990,6990,-1000
2018-06-01,989911930,E061020,섬유유연제,[LG]LG) AURA섬유유연제 (플라워바이플로라) 1L+1L,8900,7900,-1000
2018-06-01,685939718,C013020,티셔츠,[NBA] 남여공용 골든스테이트 워리어스 고주파 후드 N182TH102P,52500,47250,-5250
2018-06-01,1109539185,A017040,양배추,시금치-1kg.2kg.4kg,14900,14900,0
2018-06-01,689426260,C011020,남자상의,여심잡는 정장바지/슬랙스 스판 체크 남성 체크바지,21800,19800,-2000
2018-06-01,1350889645,F012050,의료측정기,VT 케어센스N 혈당시험지 100매/당뇨스트립,33330,31000,-2330
2018-06-01,1097007958,E031080,선풍기,신일산업 히터/좌우회전/에코반사판 SEH-M400M,73500,73500,0
2018-06-01,24202677,E011040,소파,베릴 2인소파/2인용쇼파/패브릭소파/인조가죽소파,82900,71910,-10990
2018-06-01,266488786,L021020,장신구,[폭스타일] 블링 하트 반지,8000,7280,-720
2018-06-01,151082453,A016150,아몬드,아몬드800g외 견과류&건과일 72종 무배 / 호두 캐슈넛,9900,9900,0
2018-06-01,2145647223,E031010,전기밥솥,[공식] 신제품 쿠첸 6인용 압력밥솥 CJS-FC0603F,101000,101000,0
2018-06-01,814637773,I012060,저장장치,볼텍스 ET G2 기계식키보드 청축 게이밍 2년무상 sc,25900,25900,0
2018-06-01,1060687670,I011030,사진기,소니 알파 A7R II 본체 정품 명품,2489730,2489730,0
2018-06-01,451143548,A019010,고춧가루,가을 청양 고추가루 2.5kg2개 가루 고추가루 가을고,106520,95870,-10650
2018-06-01,1663153418,E041020,컵,메이슨자 500ml 손잡이머그 카페컵 아이스컵 드링크자,1900,1900,0
2018-06-01,1265763393,A021010,커피,모카골드 자판기 커피믹스 1kg 믹스커피 자판기커피,3700,3700,0
2018-06-01,848384054,L021020,장신구,저렴처분/1.05캐럿 천연루비/큼직/미얀마산,84000,84000,0
2018-06-01,619627286,L021020,장신구,스와로브스키 귀걸이 이어링 귀고리 은침 유색 크리스탈 비즈 여성악세사리선물 패션쥬,9000,8730,-270
2018-06-01,1097007962,E031080,선풍기,대웅모닝컴 히터/스탠드형/회전기능 DWH-KQ5600,30000,30000,0
2018-06-01,1304124231,L021010,손목시계,Paop-u_스포츠시계 패션잡화 스포츠시계 시계 방수시,12150,12150,0
2018-06-01,272119197,G011070,자전거,삼천리자전거/아젠타 하이브리드 자전거/로드 자전거,110000,99000,-11000
2018-06-01,1222855381,E031020,가스레인지,/벽고정레인지후드 스테인리스 060 뤼트미스크 060/,297460,264740,-32720
2018-06-01,749900653,C013010,점퍼,유아다운점퍼 초등여아패딩 여아겨울점퍼 유아동점퍼,27800,26800,-1000
2018-06-01,1851913506,E011020,침대,소나무 우물마루 원목침대/싱글/퀸/킹/가구,1140000,1140000,0
2018-06-01,421585833,C013050,운동복,[이라인]커플신상/아이스배기팬츠/레깅스/7부 9부바지,4000,3900,-100
2018-06-01,1505896068,E021020,커튼,세진아트 목각비즈발/문발/대나무발/갈대발/그림발,9850,9850,0
2018-06-01,203138191,C013020,티셔츠,100%국내생산/24종/여성나시/끈나시/롱나시/속바지,3900,3900,0
2018-06-01,1824444163,E031010,전기밥솥,추천) 쿠첸 2017년 출시 6인용 압력밥솥 CJS-FA0606V,111000,111000,0
2018-06-01,1947360264,E011050,책상,위드멀티책상세트/컴퓨터책상/학생책상/학생용 책상,77000,77000,0
2018-06-01,108108265,A017220,양파,국내산 깐쪽파 쪽파 1단,8900,8900,0
2018-06-01,1197103967,C012030,여자상의,탑나시원피스/쉬폰/레이스/민소매/프릴셔링/롱끈/미니,26800,26800,0
2018-06-01,1384600471,E041030,솥,2018년 풍년 압력 밥솥 11종 하이클래드 밥통 압력솥,56900,56900,0
2018-06-01,471884659,A015020,식용유,데체코 엑스트라버진 올리브유 1L,11700,11700,0
2018-06-01,1948550338,L012010,면도기,쉬크 면도기 모음/하이드로3/5/프리미엄+사은품,6900,6900,0
2018-06-01,333232852,C012060,여자내의,런샵 면스판 쫀쫀 치마레깅스 DK-1932 레깅스 양말 스타킹타이즈 쫄바지 치마레깅스 레,14600,11680,-2920
2018-06-01,328609915,A018090,잼,로투스 비스켓스프레드 400G,11710,11710,0
2018-06-01,1011182948,A012010,국산쇠고기,채끝등심 500g (1+등급),60000,50000,-10000
2018-06-01,957643528,A021010,커피,칸타타 원두 드립 (블루마운틴/8T*7G),6700,6700,0
2018-06-01,576152351,E031110,청소기,지웰 8036 유선 진공 청소기 세트형,59900,59900,0
2018-06-01,1318157253,C012060,여자내의,로이 니트 스커트 세트- 스커트세트 니트세트 허리밴,21090,21090,0
2018-06-01,1149683842,C013050,운동복,디테일링 에탄올/보쉬/소낙스 워셔액/6개 무료배송,1950,1950,0
2018-06-01,1221036171,C012040,여자학생복,[올트]스트라이프 핀턱 반팔 셔츠원피스_무료배송,42500,42500,0
2018-06-01,712133298,C012040,여자학생복,밍크털오픈조끼 BR1712 여자베스트 털조끼 여성조끼,159880,142300,-17580
2018-06-01,444425182,C021040,실내화,나이키운동화 테니스화 줌베이퍼 줌케이지 코트,74000,63640,-10360
2018-06-01,1530559624,C012020,원피스,MELODY F102/코트/여자코트/겨울코디/겨울코트/자켓/점퍼 미국 여성토탈브랜드 멜로디,39700,39700,0
2018-06-01,2056155733,C014020,유아복,유니크한 4가지패턴 유아바람막이(S~2XL),17600,17600,0
2018-06-01,1201418618,A013120,낙지,[코스트코] 마마스 초이스 구운 오징어채(국내산)250g,22030,22030,0
2018-06-01,981775168,E061020,섬유유연제,샤프란 아로마용기(3.1L),7990,3490,-4500
2018-06-01,981775169,E061020,섬유유연제,샤프란 코튼용기(3.1L),7990,3490,-4500
2018-06-01,595277734,C013050,운동복,봄신상 추가 트레이닝복세트/츄리닝/남자/운동복/바지,22800,19800,-3000
2018-06-01,835724251,E031120,믹서,정품. 2년무상AS 필립스 믹서기 HR2142/90 HR-2142,43350,42250,-1100
2018-06-01,41981701,C013020,티셔츠,당일출고 타미힐피거 반팔 v넥c887849809-475,32900,31260,-1640
2018-06-01,853948886,I053020,스케치북,글로벌문구 헬로키티 스케치북 1개 (랜덤발송) - 스,5030,5030,0
2018-06-01,1778592342,L021010,손목시계,[바보사랑][공식  백화점AS] 캠브리지 남녀공용시계(메탈)_W1078G1,208000,208000,0
2018-06-01,2085463849,C012060,여자내의,푸조 여성 워테레깅스 ( S26-1 ),28300,28300,0
2018-06-01,1778592341,L021010,손목시계,[바보사랑][공식  백화점AS] 캠브리지 남녀공용시계(가죽)_W1075G1,148000,148000,0
2018-06-01,266220695,I053020,스케치북,세종문구화구-스케치북200g [8절/5절/4절]선택 전문가용/미술재료/물감/스케치북크로키,3200,3200,0
2018-06-01,1244894394,I012010,컴퓨터,삼성 카비레이크 DM500S7Z-AD2A (Pentium/SSD128)biz,503730,489000,-14730
2018-06-01,1139209960,A022010,주스,야노시호&박지윤의 클렌즈밀 3일 프로그램(시호스무디9+욕망뉴트리밀6병),42900,42900,0
2018-06-01,1778592345,L021010,손목시계,[바보사랑][공식  백화점AS가능]테일러 남성시계(가죽)_W1017L2,188000,188000,0
2018-06-01,1752381566,E021010,침구,코튼렛 호텔침구 프리미엄 모달 이불커버세트(SS/Q/K),87000,87000,0
2018-06-01,242922596,C013050,운동복,아동용 기모바지/핫팩바지/우유바지/밴딩바지/겨울바,6000,5900,-100
2018-06-01,1778592344,L021010,손목시계,[바보사랑][공식  백화점AS가능]테일러 남녀공용시계(메탈)_W1018L3,258000,258000,0
2018-06-01,1340140497,C015040,장갑,주름장식 가죽장갑(남성) 남가죽장갑 신사용가죽장갑,26670,26670,0
2018-06-01,1304922767,C013010,점퍼,MJ-1055 (겨울신상) 원 컬러 레드 심플 패딩 (95-110),108650,97790,-10860
2018-06-01,489424230,C011030,남자학생복,여성_하이넥 래쉬가드집업(PHX2TC2500)/ 폴햄,15000,12750,-2250
2018-06-01,989052022,A016150,아몬드,구운아몬드 800G/봉,14990,14990,0
2018-06-01,489424235,C011030,남자학생복,남성_하이넥 래쉬가드집업(PHX2TC1500)/ 폴햄,15000,12750,-2250
2018-06-01,327246071,L012040,치약,리치 컴플리트케어 치약/칫솔/가글 (택일),9900,9900,0
2018-06-01,1314960091,C013030,스웨터,밀란시아 4G 꽈배기 폴라티 mar171-001 남성캐쥬얼 캐,46750,45820,-930
2018-06-01,1778592349,L021010,손목시계,[바보사랑][공식  백화점AS가능]컨스텔레이션 남녀공용시계(메탈)_W1006L2,278000,278000,0
2018-06-01,987054101,A013180,젓갈,[해음] 짠맛을 줄인 속초 조개젓 400g,18200,13700,-4500
2018-06-01,1871061268,E011040,소파,플로바움 그랑빌 3인용 쇼파,211500,211500,0
2018-06-01,368240079,L021020,장신구,레오파드 송치 귀걸이 패션귀걸이 호피 도형귀걸이 악세사리 주얼리 쥬얼리 이어링,17600,14600,-3000
2018-06-01,1947445725,E021010,침구,국내산 사계절용 차렵패드세트/침구세트/이불세트,34900,34900,0
2018-06-01,1375377004,I011020,영상음향기기,디비코 멀티미디어 빔프로젝터 V3 LED86 / 2700루멘,278000,278000,0
2018-06-01,2098011022,C013050,운동복,카본 범퍼윙 가드 대 중 소 중 택1 가드 도어가드 범,20010,18230,-1780
2018-06-01,2069441,C012060,여자내의,[포에버21]말드 바이커 반바지/FOREVER21/바지/팬츠/핫팬츠,6900,6900,0
2018-06-01,1076572916,A012050,소시지,사조오양 수제 모듬 소시지 385g (아이스박스+팩포장),3500,3500,0
2018-06-01,1920921887,C013020,티셔츠,빈스걸+빅사이즈XL~99까지 반팔 롱박스 원피스티셔츠,12900,12900,0
2018-06-01,896817226,A011180,파스타면,[오뚜기]오뚜기 스피가도르 후실리 (500g),2790,2200,-590
2018-06-01,1320532401,E011020,침대,프리미엄 패밀리침대 SS+SS 오픈형 20T라텍스매트리스,698900,677940,-20960
2018-06-01,1688221832,A011110,당면,[농협] 안동 전통방식 국산콩 두부 기획전,13900,13900,0
2018-06-01,1099231728,E011010,장롱,키높이2100 하프루바 틈새장/장롱/옷장/이불장/장농,79000,71100,-7900
2018-06-01,1173166725,C011050,남자내의,[지오다노] 108220 코튼 버뮤다(웨빙 벨트 증정),19800,16440,-3360
2018-06-01,722283686,E011070,식탁,철제강화유리 주방테이블 스틸식탁 4인6인용 메탈식탁,59620,59620,0
2018-06-01,1731149381,C013020,티셔츠,[트윈키즈]여름맞이 대박특가! 티셔츠/팬츠 99종,4000,3960,-40
2018-06-01,910972838,A022020,두유,이롬-황성주 발아약콩 두유 100팩-베지밀/약콩두유,53900,53900,0
2018-06-01,1807884969,C013010,점퍼,[밍크뮤] 마우스화섬점퍼 (37214-110-01),43000,35260,-7740
2018-06-01,1736771930,E061040,부엌용세제,암웨이 주방세제/연마세정제/금속세정제/최저가,6100,6100,0
2018-06-01,1199546872,C021040,실내화,아디다스 엘레멘트 레이스 ADIDAS CF ELEMENT RACE 3종택일 (DB1459/DB1463/DB1776),48000,38400,-9600
2018-06-01,285599525,C013040,청바지,주니어의류 초등 남아 4부/5부/7부 반바지/청반바지,12900,12900,0
2018-06-01,492498633,C012040,여자학생복,[에이비에프지]퀼리티 좋은 가디건 AFR3y05,29000,27550,-1450
2018-06-01,281207405,F012020,생리대,순수한면 제로.슈퍼가드.더건강한 생리대 골라담기~,2900,2900,0
2018-06-01,1905839999,E061050,청소용세제,아스토니쉬 초강력 기름때제거 멀티클리너 현진포커스,13000,11830,-1170
2018-06-01,66495755,I012010,컴퓨터,특가 65만원!MS오피스증정/삼성노트북 NT300E5K-L56SS,739000,698000,-41000
2018-06-01,1070662286,E051030,디지털도어록,EN100 레드/디지털도어락/번호키/보조키/현관열쇠,37000,37000,0
2018-06-01,1433218531,C011050,남자내의,비클레이 밴딩조거팬츠 M~XXL 카모 면바지,34800,34800,0
2018-06-01,1158610105,A017080,무,생와사비 뿌리 특가전,4500,4500,0
2018-06-01,1291220196,C013010,점퍼,걸크러쉬 슬림 가죽 자켓-m1071 (블랙) 여성자켓 여성,55310,55310,0
2018-06-01,862650486,L012060,샴푸,[비어랩] 독일 맥주효모 탈모 샴푸 490ml 3통,48500,45110,-3390
2018-06-01,868222994,E031120,믹서,JB3060BK 브라운 믹서기 1.75L/내열강화유리 dk,91000,84260,-6740
2018-06-01,1691163622,E031090,공기청정기,A[2018형] 위닉스 공기청정기 제로플러스 AZPE500-HWK,309000,278100,-30900
2018-06-01,733342208,A011130,시리얼,오뚜기 바삭하고 고소한 부침가루 1kg X 10EA 고소한,38410,38410,0
2018-06-01,415154999,C011020,남자상의,남자 자켓 정장자켓 WS-JK23 남자자켓 남성자켓 정장,72190,70750,-1440
2018-06-01,944271338,A014010,우유,하루야채 350 오리지날/퍼플 200ml X 40개 (2개월)/ 한국야쿠르트,72000,72000,0
2018-06-01,155474303,C021020,구두,토즈 다크블루 드라이빙슈즈 XXM0GW05470RE0U820,387000,337550,-49450
2018-06-01,728115903,E031070,에어컨,한라 SKY 실링팬/52인치/천장실링팬/리모콘/,188000,188000,0
2018-06-01,1320532432,E011020,침대,프리미엄 패밀리침대 Q+SS 오픈형 프레임,329100,319230,-9870
2018-06-01,446469336,C012030,여자상의,[무료배송]빅사이즈 DNB0073R 베스트 핏 원피스 802,38980,38980,0
2018-06-01,1312335669,A013090,전복,무배 냉동 중국 초밥용 조미 가리비 조개 20미 120g,12550,12550,0
2018-06-01,1041109079,E031110,청소기,다이슨 진공청소기 씨네틱 빅 볼 CY22 /이벤트,865000,795800,-69200
2018-06-01,620429905,L021020,장신구,스와로브스키스톤 귀걸이 이어링 귀고리 은침 유색보석 비즈 실버 패션쥬얼리 악세사리,17400,16880,-520
2018-06-01,2103329570,E031010,전기밥솥,쿠쿠압력밥솥고무패킹 분리형커버 이중모션6/8/10인용,4900,4700,-200
2018-06-01,1116414877,C012060,여자내의,[베스티벨리]데님 슬릿 미디 스커트 (BMSKD2361)_H5A4,28900,27460,-1440
2018-06-01,391027385,C013010,점퍼,푸조 여성 바람막이 자켓(FZ317-5) 여성바람막이잠바,34440,34440,0
2018-06-01,983391699,A013170,생선통조림,[사조]사조 고등어 기획 (400G*2),3990,3990,0
2018-06-01,1991643025,C013020,티셔츠,엘룬/M~4XL/반팔티/티셔츠/쿨론티/빅사이즈/반바지,11900,11900,0
2018-06-01,906176999,A018090,잼,프랑스산 샹달프 블루베리잼 딸기잼 284g x 4개/쨈,20490,20490,0
2018-06-01,1320532463,E011020,침대,프리미엄 패밀리침대 Q+SS 오픈형 본넬 매트리스,593700,575890,-17810
2018-06-01,468594776,C013020,티셔츠,면스판 기본 박스 브이넥티 DM-5640 여름반팔 반팔티,9770,9770,0
2018-06-01,1913309196,C012040,여자학생복,지나블리스 스트라이프 반팔 셔츠 7326,19800,19800,0
2018-06-01,437191337,C013020,티셔츠,웨이브맨투맨(ZYD_1602) 여성티 빅사이즈긴팔티 빅사,17880,17880,0
2018-06-01,306629238,C021040,실내화,푸마 남여공용 BTS 콜라보 코트스타 366202-01,79000,67940,-11060
2018-06-01,446531770,C012030,여자상의,[무료배송]빅사이즈 DBR1245 민트 체크 배색원피스 80,77380,77380,0
2018-06-01,41800926,E061040,부엌용세제,액큐친환경 오븐크리너그릴청소세제 20kg,33270,33270,0
2018-06-01,237308662,C021040,실내화,나이키 에어맥스 테일윈드8,86000,86000,0
2018-06-01,988899037,F011150,건강기능식품,[무료배송] 고려은단 비타민C 1000 120정,12800,10200,-2600
2018-06-01,765742452,F011130,홍삼,[선물세트] 1+1 김정환 홍삼순액(70ml*30포),72000,72000,0
2018-06-01,1237946507,C013020,티셔츠,베이직 목폴라 여성 캐주얼 목폴라티셔츠,21610,21610,0
2018-06-01,530479981,C012060,여자내의,백합주름치마 핑크체크 전체 주름 교복치마 교복 예쁜,55060,53410,-1650
2018-06-01,1778592375,L021010,손목시계,[바보사랑][공식  백화점AS가능]SUMMIT 남성시계(가죽)_W1000G4,228000,228000,0
2018-06-01,2109428399,C013050,운동복,(닥터카) 성에 제거제 성애제거제 성에제거제 차량성,8620,8620,0
2018-06-01,1778592374,L021010,손목시계,[바보사랑][공식  백화점AS가능]SUMMIT 남녀공용시계(메탈)_W1001G1,238000,238000,0
2018-06-01,1778592373,L021010,손목시계,[바보사랑][공식  백화점AS가능]크루 남녀공용시계(메탈)_W1002G1,218000,218000,0
2018-06-01,751037870,A018100,꿀,트라피스트 수녀원 유기농 딸기잼 410g 딸기쨈 과일잼,14000,13580,-420
2018-06-01,1778592379,L021010,손목시계,[바보사랑][공식  백화점AS가능]트레드 남성시계(메탈)_W0967G1,208000,208000,0
2018-06-01,231826927,F011120,인삼,(장생농산장수산삼 8년근 10주(10뿌리) 건강식품 명절,420730,408110,-12620
2018-06-01,2083984665,C012030,여자상의,TL_ID001 팝콘 칠부 원피스 /(참고)봄날원피스 고급디,39800,35030,-4770
2018-06-01,1778592377,L021010,손목시계,[바보사랑][공식  백화점AS가능]익스체인지 남녀공용시계(나일론)_W0976G1,118000,118000,0
2018-06-01,1778592372,L021010,손목시계,[바보사랑][공식  백화점AS가능]스타게이저 여성시계(가죽)_W1005L1,168000,168000,0
2018-06-01,1078335117,I031010,장난감,벤틀리 벤테이가 멀티 붕붕카 다기능 3in1 푸쉬카,68900,68900,0
2018-06-01,1440707769,C012060,여자내의,[제이블리]로맨틱 페플럼 스커트 00118,19800,17430,-2370
2018-06-01,1283133864,A011160,빵,냉동베이커리 베이글 초코머핀 크로크무슈 디저트 AN,3600,3600,0
2018-06-01,546930761,C012060,여자내의,[클라비스]오링 포인트 치마바지 CVTW82505M,39900,34720,-5180
2018-06-01,2010047756,C013050,운동복,LED 손전등 겸용 경광봉 지시봉 신호봉 안전봉 레드,12900,12520,-380
2018-06-01,1926238583,I011030,사진기,캐논 Powershot G7X Mark II +5785 케이스 명품,675400,621280,-54120
2018-06-01,102359661,C013020,티셔츠,[DUCLY] 신상 맨투맨/후드티/후드집업/기모/빅사이즈,19900,19900,0
2018-06-01,607376012,A022050,탄산음료,[코카콜라] 몬스터 에너지 울트라 시트라 355ml x24,29800,29800,0
2018-06-01,1727492955,E061030,전구,초특가삼파장형광등장수램프번개표오스람바텍전구램프,2000,1850,-150
2018-06-01,411626108,F011150,건강기능식품,여에스더 유산균 60캡슐 6병(냉장/일반),170290,170290,0
2018-06-01,386731665,C015020,모자,[마블정품]성인 아이언맨캐릭터 스냅백(D)&모자&힙합,30800,26180,-4620
2018-06-01,480042548,L021020,장신구,고품격 럭셔리 체인 87종 실버팔찌 (open-n22b) 여성 남성팔찌 선물용인기 골드조아,89500,89500,0
2018-06-01,227670651,A016090,참외,성주 참외 가정용9kg 못난이 랜덤특가,13900,13900,0
2018-06-01,1714428187,C021040,실내화,[푸마] 여자 아동화 Suede Heart Jewel Inf 365139-01 02,69000,58650,-10350
2018-06-01,663746988,A019100,식초,(오뚜기) 1회용 케찹 딸기잼 디스펜팩 머스타드 일회,24900,24900,0
2018-06-01,259646205,L012010,면도기,질레트 퓨전 면도기 + 5중 면도날 x 9입 초특가 쉬크,29800,29800,0
2018-06-01,84972693,A019040,소금,9회죽염 분말 100g/개암죽염 죽염 소금 양치 가글 가루 치약 생활 양치용 구회 구운 죽,25000,25000,0
2018-06-01,565717987,I053030,복사용지,한솔 A4 미색복사용지(A4용지) 80g 2500매 2BOX,44300,38550,-5750
2018-06-01,241392039,C013020,티셔츠,v style-t,14000,14000,0
2018-06-01,1157564624,C011030,남자학생복,[스파오][스파오] 캐시라이크 카디건(SPCK348C01_BL),5900,5610,-290
2018-06-01,953985034,F012020,생리대,유기농본 대형 날개형 14P,6400,3800,-2600
2018-06-01,1246770577,E061050,청소용세제,계양산업 곰팡이제로골드 곰팡이제거 욕실청소 크리너,4400,4400,0
2018-06-01,1487219350,C013010,점퍼,베이직 그레이 패딩,97720,97720,0
2018-06-01,671377328,F012050,의료측정기,브라운체온계 IRT-6520 / IRT-6030 귀체온계,86020,80000,-6020
2018-06-01,454355575,C012060,여자내의,[빌드]BIMP312 아이스 스키니/빅사이즈/미시/여성,29900,29900,0
2018-06-01,1047078015,D031010,주택수선재료,(주)노루페인트/본사정품/본사직송/옥상방수30평형(코,426700,426700,0
2018-06-01,325924123,L012060,샴푸,헤드앤숄더 샴푸/린스 850ml x2개/가려운두피/팬틴,14900,14900,0
2018-06-01,959349495,A019120,혼합조미료,[청정원]청정원 멸치 국물내기 티백 (80G),6950,6950,0
2018-06-01,198245173,C012060,여자내의,RT5 리즘 주름 롱스커트 SD-9028,19350,18970,-380
2018-06-01,391982620,A019040,소금,월계수잎(영흥 230g)X6 월계수잎 식당용월계수잎 업소,48990,44100,-4890
2018-06-01,959349493,A011090,국수,팔도 김치 왕뚜껑(110g),950,950,0
2018-06-01,245857395,C012030,여자상의,빅사이즈 띠별롱니트 EB1704 빅사이즈 여성의류 미시,38520,37750,-770
2018-06-01,1913686111,A017210,파,[제철특가]영양만점 토마토 5kg 웰빙식품,9000,8900,-100
2018-06-01,1685116654,A019050,간장,계란간장 계란에 뿌리는 간장소스 300ml /타마고,6100,6100,0
2018-06-01,1967232572,C013050,운동복,지엠걸/55~110/여름신상트레이닝세트/디즈니/빅사이즈,9900,9900,0
2018-06-01,117257521,A022030,생수,롯데 트레비500mlX20펫/초정탄산수/음료수,14500,14500,0
2018-06-01,427983286,A018090,잼,초록원 딸기잼 1kgx2개/버터/잼/간식/빵/과일/버터,10500,10500,0
2018-06-01,2008346891,C013010,점퍼,[닉스]W NIX 남여공용 여름 바람막이 NLMCUA704,39000,37050,-1950
2018-06-01,2143084034,C012060,여자내의,[마일리지]니트훌스커트 SK025D7,45800,43510,-2290
2018-06-01,995652254,E061030,전구,오스람 번개표 장수램프 형광등 10W/20W/32W/40W,30000,26910,-3090
2018-06-01,1748718423,E011020,침대,리버퍼니쳐 아이사랑 65T CL라텍스 폴리원단 슈퍼싱글,118250,118250,0
2018-06-01,1534570983,A017150,버섯,콩나물 키우기 5인용 만들기 세트 집에서 키우는 방법,28000,27160,-840
2018-06-01,1407786831,C011050,남자내의,겐트]18 S/S 린넨/마바지/슬랙스/면바지/남자,13900,13900,0
2018-06-01,1384034972,I031070,애완동물관리비,슬레진져 테니스 라켓 입문용 학교 수업용 초보자,21000,21000,0
2018-06-01,509359069,L012090,기초화장품,마몽드 마이크로 마스크 투 폼 화장품 피부 스킨케어,13850,13440,-410
2018-06-01,1956895215,L021020,장신구,여름 핫 아이템 블링블링 써지컬스틸 배꼽피어싱 귀걸,6000,5940,-60
2018-06-01,888572071,F012020,생리대,바디피트 팬티라이너 160개 생리대 좋은느낌 화이트,10900,10900,0
2018-06-01,1011096433,F011150,건강기능식품,[한정특가][내츄럴플러스] 바디핏 다이어트 CLA (800mg x 42캡슐) - 1박스,15000,5900,-9100
2018-06-01,62262908,A019040,소금,개암식품 개암9회죽염(자죽염알갱이형) 1kg/개암9회,259000,259000,0
2018-06-01,517245151,C011030,남자학생복,[써스데이아일랜드](T184MVT231W) 손뜨개 꽃장식 끈나시형 베스트,159000,127200,-31800
2018-06-01,2135727233,E031010,전기밥솥,풍년 압력 밥솥 고무 패킹/스텐인레스/BSPC-20C/BSPC-22C/BSPC-24C/BSPC-26C/HCPC-20C,4000,3680,-320
2018-06-01,542285738,E011050,책상,원목책상 원목책상의자 주문제작 북유럽풍,99000,89100,-9900
2018-06-01,1858927842,C013050,운동복,K-345 스타렉스 2004후사경 실외용후사경 자동차실외,25660,23380,-2280
2018-06-01,358527021,C012040,여자학생복,[쥬시팍시][쥬시팍시]멜로 가디건,31200,29960,-1240
2018-06-01,1530560588,C012020,원피스,MELODY F118/코트/여자코트/겨울코디/겨울코트/자켓/점퍼 미국 여성토탈브랜드 멜로디,54700,54700,0
2018-06-01,1854450503,A018040,아이스크림,돌핀 폴라레티 후르츠/트로피칼 아이스바 40ml x60개,11900,11900,0
2018-06-01,502844567,E011070,식탁,파인 원목 아일랜드 식탁/홈바/렌지대/주방/수납장,198900,198900,0
2018-06-01,1126403267,A016070,귤,싱싱몰 제주서귀포하우스감귤3kg 꼬마,26900,26900,0
2018-06-01,256821090,C012020,원피스,슬림핏모던체크자켓(N181XSF003)/ 나이스클랍,258300,211810,-46490
2018-06-01,916623891,A017180,호박,(맛나)예천청결고추가루(국산한식)3kg,109300,98370,-10930
2018-06-01,1663513568,C011030,남자학생복,[행텐] 남성 블럭 셔츠 10120-020-411-26 NC아울렛,49800,12000,-37800
2018-06-01,2147393847,C013020,티셔츠,반팔티 티셔츠 롱티 박스티 여자 여성 7부 여름 박시,9900,9800,-100
2018-06-01,1614864521,C014010,아동복,아동 셔츠/ 아동 남방/ 아동 솔리드 옥스포드 셔츠/ 옥스포드 남방/ 흰남방/ 흰색셔츠,21800,21800,0
2018-06-01,1511904620,C012040,여자학생복,브이배색니트 /니트/브이넥니트/니트티/반팔니트/ 톰앤래빗,19000,17860,-1140
2018-06-01,1391971926,C013010,점퍼,라보니 아동 리얼폭스퍼 다운점퍼 -카키,106280,106280,0
2018-06-01,1089205564,I031010,장난감,슈퍼윙스붕붕카 호기 아리 붕붕카 장난감 아기붕붕카,27300,27300,0
2018-06-01,643945596,E021020,커튼,10%쿠폰! 코튼베딩 암막커튼1+1/거실커튼/창문커튼/여름커튼,6900,6900,0
2018-06-01,451794080,C013010,점퍼,[구김스]구김스 930_오버핏 울 테리오버 코트 (G15WMCTA01),249000,236550,-12450
2018-06-01,2060238712,F012030,안경,뿔테 선글라스 실리콘코패드 세루시루유 세루시루U,6000,6000,0
2018-06-01,896925141,C014010,아동복,[인디고뱅크키즈]화이트 반팔셔츠 IKYC183G1,11100,11100,0
2018-06-01,1267063844,D031010,주택수선재료,칠만표/강력접착방수제/CMA-1A/옥상방수/균열보수,26000,26000,0
2018-06-01,603131374,C013020,티셔츠,당일발송 나시/민소매/골지/망고/런닝/반팔티남여공용,4900,4900,0
2018-06-01,989137450,E041080,부엌용용구,스마트 태그,2000,100,-1900
2018-06-01,978463038,A018110,물엿,[청정원] 대상 청정원 황물엿 10kg,21300,21300,0
2018-06-01,1685189706,L012060,샴푸,(신형) 엘라스틴 퍼퓸 샴푸린스 X 5개 / 대용량 구성,21900,21900,0
2018-06-01,989137459,A017280,김,초L)치자쌍단무지 400G,2780,2780,0
2018-06-01,522897630,A011050,콩,[가온애]정품 초코볼 총모음 땅콩 해씨 스톤 고구마스틱 스낵류 찹쌀땅콩 볶음땅콩 과,3900,3900,0
2018-06-01,989137457,A017280,김,초L)치자쫄깃 단무지 200G,1780,1780,0
2018-06-01,489030738,A021010,커피,맥스웰하우스 마일드 900g/추가금액 없음,4500,4500,0
2018-06-01,989137456,A017280,김,초L)치자맛 단무지 300G,1680,1680,0
2018-06-01,714456299,I031040,생화,GDF 서프시드 25-450 원투낚시대/원투대/입문용원투대,50000,50000,0
2018-06-01,508461645,C012060,여자내의,[오빵스타일]와이드팬츠8부팬츠이프 와이드핏 린넨팬츠,29000,27550,-1450
2018-06-01,1067142143,A013070,굴,러시아대게2.5Kg/어른3-4명/15~18큰사이즈/수율80%,95000,69000,-26000
2018-06-01,1302802414,C011050,남자내의,(색상:사이즈 : 카키:M) DON 1846 린넨9부,28220,28220,0
2018-06-01,462674677,C013010,점퍼,수퍼노바 스톰 자켓 남성용자켓 트레이닝복 트랙자켓,141530,138700,-2830
2018-06-01,2070156937,A017100,당근,건우농산/무청시래기(실온) 1kg,3600,3600,0
2018-06-01,2104872530,I031010,장난감,(스텝2 사파리웨곤(new))대형완구 푸시카 지붕차 승용,659390,586860,-72530
2018-06-01,747774721,A019080,고추장,[순창 이기남할머니 고추장 1kg]고추장/된장/장아찌,15900,15900,0
2018-06-01,68733874,A013050,오징어,동원 꽁치캔400g / 펭귄 꽁치캔400g / 꽁치 통조림캔,2090,2090,0
2018-06-01,900655650,A021010,커피,1kg원두커피 대용량/3kg무배/10+1 행사(특가제품제외),8500,8000,-500
2018-06-01,1827125403,A017120,고구마,유명한 햇 고령개진감자 5kg 3kg 큰크기 반찬용,13900,13900,0
2018-06-01,1615550727,A019040,소금,국산 (신안군 천일염 20kg) 소금 박스포장 오늘출발~,10000,9400,-600
2018-06-01,1277157317,C014010,아동복,[베네통키즈] QATS31831 (스트라이프뒷트임드랍티셔츠) 100~155,34300,27440,-6860
2018-06-01,2086690171,C012030,여자상의,[앙투] 여름신상 원피스44~110빅사이즈 루즈핏 린넨,12800,12800,0
2018-06-01,6679585,L012060,샴푸,(샘플10매증정) 댕기머리 뉴골드/명품 프리미엄 샴푸,18900,15800,-3100
2018-06-01,1147720804,C013010,점퍼,[크로커다일레이디]17봄)힙기장의점퍼(CL7MJP206)[갤러리아],49000,39200,-9800
2018-06-01,1036514639,I012060,저장장치,앱코 HACKER K640 LED 게이밍 추천 기계식키보드,38900,38900,0
2018-06-01,1488149625,A017160,오이,산지직송 금강 생 표고버섯1kg/파지/대중소/,9900,9900,0
2018-06-01,2030749305,A018050,비스킷,[CJ제일제당] 맛밤(80gx3봉),4490,4050,-440
2018-06-01,1295685720,C012030,여자상의,[패션24시30%쿠폰][첼로걸]예쁨주의!시원한썸머원피스,9900,9900,0
2018-06-01,92375360,I011010,TV,UHD43F 43인치UHDTV 100%무결점 A등급패널 2년무상AS,353130,339000,-14130
2018-06-01,1441501747,A011080,밀가루,[구포국수]60년 전통의 원조 구포쫄깃국수/소면 중면,1590,1590,0
2018-06-01,1471677772,A019180,즉석식품,[만두모음]대림/물만두/교자/찐만두/군만두/엄지/만두,4200,4200,0
2018-06-01,1619807253,E041010,식기,자크라디 폴란드 수입 그릇/소스볼/찬기/식기/앞접시,9900,8190,-1710
2018-06-01,241178939,E011060,의자,[BC체어]게이밍 컴퓨터 PC방 사무용 학생 책상 의자,48900,44010,-4890
2018-06-01,1530623949,C012020,원피스,MELODY F133 차콜/코트/여자코트/겨울코디/겨울코트/자켓/점퍼 미국 여성토탈브랜드 멜,98700,98700,0
2018-06-01,1428486547,C012020,원피스,[숲(SOUP)]스모킹밴딩원피스(대구신세계),41700,37220,-4480
2018-06-01,482796137,C012060,여자내의,-마리 프릴 브이넥 티셔츠- 플라워패턴티셔츠 플라워(,44400,39080,-5320
2018-06-01,2024103597,C013010,점퍼,푸마 아스널 캐주얼 자켓 ( 74978405 ),112700,112700,0
2018-06-01,420755791,C012020,원피스,라마 혼방 롱코트 MQDAWL1130/ 미니멈,595000,523600,-71400
2018-06-01,1228545119,I053020,스케치북,스케치북/크로키북/블랙스케치북/하이크로키북/드로잉,2800,2800,0
2018-06-01,1114343475,C013050,운동복,콘솔트레이 올뉴카니발 그랜져HG 티볼리 YF소나타,14440,13000,-1440
2018-06-01,1420752693,C013050,운동복,에어.컴프레셔.콤푸레셔12V타이어공기주입차량용펌프.튜브.자전거.바이크 공기주입.멀,54000,54000,0
2018-06-01,652553906,C015030,넥타이,NV031 단색레드 나비넥타이 패션넥타이 나비넥타이 리,9650,9650,0
2018-06-01,1067374237,C011030,남자학생복,[모다아울렛][지이크F]FQBAD5308와이드 카라 내추럴 린넨 셔츠,39000,35100,-3900
2018-06-01,257604657,A012030,돼지고기,돼지 갈매기살 지방이 적고 쫀득쫀득 씹는 맛이 최고,5900,5900,0
2018-06-01,1893858940,L012040,치약,센소다인 멀티케어치약100gx5개/시린이/글락소스미스,21400,21400,0
2018-06-01,123749982,C013050,운동복,피난유도등,14600,14600,0
2018-06-01,2099844898,A012030,돼지고기,목심 구이/보쌈/제육볶음용 500g(택1)/ 도드람한돈,8900,8900,0
2018-06-01,820838360,E011070,식탁,모드니가구- BEST 인기식탁 총집합 특가 (생산자직판),89900,89900,0
2018-06-01,651985092,E011040,소파,[동서가구] LV 특가 3인용 소파 4종택일,144000,129000,-15000
2018-06-01,1147840744,C013020,티셔츠,브랜드특가 기능성 라운드티/V넥티/골프티셔츠/단체티,24800,17500,-7300
2018-06-01,987054011,A013180,젓갈,[해음] 짠맛을 줄인 속초 오징어젓 400g,15900,13900,-2000
2018-06-01,1241582036,I053010,공책,근영사)아이디얼 양장노트(무지_블루)박스(24개입) 양,125470,125470,0
2018-06-01,288523829,A014040,발효유,서울 비요뜨 143g/초코링/그레놀라/그레놀라/베리믹스,1270,1270,0
2018-06-01,2054143226,C012040,여자학생복,[로즈맘]백레이스가디건,11570,10420,-1150
2018-06-01,346734414,E031040,전기레인지,C형 냉장고 스마트 블록 특대 대 풀세트 냉장고 정,91300,91300,0
2018-06-01,367461706,E061060,살충제,컴배트 좀벌레싹 아로마향 서랍장 10p x4개+퍼실300ml,14400,14400,0
2018-06-01,2079441008,A011090,국수,팔도비빔면 130g 48개 /찰비빔/라면/비빔면,28800,28800,0
2018-06-01,297415104,C013050,운동복,신상 트레이닝복 트레이닝복세트 운동복 트레이닝바지,19900,19900,0
2018-06-01,1361912239,F012010,종이기저귀,폴맘오버나이트26px2팩/굿나이트/하기스 기저귀,28900,28900,0
2018-06-01,1665087038,C013040,청바지,[게스]GUESS 남성_아이스 구제 레귤러 테이퍼(MI2D9089),70200,58970,-11230
2018-06-01,266486053,L021020,장신구,[폭스타일] [실버] 앰버 반지,17000,15470,-1530
2018-06-01,61934291,C013010,점퍼,시크폭스 크레프트 바람막이점퍼/ 시크폭스,17100,13340,-3760
2018-06-01,989137490,A017280,김,초L)우엉과단무지 250G,2680,2680,0
2018-06-01,361291909,E021020,커튼,/벌집블라인드 화이트 호프발스 100x155 cm/ 롤스크린,56280,50090,-6190
2018-06-01,1424936463,C013010,점퍼,[대구백화점 I관] [HUM]오버 숄더 박스핏 점퍼(HMECUN501M),79900,65520,-14380
2018-06-01,2054143230,C012040,여자학생복,[루시다]G33 KN4780피키 시스루 썸머가디건,23760,21150,-2610
2018-06-01,2018925425,C012040,여자학생복,[대구백화점 II관] [에고이스트]프린트 패턴 로브(EJ2EZ511),79000,68730,-10270
2018-06-01,2084163349,C013040,청바지,(SR)MHA700 남자기모빅사이즈스판기모본딩청바지 /(참,54700,48140,-6560
2018-06-01,821015365,C011050,남자내의,아로미 905/고무호피 발목 고무밴딩 스프사 9부파자마,11700,10420,-1280
2018-06-01,1508553323,F011150,건강기능식품,브리오 종합비타민 미네랄 /멀티비타민 무기질 영양제,45000,45000,0
2018-06-01,1331318914,E011050,책상,2인용 책상/책상침대세트/책장/책꽂이/2인/쌍둥이,288900,288900,0
2018-06-01,227513745,C013010,점퍼,[R.ROBOT]BL)패턴바람막이점퍼(18329-110-08),79200,60990,-18210
2018-06-01,1639173370,C013030,스웨터,[빅브라더]빅사이즈니트/가디건/폴라티/터틀넥/브이넥,29920,29920,0
2018-06-01,535278261,L021020,장신구,원석팔찌 161-0393-B/ 에디포스,87000,82650,-4350
2018-06-01,88845785,C012040,여자학생복,[MLB]엠엘비 3종택1 남여공용 소매박스로고 MLB 후드집업(31TRS1811),79000,67150,-11850
2018-06-01,2126979672,C013010,점퍼,까르뜨블랑슈 여름(CMM8WJ61)비지니스 블랙 스포티 써커 자켓,250600,208000,-42600
2018-06-01,1433578156,A019090,카레,S&B골든커리220g/하우스바몬드카레230g/일본카레,3050,3050,0
2018-06-01,411220879,E011020,침대,마사지침대  경락베드  때밀이침대  안마침대,95000,95000,0
2018-06-01,897708786,A019090,카레,청정원 카레여왕(분말) 망고&바나나 108G,3650,3650,0
2018-06-01,958507592,A011110,당면,초L프레시)실속두부 (520G),4790,1990,-2800
2018-06-01,123750919,C013050,운동복,분말소화기3.3k(한울or조경),29900,29900,0
2018-06-01,1165555161,C012040,여자학생복,멀티스트라이프니트 (J11PNT187)/ 매그제이(MAGJAY),25900,23310,-2590
2018-06-01,1869012785,C012030,여자상의,[더봄] 오늘도 예쁜 로맨틱 여성의류 특가,18900,18900,0
2018-06-01,1326777564,C013050,운동복,[오토컴] 스마트브라운_접이식콘솔박스 자동차수납함 콘솔박스,26210,23880,-2330
2018-06-01,389235930,C015030,넥타이,(색상 : 옐로우) BTIE_063 분홍점 옐로우 보,12740,12740,0
2018-06-01,419750526,C013050,운동복,삼정 성에제거기 특대 삼정성에제거기 성에제거 차량,7700,7020,-680
2018-06-01,1209432584,C013040,청바지,[Blouson]쿨링 밴딩 포켓 반배기 팬츠_[B1806PT061B],16000,14230,-1770
2018-06-01,13200441,F012050,의료측정기,오므론 프리미엄 혈압계 택1(HEM-7320/HEM-7310),138000,128000,-10000
2018-06-01,369096679,C015040,장갑,부드러운 여성 여자 망사 장갑 망사장갑 (낱개판매),2100,2100,0
2018-06-01,564527857,C013050,운동복,세줄트레이닝바지/ 츄리링/두줄체육복/반바지,8900,8900,0
2018-06-01,1671036839,A011080,밀가루,복만네 콩가루850g+복만네 콩국수 1.5kg(무료배송),10750,10750,0
2018-06-01,1751239997,C014010,아동복,아동남방/남아정장/유아셔츠/돌복/아동복/흰남방,17900,17900,0
2018-06-01,989908296,E041030,솥,PN풍년 뉴 하이클래드IH하이브 압력솥/압력밥솥 4인용(사은품: 지홈 우드 밥주걱),139600,88700,-50900
2018-06-01,989908297,E041030,솥,PN풍년 뉴하이클래드IH하이브 압력솥/압력밥솥 6인용(사은품: 지홈 우드 밥주걱),146730,93000,-53730
2018-06-01,1464333835,A022010,주스,오뚜기시럽 슬러시 슬러시시럽 스러시원액 슬러쉬원액,2890,2890,0
2018-06-01,989908298,E041030,솥,PN풍년 뉴 하이클래드IH하이브 압력솥/압력밥솥 8인용(사은품: 지홈 우드 밥주걱),155650,98500,-57150
2018-06-01,989908299,E041030,솥,PN풍년 뉴 하이클래드IH하이브 압력솥/압력밥솥 10인용(사은품: 지홈 우드 밥주걱),187000,104500,-82500
2018-06-01,1649453423,C011030,남자학생복,[STCO] 봄/여름 셔츠/티셔츠 6 900원~무배,9900,9900,0
2018-06-01,1436333160,E031070,에어컨,벽걸이선풍기/영업용선풍기/업소용선풍기/특가모음전,19400,19400,0
2018-06-01,60093193,C021040,실내화,아디다스 볼루믹스 슬리퍼 AQ5898 S80406 cp9445 6 7,24900,21170,-3730
2018-06-01,989137481,A017280,김,초L)김밥단무지 350G,2180,2180,0
2018-06-01,2047041674,E031120,믹서,한일 티타늄골드믹서기 HMF-3500TG/마늘박피판증정,118000,116820,-1180
2018-06-01,1579471631,C012060,여자내의,푸조 워테레깅스 ( S26-3 ),28540,25690,-2850
2018-06-01,1395610290,C013010,점퍼,알론트 폴라폴리스 집업점퍼 S~3XL STLD-6620/집업점,35400,33630,-1770
2018-06-01,253863291,A011080,밀가루,백제 쌀국수20개 30개 쌀떡국 선택구매 현진포커스,19900,19900,0
2018-06-01,244109090,A017020,상추,친환경 모듬 쌈채소 1kg/500g 밥선생,6900,6900,0
2018-06-01,1188039533,E021010,침구,최고급 호텔침구납품업체 이불커버/베개커버/매트커버,13900,13900,0
2018-06-01,2147212944,C013010,점퍼,네파키즈 센트로 바람막이점퍼 KDD0600/ 네파키즈,39600,32480,-7120
2018-06-01,1024312995,A014020,분유,(10팩) 0~24M 베비언스 액상분유 180/240ml,11900,11900,0
2018-06-01,894099331,A016040,포도,동원)황도 슬라이스 400g x 12개 사시사철 맛있는,41360,41360,0
2018-06-01,989908273,E041030,솥,PN풍년 뉴 하이클래드IH하이브 압력솥/압력밥솥 2인용（사은품: 지홈 우드 밥주걱）,101900,84500,-17400
2018-06-01,255063544,C012060,여자내의,미샤 세미 정장 일자 슬랙스 슬림핏 팬츠 여성바지,19900,19900,0
2018-06-01,1331221584,E031050,냉장고,인증점P 삼성 김치냉장고 RQ28M6102S8 전국무료,850000,799000,-51000
2018-06-01,1126403206,E011050,책상,/코너높이조절책상L 화이트 블랙 베칸트 160x110 cm/,1077590,959060,-118530
2018-06-01,1009287768,E011050,책상,데이지 내츄럴/화이트/티크 테이블/다용도테이블/2인,29000,29000,0
2018-06-01,408206209,I031010,장난감,매직 물풍선 제조기 (37개x3봉지 총111개),5900,5900,0
2018-06-01,1674983213,E011040,소파,아로미가구 인조가죽/소가죽 4인용소파 모음전,399000,399000,0
2018-06-01,1966970885,C014010,아동복,[네파키즈]리가트레이닝세트(KDD5909)(광주신세계),27870,27870,0
2018-06-01,526479150,I031040,생화,캠핑샤워실/캠프샤워/간이화장실/샤워텐트/간이탈의실,19800,18220,-1580
2018-06-01,1122627533,E041010,식기,루미낙 루미락 나뭇잎 습접시20.5x46p,42200,40090,-2110
2018-06-01,1059696854,C012040,여자학생복,스퀘어넥롱원피스 (J11POP076)/ 매그제이(MAGJAY),69900,62910,-6990
2018-06-01,1059696852,C012040,여자학생복,패턴나염블라우스 (J11PBL088)/ 매그제이(MAGJAY),34900,31410,-3490
2018-06-01,689355448,C011030,남자학생복,잭루이스 2018 봄여름 린넨_헨리넥_체크_7부 셔츠모음,16700,16700,0
2018-06-01,609602091,L012030,칫솔,20%쿠폰! [오랄비X리스테린]패키지+파우치 15 120원~,18900,18900,0
2018-06-01,1240801552,C013020,티셔츠,아스토레 JSG-LSTW10006 골프 캐주얼 카라티셔츠(PP),64950,64950,0
2018-06-01,1532712176,A011170,떡,[칠갑농산]뜨거운 물로 바로먹는 똑쌀떡국/12개입1박스,19800,19800,0
2018-06-01,80337457,C012060,여자내의,[딱!5일간무료배송]C564S_최강스판 베이직 면3부 팬츠,19900,19900,0
2018-06-01,410076136,L012090,기초화장품,제이앤씨 98% 알로에베라 프리미엄 슈퍼겔 240ml,23000,21840,-1160
2018-06-01,2014002289,C013020,티셔츠,크리스찬오자르 남녀 카라 티셔츠 균일가전!,7900,7900,0
2018-06-01,895701724,L021050,우산,검정폰지 바이어스 패션우산 14k장우산 무지개우산,4400,4200,-200
2018-06-01,899358646,C013040,청바지,[젤리스푼]시원한간지배기데님팬츠,20900,18810,-2090
2018-06-01,1811290153,C011050,남자내의,카고바지/빅사이즈/조거/면/스판/건빵/카모/남자/남성,23800,23800,0
2018-06-01,2023549329,E031020,가스레인지,SK매직 Eco버너 고화력 2구 가스렌지 GRA-820SR,150000,150000,0
2018-06-01,1954293284,E031110,청소기,신일 롤링스턴 SDC-S7000WO 스팀청소기 물걸레 겸용,139000,139000,0
2018-06-01,1081446131,A013140,북어채,[가온애]시원한국물용 황태머리 북어머리 국내건조 황태채 황태포 황태구이 북어포 북,6900,6900,0
2018-06-01,1421124718,F012010,종이기저귀,18년형 군기저귀 오리지널/프리미엄/원터팬티,38900,38900,0
2018-06-01,2028505718,C013040,청바지,남자청바지 디스트로이드 슬림 밴딩 바지 BX0717002,47890,47890,0
2018-06-01,989911895,E051020,건전지,에너자이저절약형충전기340G,26800,26800,0
2018-06-01,1570601018,I031040,생화,[K2]케이투 JACLYN 12 배낭 KMA17B14,88000,80960,-7040
2018-06-01,4657779,E011020,침대,[잉글랜더]아이비 멀티 수납침대/슈퍼싱글침대/퀸침대,115900,115900,0
2018-06-01,1010254559,A014040,발효유,푸르밀 비타요구킹 900ML,1280,990,-290
2018-06-01,1897250572,C013050,운동복,차량용소화기/휴대용소화기/간이소화기/미니소화기,13400,12330,-1070
2018-06-01,2095151832,C013050,운동복,토드 다용도 트렁크 콘솔박스,14020,14020,0
2018-06-01,644031987,C013020,티셔츠,한두장으로는 모자라! 베스트 반팔티셔츠 M~XXL,15900,9900,-6000
2018-06-01,1171347564,C012030,여자상의,빅사이즈민짱/무배/가벼운니트모음/55-100/스웨터,16900,16900,0
2018-06-01,1462878699,C013010,점퍼,[머스트비] Y 아일렛 변형 박시 점퍼 FMKFCUA532M_NAA/ 머스트비,38900,38900,0
2018-06-01,537626805,C013020,티셔츠,프린트스타 32수 무지 라운드 반팔티셔츠 00083-BBT,4500,3900,-600
2018-06-01,1029375665,C013020,티셔츠,RT6 빅사이즈 헨리넥7부남자긴팔면티셔츠,51370,50350,-1020
2018-06-01,1134504186,C013040,청바지,봄신상입고/아동 주니어 청바지/스키니/스판/밴드/,9900,9900,0
2018-06-01,1088025698,A017120,고구마,2018년 포근포근 노지감자 5/10kg,10000,10000,0
2018-06-01,473189009,C013040,청바지,ACCHT8053 오버 데미지 데님 5부팬츠 5부바지 남자여,36010,36010,0
2018-06-01,982436402,A018020,사탕,[롯데]롯데 폭신폭신 말랑카우(158G),4200,4200,0
2018-06-01,2013947693,C012040,여자학생복,[리스트] 일러스트 썸머키키 프린트 카라 셔츠/ 리스트,14800,13620,-1180
2018-06-01,794569712,C011050,남자내의,[백화점SAY][티비제이]남성 밴딩 팬츠(T182PT260P),29900,21740,-8160
2018-06-01,1121543490,F012020,생리대,엘리스 생리대 메가미 슬림 날개 소중형 20P x 2팩/ 엘리스,10500,9980,-520
2018-06-01,1783241665,L021020,장신구,[바보사랑]4004 스퀘어 이어링 (2colors),10000,10000,0
2018-06-01,982436405,A018020,사탕,[롯데]롯데 아이스 브레이커스 쿨민트42G,2900,2900,0
2018-06-01,1339063247,C015040,장갑,투버클 포인트 피혁장갑(여성) 장갑 가죽장갑 여자장,12320,12320,0
2018-06-01,394677825,E011040,소파,레이디가구 스위트홈 패밀리홈 발수코팅 패브릭 소파,343010,308710,-34300
2018-06-01,1561926299,C013010,점퍼,[모다아울렛][후라밍고]누빔패딩 (F8071030베이지 네이비),179000,157520,-21480
2018-06-01,1099390477,A013080,조개,왕중왕 해물나라 900g2개,36190,36190,0
2018-06-01,2119586219,C013010,점퍼,여름 청자켓 남자 남성 데님 점퍼 워싱 남방 빈티지,25800,25800,0
2018-06-01,407185756,D031010,주택수선재료,소리담 층간소음방지매트 보온보냉 장판 DIY 바닥재,8000,7000,-1000
2018-06-01,1499500939,C012030,여자상의,냉장고 쿨 원피스 린넨 빅사이즈 홈웨어 잠옷 임부복,5900,5900,0
2018-06-01,475190768,C011030,남자학생복,오투_쿨링타올(프리미엄) 아이스타올 쿨링타올 얼음타,23390,23390,0
2018-06-01,978380354,C015040,장갑,휴몬트 등산장갑 춘추하계 스마트폰터치,9900,8870,-1030
2018-06-01,587888981,C012060,여자내의,데일리먼데이 Vintage unbal denim skirt/스커트/ 데일리먼데이,26500,22530,-3970
2018-06-01,1516701018,A013070,굴,다인 생새우살(31/50) 실중량200g/냉동새우/새우살,4300,4300,0
2018-06-01,1567291277,C013020,티셔츠,(OR)고양이와펜티셔츠(36313-332-01)/ 밍크뮤,16000,15200,-800
2018-06-01,1237018955,C012040,여자학생복,쉬즈미스 프런트 버튼 가디건_SSKCDG70020_KH/ 쉬즈미스,29000,23490,-5510
2018-06-01,857920701,F011130,홍삼,우리가족 건강! 한뿌리로 지키세요~,32700,32700,0
2018-06-01,126600839,C012030,여자상의,봄원피스/오피스룩/하객룩/결혼식/럭셔리원피스,54900,44900,-10000
2018-06-01,769989661,E061030,전구,LED 볼전구 모음/인테리어 전구/인테리어 조명,3100,3100,0
2018-06-01,1011182890,A012010,국산쇠고기,안심 500g (1+등급),60000,54900,-5100
2018-06-01,1691099217,A017080,무,1+1 양배추즙 총60포 해썹인증 자람푸드 홈플러스,17900,17900,0
2018-06-01,1460807643,G022020,자동차타이어,금호타이어 마제스티 솔루스 KU50 245/45R18 무료배송,144800,123080,-21720
2018-06-01,856088644,D031010,주택수선재료,[월데코]풀바른 합지벽지 간편한 셀프도배 [폭93cm],2890,2890,0
2018-06-01,2118181677,C013040,청바지,아둘 패밀리룩 여름 반팔 조던 쥬니어 상하세트 36,15900,15900,0
2018-06-01,507271702,C013010,점퍼,[펠틱스][펠틱스] 남성 뉴욕 후드 점퍼 FEQBMJP01,17900,17010,-890
2018-06-01,929305375,C013010,점퍼,[패션플러스][플레이팝][플레이팝]글램S점퍼,54900,50510,-4390
2018-06-01,1212901112,E011050,책상,카멜책상 사무용 컴퓨터 2인용 수강용 회의용 테이블,59900,59900,0
2018-06-01,492281258,C013020,티셔츠,[플리츠미] 밑단 자수 레이스 블라우스,159200,127360,-31840
2018-06-01,819571315,C013050,운동복,K-345 스타렉스 2004후사경 자동차후사경 차량용후사,21650,19270,-2380
2018-06-01,776030239,A011130,시리얼,백설 부침가루 500gx20개,49170,43770,-5400
2018-06-01,786373790,C013020,티셔츠,헨리넥 긴팔티/브이넥/나그랑/무지티/티셔츠/티/7부티,7900,7900,0
2018-06-01,238812107,C015020,모자,(COLOR : 네이비) MC-019 투버튼 포인트 군,12740,12740,0
2018-06-01,984544862,L012010,면도기,[P&G]질레트 프로글라이드 플렉스볼 파워 1UP 면도기,19900,19900,0
2018-06-01,1396515734,A019140,이유식,[미즈앤코 우리애들밥상] 3분간편 한끼 죽 (7종택1),7440,7440,0
2018-06-01,1252995349,C012030,여자상의,44~110 나봉월드 쉬폰 플라워 빅사이즈 봄 여름원피스,9900,9900,0
2018-06-01,266523501,C013050,운동복,RO 반팔 트레이닝복세트 남자 츄리닝 SETRO-s801,18800,18800,0
2018-06-01,479447105,A022020,두유,삼육 검은콩 칼슘195ml 48/72팩/950ml 12팩/블랙푸드,20000,20000,0
2018-06-01,1606124496,E061020,섬유유연제,다우니 대용량 섬유유연제 3L x 2개 / 5.03L / 8.5L,14800,14800,0
2018-06-01,133846821,C012040,여자학생복,[포에버21]후드 니트/FOREVER21/니트/스웨터/후드니트,37900,26530,-11370
2018-06-01,989908208,E041040,프라이팬,라체나세라믹냄비24cm,19900,19900,0
2018-06-01,371023199,C021040,실내화,[아디다스]정품/울트라부스트클라이마/BY8888/런닝화,191000,176000,-15000
2018-06-01,1700701801,C013010,점퍼,[파파브로][HAN-HA6-2-민트]밴드 잔체크 반팔점퍼,39600,39600,0
2018-06-01,1856508999,L012090,기초화장품,클린 잇 제로 대용량(180ml)/리뉴얼/클린잇제로,15400,15400,0
2018-06-01,1427622994,E031110,청소기,BSW 핸디스팀 청소기 BS-1509-HSC 고온살균/소독/스팀,26800,22900,-3900
2018-06-01,106813803,I053030,복사용지,한솔 A4 복사용지(A4용지) 복사지 80g 2박스/더블에이,38960,33510,-5450
2018-06-01,442814834,E061030,전구,[직관형광등 모음전] 40w 36w 32w 30w 20w 10w 15w 삼,40000,40000,0
2018-06-01,1741875638,A019080,고추장,순창 태양초 실속고추장14kg 업소용/대용량/식자재,20500,20500,0
2018-06-01,1458901374,E011060,의자,보조의자 풋레스트 스툴,32000,31340,-660
2018-06-01,1011182885,A012010,국산쇠고기,등심 500g (1+등급),60000,50000,-10000
2018-06-01,2069080855,A013170,생선통조림,동표 골뱅이 400g 번데기 안주,6080,6080,0
2018-06-01,311689752,I031070,애완동물관리비,15 프로케넥스 테니스라켓 키네틱 Ki 15 (260g) BL/ Kinetic,191400,160020,-31380
2018-06-01,1037511566,F012020,생리대,좋은느낌 오가닉 수퍼롱 오버나이트 16x2,16700,15940,-760
2018-06-01,389811618,F012020,생리대,템포 (레귤라/슈퍼)10Px10개 / 혼합주문가능,32500,32500,0
2018-06-01,862662315,A013030,조기,영광굴비/굴비/선물세트/특/참굴비/참조기/1.6kg/10미,449900,449900,0
2018-06-01,16857225,C013020,티셔츠,[앨빈클로]봄신상 무지 맨투맨 후드티 집업 긴팔 커플,25000,14900,-10100
2018-06-01,501182314,C012060,여자내의,허리밴딩 패턴 플리츠 스커트 (VQSAC2309)/ 이사베이,29000,26100,-2900
2018-06-01,984280621,A019030,생강,프L)유기농깐마늘 (180G/봉),5990,5990,0
2018-06-01,1325610555,L021010,손목시계,Nibosi 남성 메탈 손목시계 크로노기능 No.2322 블랙,59900,59900,0
2018-06-01,1812690935,C013050,운동복,차량 경고음 방지 벨트 클립 안전벨트 BMW 벤츠 아우,5000,4850,-150
2018-06-01,579929593,C014010,아동복,남아 여아 트레이닝 어린이집 유치원 아동복,11900,11900,0
2018-06-01,857919748,F011130,홍삼,눈건강/뼈건강을 위한 의 제안!,4950,4950,0
2018-06-01,1774914852,F011130,홍삼,정관장 홍삼정타브렛(500MG*240),160000,160000,0
2018-06-01,568183134,A011080,밀가루,칠갑농산 우리쌀국수 77.5gx18개/매운/멸치/북어맛,27000,27000,0
2018-06-01,2110407207,E021010,침구,굿몽 이불+패드+세트(+솜증정) 기숙사 이불패드세트,36900,36900,0
2018-06-01,455670903,A013090,전복,섬진강 재첩진국 500gX5팩 /총 2.5kg / 속풀이에 탁월한 재첩국 /시원한 재첩국,37000,36000,-1000
2018-06-01,1271191256,A012060,햄및베이컨,선진FS 베이컨 스트립 1kg,29840,29840,0
2018-06-01,1196660943,C012040,여자학생복,홈쇼핑 엘리스블루 여성가디건 반팔 젤리퍼 청바지,9900,9900,0
2018-06-01,1889146267,C013050,운동복,트레이닝복 세트 츄리닝 바지 남자 남성 운동복 헬스,17800,17800,0
2018-06-01,983391700,A013170,생선통조림,[사조]사조 살코기+마일드참치기획(안심따개) 100G*6입,11900,6990,-4910
2018-06-01,1699776233,C013020,티셔츠,자수무료 작업복티 반팔티 긴팔티 쿨론티 기능성티,10000,10000,0
2018-06-01,984544831,E061030,전구,GE)할로겐4 2W 2입,6900,6900,0
2018-06-01,299802698,C013020,티셔츠,브라탑/나시/런닝/노와이어/탑/롱/티/캡/스포츠브라,8900,7900,-1000
2018-06-01,282314543,E061040,부엌용세제,[아스토니쉬] 찌든때 클리너 500g /주방세정제/주방세제,9900,9900,0
2018-06-01,2048257490,L021060,유모차,크라운에스S 유모차 체리캐롯 절충형 양대면 디럭스형,510000,510000,0
2018-06-01,1419254445,A018090,잼,트라피스트수녀원 유기포도잼x410g 포도잼 유기포도쨈,14360,14360,0
2018-06-01,1001347613,A013170,생선통조림,골뱅이캔 (자연산 삼포140g) x48,193990,193990,0
2018-06-01,1953272625,I031010,장난감,S_B PS4 플레이스테이션4 Slim 500G/1TB,639830,639830,0
2018-06-01,76775915,C014010,아동복,(숲자람) 기능성 키즈 바람막이 유아용바람막이 바람,71160,71160,0
2018-06-01,524830165,A011050,콩,[가온애]과자 스낵류 주전부리 콘 강정 깨강정 찹쌀땅콩 해씨볼 고구마스틱 초코볼 땅,3900,3900,0
2018-06-01,823196758,C013020,티셔츠,[블루독베이비](RD)레트로STRIPE티셔츠 (47314-332-07M),26000,22100,-3900
2018-06-01,1187486193,A013150,어묵,삼진어묵 해물맛 모듬어묵 3개/ 삼진어묵,30000,30000,0
2018-06-01,375430837,A013090,전복,키조개 관자1kg(급냉) /15개~22개내외/국내산 /무료배송,43500,41900,-1600
2018-06-01,1009550151,C021040,실내화,여성 스니커즈 키높이 운동화 슬립온 통굽 웨지힐,28700,28700,0
2018-06-01,1354364065,C013020,티셔츠,심플 후드집업 LTT0043 여성후드집업 트레이닝복,30210,29610,-600
2018-06-01,379579473,C014020,유아복,삐삐롱 순면 여자 아이 아동 여아 민소매 나시 반바지,10440,10440,0
2018-06-01,1404633588,G011070,자전거,스타카토 미니벨로 접이식자전거 스튜어트20GS 7단,97000,87300,-9700
2018-06-01,1479410375,A017160,오이,[농협]무농약 청정지역 장성 새송이버섯 정품 2kg이내,7900,7900,0
2018-06-01,1660506993,I012010,컴퓨터,DB-P400 i5-2500 4G SSD120G+SATA-500G GTX650 WIN10,389000,389000,0
2018-06-01,984341967,L012090,기초화장품,[LG]베비언스 베이비 로션 250ML,12900,12900,0
2018-06-01,957738579,A019110,드레싱,오뚜기 키위 드레싱(255G),2980,2980,0
2018-06-01,1771893095,E031130,보온매트,#“ TV홈쇼핑정품”#고급매트 전자파방지 온사랑 매트 고급형 [퀸사이즈]새싹절전형/황,168000,166320,-1680
2018-06-01,289424027,A017180,호박,가을 청양 고추가루 2.5kg,53100,51510,-1590
2018-06-01,2124730309,C012030,여자상의,앨리스 민소매 롱니트 KD 민소매니트원피스 여성롱니,40230,40230,0
2018-06-01,818716330,A017120,고구마,[농협] 수미감자 10kg(왕특/개당150-250g),36800,36800,0
2018-06-01,1837706091,C015040,장갑,[카르닉] 스포츠 등산장갑/자전거장갑(긴장갑/반장갑),8900,8900,0
2018-06-01,939404124,L012060,샴푸,정유미 샴푸! 더마앤모어 샴푸/린스 600ml x2개,12900,12900,0
2018-06-01,1340380287,E061020,섬유유연제,샤프란 아로마시트 50매 x3개 시트형 섬유유연제 티슈,22800,22800,0
2018-06-01,1271278703,C011020,남자상의,여름 강아지 마 싱글수트-네이비 리즈코 남자옷도매,193900,174510,-19390
2018-06-01,1063910436,A014030,치즈,델리치푸드/코리원 모짜렐라치즈 2.5kg/피자/치즈,18500,18500,0
2018-06-01,1731005696,A017120,고구마,{햇 감자 수확} 18년산 감자 10kg/20kg(중/대/특),15900,15900,0
2018-06-01,1838477273,C013020,티셔츠,후드티셔츠 롱후드 신상 롱후드 빅사이즈 허밍퍼플,20000,19800,-200
2018-06-01,348746767,D031010,주택수선재료,국산 접착식 본드식 데코타일 3.2㎡ 타일 바닥재 장판,16900,16900,0
2018-06-01,972401781,A013070,굴,살아있는 알베기 암 꽃게1kg(4~6미) 당일조업.직송,39900,39900,0
2018-06-01,1741212916,E041050,냄비,네오플램 뽀떼 인덕션 5종 냄비세트/인덕션냄비/냄비,189000,179000,-10000
2018-06-01,109710205,A017040,양배추,(면)(냉동)청학 부추1kg,4820,4820,0
2018-06-01,1812168644,L021060,유모차,미래형 진화 유모차 기내반입 휴대용 세스토라이트T,210000,210000,0
2018-06-01,77410591,E011060,의자,원사출 간이의자/보조의자/식탁의자/화장대의자,15900,14900,-1000
2018-06-01,679567019,A011120,두부,포스트 아몬드후레이크 1kg+증정[시리얼/씨리얼],8900,8900,0
2018-06-01,1496116256,C012040,여자학생복,[레티노][레티노] 벌키숄카라 니트_(R503),20900,19860,-1040
2018-06-01,1683816047,E041020,컵,리자인 도자기 커피 머그컵 카페 머그잔 모음,2600,2470,-130
2018-06-01,382050486,E041050,냄비,통3중 스텐 편수냄비16cm/ 해피콜,32800,28870,-3930
2018-06-01,1491219559,A013090,전복,두레생협 국산새우살 300g,41360,40120,-1240
2018-06-01,809217448,L021010,손목시계,젤리 아쿠아 방수시계 아쿠아손목시계 패션팔찌시계,12770,12770,0
2018-06-01,2103126938,C013020,티셔츠,[홈런]반팔/7부/라운드/티셔츠/루즈/오버핏/남자/남성,10000,9800,-200
2018-06-01,5813513,A012050,소시지,롯데 의성마늘프랑크 70gx30개 1박스/후랑크/핫바,21900,21900,0
2018-06-01,1148643016,C013020,티셔츠,브랜드특가 쾌적한 골프티셔츠/기능성반팔/골프웨어,24800,17500,-7300
2018-06-01,984544840,L012010,면도기,[P&G]질레트 프로글라이드 플렉스볼 매뉴얼 2UP 면도기,16500,16500,0
2018-06-01,859952656,A011170,떡,(맛나)순쌀떡500g/칠갑,3100,2790,-310
2018-06-01,326949483,C013040,청바지,신상 여성 일자 스키니 반바지 데님 스판 밴딩,12900,12900,0
2018-06-01,2100575732,E021020,커튼,유로피안 프리미엄 플라워 모기장 침대캐노피 캐노피,58570,58570,0
2018-06-01,635638462,F012020,생리대,위스퍼 슈퍼 롱 오버나이트 10P,3440,3440,0
2018-06-01,1220040442,A017090,열무,국내산 100% 무말랭이 600g / 무우말랭이 무말랭이차,8000,8000,0
2018-06-01,989078744,A019180,즉석식품,대광 돈육훈제바베큐 400G*2,15800,12900,-2900
2018-06-01,1469370101,E011060,의자,[BC체어]컴퓨터 책상 pc방 사무실 학생 공부 메쉬의자,21400,19260,-2140
2018-06-01,1123878603,E011030,거실장,뷰로 뉴욕소파,455000,455000,0
2018-06-01,1123878604,E011030,거실장,뷰로 노블소파,455000,455000,0
2018-06-01,663553556,A012030,돼지고기,[산지직송]산청흑돼지 삼겹살/목살1kg(밑반찬증정),7000,7000,0
2018-06-01,251828572,A018100,꿀,지리산 토종꿀 병꿀1.2kg or 2.4kg/뱀사골 한봉꿀,44000,41800,-2200
2018-06-01,957643660,A018040,아이스크림,위즐 바닐라 피칸 3개,16500,12000,-4500
2018-06-01,631946450,A016060,감,달콤샤르르 자연그대로 만든 아이스 왕 홍시 18개(컵),43300,38110,-5190
2018-06-01,1778651057,L021020,장신구,[바보사랑][액세서리키친] 925실버 Oval 반지 A7910R001,58900,58900,0
2018-06-01,1778651056,L021020,장신구,[바보사랑][합격열쇠] 행운의 클로버키 실버목걸이 A7902N001,25900,25900,0
2018-06-01,954150157,A013090,전복,다인 키조개관자 800g 게아지살 가이바시 관자살,21000,21000,0
2018-06-01,339020968,C012040,여자학생복,[2001OUTLET] [JESSINEWYORK] 제시뉴욕 두겹 나시 J725NPTZ516S,34300,33280,-1020
2018-06-01,443837549,C013010,점퍼,USD451_3107_D.OR 등산자켓 남성잠바 등산점퍼 남성아,57000,56430,-570
2018-06-01,895774511,A013180,젓갈,[일미]일미 양념우엉 (150G),3080,3080,0
2018-06-01,391982587,A011100,라면,버미셀리(M F 250g)X6 버미셀리파스타면 파스타면 식,16960,15270,-1690
2018-06-01,895774510,A017280,김,[일미]일미 고기 쌈무 (350G),2550,2550,0
2018-06-01,1686321496,I011010,TV,(공식파트너)삼성 108cm UHD TV UN43MU6300FXKR,981000,669000,-312000
2018-06-01,1778651059,L021020,장신구,[바보사랑][액세서리키친] 925실버 좋은기운가득 천연원석 반지,35900,35900,0
2018-06-01,1778651058,L021020,장신구,[바보사랑][액세서리키친] 925실버 좋은기운가득 천연원석 반지-오닉스,35900,35900,0
2018-06-01,852129537,A011110,당면,국산 콩100% 쌈두부 면두부 샐러드용 저칼로리 식단,3200,3200,0
2018-06-01,1057513009,I031040,생화,[HEAD]헤드녹차물병/녹차물병/물병/물통/녹차물통,1300,1170,-130
2018-06-01,606825880,C012030,여자상의,전상품 균일가로 전부 담기! 비바잉 롱원피스/쉬폰,8900,8900,0
2018-06-01,282290057,A014020,분유,순산양유아식 3단계 400g/ 아이배냇,16900,16900,0
2018-06-01,1424708785,A016100,수박,수박 7kg 8kg 9kg 2통 세트/국내산/최상품/팜웨이,32000,32000,0
2018-06-01,1241560686,C013020,티셔츠,MD추천 프리미엄 PK / 팬츠 / 반팔티,20900,18900,-2000
2018-06-01,1778651060,L021020,장신구,[바보사랑][액세서리키친] 925실버 Vintage 반지 2종택1,38900,38900,0
2018-06-01,1987704479,C013020,티셔츠,롱원피스/티셔츠 신상 블라우스 빅사이즈 허밍퍼플,25800,25800,0
2018-06-01,1134421982,C015040,장갑,등산장갑 스포츠장갑 기능성장갑 기모장갑 고급장갑,6800,6800,0
2018-06-01,26873134,C013020,티셔츠,알마니 여성 95 빈티지 면 브이넥 반팔 티 핫픽스장식,26930,26930,0
2018-06-01,1752826105,L021010,손목시계,[바보사랑]제이로렌 ETC0012 레트로 유광 브라운가죽 빈티지시계,49000,49000,0
2018-06-01,2055720231,C013010,점퍼,빅사이즈 야상 딜러자켓 BW 바람막이 점퍼 남자바람막,88310,88310,0
2018-06-01,881330175,C013020,티셔츠,사각그물티/레이어드/레이스티/시스루/커버업/망사티,7900,7900,0
2018-06-01,145568783,E041060,수저,H.JIN 금수저/은수저세트/부모님/외국인선물/답례품,24000,24000,0
2018-06-01,2051366863,C013010,점퍼,[푸마] (사이즈 : 2XL(110)) 아스널 컵 롱 벤치,206530,206530,0
2018-06-01,1225174062,A022010,주스,무배 프로푸드 열대과일 주스 250ml 10캔 5종中선택,17570,17570,0
2018-06-01,52450013,C011050,남자내의,[지오다노]여 슬림핏 슬랙스 418505(영등포점B),39800,32820,-6980
2018-06-01,525275384,A014040,발효유,[동원] 덴마크 요거트 플레인 400g×12개,23900,23900,0
2018-06-01,2059872589,E031110,청소기,아이룸 AST-008 무선청소기 진공청소기 차이슨 청소기,98000,98000,0
2018-06-01,81615900,E061100,습기제거제,[초특가]제습제X12개 /물먹는하마/G-life/피죤/홈스타,13000,10600,-2400
2018-06-01,286525042,E021020,커튼,실커튼/실커텐 가로3mx세로2.8m 비즈발/커튼봉/창엔롤,20000,18900,-1100
2018-06-01,1967773262,C011030,남자학생복,레귤러 아워글래스 패턴 퍼플 셔츠 카라셔츠 컬러셔츠,26270,25490,-780
2018-06-01,847121787,A012060,햄및베이컨,에쓰푸드 통 베이컨 500g/SFOOD/구이/바베큐/돈육,9900,9900,0
2018-06-01,984400810,A019010,고춧가루,초이스엘 고춧가루 300G,15900,15900,0
2018-06-01,900364024,A018030,껌,롯데 자일리톨 알파 리필 (84G),4000,4000,0
2018-06-01,565211386,L012090,기초화장품,셀레피덤 스킨케어모음전/토너.로션.크림.비비.에센스,19500,19500,0
2018-06-01,264297447,I053010,공책,풀디자인 기억보관함 라인_미디움/양장노트/유선노트,18320,18320,0
2018-06-01,895774534,A017280,김,[일미]일미 치자 단무지 (350G),3290,3290,0
2018-06-01,511337072,C013020,티셔츠,[시에로][18F/W] OSLO 호일프린트 반팔티셔츠 (SE3TSF125)[갤러리아],69000,53130,-15870
2018-06-01,1234433477,C013030,스웨터,삼색단가라 목폴라 짚업니트자켓 가디건 니트 짚업점,54500,53410,-1090
2018-06-01,864828795,F012010,종이기저귀,18년형 군기저귀1팩/오리지널/프리미엄/윈터팬티밴드,12450,12450,0
2018-06-01,1123815023,E031080,선풍기,엠엔 카본 히터 MNS-C30P,64600,64600,0
2018-06-01,393713159,C013050,운동복,아디다스 렌기 라이트 니트 수트 세트(AJ1291) 남자체,141960,141960,0
2018-06-01,307087162,C011030,남자학생복,[쿠비코][쿠비코]따뜻한 폴라폴리스 집업조끼 COV-MGB689,19800,15840,-3960
2018-06-01,1762240756,C013040,청바지,정품LEVIS 리바이스청바지 반바지 카고 일자 빅사이즈,28400,28400,0
2018-06-01,689015528,F012020,생리대,[위스퍼][슈퍼롱팩] 피부애 슈퍼슬림 슈퍼롱10P x 3팩,16300,15760,-540
2018-06-01,1296464131,C011050,남자내의,남성/면바지/9부바지/린넨팬츠/썸머/밴딩바지/봄/여름,17500,17500,0
2018-06-01,333229105,C012060,여자내의,런샵 쏙쏙 기모 고리 레깅스 DK-1930 레깅스 양말 스타킹타이즈 쫄바지 치마레깅스 레,6700,5360,-1340
2018-06-01,1991307684,C015020,모자,볼캡 야구 군모 무지모자 큰모자 여름 여성 남자 모자,10000,10000,0
2018-06-01,921607501,E031020,가스레인지,(사은품증정) 무연무수 2구 가스렌지+그릴 GRA-C2100R,259000,259000,0
2018-06-01,2071045969,C012040,여자학생복,빅사이즈/소라/줄지/배색/셔츠 / 참고 미시옷 임부복,57500,48880,-8620
2018-06-01,387343478,C011030,남자학생복,꾸제꾸제/SYSTEM 니트 가디건/여성 M/울혼방/스웨터/세일/브랜드/빈티지/구제 중고/시,16900,16900,0
2018-06-01,1117423557,L012090,기초화장품,마몽드 맨 리차징 크림 50ml 수분크림 보습크림 맨크,16910,16910,0
2018-06-01,1388654374,A011100,라면,중국당면 녹두납작당면 180g2봉,3600,3600,0
2018-06-01,1002889670,E011030,거실장,[채우리] 리차드 1800 거실장,835000,835000,0
2018-06-01,989137606,A016160,과일가공품,감숙왕바나나(1.2KG내외),4990,4990,0
2018-06-01,660086004,C013040,청바지,[폴햄] PHY2DP1022 남성용 아이스 슬림진 데님 팬츠 청바지,35900,29440,-6460
2018-06-01,1088870405,E031080,선풍기,Mill_ 프리미엄 가정용 전기 라디에이터 MOH-700MW,182000,182000,0
2018-06-01,1088870403,E031080,선풍기,나노전자_욕실히터 벽걸이형 3구 NC-H3D,74000,74000,0
2018-06-01,1088870402,E031080,선풍기,나노전자_욕실히터 벽걸이형 2구 NI-R2,69000,69000,0
2018-06-01,1352462033,E011060,의자,의자 피오르환의자/보조의자/빵의자/진찰용/작업/간이의자/인테리어의자/원형/병원/진,31900,31900,0
2018-06-01,1895095509,C012040,여자학생복,[베스티벨리]레이스 스트라이프 가디건 (BMCAE2188)_W7T1,65800,62510,-3290
2018-06-01,806911535,E031020,가스레인지,SK매직 2017년형 POP 2구 가스렌지 골드 GRA-810SR,115000,115000,0
2018-06-01,1266603408,C011030,남자학생복,라피스 린넨셔츠 BTT0187 셔츠 여름셔츠(YA02004) 남,26160,26160,0
2018-06-01,185130324,C013010,점퍼,오리털100%덕다운패딩/경량패딩/오리털패딩/커플패딩,29900,29900,0
2018-06-01,656847409,F012020,생리대,예지미인 울트라슬림 날개 소형 16개입 x 40,177240,177240,0
2018-06-01,50525670,C011030,남자학생복,[로가디스]네이비 재킷형 카디건 (RY715AP11R),92500,72150,-20350
2018-06-01,887005134,C013040,청바지,[블루독](NY)베이직 5부 데님팬츠(27315-414-55),53000,40810,-12190
2018-06-01,76061149,C013040,청바지,구제청치마바지 주니어바지 주니어반바지 주니어치마바지/ 제이키드 주니어,19690,16150,-3540
2018-06-01,1011118281,A013060,게,[근해통발수협] 통발로 잡은 국내산 손질문어 180g x 3팩,30900,23500,-7400
2018-06-01,2064952103,C013040,청바지,[지기젠]신상 스키니/청바지/빅사이즈/팬츠/일자,9900,9900,0
2018-06-01,2079561073,A016160,과일가공품,[베리필드]A등급 아이스블루베리 5kg(1kg x 5봉),34500,33470,-1030
2018-06-01,2110926724,A011050,콩,[가온애]땅콩 분태땅콩 땅콩분태 볶음땅콩 견과류,6900,6900,0
2018-06-01,349192915,C012060,여자내의,[에고이스트]레터링 구제 스키니 데님 팬츠 EH2DP660,84000,65520,-18480
2018-06-01,1105111234,C013020,티셔츠,여름 나시티 빅사이즈나시 루즈핏 쿨링 민소매 롱나시,9800,9800,0
2018-06-01,1308638444,C011020,남자상의,MJ_1136 네이비 더블트렌치 남성트렌치코트 남성자켓,212590,212590,0
2018-06-01,1090774142,E061100,습기제거제,천연 제올라이트/라돈저감/습기제거제/새집증후군,14900,14900,0
2018-06-01,1739920332,D031010,주택수선재료,[노루]목재/철재용 유성페인트 슈퍼에나멜-1L 기본색,8400,8400,0
2018-06-01,391027261,D031010,주택수선재료,베란다 유리창 창문 썬팅지 자외선차단 암막 썬팅 필,34000,33660,-340
2018-06-01,988899122,F011150,건강기능식품,드림앤슬림 다이어트 잔티젠 4주분,48000,48000,0
2018-06-01,961340594,L012080,화장지,초이스L 스마트 에코 티슈 230매,1390,1390,0
2018-06-01,922533367,C013010,점퍼,[체이스컬트]17 SS 남성용 경량 차이나카라 점퍼-GBMK4110C40,49900,47410,-2490
2018-06-01,280139947,A013070,굴,[대게직거래장터]3kg 5kg 러시아대게 홈쇼핑대게,108000,108000,0
2018-06-01,1737069502,F012030,안경,신상국산 메탈안경 패션안경테 동글이 블루라이트차단,9900,9900,0
2018-06-01,1486296788,A018100,꿀,잡화꿀 (다드림 500g) X20,131250,116820,-14430
2018-06-01,895774509,A017280,김,[일미]일미 비타 통단무지 (500G),4990,4990,0
2018-06-01,895774507,A017280,김,[일미]일미 비타 맛 단무지 (250G),2150,2150,0
2018-06-01,895774506,A017280,김,일미 비타김밥단무지 (400G),2790,1990,-800
2018-06-01,162405327,C013010,점퍼,랜더스 남여공용 노르딕 헤비 패딩자켓 ( JK850W ) 블,69780,69780,0
2018-06-01,895774505,A013180,젓갈,[일미]일미 깐마늘 (250G),3590,3590,0
2018-06-01,995759299,A011080,밀가루,오뚜기 옛날국수/소면/중면/3kgx4개/옛날 국수/대용량,25100,25100,0
2018-06-01,266488819,L021020,장신구,[폭스타일] 이즈 러브 반지,8000,7280,-720
2018-06-01,1088870428,E031080,선풍기,Mill_ 프리미엄 가정용 전기 라디에이터 MOH-1500EW,249900,249900,0
2018-06-01,2126150738,C013060,등산복,코오롱쿨론 등산복 등산바지 아웃도어 작업복 반팔티,8460,8460,0
2018-06-01,1088870427,E031080,선풍기,Mill_ 프리미엄 가정용 전기 라디에이터 MOH-1000EW,222800,222800,0
2018-06-01,515370094,I012010,컴퓨터,APPLE Mac MINI MGEN2KH/A / SG / 정품 / 2015년형 맥미니/ 빠른발송,851580,851580,0
2018-06-01,1698958282,C011050,남자내의,SS시즌 남성슬랙스/면바지/린넨/반바지/밴딩/일자팬츠,15800,12800,-3000
2018-06-01,1386306239,C012060,여자내의,#NAME?,30850,29930,-920
2018-06-01,1401803071,I012010,컴퓨터,[특가 134만] 썬더볼트 삼성노트북9 NT900X5T-K58A,1546310,1469000,-77310
2018-06-01,1356276328,C011030,남자학생복,빅오버핏 롱가디건 BMD005 남자가디건 남성가디건(YA0,58400,51400,-7000
2018-06-01,1298462013,C012030,여자상의,데일리 심플 스판 나시 원피스 택1 여성롱원피스 원피,14640,14640,0
2018-06-01,1179760966,C013050,운동복,1_고구마베이비 아기옷-옐로우 공룡 민소매 상하세트,6580,6390,-190
2018-06-01,1825129299,C013050,운동복,모비스 크루저 루프백 자동차루프백 캠핑루프백 차량,254680,227280,-27400
2018-06-01,410980469,A017020,상추,인기상품몬 뉴월남쌈300g(16cm) 2개,12340,12340,0
2018-06-01,1215043723,A022030,생수,[풀무원] 스파클링 아일랜드 4종 20개,12900,12900,0
2018-06-01,719739571,L012010,면도기,도루코 페이스 4 일회용 4중날 면도기 12개,9500,9500,0
2018-06-01,1384247012,C021040,실내화,스카이 9cm 키높이 통굽 운동화 스탠딩화 도우미신발,36900,36900,0
2018-06-01,426058620,C013050,운동복,툴마트백업패드 5/6/7인치 M10/14/16 광택기패드,19900,14650,-5250
2018-06-01,711090767,I012010,컴퓨터,2017년 아이맥iMAC/4G/PC4-2400MHZ/삼성/SK/마이크론,66800,66800,0
2018-06-01,2078540138,I053010,공책,모닝)초등 1-2 무제노트(남)-팩(10권입) 무제노트 문,11920,11920,0
2018-06-01,631478585,C012040,여자학생복,블루페페 니트(P172KSK003),32700,27800,-4900
2018-06-01,1318133120,E061050,청소용세제,대용량 맥스크린 살균제 500ml+4L / 무독성살균소독제 산후조리원 어린이집 병원 소독,24000,22000,-2000
2018-06-01,1002889666,E011030,거실장,[채우리] 리차드 500 협탁,311000,311000,0
2018-06-01,1667447725,C013020,티셔츠,로로텐 롱/루즈핏/라운드/티셔츠 빅사이즈 여성의류,9900,9900,0
2018-06-01,1267614503,C013040,청바지,[R.ROBOT]6부트랙데님팬츠(18329-411-02 03) 2종 중 택1,69000,53130,-15870
2018-06-01,326105603,C013020,티셔츠,캡내장V넥시스루레이스나시/민소매/섹시/무지/망고,5900,5900,0
2018-06-01,1959059820,A017170,풋고추,[농협]한아름드린 백다다기오이3kg,12800,12800,0
2018-06-01,2146587619,C021040,실내화,[아디다스]UNISEX ORIGINALS 퍼포먼스 운동화6종 [CQ20332][CQ2333][CQ2536][DB0374][,44800,37820,-6980
2018-06-01,2101909072,D031010,주택수선재료,[안새내]슁글박사/아스팔트방수/시공방수/방수제/방수,120000,120000,0
2018-06-01,1761263427,I031010,장난감,PS4 프로 USB 허브 주변기기 PRO HUB 악세사리,14850,14850,0
2018-06-01,1524733679,C013010,점퍼,[대구백화점 II관] [레코브]자수 야상점퍼(L9217XBY803X),64000,60800,-3200
2018-06-01,23528606,C013010,점퍼,빈폴키즈 블루 디테처블 다운 아동 점퍼 BK6Y37B30P_S,600000,560000,-40000
2018-06-01,2110674496,C013020,티셔츠,미니멜리사 지그재그샌들 4종MSK182CAM011-JS,57600,57600,0
2018-06-01,1433218607,C015040,장갑,리락쿠마 핸드퍼펫 인형장식장갑 겨울장갑 PC장갑 다,18440,18440,0
2018-06-01,115886246,C011030,남자학생복,오마샤리프 스트라이프셔츠 드레스셔츠 정장/30332NA,18800,18800,0
2018-06-01,1125585300,C015020,모자,남여 무지 볼캡 야구 모자 대두모자,1900,1900,0
2018-06-01,958664178,A016160,과일가공품,DOLE 후룻바틀 황도 (666g),9900,5990,-3910
2018-06-01,535278318,C012030,여자상의,데일리 여성 체크 롱 원피스 세트 정장원피스,19950,19950,0
2018-06-01,2104412879,A019040,소금,해마루 함초 명품 천일염/신안 비금도100%/함초함유,3000,3000,0
2018-06-01,663492112,A016100,수박,델리참_국산가당 딸기 1kg x 10개입 / (주)남양냉동식,94200,80070,-14130
2018-06-01,1119954919,C012020,원피스,[보니알렉스](보니알렉스)노카라 코튼 코트(BCHZ181C),26600,23410,-3190
2018-06-01,1994544515,A019020,참깨,검정깨가루 (한1K),24950,22210,-2740
2018-06-01,1119954925,C012020,원피스,[보니알렉스](보니알렉스)루즈핏 박시 트위드코트(BAHY115A),38800,34150,-4650
2018-06-01,2071261514,C013010,점퍼,펠틱스 역시즌 구스다운/베스트/후드티외 단독특가전!,14900,14900,0
2018-06-01,2099614605,C013020,티셔츠,[앤디애플]데이지플라워롱티셔츠,9900,8910,-990
2018-06-01,1254905486,A022010,주스,웅진)자연은 포도100 180ml12개입 과즙음료 과일음료,15710,15710,0
2018-06-01,1255845720,A015020,식용유,(맛있는 CJ)올리고당 700g x 4개 A13096 - 단맛 찜닭,24030,21390,-2640
2018-06-01,990358701,A022010,주스,카프리썬 200mlx20팩 주스/음료수/어린이음료수,9460,8900,-560
2018-06-01,1119954922,C012020,원피스,[보니알렉스](보니알렉스)트위드 오버 코트(BAHZ180C),29900,26320,-3580
2018-06-01,1604523321,L012110,색조화장품,2018 AHC 내추럴 퍼펙션 선스틱 14g+14g / 썬스틱,17400,17400,0
2018-06-01,1272202381,C013010,점퍼,나이스크랍 폭스퍼카라다운패딩 N174YSG006,207200,207200,0
2018-06-01,816102233,C012060,여자내의,[달리샵]봄신상 슬랙스/체크/부츠컷/일자,12900,12900,0
2018-06-01,414309431,A018010,초콜릿,미니핫브레이크532g(2+1) 초콜릿 초코바 과자 간식,25800,25800,0
2018-06-01,1119954924,C012020,원피스,[보니알렉스](보니알렉스)랍빠 트리밍 배색코트(BAHY201A),19900,17520,-2380
2018-06-01,990059951,L012060,샴푸,[LG]LG)오가니스트티트리샴푸500ML,8990,6990,-2000
2018-06-01,982436304,A019110,드레싱,오뚜기 논오일 오리엔탈드레싱_270G,4180,4180,0
2018-06-01,2143084127,C012060,여자내의,[마일리지]절개니트훌스커트 SK027D7,33800,32110,-1690
2018-06-01,1892448006,A022030,생수,동원샘물 2L 6병 한박스/생수/미네랄/대용량/석수/물,4900,4900,0
2018-06-01,895835953,E061060,살충제,[한국존슨]에프킬라 내츄럴 후레쉬 500ML*3,9590,9590,0
2018-06-01,215538834,A012060,햄및베이컨,베이컨파지 1kg/치킨텐더 팝콘치킨 치킨너겟 순살치킨,8500,8500,0
2018-06-01,198465355,L021020,장신구,(실버) 니트 스틱 목걸이 (Gold Rose Gold) 목걸이금,25050,25050,0
2018-06-01,2104872617,I031010,장난감,(스텝2 사파리웨곤(new))대형완구 푸시카 지붕차 승용,659390,586860,-72530
2018-06-01,1883701912,A017220,양파,대파 (냉동/슬라이스) 1kg,3900,3900,0
2018-06-01,289292273,C012040,여자학생복,[랩(LAP)]* [made by LAP] 루즈핏 코튼 블라우스(AJ2WB481)(영등포점A),29400,25430,-3970
2018-06-01,385589416,C012030,여자상의,에이 루즈 꽃 원피스 CE0275M805 빅사이즈,44580,41910,-2670
2018-06-01,414226260,C013010,점퍼,지퍼문양 바람막이 캐주얼 바람막이 점퍼 패션바람막,38980,38980,0
2018-06-01,441066063,C013050,운동복,ABC 분말소화기 2.5KG 축압식 소화기 소방용품 가정,40990,37350,-3640
2018-06-01,791247149,E031030,전자레인지,20L 전자렌지/전자레인지 MWB20MB,60000,56400,-3600
2018-06-01,1596200081,L012010,면도기,질레트 프로쉴드 면도기 2UP+8입날,47900,47900,0
2018-06-01,415213829,C015020,모자,스냅백 모자 볼캡 레더볼캡모자 볼캡 스냅백 패션모자,16440,16120,-320
2018-06-01,135913176,A016120,바나나,[로얄사이즈]고당도 에스트렐라 바나나 6손/13kg/선별,39900,35900,-4000
2018-06-01,1266818023,C012040,여자학생복,[지센] 투포켓 골지 롱 카디건(LCTSI463),29900,29900,0
2018-06-01,1804633581,L021020,장신구,[바보사랑]비즈 큰 별 귀걸이,11120,11120,0
2018-06-01,461783364,A019110,드레싱,(참소당 짬뽕소스2kg)해물짬봉 볶음 짬뽕페이스트소스,16500,16500,0
2018-06-01,918885413,E011010,장롱,[까사베르데]슬라이딩/장농/장롱/6자/9자/디자인/PU가죽/흑경/은경/인테리어/가구/붙박,420000,415000,-5000
2018-06-01,672075708,C014010,아동복,여름신상/기본반팔/아동반팔티/캐릭터티셔츠/단체티,3900,3900,0
2018-06-01,895835984,E061060,살충제,[헨켈]홈매트 3시간더(60매),9900,9900,0
2018-06-01,2054786966,E021010,침구,시어서커 여름 차렵이불세트(이불+패드+베개커버),46800,46800,0
2018-06-01,1895095481,C012040,여자학생복,[베스티벨리]레이스 요크 배색 오픈 가디건 (BMCCE2962)_R8R2,58800,55860,-2940
2018-06-01,1435192773,E031030,전자레인지,[LG전자] LG전자 MW23BP 인버터 전자레인지 23L (주)대명,169000,156000,-13000
2018-06-01,1058345545,C013020,티셔츠,[게스]GUESS 남여공용_오리지날 삼각로고 PVC 반팔티셔츠(MI2K9416),25200,21170,-4030
2018-06-01,2143084160,C012060,여자내의,[마일리지]A라인니트스커트 SK029D7,24800,23560,-1240
2018-06-01,1895095484,C012040,여자학생복,[베스티벨리]노 버튼 골지 롱 가디건 (BMCCG2975)_L3Z9,35900,34110,-1790
2018-06-01,1261238887,C012060,여자내의,빅사이즈/페미닌/레이스/스커트 페미닌레이스스커트,55820,54150,-1670
2018-06-01,1200686534,A019030,생강,흑생강 10봉(100gX10) 1kg 자색생강 검은생강,49600,49600,0
2018-06-01,2093745964,E061010,세탁세제,지금 최저가!! 대용량 액츠 파워젤 14L 드럼겸용 피죤,25700,24700,-1000
2018-06-01,1287028459,A019180,즉석식품,무료배송10팩/6kg 한우100%사골곰국곰탕/상무축산유통,25000,25000,0
2018-06-01,2121965888,I012010,컴퓨터,LG데스크탑 Z71EV-AX7P16 펜티엄 4G 500G 윈도우없음,445740,419000,-26740
2018-06-01,2102355346,C013050,운동복,모비스 크루저 루프백 캠핑가방 루프백 자동차루프백,257730,230000,-27730
2018-06-01,418765752,C013020,티셔츠,에고이스트(EJ2CH464) 소매셔링 티셔츠,79000,67150,-11850
2018-06-01,1266640424,C011020,남자상의,바바리 코트 2016 파일지 코트 남자트랜치코드 트랜치,226910,226910,0
2018-06-01,623640457,C013050,운동복,과속방지턱/주차용품/서행/안전표시/조립식/앙카포함,18900,17390,-1510
2018-06-01,633569465,I031040,생화,[SOS긴급구호세트] 구급 구급함 구급가방 미니구급함 구급용품 여행용구급함 응급용품,26600,25500,-1100
2018-06-01,989137520,F011150,건강기능식품,제주삼다수 2L*6입,5820,5700,-120
2018-06-01,990060918,A011010,쌀,Lgrow 씻어나온깨끗한쌀 (3KG/봉),12900,9500,-3400
2018-06-01,990060917,A011010,쌀,농부의미소(포)10KG,31900,31900,0
2018-06-01,1054014487,L021020,장신구,은팔찌 순은 체인 3돈 실버925 은볼 태슬 남자 커플,35900,35900,0
2018-06-01,415443997,F012050,의료측정기,VT 케어센스 혈당시험지 100매/혈당지/당뇨측정지,28680,25000,-3680
2018-06-01,171532960,C011030,남자학생복,[게스]GUESS 여성 도트 러플 블라우스(YI1W4281),69000,56580,-12420
2018-06-01,1996096676,C021040,실내화,(국내총알배송)나이키 에어맥스 2017 블랙,76900,76900,0
2018-06-01,1318076917,A022040,기능성음료,포카리스웨트1.5LX12펫/이온음료/파워에이드/음료수,17400,17400,0
2018-06-01,797310037,L021030,가방,폴라리스 노트북 파우치 케이스 가방 11.6~15.6인치,12500,12500,0
2018-06-01,791032618,C013050,운동복,하이퍼소닉 우산걸이 RV/SUV용 HP3520,10000,9110,-890
2018-06-01,982436335,E061040,부엌용세제,자연퐁 식기세척기 전용 액체세제(938ML),8990,8990,0
2018-06-01,121318916,A017150,버섯,해물찜 삼겹살 비빔밥과 찰떡궁합 일자콩나물 500g,2450,2450,0
2018-06-01,1458829481,F012010,종이기저귀,[리베로]리베로기저귀 밴드형4단계 60매 3팩,56500,52550,-3950
2018-06-01,982436339,G022010,자동차용품,세차타월3종세트,9900,9900,0
2018-06-01,895798532,E061060,살충제,[헨켈]홈키파 무향 에어졸 (500ML),4990,4990,0
2018-06-01,1010229418,A013180,젓갈,[더반찬] 숙주나물(300g),3300,3300,0
2018-06-01,469698217,E041010,식기,철제로봇/로보트/인테리어소품/장식품/tf-401/오토봇,250800,245790,-5010
2018-06-01,961254100,A012060,햄및베이컨,[대림]대림 숯불구이맛 김밥햄 (100g),1590,1590,0
2018-06-01,1489217423,C014010,아동복,아둘 쥬니어 커플 엄마랑 도날트덕 롱 원피스 티 65,14300,14300,0
2018-06-01,492694859,C012060,여자내의,[블루종]스트라이프 옆리본 랩스커트_[B1806SK075B]/ 블루종,44000,35200,-8800
2018-06-01,1169201651,A013090,전복,(전남오픈마켓/멸치신랑)건홍합500g/진도/홍합/건홍합,23000,23000,0
2018-06-01,9458655,A013130,오징어채,밥도둑 명엽채 500g 쥐치손채 이중채 진미채 오징어채,5500,5400,-100
2018-06-01,608497686,I011030,사진기,후지필름 파인픽스 XP130 방수카메라,289000,264780,-24220
2018-06-01,56276274,A019040,소금,자죽염 알갱이 100g/개암 9회 자죽염 고체 미네랄 죽염 소금 자줏빛 자색 죽염 9번 구,33000,33000,0
2018-06-01,1521533895,F011150,건강기능식품,바이오가이아 베이비드롭 5ml / 프로바이오틱스,31200,31200,0
2018-06-01,716261657,E031020,가스레인지,무료배송설치/ SK매직 가스 오븐 레인지/GOR-S2200,567200,567200,0
2018-06-01,1323829154,C013040,청바지,(색상 : 연청 | 사이즈 : 28) MPS18033 에,49740,49740,0
2018-06-01,801243427,C011020,남자상의,OMJ-001 레더배색 누빔 하프코트 M-XL 네이비패딩 라,111700,111700,0
2018-06-01,826480463,E011020,침대,홈잡스 평상서랍형침대 매트리스+서랍 무료포함,140000,137900,-2100
2018-06-01,753163151,C012040,여자학생복,[보니알렉스]소매 프릴 블라우스 (BBSB526)(의정부점),55200,49270,-5930
2018-06-01,59246039,A012010,국산쇠고기,호두기름 견과세트 11호(고품격 웰빙 선물세트)사은품,123560,123560,0
2018-06-01,1106930637,C012060,여자내의,[게스]YI1K2101 [ORIGINALS] 사선 절개 스커트 (본점),40600,35450,-5150
2018-06-01,2112055230,C012040,여자학생복,[일라일(ILAIL)][17F/W]포켓배색포인트숏가디건(BWKG-17803-BL)[갤러리아],184000,174800,-9200
2018-06-01,1577823457,A017230,마늘,2018년 햇 양파 10kg,7300,7300,0
2018-06-01,1095553853,C013050,운동복,제로백 다용도 에어펌프(싱글/더블)발펌프 자전거펌프,18500,17580,-920
2018-06-01,731800029,I031040,생화,허킨스 2018 스타알파 2000루멘 LED랜턴 캠핑랜턴,65000,50900,-14100
2018-06-01,908184081,C012040,여자학생복,남방 5900~/셔츠/남방/블라우스/체크/스트라이프,9900,9900,0
2018-06-01,90896787,C013010,점퍼,[프린세스걸]베이지 스카프 가죽 블루종집업 점퍼 짚업 자켓 갈색 지퍼 유니크 포켓 루,401800,321440,-80360
2018-06-01,1799304325,E031020,가스레인지,SK매직/GORS7700/GOR-S7700/가스오븐레인지/방문설치,1078000,1078000,0
2018-06-01,1985708434,C013010,점퍼,봄기획.득템찬스.자켓트렌치야상.55-110..빅사이즈,29900,29900,0
2018-06-01,1209924307,I011010,TV,TV 20인치24인치27인치32인치 LEDTV 티비 TV모니터,99000,99000,0
2018-06-01,663467128,A016100,수박,델리참_국산무가당딸기 IQF 1kg x 13개입 / (주)남양,148800,126480,-22320
2018-06-01,528296354,I011030,사진기,소니정품A7Mlll/풀바디/A7M3/+포켓융증정/ED,2810000,2583360,-226640
2018-06-01,816310585,D031010,주택수선재료,[오공포리왁스]디럭스타일/데코타일/PVC타일용왁스/광택재/각종바닥재/오공본드/바닥보,9500,9500,0
2018-06-01,988961625,L012030,칫솔,[P&G]P&G) 오랄비 초소형 헤드 잇몸 케어 4입,8900,8900,0
2018-06-01,1746601595,A016020,배,[참예과] 가정용 햇배 15kg 36-40과,19900,19230,-670
2018-06-01,1207159921,C013010,점퍼,[데일리스트/앤섬] 모던 플랩 장식 배색 자켓 MVTFUQM3111,19000,17860,-1140
2018-06-01,624773480,L021010,손목시계,줄리아 가죽시계/패션/손목시계/여자/팔찌시계/선물,3800,3800,0
2018-06-01,1761505583,A011010,쌀,임꺽정의 고장 양주골 쌀/경기미/ 20kg,59900,59900,0
2018-06-01,581680630,C014010,아동복,[GAP kids]갭키즈 [토들러 남아 2-5세] 반팔 수퍼맨 망토 티셔츠(센텀시티점),19000,17510,-1490
2018-06-01,1875115777,C013020,티셔츠,3장특가 레이어드 롱나시 민소매 난닝구 요가 나시티,11900,11900,0
2018-06-01,2083113131,C013010,점퍼,#NAME?,172600,151890,-20710
2018-06-01,18581728,A017210,파,유리온실에서 키운 완숙토마토 3kg/5kg (1~5번)로얄과,8900,8900,0
2018-06-01,631971469,C012020,원피스,빅사이즈/골지/롱/슬림/가디건 빅사이즈,32050,31090,-960
2018-06-01,1981933724,L012060,샴푸,(초특가) 리엔샴푸 윤기강화 400mlx3개 / 한방샴푸,11900,11900,0
2018-06-01,391982524,A019040,소금,MSG(대원미 대원 3K) MSG 미원 식자재 업소용식자재,23270,20950,-2320
2018-06-01,1010229417,A013180,젓갈,[더반찬] 꽈리고추양념찜(250g),4400,4400,0
2018-06-01,1578518006,L012090,기초화장품,[특가]천삼액/자음미단/홍삼진액/청양단/슬리머 모음,56000,56000,0
2018-06-01,986189200,A019180,즉석식품,장작 바베큐 삼겹살_400G+400G,16900,16900,0
2018-06-01,2118768216,L012010,면도기,도루코 1BOX(700EA)최상급 원터치포장 2중면도날,54900,54900,0
2018-06-01,1010144017,A011140,부침가루,띠리에)프리스티지오누와(호두) 420G,18800,16900,-1900
2018-06-01,1075739244,C012060,여자내의,[TBJ]남성 5부 TR 사이드밴딩 팬츠-T182PT530P,39900,33120,-6780
2018-06-01,350651433,C012020,원피스,KAA-C192 쉬폰가디건숄 숄가디건 숄원피스 비치롱가디,17120,17120,0
2018-06-01,1705017905,E021020,커튼,화이트 캐노피모기장/공주모기장/원터치모기장/케노피모기장/사각모기장/아기모기장/침,16010,16010,0
2018-06-01,989162567,A011140,부침가루,[풀무원] 토이쿠키 만들기 (300g)x3개,26700,21900,-4800
2018-06-01,1348503924,A013170,생선통조림,골뱅이캔 (자연산 삼포140g) x48,194000,194000,0
2018-06-01,1156675799,C013010,점퍼,[대구백화점 II관] [시에로]체크 소매 셔츠형 후드 점퍼(SE3JPF096),199000,157210,-41790
2018-06-01,802881352,L012110,색조화장품,2018 AHC 썬스틱3개 퍼펙션 썬크림 SPF50+PA+++선스틱,24900,24900,0
2018-06-01,618846134,A011080,밀가루,오뚜기 옛날 국수 (중면) 3kg,6580,6580,0
2018-06-01,384228950,C013010,점퍼,푸조 여성 바람막이 자켓(FZ317-5) 여성자켓 바람막이,32760,32760,0
2018-06-01,1305752837,A019040,소금,[개암죽염] 3회 황토 다용도 죽염 250g 생활 죽염소금,9000,9000,0
2018-06-01,1917197489,A015020,식용유,청정원 포도씨유 900ml X 12EA 기름 스페인산오일 청,185310,185310,0
2018-06-01,1060333047,A014030,치즈,칸스타 파마산 치즈블랜드 1kg 치즈 가루 분말,9150,9150,0
2018-06-01,420755892,C012020,원피스,수리알파카 롱 울코트 MQDAWL1100/ 미니멈,695000,611600,-83400
2018-06-01,1175162758,C015030,넥타이,[나쁜남자]나비넥타이 리본 보타이 결혼식 체크 도트,2900,2900,0
2018-06-01,544665164,C013020,티셔츠,2장9900원 망고 나시 골지 여름 루즈핏 민소매 티셔츠,5900,5900,0
2018-06-01,2025173130,C013020,티셔츠,포켓맘 포켓수유티,31400,27950,-3450
2018-06-01,252950639,A017160,오이,쫄깃 무농약 머쉬마루버섯 300g*3봉 (팽이버섯증정),5900,5900,0
2018-06-01,243678278,A022050,탄산음료,코카콜라 칠성사이다 업소용 펫트 모음전 콜라1.25L,16910,15900,-1010
2018-06-01,1010254408,A019170,냉동식품,요리하다 케이준양념감자 500G,4580,4580,0
2018-06-01,1572444180,A014020,분유,유유밀(유미락 리치밀 1K)X20개/우유밀 우유사탕 밀크,78360,72100,-6260
2018-06-01,175356118,A017300,미역,광천전장김 25봉/시골전장김 25봉 김 광천김 대천김,16900,16900,0
2018-06-01,432982711,E021020,커튼,(시샘맘) 현관 파리문발/업소용 파리발/현관문발,8200,8200,0
2018-06-01,830469990,G011070,자전거,[파격특가]이지로드200 클라리스 16단 디스크브레이크,198000,198000,0
2018-06-01,1005857210,I011030,사진기,정품 리코 GR II /GR2 블랙색상 //RICOH 공식대리점,815000,749800,-65200
2018-06-01,1304065514,E051020,건전지,3500mAh 18650 배터리 국산 리튬 충전지 건전지 충전,9900,9900,0
2018-06-01,173828449,A017120,고구마,당엔 (볶음)돼지감자 300g/국내산100% 돼지감자,5200,5200,0
2018-06-01,825904601,I012060,저장장치,[문상오천원권] COX CK700 라이트닝 카일광축 기계식,54900,54900,0
2018-06-01,478017973,C012020,원피스,[엄마옷 데드라] 8B-PT128 패턴와이드일자팬츠,18200,15290,-2910
2018-06-01,1098704752,E031070,에어컨,타워팬 타워형선풍기 슬림 리모콘 선풍기 스탠드,29900,29900,0
2018-06-01,2002681362,A013050,오징어,오이피클(슬 일미 3k)X6 간장피클 can 피클병 모피클,38060,38060,0
2018-06-01,775900106,E011060,의자,로니 체어 카페 학생 책상 의자 식탁 디자인 인테리어,29900,26910,-2990
2018-06-01,512568472,A011140,부침가루,필라델피아치즈케익794g/플레인/터틀/라즈베리,18500,18500,0
2018-06-01,2123248233,E031070,에어컨,듀플렉스 타워팬 선풍기 DP-70TF/타워팬/120분타이머,25500,25500,0
2018-06-01,1856638190,E061020,섬유유연제,샤프란 아로마시트 코튼블로섬 30매 x 12,66520,59210,-7310
2018-06-01,1011096396,A011110,당면,흑임자콩국물 1L,2490,2490,0
2018-06-01,90147174,A011010,쌀,2017년 햅쌀 [지리산메뚜기쌀]10Kg/백미 현미,26500,26500,0
2018-06-01,404781500,A011180,파스타면,스파게티면 500g 마카로니 500g 이태리 스파게티면,780,780,0
2018-06-01,450254684,C011030,남자학생복,남녀공용아우터 타탄체크 조끼,31410,31410,0
2018-06-01,420755888,C012020,원피스,앙고라 울코트 MQDAWL2100/ 미니멈,349000,307120,-41880
2018-06-01,1201612331,A016070,귤,42513/ 화남-밀감대(3kgX6개),65560,65560,0
2018-06-01,1498090542,C013010,점퍼,[드레스날다]드로잉 썸머 시스루 스트링 후드 점퍼(outer996),41800,37620,-4180
2018-06-01,401591009,F011150,건강기능식품,[본사정품]라미나인OPT플러스/옴니아/오메가/최신정품,55000,53000,-2000
2018-06-01,2144746548,C012060,여자내의,빅사이즈/페미닌/레이스/스커트,59120,53210,-5910
2018-06-01,1010229450,A013180,젓갈,[더반찬] 알감자간장조림,4200,4200,0
2018-06-01,84103681,I053040,기타문구,3M 원터치 테이프 디스펜서+테이프2롤,10900,10900,0
2018-06-01,989162538,A012010,국산쇠고기,홍성한우 채끝등심스테이크 300g 1등급,37000,35300,-1700
2018-06-01,1095428283,E041070,밀폐용기,27종스텐 밀폐용기 오렌지락/찬통/찬합/반찬통/도시락,4650,4190,-460
2018-06-01,1680993218,E011060,의자,업소용테이블/식당/카페/인테리어/티테이블/식탁/간이,35900,35900,0
2018-06-01,989162537,F011120,인삼,견과건버섯혼합세트,199000,199000,0
2018-06-01,1028112769,A022030,생수,산펠레그리노 탄산수 500ml 24개/스파클링/페리에,27990,27990,0
2018-06-01,2145743030,C014020,유아복,둥근카라자수bl/블라우스/화이트/심플셔츠/여아셔츠/,9900,9900,0
2018-06-01,984544924,A017130,도라지,초L프라임)얼굴이보이는 달콤담백고구마(700G/봉),5990,5990,0
2018-06-01,984544925,A017130,도라지,초L프라임)얼굴이보이는 스위트호박고구마(700G/봉),6990,6990,0
2018-06-01,2005203209,C011020,남자상의,(무료배송) AG 체크자켓 자켓 DB787 보카시 검정체크,208920,183850,-25070
2018-06-01,1742382928,A014030,치즈,코다노 모짜렐라치즈 1kg/100%자연산/스트링치즈스틱,11500,11500,0
2018-06-01,1555845471,L021030,가방,타거스 TSB845AP 15.6인치 노트북가방 백팩/WR,52000,51000,-1000
2018-06-01,1121543581,F012020,생리대,엘리스 생리대 메가미 슬림 팬티라이너(일반) 36P x 2팩/ 엘리스,10500,9980,-520
2018-06-01,2142616598,I031040,생화,시즌특가 카릭스 LED 후레쉬 라이트 XPL V6 1400LM L2,12450,12450,0
2018-06-01,2084163438,C013040,청바지,(SR)MHA535 남자기모빅사이즈스판기모본딩청바지 /(참,73400,64600,-8800
2018-06-01,1223374715,E061060,살충제,바퀴트랩(낱개200개)-바퀴벌레약 소독 끈끈이 식당 쓰,51000,44880,-6120
2018-06-01,1769866066,A022010,주스,가야농장 행복 건강 종합선물세트(180mlx12병) 병음료,6900,6900,0
2018-06-01,420755860,C012020,원피스,벨티장식 라마 롱코트 MQDAWL1140/ 미니멈,449000,395120,-53880
2018-06-01,1371504467,A013170,생선통조림,[유동]유동골뱅이300gx2 + 꼬막280g x1개 +팔도비빔면,16900,16900,0
2018-06-01,576260194,F012010,종이기저귀,폴맘 오버나이트/밤기저귀/팬티형/밴드형/중형/대형,22900,22900,0
2018-06-01,1055639312,A013170,생선통조림,[동원] 라이트스탠다드 참치 85g x 15캔 / 고추참치,17900,17900,0
2018-06-01,420731898,C012020,원피스,D링 벨티드 라펠 캐시미어 울코트 MQDAWL9220/ 미니멈,379000,333520,-45480
2018-06-01,1121543578,F012020,생리대,엘리스 생리대 고쿠수이 날개 중형 21P x 2팩/ 엘리스,10500,9980,-520
2018-06-01,467906661,C013020,티셔츠,SPG001 미니크라운 스팽글 라운드티 기본티셔츠 기본,10840,10840,0
2018-06-01,83454424,A011160,빵,[1+1] 신세계 허니카스테라+소프트젤리롤 외 4종,13900,13900,0
2018-06-01,358857874,I031040,생화,특대형 팔각 파라솔 야외 2층 그늘막 햇빛차단 캠핑,17900,15850,-2050
2018-06-01,176081963,E011040,소파,[동서가구]테라 라텍스탑 천연가죽 4인소파/쇼파,439000,439000,0
2018-06-01,988094890,F011120,인삼,초L프레시)한끼건표고버섯 20G,890,890,0
2018-06-01,1460950107,E021010,침구,국내산 순면 차렵이불 패드세트 이불 침구세트,35900,35900,0
2018-06-01,1539486494,C014020,유아복,더미누]여름신상/오가닉/유아내의/아동내복/수면조끼,6900,6900,0
2018-06-01,802120197,L012040,치약,페리오 클링스 치석케어 치약 100g x 6개 외,10900,10900,0
2018-06-01,1151778198,A011160,빵,[오늘출발] [무료배송][안흥찐빵]할매안흥찐빵(30개)+단호박안흥찐빵(30개) 빠른배송위,27100,27100,0
2018-06-01,2077048659,C014020,유아복,유아실내복 반팔 민소매 스타일택1,7900,7900,0
2018-06-01,896580537,A018060,스낵과자,[농심]농심 칩포테토 오리지날(60G),1300,990,-310
2018-06-01,1863853570,A022050,탄산음료,탑씨1.5LX12펫/음료수/콜라/사이다/펩시콜라/슬러시,10500,10500,0
2018-06-01,1686886348,C013010,점퍼,꾸제꾸제/FILA 바람막이 점퍼/여성 S/아웃도어/자켓/세일/브랜드/빈티지/중고/구제/휠,19900,19900,0
2018-06-01,895627226,F011120,인삼,초L)아침이슬담은 새송이버섯(봉),1490,1490,0
2018-06-01,1158396615,L012060,샴푸,미용실전용/ 아론리페어실크헤어약산성샴푸린스,15000,15000,0
2018-06-01,2038521578,C013020,티셔츠,말랑루즈/몸에예쁘게핏되는티/시스루/레이스/원피스,27000,25000,-2000
2018-06-01,1194180748,E061050,청소용세제,올인원 버블퐁 메디테라피 천연살균제 1박스(30알),19800,19800,0
2018-06-01,1938982092,C011030,남자학생복,[TI FOR MEN] 티아이포맨 스트라이프 베스트 M144MVT2,15300,13470,-1830
2018-06-01,390248824,C021020,구두,[에스콰이아]남성 정장화 균일가 11종 택 1,53000,44520,-8480
2018-06-01,394110933,A011120,두부,포스트 오레오오즈 500gx2개+랜덤증정,13600,13600,0
2018-06-01,1736876278,C011030,남자학생복,긴팔와이셔츠/무료배송/사은품 증정/반슬림.일반,13500,13500,0
2018-06-01,420755853,C012020,원피스,하이넥 클래식 라마 울코트 MQDAWL1280/ 미니멈,449000,395120,-53880
2018-06-01,420755856,C012020,원피스,A라인 울 캐시미어 롱코트 MRDOWL9910/ 미니멈,329000,289520,-39480
2018-06-01,1346953932,F012010,종이기저귀,특가 쿠잉 밴드/팬티 기저귀 3팩/4팩,30900,30900,0
2018-06-01,1833568511,C013050,운동복,여름 7부트레이닝바지 트레이닝반바지 츄리닝 남자,8900,8900,0
2018-06-01,1010229483,A013180,젓갈,[더반찬] 미역줄기볶음,3300,3300,0
2018-06-01,1010229486,A013180,젓갈,[더반찬] 떠먹는피자,5900,5900,0
2018-06-01,1010229480,A013180,젓갈,[더반찬] 오징어두루치기/넉넉한2인분,9800,9800,0
2018-06-01,172107765,C011050,남자내의,여름바지.봄바지.카고바지.건빵바지.밀리터리.작업복,13500,13500,0
2018-06-01,1252596452,L021020,장신구,피어싱 9800원무배 내일도착/귀걸이/남자/패션/귀걸이,900,900,0
2018-06-01,1318870284,A019020,참깨,해정원 볶음들깨(거친) 1kg 볶음깨 식자재 가공식품,19770,19770,0
2018-06-01,1812746495,C011050,남자내의,[나쁜남자] 와이드크롭 밴딩바지 롱슬랙스 배기팬츠,12900,12900,0
2018-06-01,1972023192,C013020,티셔츠,앨빈클로 남녀공용 반팔티 무지 티셔츠 오버핏 커플룩,13900,9900,-4000
2018-06-01,639428714,E041050,냄비,[올리오]깜짝특가 드라마항균 냄비 밀크팬/이유식냄비,19900,16900,-3000
2018-06-01,1820872350,C012040,여자학생복,여성 체크 셔츠 블라우스 남방 리본 오프숄더,19800,19800,0
2018-06-01,324061539,A011020,현미,찹쌀(산들샘 1k)X10 식자재 업소용식자재 대량구매,78790,75640,-3150
2018-06-01,1154942026,C012040,여자학생복,8B-CA017 플로라쉬폰가디건/ 데드라,50400,37800,-12600
2018-06-01,1293903130,A014020,분유,[베비언스] 산양 액상분유 3단계 240ml 20입,42900,42900,0
2018-06-01,1589266352,C012040,여자학생복,여자남방 여성남방 여자남방셔츠 빅사이즈 여자셔츠,14800,14200,-600
2018-06-01,1984746767,A013140,북어채,수협손질먹태채90gx5마리/먹태/황태/안주/북어/노가리,19800,19800,0
2018-06-01,409638512,A011090,국수,컵라면 삼양소컵 초특가 진라면소컵 30개 15900원,15000,15000,0
2018-06-01,1151536026,E061100,습기제거제,제습제 블랙홀 525mlx24개/ 탈취제/ 세제/습기제거제,15900,15900,0
2018-06-01,1473923248,A011020,현미,청우 전통 과자 찹쌀 모나카 180g 1 BOX,43020,43020,0
2018-06-01,659022158,C012020,원피스,말표구두약 이코노 흑색 40g,1940,1940,0
2018-06-01,984519944,E061030,전구,GE) T528W 직관,19400,19400,0
2018-06-01,988094867,A016130,키위,제스프리 썬골드키위(특대/개),3000,1500,-1500
2018-06-01,1544640469,C011030,남자학생복,[GGIO2] 헤어라인 S/T 셔츠 AXSAM17511BUX,29000,26970,-2030
2018-06-01,420755831,C012020,원피스,체크 폭스퍼 배색 울코트 MQDAWL1360/ 미니멈,599000,527120,-71880
2018-06-01,2054941939,L021030,가방,[다바걸][다바걸]심플브라클립_D2UW,3350,3190,-160
2018-06-01,415007277,A019040,소금,스파게티면(11번 데체코 1K)X12 스파게티면 마카로니,118540,106690,-11850
2018-06-01,1596828474,A014020,분유,초유밀 플러스 1단계 100g/2단계 100g,14800,14800,0
2018-06-01,379604432,C014020,유아복,여아 여자 아이 주니어 순면 상하 실내복 반팔 세트,12470,12470,0
2018-06-01,299547371,E031070,에어컨,SIF-16CSR/정품/천장형선풍기 모음전/신일선풍기,49900,49900,0
2018-06-01,1682734162,C013010,점퍼,[모다아울렛][에이비에프지]누빔배색점퍼,55000,50600,-4400
2018-06-01,499909491,E011020,침대,[필우드가구]킹 가죽침대/K/평상형침대/침대프레임,369000,369000,0
2018-06-01,898600688,A017150,버섯,풀무원 국산콩 콩나물 340G,2290,2290,0
2018-06-01,1088869342,A019110,드레싱,[CJ직배송] 유자샐러드소스250gX4개,12980,12980,0
2018-06-01,368819445,C021020,구두,남성구두 MA90 키높이 신사화 천연가죽 5cm 정장슈즈,53390,53390,0
2018-06-01,395613337,A011170,떡,(떡국떡/떡볶이떡)쌀떡 쌀떡볶이 신당동떡 밀떡뽁이,2700,2700,0
2018-06-01,1262007537,L021020,장신구,도리스 진주 초커 목걸이 여성스러운목걸이 초커네크,11290,11290,0
2018-06-01,1723337480,I031040,생화,세진아트 아이스쿨링백/보냉가방/쿨러백/캠핑용품/아이스박스/보냉백/아이스백/여행용,12490,12490,0
2018-06-01,80109598,E011040,소파,아로미가구 티파니 소가죽 기능성 3인용소파,279000,279000,0
2018-06-01,1262235206,C012060,여자내의,s.a.d.e 샤데이 퍼팩트핏 린넨 슬랙스 3종,49000,48000,-1000
2018-06-01,50175021,C011030,남자학생복,인터페이스제작 특양면가디건 무지 후드집업자켓,23700,23700,0
2018-06-01,877297920,E061060,살충제,독일 바이엘 바퀴벌레약 맥스포스셀렉트겔 바퀴끈끈이,10000,2600,-7400
2018-06-01,868002650,E031080,선풍기,벽걸이히터 MFH-1614HW [안전망 화상방지 코팅 / 안전장치 바이메탈 스위치 채용],39000,39000,0
2018-06-01,1469697180,C011030,남자학생복,남자남방 남성남방 체크남방 체크셔츠 롱남방 롱셔츠,42500,42500,0
2018-06-01,1064619944,E041070,밀폐용기,스텐락/밀폐/찬합/도시락/통/반찬/그릇/찬합/배달용기,9900,9900,0
2018-06-01,868002652,E031130,보온매트,마이프랜드 2인용 전기방석 MF-C2,27720,27720,0
2018-06-01,868002651,E031130,보온매트,마이프랜드 1인용 전기방석 MF-C1,19800,19800,0
2018-06-01,480571291,E041010,식기,베트남쌀국수 멜라민 우동그릇 라면그릇 면기 라면기,3500,3160,-340
2018-06-01,868002653,E031080,선풍기,마이프랜드 미니2단 석영관 히터 MF-22S [순간난방가능 / 스토브형],23070,23070,0
2018-06-01,903035615,E041050,냄비,[해피콜] 아르마이드 세라믹냄비 4종/5종 세트 外,98100,98100,0
2018-06-01,1374439342,C013010,점퍼,[제이알주니어] 썸머슬리브점퍼(아이보리_체리핑크_곤,16900,13520,-3380
2018-06-01,1002889766,E011030,거실장,[동서가구]EDF 6인용 천연가죽소파 스툴세트 DF635970,1890000,1890000,0
2018-06-01,1279772523,D031010,주택수선재료,본크리트 방수재 20kg (옥상방수 방수페인트),110000,110000,0
2018-06-01,1176089751,C012040,여자학생복,테이프 나시)니트나시/여름/탑뷔스티에/조끼/베스트,8900,8900,0
2018-06-01,2139106074,L012090,기초화장품,헤라 썬메이트 데일리/레포츠/프로텍터/선스틱,22000,22000,0
2018-06-01,476524459,C011030,남자학생복,FS-053 포켓 디테일 스티치 청남방 청남방 남성남방,34240,34240,0
2018-06-01,1864837287,E061010,세탁세제,LG생활건강 수퍼타이 액체세제 14L / 일반 드럼겸용,13950,13950,0
2018-06-01,1010349514,A018010,초콜릿,롯데 키세스아몬드(V-DAY) 283G,9200,9200,0
2018-06-01,149322938,A016040,포도,송산포도과즙,43010,43010,0
2018-06-01,1411965728,C014010,아동복,어린이 방한 마스크 FR0050 겨울왕국스노우펄,8720,8720,0
2018-06-01,254091658,D031010,주택수선재료,[풀바른실크벽지][물에빠진벽지]_애로우민트 1ROLL,29800,26820,-2980
2018-06-01,1992619885,C012040,여자학생복,[대구백화점 I관] [보니알렉스]칠부소매숏가디건(BBWB657),44100,39250,-4850
2018-06-01,1116642337,A011180,파스타면,특가 [데체코 DECECCO] 라자냐 500g/이탈리아/스파게티면/스파게티소스/파스타면,6000,5900,-100
2018-06-01,1868013625,F012050,의료측정기,지메이트 오리진 혈당계+시험지 50매+침110+솜100,17090,15900,-1190
2018-06-01,989884024,A019180,즉석식품,CJ 비비고 닭곰탕 500G,4580,3590,-990
2018-06-01,1155448936,C021040,실내화,월드컵 남성 여성운동화 조깅화 찍찍이 런닝화 워킹화,18320,18320,0
2018-06-01,1959033302,L021010,손목시계,22mm 메탈밴드 갤럭시기어S3시계줄 어베인시계줄호환,25000,25000,0
2018-06-01,582510961,I012010,컴퓨터,LG총판 LG데스크탑 Z70EV-AR7P16 펜티엄 500GB Win10,584040,549000,-35040
2018-06-01,502925080,C013040,청바지,[아이잗컬렉션]CH9E0SL51(청바지)(영등포점A),59000,56050,-2950
2018-06-01,389184091,C012040,여자학생복,[망고 (MANGO)] 노츠 리넨 셔츠,59000,59000,0
2018-06-01,1437295154,C012060,여자내의,[모다아울렛][메케나]크리스탈 블랙 스판 바지(MX2Y1PT004099),29000,27550,-1450
2018-06-01,264684992,A017170,풋고추,취청오이-2kg.5kg.10kg,16900,16900,0
2018-06-01,1159621287,F011150,건강기능식품,소소생활 숙취 걱정 끝 건강한 소소한잔,14800,14800,0
2018-06-01,589617041,A017230,마늘,2018년 무안 황토골 자색양파 5kg,9900,9900,0
2018-06-01,1379664816,C012020,원피스,루즈핏 핸드메이드 하프자켓(C181MSF503)/ 씨씨콜렉트,199000,169150,-29850
2018-06-01,216562835,E031050,냉장고,[삼성전자] 인증점 삼성 김치냉장고 김치 플러스 RQ47M9252XS,2904900,2904900,0
2018-06-01,1655522863,A011010,쌀,2017년 햅쌀 출시 대나무향미 10kg 쌀 신동진 현미,25900,25900,0
2018-06-01,1992619890,C012040,여자학생복,[대구백화점 I관] [보니알렉스]반팔언발롱가디건(BBWB655),44100,39250,-4850
2018-06-01,1477377450,E061010,세탁세제,테크x11st 천연베이킹 일드겸용 액체세제 1.5Lx4개,11900,11900,0
2018-06-01,1088870335,E031080,선풍기,마이카 전기히터 AIR1500H,135000,135000,0
2018-06-01,645821242,C014010,아동복,[아이러브제이] 여름 로코니 셔링 티셔츠 JPUTO60-DA1C,11040,9990,-1050
2018-06-01,1088870334,E031080,선풍기,마이카 전기히터 AIR2000H,159000,159000,0
2018-06-01,1088870342,E031080,선풍기,대성쎌틱_ 전기 라디에이터 DSRA-5 (5핀/1kw),62000,62000,0
2018-06-01,1088870341,E031080,선풍기,굿프렌드_프리미엄 욕실난방기 골드 (HR1-023),69500,69500,0
2018-06-01,231209603,C015040,장갑,실버D 국내제조 성인용 손싸게 2개 1세트 어른손사께,88150,88150,0
2018-06-01,1271191189,A012060,햄및베이컨,선진FS 베이컨 스트립 1kg x 3EA,85660,85660,0
2018-06-01,1087474338,C013060,등산복,기능성 아웃도어 등산자켓 방풍/방수/점퍼/트레이닝,39800,39800,0
2018-06-01,1639919390,A017090,열무,계양]알루미늄용팁쏘 9인치 230*80*3.0t/국산,41090,41090,0
2018-06-01,370352078,E011050,책상,GT600 -10종사이즈 30각철재다리 사각책상/다용도탁자,49000,49000,0
2018-06-01,308918756,C011050,남자내의,[클라이드] 남성 슬림핏 면 팬츠(CHAPT101M),9000,7470,-1530
2018-06-01,916961336,A018080,설탕,백설/큐원 갈색/흰색 설탕5kgx4(총20kg),35900,35900,0
2018-06-01,528211747,E031110,청소기,메디하임 핸디형스팀청소기 MH-900 한경희 HS-101Y,29900,29900,0
2018-06-01,175417645,E031130,보온매트,일광온수매트_더블(쟈가드),188200,188200,0
2018-06-01,175417646,E031130,보온매트,일광온수매트_더블(황토),188200,188200,0
2018-06-01,175417641,E031130,보온매트,일광온수매트_싱글(피톤치드),181400,181400,0
2018-06-01,175417642,E031130,보온매트,일광온수매트_싱글(쟈가드),181400,181400,0
2018-06-01,175417643,E031130,보온매트,일광온수매트_싱글(황토),181400,181400,0
2018-06-01,451527352,C011020,남자상의,MJSF18001 블랙 코튼 베이직 코트 남성코트 기본남성,91580,91580,0
2018-06-01,175417644,E031130,보온매트,일광온수매트_더블(피톤치드),188200,188200,0
2018-06-01,1235238636,C011020,남자상의,MJ_1136 네이비 더블트렌치 겨울코트 남성자켓 코트,216140,216140,0
2018-06-01,1606917200,C012060,여자내의,봄신상 고급플레어스커트 77 88 빅사이즈 정장 오피룩,29900,29900,0
2018-06-01,390297724,E021010,침구,[국내제품] 순면100% 이불세트 차렵이불 침대커버,29900,29900,0
2018-06-01,1088870368,E031080,선풍기,대웅_ 프리미엄 팬히터(온풍기) CZ-RH0624 (1 000w),77000,77000,0
2018-06-01,1864825246,A018010,초콜릿,크런키초코바웨하스빅크런키더블크런치통크런키초콜릿,6900,6900,0
2018-06-01,1088870367,E031080,선풍기,대성쎌틱_ 전기 라디에이터 DSRA-13 (13핀/2.5kw),100000,100000,0
2018-06-01,1088870366,E031080,선풍기,대성쎌틱_ 전기 라디에이터 DSRA-9 (9핀/2kw),80000,80000,0
2018-06-01,1088870365,E031080,선풍기,대성쎌틱_ 전기 라디에이터 DSRA-7 (7핀/1.5kw),70000,70000,0
2018-06-01,2054397335,C013020,티셔츠,T2276-여성 데일리 제이 앞꼬임 티셔츠 정장티셔츠 브,33670,31990,-1680
2018-06-01,1010350541,A018010,초콜릿,프론티어 졸리초콜릿비스킷볼 20G,980,980,0
2018-06-01,1088870371,E031080,선풍기,대웅_ 프리미엄 팬히터(온풍기) CZ-RH0824 (2 000w)),99000,99000,0
2018-06-01,1233845875,L012110,색조화장품,AHC 내추럴 퍼펙션 프레쉬 선스틱 22gx2개/썬스틱/,22000,20600,-1400
2018-06-01,1088870370,E031080,선풍기,대웅_ 프리미엄 팬히터(온풍기) CZ-RH0724 (1 500w),89000,89000,0
2018-06-01,692210632,C011030,남자학생복,프리미엄 선물전 레귤러&컨템포 반소매셔츠 12종 택1(선물포장가능)/ 닥스(셔츠),60000,49200,-10800
2018-06-01,1405159124,C012040,여자학생복,[공구우먼] 헤로젤 린넨 남방 29166 빅사이즈여성의류 오버핏셔츠,34000,34000,0
2018-06-01,1322904741,C015040,장갑,(옵션 : L) 아디다스 COND 니트장갑(BR9919),32970,32970,0
2018-06-01,364743533,E011050,책상,[까사미아]스튜디오 책장 조합형-2400(블랙)(강남점),563000,532070,-30930
2018-06-01,298911622,C012040,여자학생복,[베스티벨리]모 혼방 리본 장식 가디건 (BMCCB2964)_T2X4,29900,28410,-1490
2018-06-01,461012694,C011020,남자상의,아이보리 체크 밍크털 코트 캐주얼코트 캐쥬얼코트 코,107510,104290,-3220
2018-06-01,961398217,A013050,오징어,냉동제주 갈치(300G내외/1마리),7490,7490,0
2018-06-01,507173361,E021010,침구,국산 밍크 극세사 겨울 이불 차렵이불 요토퍼 카페트,29900,24500,-5400
2018-06-01,724301438,C014010,아동복,유아 아동 여름 반팔 상하복세트/남아 여아 반팔세트,21400,21400,0
2018-06-01,833151863,A017080,무,청도미나리 4kg(벌크) / 생야채로 먹는 미나리,36900,34900,-2000
2018-06-01,1548865741,L012040,치약,크리오 플러스엠 치약 130g x 10개 외 칫솔,7900,7900,0
2018-06-01,704262434,C013020,티셔츠,커터앤벅 남성 스판 카라 반팔티셔츠- 1462-101-04,44900,39900,-5000
2018-06-01,1100698640,I031010,장난감,톨로 사파리쿼드바이크 행사 완구 장난감 어린이 아,38020,38020,0
2018-06-01,1722688294,A017050,미나리,유기농 양배추 10kg,29000,23200,-5800
2018-06-01,1001347740,A013170,생선통조림,골뱅이캔 (자연산 삼포400g) x24,211940,211940,0
2018-06-01,725552073,C013010,점퍼,[포에버21]레이스 봄버 자켓/FOREVER21/점퍼/누빔점퍼,44900,22450,-22450
2018-06-01,809181088,L021010,손목시계,젤리 아쿠아 방수시계 손목시계 방수시계 아쿠아손목,12770,12770,0
2018-06-01,1015669881,A017040,양배추,미나리4kg1박스 두리반농산,18000,18000,0
2018-06-01,1733495035,L021030,가방,쌤소나이트 콤보 서류가방 쌤소나이트가방 가방 남자,171000,171000,0
2018-06-01,1904659926,E011020,침대,[안전한! 베디스]KC인증 컬러가죽침대Q+프리미엄매트Q,409000,399000,-10000
2018-06-01,45719220,F011150,건강기능식품,CJ 컨디션 헛개수 1.5L(12페트) 무료배송,15900,15900,0
2018-06-01,2094781881,C012020,원피스,여성 코트 아웃터 트랜치코트 롱코트 모직코트,88650,88650,0
2018-06-01,868002685,E031080,선풍기,오드앵글 카본히터 OA-CH90S [ 2단계 온도조절 / 빠른 발열시스템 / 고효율 에너지절약 ],58000,58000,0
2018-06-01,868002687,E031080,선풍기,신일 카본히터 SEH-900JCM [2단온도조절 / 무소음 / 저전력 / 버튼식],69000,69000,0
2018-06-01,868002686,E031080,선풍기,파세코 석유난로 PFH-5K [파세코 팬히터/ 실내용 등유/ 적은 산화가스/ 가정용에 적합],299000,299000,0
2018-06-01,5487584,C021010,아동화,특가/3월가격인하/다이모/아동운동화/아동화/아동구두,9900,9900,0
2018-06-01,121111292,C013010,점퍼,[모다아울렛][아가방]엠비UV화섬점퍼,29000,27550,-1450
2018-06-01,1976572236,A017110,감자,(2018년 신상) 갓 수확한 햇 국내산 레드비트 / 5kg,15400,14400,-1000
2018-06-01,2062765653,C011030,남자학생복,[YEZAC]2018 S/S 예작 반소매셔츠 25종 택 1 (YJ8MBS206WH 외 24종)[갤러리아],30000,22200,-7800
2018-06-01,242694507,A018040,아이스크림,하겐다즈 아이스크림 쿼터 946ml X 2개,37900,37900,0
2018-06-01,966934377,E011070,식탁,[ilooiloo]원목식탁세트 10종모음전/4인식탁/당일발송,189000,189000,0
2018-06-01,1272057299,C013040,청바지,[젤리스푼]간지워싱롤업데님팬츠,21900,19710,-2190
2018-06-01,1529050120,C013020,티셔츠,[타미힐피거키즈]타미힐피거칠드런(3~16세) 져지 반팔티(TBLS1KOS20A0 )[갤러리아],28000,22960,-5040
2018-06-01,1010350571,A017100,당근,로컬)열무,2790,2790,0
2018-06-01,1666245762,E031110,청소기,[레이캅]탈취까지 완벽한 무선 침구청소기 RX-100KRWH,598000,586040,-11960
2018-06-01,2068311986,C013010,점퍼,(티티뱅크) JK700W 블루종 패딩 점퍼 / 참고 블루종,69600,61250,-8350
2018-06-01,1296151274,C012060,여자내의,[밸리걸] 프린트 숏 점프수트 254740,29900,25420,-4480
2018-06-01,1597029390,F011130,홍삼,정관장 홍삼오메가(650MG*120정),100000,100000,0
2018-06-01,1804743606,E031040,전기레인지,로이첸칸칸용기10P(5세트) 냉장고정리용기 냉장고용,27580,27580,0
2018-06-01,1178470091,C013040,청바지,[컨셉원] 118507 코튼 스판 라이트 웨이트 치노 (10118507),49800,39840,-9960
2018-06-01,247263261,C013040,청바지,여름신상 청바지/빅사이즈/일자/블랙진/면바지,14900,14900,0
2018-06-01,1670760045,C011030,남자학생복,아디다스 콘디보 16 패딩조끼/패딩베스트/방한조끼,99800,99800,0
2018-06-01,2019684449,A014020,분유,[1+1] 베비언스 액상분유 6입 180/240ml + 니플,17800,17800,0
2018-06-01,1104342537,A012050,소시지,진주햄 천하장사 15g x 20개 X 20EA _1BOX 간식소세지,99510,97520,-1990
2018-06-01,1298271605,C021010,아동화,[빔보빔바] 빔보빔바 베리우븐 유아 슬립온 (아기/여아/남아/신발,25000,25000,0
2018-06-01,1251237729,C012040,여자학생복,[보브(여성의류)] 2001중계아울렛] A라인 집업가디건(7116450206),479000,192000,-287000
2018-06-01,1354401893,C012040,여자학생복,[로즈맘][로즈맘]소망레이스가디건,24050,21650,-2400
2018-06-01,1742778846,I011010,TV,사운드바증정 더함 코스모 C780UHD 78인치 UHD TV,1742260,1690000,-52260
2018-06-01,1254472097,C012040,여자학생복,여름신상 남방44-88빅사이즈 단가라 박시 언발 롤업,19800,19800,0
2018-06-01,1222336066,C012040,여자학생복,[에스티아]롱남방/롱셔츠/롱블라우스,25900,25900,0
2018-06-01,882776803,E011020,침대,인쏘노 패밀리침대 마리아쥬 + 전용 패드 증정 (Q+SS),501270,501270,0
2018-06-01,600667951,C021010,아동화,[아디다스키즈]전세계 유일 단독디자인 한정판! SUPERSTAR ISC 골드/연핑크 (F97648/F,48300,39830,-8470
2018-06-01,707621963,F012050,의료측정기,VT 케어센스 혈당측정기 혈당계+시험지60+솜100+침210,25650,22000,-3650
2018-06-01,344423038,E041050,냄비,[네오플램] 이유식 냄비/밀크팬/편수냄비,14900,14900,0
2018-06-01,437433933,A013060,게,[bada4u]대왕오징어족1kg 조미 버터구이 대왕오징어,11200,11200,0
2018-06-01,1800410222,L012110,색조화장품,30%+5%중복쿠폰! CNP차앤박 톤업프로텍션선크림/앰플,12900,12900,0
2018-06-01,1167374548,I031010,장난감,ITALTRIKE 붕붕카 라코사 실내 승용완구 소방차,69000,69000,0
2018-06-01,1651298419,C013010,점퍼,사파리 발수제 발수스프레이 의류 자켓 다운 점퍼 패딩 야상점퍼,20000,20000,0
2018-06-01,633726334,A017120,고구마,맛있는 감자 특가판매 3kg/5kg/12900원/품질엄선,12900,12900,0
2018-06-01,1462370142,E061050,청소용세제,홈스타 뿌리면 곰팡이싹X2/바르면 곰팡이제거제 모음,8400,8400,0
2018-06-01,1657407065,C013060,등산복,경량바람막이 아웃도어 여름점퍼 남자잠바 등산복자켓,49800,35630,-14170
2018-06-01,1351742396,C012060,여자내의,톰스 연청 멜빵 청반바지 멜빵탈부착 SD 4085,17330,17330,0
2018-06-01,1562793484,A016110,딸기,제이제이 냉동딸기 1kg 2개,19770,19770,0
2018-06-01,677958431,F012020,생리대,[바디피트] 엘지 쏘피 바디피트 볼록맞춤 안심숙면420 수퍼롱 20p,6750,6750,0
2018-06-01,741768498,A012050,소시지,청정원 크랩봉 75g (15gx5개)x10봉,10500,10500,0
2018-06-01,992317046,C012030,여자상의,세일코너/ 러블리원피스 /셀프웨딩/빅사이즈행사룩,22800,22800,0
2018-06-01,1269553893,C013010,점퍼,남녀 바람막이 자켓 JK115 랜더스,36600,36600,0
2018-06-01,466508081,C013050,운동복,DDK00218 트레이닝 져지 803 여성트레이닝자켓 여자집,50720,49200,-1520
2018-06-01,1275186369,A019040,소금,[개암죽염] 3회 착한 생활용 죽염 1kg 생활죽염 소금,33000,33000,0
2018-06-01,721739381,C013060,등산복,콜핑 남성 여름 등산복 4종,99000,96000,-3000
2018-06-01,258106533,A012050,소시지,동원 리얼크랩봉/치즈봉 540g+540g (총36개),10900,10900,0
2018-06-01,64451844,E031080,선풍기,홍진테크 할로겐히터 NSB-1200 /탄소발열히터/파티션난로/파티션히터,27200,27200,0
2018-06-01,354198266,C013010,점퍼,남여) 경량다운 베스트 MSW4VP1921외2종/ 탑텐,24900,21170,-3730
2018-06-01,123446370,L012030,칫솔,일회용칫솔 1000개 고급미세모/치과/모텔/마사지샵,20000,20000,0
2018-06-01,354198265,C013010,점퍼,남여)경량다운점퍼 MSW4JP1024외 5종/ 탑텐,29900,25420,-4480
2018-06-01,572531537,C011030,남자학생복,밀란시아 캐쥬얼 집업조끼 10-045-1 남성캐쥬얼 캐쥬,42400,41560,-840
2018-06-01,676972540,C014010,아동복,[앤디애플][앤디애플] 건빵포켓배기데님팬츠_B,11900,11190,-710
2018-06-01,1064681902,E031080,선풍기,밀 전기컨벡터 mill1200M,147500,147500,0
2018-06-01,1064681903,E031080,선풍기,밀 전기컨벡터 mill1200E,185000,185000,0
2018-06-01,1010171827,A018030,껌,롯데 스크류바왓따 껌23G,400,400,0
2018-06-01,1315728323,C014010,아동복,[시즌특가]풍기인견100%/상하복/아기옷/실내복/인견옷,21900,21900,0
2018-06-01,897503282,A021010,커피,[동서]동서 모카골드 블랙믹스 (100T*2.7G),13900,13900,0
2018-06-01,524722170,C012060,여자내의,가죽바지 래더바지 파우더 벨트세트 가죽반바지 SD-50,21990,21990,0
2018-06-01,1157588446,E021010,침구,국내 순면100% 시원한 이불세트 침대커버 침구세트,29900,29900,0
2018-06-01,627177656,C021040,실내화,[리복(Reebok)][REEBOK CLASSIC/UNISEX] 리복 로얄 컴플리스2/클럽씨 FVS (CM9635 CM9,38500,32500,-6000
2018-06-01,896602732,E061060,살충제,[헨켈]홈매트 3시간더 (150매/90+60매),18200,18200,0
2018-06-01,1242620942,C011030,남자학생복,[무료배송]FSSF18033 블루 선염 도비 셔츠 남자기본셔,35570,35570,0
2018-06-01,1099389545,A013090,전복,부경 냉동반가리비 2.1kg(210gx10개),65500,65500,0
2018-06-01,985203179,A013060,게,생물 오징어(생물/마리),3990,3990,0
2018-06-01,604658398,C012020,원피스,CD355-도도 왕진주 퍼프 가디건 라운드가디건 퍼프소,63560,61660,-1900
2018-06-01,1692605658,C013010,점퍼,아디다스 롱 다운 파카(M64172),183570,168890,-14680
2018-06-01,1686042362,I031040,생화,바낙스 군도기 갯바위 릴낚시대 세트ㅣ릴 찌낚시세트/,71000,59640,-11360
2018-06-01,371280525,C012040,여자학생복,니트원피스가디건set/모직원피스/니트스커트/do,27140,27140,0
2018-06-01,632923882,A012010,국산쇠고기,(목우촌 선물세트)맛있는 햄 복합 4호 x 3개 고급 쇼,226400,199240,-27160
2018-06-01,1796336891,D031010,주택수선재료,숲으로 에이스 외부용 3.78L 수성/무광/담장/벽화/SE,15000,14800,-200
2018-06-01,437433908,A013020,명태,[bada4u]대구알/대구곤 [800g]곤 이리 알탕 해물탕,5200,5200,0
2018-06-01,271884989,E021020,커튼,/벌집블라인드 그레이 호프발스 100x155 cm/ 롤스크린,56280,50090,-6190
2018-06-01,89518745,I053040,기타문구,3M 포스트잇 강한점착용 다이컷 모양 노트 9종 택1,4540,4540,0
2018-06-01,989103942,L012030,칫솔,미니언즈치약칫솔양치컵(남아)기획팩,8900,6900,-2000
2018-06-01,630441293,C011030,남자학생복,[지오다노][남녀공용]라이트웨이트 코튼 린넨 셔츠(048520)[갤러리아],39800,33830,-5970
2018-06-01,1309192655,A014030,치즈,동원 파마산 블렌드 골드 1kg 치즈가루,10300,10300,0
2018-06-01,1295034660,C011050,남자내의,베이직 스판 그레이 밴딩 슬랙스 슬렉스_JMP603 남자,25470,25470,0
2018-06-01,663709819,C013010,점퍼,[윌슨]아동~성인 멀티자켓 후드짚업 경량비치웨어,16800,16800,0
2018-06-01,1006207822,C013060,등산복,여름신상/등산바지/등산복/작업복바지/아웃도어/남성,12800,12800,0
2018-06-01,1398899856,C012040,여자학생복,수지네 일본 구제 베이지 린넨혼방 베스트 여성 S 19-,13570,13570,0
2018-06-01,404524072,C021040,실내화,나이키 클래식 코르테즈 레더 운동화 흰검 807471-101,87800,77270,-10530
2018-06-01,1647937385,A012060,햄및베이컨,(부대햄1.81kg)포크런천 촙트포크 부대찌개국물햄,15900,15900,0
2018-06-01,193015892,E031120,믹서,일렉트로룩스 마스터피스블렌더 EBR9804S/DG,334900,334900,0
2018-06-01,1989100732,A013090,전복,부경 냉동반가리비 2.1kg(210gx10개),62590,62590,0
2018-06-01,1269492424,C012020,원피스,설레는 핏 여성 빅사이즈 포켓 가디건 여자가디건,49090,49090,0
2018-06-01,1316379623,C015040,장갑,실버D 국내제조 성인용 손싸게 2개 1세트 실버장갑 할,91110,91110,0
2018-06-01,657244941,C011020,남자상의,프리미엄 남성수트 특가/투버튼/원버튼/스트라이프,118900,118900,0
2018-06-01,897503253,A012050,소시지,롯데 비엔나소시지 300G*2,8080,5990,-2090
2018-06-01,234351362,I031010,장난감,스텝2 디딤대,19100,17190,-1910
2018-06-01,988985771,A013150,어묵,[풀무원]풀무원 알래스칸 채소사각어묵 180G,2380,1690,-690
2018-06-01,1379157779,A016120,바나나,(무료배송) 정품 Dole 바나나 / 부드럽고 달콤한 상품,14200,13600,-600
2018-06-01,437589798,I031040,생화,K4camp 1+1 접이식 캠핑의자 낚시의자 릴렉스체어,49450,49450,0
2018-06-01,957738608,L012040,치약,애경 2080 진지발리스K 허벌민트 120G*3,7990,7990,0
2018-06-01,1239016909,C011050,남자내의,[베스티스]베스티스 아이스 쿨링 스타 팬츠,69000,65550,-3450
2018-06-01,784759341,C014010,아동복,[M.K] 한국생산 아기정장 노랑체크 5종세트(3-24개월)201930,74390,66210,-8180
2018-06-01,188161295,A021010,커피,맥심리필커피 300g/500g,9900,9900,0
2018-06-01,206862888,A012010,국산쇠고기,축협 1등급 한우선물세트 갈비 등심 추석선물세트 택1,175000,173250,-1750
2018-06-01,1154077966,C012040,여자학생복,썸머 파인애플 니들워크 가디건 SADI2704/ 솔로이스트,19000,17100,-1900
2018-06-01,1010288070,E041070,밀폐용기,락앤락뉴베이직죽통350ML브라운,9900,8900,-1000
2018-06-01,1964139628,A017020,상추,제이제이몰 청치마상추 종자 씨앗 3g 채소 재배 상추 농산물 쌈채소 텃밭 귀농 농사,3370,3370,0
2018-06-01,1230946681,A016090,참외,달콤한 성주 꿀참외 7kg이내,9800,9800,0
2018-06-01,1010288071,E041070,밀폐용기,락앤락뉴베이직죽통350ML베이지,9900,8900,-1000
2018-06-01,289426728,A017180,호박,가을 상 고추가루 2.5kg,42500,41230,-1270
2018-06-01,192641236,C013010,점퍼,크래커스]코스 블루종,75000,72750,-2250
2018-06-01,891321661,C013020,티셔츠,(4926상)랩스타일 산전산후 수유가능한 면스판 임부상,17370,17370,0
2018-06-01,1866125754,D031010,주택수선재료,타미하우스 베란다 조립식마루 바닥재 바닥 타일 장판,26900,26900,0
2018-06-01,780272698,E061030,전구,[조이라이팅][T5간접조명모음] 8w 14w 21w 28w T5등기구/T5램프/영업집 간접조명/간접,1400,1260,-140
2018-06-01,351300938,A019180,즉석식품,쿠플 크링클컷 포테이토 400g,2700,2700,0
2018-06-01,2003584968,E011030,거실장,주말특가[AFS-2200확장형 거실장] 티비다이 TV장식장,135000,135000,0
2018-06-01,399983733,A011100,라면,무료배송 특가 디딤돌 당면 13kg /고구마전분/잡채/사리/찜닭 만두재료/동그랑,36900,36900,0
2018-06-01,1239016937,C011050,남자내의,[베스티스]베스티스 아이스 쿨링 서클 팬츠,69000,65550,-3450
2018-06-01,1882533917,I012060,저장장치,로지텍G403게이밍마우스/유선/유무선겸용/병행/당일출,65600,63600,-2000
2018-06-01,1312421932,A013090,전복,두레생협 생홍합살(300g 국산) 요리용홍합살 생홍합살,24480,24480,0
2018-06-01,348095633,L021010,손목시계,패션 가죽시계 남자 남성 손목시계,52900,52900,0
2018-06-01,420537790,L012090,기초화장품,이니스프리 포레스트 포맨 올인원 에센스/택1,20400,20400,0
2018-06-01,1468554374,A012010,국산쇠고기,[무항생제] 불고기샤브샤브400g 1+등급,24900,24900,0
2018-06-01,1835169906,A022010,주스,망고원액(참존835ml)/망고농축액 망고주스,4070,3870,-200
2018-06-01,2143086889,C012060,여자내의,[마일리지][마일리지] 골지니트주름스커트 SK032D7,21800,20710,-1090
2018-06-01,1302769869,C011050,남자내의,(색상:사이즈 : 네이비:M) DON 1846 린넨9,28220,28220,0
2018-06-01,628874332,A018060,스낵과자,[청우 참깨스틱 85g X 6개]무료배송/과자,9900,9900,0
2018-06-01,899163348,C013050,운동복,(7900원~)봄신상/트레이닝바지/츄리닝팬츠/요가복,11900,11900,0
2018-06-01,1132628496,C013020,티셔츠,남성 여름 카라넥 냉감 반팔티셔츠 단체티 단체복,9800,9800,0
2018-06-01,1497622778,L012030,칫솔,덴티메이트 칫솔x20개 미세모 페리오 2080 조르단,6900,6900,0
2018-06-01,411690516,C015040,장갑,니트벙어리 프린세스 하트 겨울철장갑 방한벙어리장갑,10190,10190,0
2018-06-01,1088869311,A019110,드레싱,[CJ직배송] 아몬드호두드레싱230gX4개,12480,12480,0
2018-06-01,1984543995,A011170,떡,떡보의 하루 떡케익,39000,39000,0
2018-06-01,375802105,C014010,아동복,[레노마키즈]레이스모티브원피스(R1661O664),14400,13030,-1370
2018-06-01,1988245167,A011130,시리얼,오뚜기 부침가루 1kg X 10EA 부침분말가루 찹쌀부침분,33370,33370,0
2018-06-01,363514323,C011020,남자상의,슬랙스 밴딩바지 밴딩팬츠 면바지 정장바지 남자 바지,15800,15800,0
2018-06-01,710607860,A019060,된장,ⓒ 해찬들 그대로 끓여먹는 된장찌개 (쇠고기)(450G),5750,5750,0
2018-06-01,1088869316,A019110,드레싱,[CJ직배송] 이탈리안드레싱235gX4개,12980,12980,0
2018-06-01,1088869313,A019110,드레싱,[CJ직배송] 사과스위트칠리소스 270gX4개,10900,10900,0
2018-06-01,1088869312,A019110,드레싱,[CJ직배송] 오이피클머스타드소스 245gX4개,10900,10900,0
2018-06-01,1088869315,A019110,드레싱,[CJ직배송] 클래식오리엔탈드레싱240gX4개,13980,13980,0
2018-06-01,492682941,I031040,생화,닌자월렛/맥가이버/멀티툴/다용도칼/카드나이프/캠핑,500,460,-40
2018-06-01,1011118530,L021050,우산,[일양약품] 모스가드 스프레이 (모기기피 진드기 캠핑) - 5개,35000,16900,-18100
2018-06-01,1011118531,L021050,우산,[터닝메카드] 썸머쿨 (벌레물린후 볼타입  50ml) _5개,25000,13900,-11100
2018-06-01,1848309642,C014010,아동복,네파키즈 베스타 구스다운 점퍼 KD82003,122430,122430,0
2018-06-01,989103878,E041060,수저,초L)옻칠디저트포크2P,4500,4500,0
2018-06-01,1011118533,L021050,우산,[일양약품] 모스닥터 썸머쿨액(볼타입 벌레물린곳 캠핑)- 5개,35000,14900,-20100
2018-06-01,1349282142,A013170,생선통조림,유동 꽁치캔 (1.88K) x6,84520,84520,0
2018-06-01,229476921,F012020,생리대,엘리스 생리대 순수감촉 일반형 대형11Px2팩 + 순수날개 대형2팩/ 엘리스,8500,8080,-420
2018-06-01,1011118536,L021050,우산,[터닝메카드] 모기제로 스프레이 (천연 모기 기피제) - 10개,70000,31900,-38100
2018-06-01,430803704,E011020,침대,고급PU헤드 평상형침대/침대프레임/퀸/슈퍼싱글/더블,199000,179100,-19900
2018-06-01,684892100,C013020,티셔츠,[단골15%]프리미엄 긴팔티 맨투맨 집업 빅사이즈까지,13900,9900,-4000
2018-06-01,508461432,C012060,여자내의,[오빵스타일]밑단컷팅바지9부바지레트로 슬림 일자팬츠,20000,19000,-1000
2018-06-01,786236097,C013050,운동복,JW중외산업 친환경 에탄올 워셔액 1.8L(12EA)무료배송,30000,27600,-2400
2018-06-01,691671886,E031110,청소기,블랙앤데커 미세먼지 스팀맙 스팀청소기 FSM1620,125000,116250,-8750
2018-06-01,1410447350,C013010,점퍼,안감양털 박시 오버사이즈 코트 예쁜여성코트 DM-4043,72770,70590,-2180
2018-06-01,611484141,A019080,고추장,CJ 이츠웰 태양초고추장 6.5kg/된장 6.5kg/쌈장6.5kg,14700,14700,0
2018-06-01,1597152468,F011130,홍삼,정관장 베풀정세트(SET),220000,220000,0
2018-06-01,1994505047,E061010,세탁세제,[액츠미친특가+용량UP!]*액체세탁세제 2.2Lx3/4.21Lx2,13900,13900,0
2018-06-01,82262005,I031040,생화,야외 플라스틱테이블+의자세트 접이식 야외테이블,55000,47350,-7650
2018-06-01,1400084210,A011160,빵,냉동 브라운브레드 18봉 36봉,10900,10900,0
2018-06-01,623448851,G011070,자전거,GIFT 2018 삼천리 26 선데이 7 여성용 시티 자전거,180000,180000,0
2018-06-01,499332573,C012040,여자학생복,[GGPX][18 여름] 카라 오픈 롱 가디건 GIB6GD744F[갤러리아],99000,79200,-19800
2018-06-01,951275088,A019060,된장,㉭ 사조해표 일식된장(14KG),19480,19480,0
2018-06-01,1197607203,E041050,냄비,퀸센스 빅토리아 디오냄비 18cm 인덕션겸용,16700,16700,0
2018-06-01,251743176,C015040,장갑,등산 스포츠장갑 반장갑 긴장갑 자전거 여성 여름 봄,5800,5340,-460
2018-06-01,687370650,E061100,습기제거제,[이연 야자활성탄3kg]천연가습기/공기정화/애완견냄새,29800,29800,0
2018-06-01,1098932510,C013010,점퍼,럭셔리/패딩점퍼/남성패딩/야상/패딩/무스탕/가죽자켓,128700,128700,0
2018-06-01,1978484166,C013010,점퍼,남녀커플용 프레쉬 시크 점퍼 블랙 항공점퍼 안감,42200,33760,-8440
2018-06-01,452095897,C012020,원피스,[오즈세컨] [여성] 프릴 플라이트 점퍼 2WMS1PN00100048,598000,538200,-59800
2018-06-01,989103879,E041080,부엌용용구,초L)옻칠어른수저1벌,6500,6500,0
2018-06-01,776801179,F012020,생리대,예지미인 롱 라이너 20개입 x 60,140950,125450,-15500
2018-06-01,1015317485,C011030,남자학생복,[티니위니]티니위니 [16P2_18S0019]솔리드가디건,12300,11690,-610
2018-06-01,1338078714,C013060,등산복,[빈폴아웃도어]남녀 공용 SUPER DOWN STANDARD 3종택1 (3종택1),116000,91640,-24360
2018-06-01,895894600,A018050,비스킷,크라운 국희 땅콩샌드(372g),4500,4500,0
2018-06-01,233506016,C013020,티셔츠,쿨카라(기능성) 작업복티셔츠/단체티/단체복유니폼,7500,7500,0
2018-06-01,895806062,A011090,국수,[오뚜기]오뚜기 우동맛 컵누들(38.1G),1050,1050,0
2018-06-01,895831020,A019050,간장,[샘표]샘표 진간장S 930ml,4350,4350,0
2018-06-01,189027779,E041020,컵,leah 바로크 커피잔세트 5인조 / 찻잔 머그컵 머그잔,65000,64350,-650
2018-06-01,492694916,C012040,여자학생복,[블루종]그물망 가오리 니트_[B1806KN104B]/ 블루종,24500,19600,-4900
2018-06-01,1489219788,C021040,실내화,[아디다스][UNISEX ORIGINALS] 슈퍼스타 (C77124)(경기점),79000,67440,-11560
2018-06-01,2074377503,D031010,주택수선재료,미앤미 편백나무 히노끼/조립식/끼움식/베란다마루,39500,37130,-2370
2018-06-01,1793531322,C012040,여자학생복,[하루메이비] [하루메이비]M219 스트라이프 롤업소매 버튼 블라우스,43900,43900,0
2018-06-01,661460675,C013010,점퍼,브랜드특가 기모후드자켓/기모야구점퍼/후드츄리닝,29800,29800,0
2018-06-01,981550827,A014010,우유,(가정배달)목장의신선함이 살아있는우유 1000ml,39500,39500,0
2018-06-01,747774999,A019060,된장,[순창 이기남할머니 전통 된장1kg]고추장/간장/장아찌,15900,15900,0
2018-06-01,626298172,I012010,컴퓨터,(E)B70EV-AG75S1/7세대/i5/16G/SSD128+1TB/GTX1060,1740000,1653000,-87000
2018-06-01,231271579,C012060,여자내의,빅사이즈/쉬폰/주름/롱/스커트 쉬폰주름롱스커트 빅사,45680,45680,0
2018-06-01,121101919,C013040,청바지,리바이스/511-4406/슬림핏/청바지/남성/블랙진/스키니,78000,68640,-9360
2018-06-01,231055995,C014020,유아복,아동바지 매화 미니쥬리 팬츠 KIDBOK-26 긴바지 긴유,10660,10660,0
2018-06-01,900388053,A016160,과일가공품,태국산 망고 (특/개),3300,3100,-200
2018-06-01,895831016,A019050,간장,[샘표]샘표 진간장 금 F3 930ml,5950,5950,0
2018-06-01,895831019,A019050,간장,[샘표]샘표 국간장 930ml,5950,5950,0
2018-06-01,727527979,A011120,두부,퀘이커 오츠 오트밀 4.52kg /귀리100% /건강식,28400,28400,0
2018-06-01,1625599290,F012010,종이기저귀,[+방수턱받이] 보솜이 리얼코튼 기저귀 3팩,32900,32900,0
2018-06-01,2095028282,A014030,치즈,동서 모짜렐라 자연치즈1kg 2개 /피자치즈,22900,22900,0
2018-06-01,1022060382,A019020,참깨,볶은 참깨 볶음 검정깨 흑임자 200g 1kg 국산 참깨,7900,7900,0
2018-06-01,895831018,A019050,간장,[샘표]양조간장 501 930ml,7350,7350,0
2018-06-01,1056046389,E031110,청소기,[단후이]시즌2 로봇청소기+물걸레겸용 up그레이드출시,298000,298000,0
2018-06-01,1874623384,E041020,컵,키스 마르키 2P머그/커피잔/찻잔/머그컵/커피잔세트,21000,20790,-210
2018-06-01,732729663,E041070,밀폐용기,타공/밧드/받드/밧트/스텐/바트/반찬/보관/용기/급식,19200,19200,0
2018-06-01,613470393,C012040,여자학생복,수지네 구제 네파 퍼플 조끼 여성 M 14-13,13770,13770,0
2018-06-01,224058123,C012040,여자학생복,H_지지미 스트라이프 셔츠/스트라이프셔츠/롤업셔츠,13900,13900,0
2018-06-01,1945751905,C013020,티셔츠,박스티 롱티셔츠 반팔티 빅사이즈 여성의류 롱원피스,19800,19800,0
2018-06-01,1466052953,I031040,생화,LED 줌 후레쉬 펜라이트 손전등 헤드랜턴 피티타임,4260,4260,0
2018-06-01,2078336798,E041060,수저,유아동 수저 케이스 에디슨 젓가락 스푼 포크 어린이,4000,4000,0
2018-06-01,1010171756,F011150,건강기능식품,정관장 홍삼원 50ml x 60포/쇼핑백 증정,100000,47900,-52100
2018-06-01,895806091,A011070,혼식곡,[곰표]곰표 강력 밀가루 2.5kg,4000,4000,0
2018-06-01,895806092,A011070,혼식곡,[대한제분]곰표 중력 1등급밀가루(2.5kg),3600,3600,0
2018-06-01,345965034,C014020,유아복,아동바지 매화 미니쥬리 팬츠 KIDBOK-26 바지 면바지,10760,10440,-320
2018-06-01,1048899751,C013030,스웨터,KD 배색 단가라 니트 여성 니트,36820,36090,-730
2018-06-01,492694978,C012040,여자학생복,[블루종]믹스 단가라 반팔 니트_[B1806KN100B]/ 블루종,24500,19600,-4900
2018-06-01,1994338796,F012010,종이기저귀,[하기스] 오버나이트팬티 5단계 공용 팬티형 62매,28200,28200,0
2018-06-01,1320519199,A018010,초콜릿,스니커즈/트윅스/자유시간/크런치바/크리미츄,9900,9900,0
2018-06-01,798923018,E031130,보온매트,[한일의료기] 편백 더블 전기매트 HL-02SM /매트/선물/,176800,176800,0
2018-06-01,1011118567,A022060,혼합음료,[CJ직배송] 한뿌리 홍삼대보 용돈박스 ( 40ml x 20포),29900,29900,0
2018-06-01,129966083,C012040,여자학생복,롱 블라우스 남방/빅사이즈 여성의류/빅파라,16800,12800,-4000
2018-06-01,1285718776,L012010,면도기,질레트 면도크림 면도젤쉐이빙폼 닥터블레이드세정제,3300,3300,0
2018-06-01,615262472,A022030,생수,무료배송 휴대용/아이시스8.0 300mlX60병,15200,15200,0
2018-06-01,1104439915,C012040,여자학생복,울 실크 대나무섬유 블라우스 자연섬유 전용 크리너 세제,21000,21000,0
2018-06-01,1560748833,L012060,샴푸,려 자양윤모 려샴푸 6개(1740ml) + 한개 더!,29000,27900,-1100
2018-06-01,1261987915,E031090,공기청정기,그린루프트 초미세 공기청정기 HM-8000 PLUS,89900,89900,0
2018-06-01,1010411981,L012030,칫솔,LG)죽염일당오치칫솔1입,4900,3990,-910
2018-06-01,895806093,A011070,혼식곡,[대한제분]대한제분 햇밀가루 2.5kg,4650,4650,0
2018-06-01,1964548104,C021040,실내화,[푸마(PUMA)]푸마 바스켓 플랫폼 367260-01 02 Basket Platform Trace KR(센텀시티점),119000,98120,-20880
2018-06-01,247483857,C011050,남자내의,남성 스키니청바지 면바지 일자 슬림 밴딩팬츠w077,16000,15800,-200
2018-06-01,1019893757,E041020,컵,리자인 매트 예쁜커피잔 에스프레소잔 라떼잔 머그컵,2800,2660,-140
2018-06-01,937144659,C011030,남자학생복,리바이스/CK/청바지/자켓/데님 남방/진/스키니/진,45000,45000,0
2018-06-01,1508516109,L012010,면도기,카이 갸스비 레그트리머 세트구성 다리털 숱 정리기,10000,9900,-100
2018-06-01,891622773,E021020,커튼,적당한 사이즈 중형 거실커튼(300cm이상)면 소창 커튼,98900,90990,-7910
2018-06-01,2089204909,C014010,아동복,한국생산 야구 상하복과 모자 레드(0-24개월)800023,64130,57080,-7050
2018-06-01,1199546692,C021040,실내화,아디다스 아딜렛 샌달 ADIDAS ADILETTE SANDAL 4종택일,62000,49600,-12400
2018-06-01,1777666124,E011030,거실장,[PookShuim]푹쉼 말리 PU가죽 전동 리클라이너 4인소파 접이식컵홀더포함,1332000,1332000,0
2018-06-01,1777666123,E011030,거실장,[PookShuim]푹쉼 말리 PU가죽 전동 리클라이너 6인소파 접이식컵홀더포함,1604000,1604000,0
2018-06-01,1777666126,E011030,거실장,[PookShuim]푹쉼 리가 MPL 2인용 미니 소파베드,238000,238000,0
2018-06-01,1777666125,E011030,거실장,[PookShuim]푹쉼 비엔나 MPL 2인용 접이식 소파베드,433000,433000,0
2018-06-01,1777666128,E011030,거실장,[PookShuim]푹쉼 리가 MPL 1인용 미니 소파베드,189000,189000,0
2018-06-01,1777666127,E011030,거실장,[PookShuim]푹쉼 딜리 3인용 FPL가죽 소파베드,388000,388000,0
2018-06-01,734302270,I012010,컴퓨터,[E]B70EV-AR75S1/7세대/i5/8G/128G+1TB/키보드+마우스,894000,849300,-44700
2018-06-01,268484722,A011050,콩,브라질너트 1kg/브라질넛트/브라질넛/브라질넛츠,28500,28500,0
2018-06-01,1777666129,E011030,거실장,[PookShuim]푹쉼 몽뜨 3인용 FPL가죽 소파베드,438000,438000,0
2018-06-01,1978484107,C013010,점퍼,케빈 트렌디 점퍼 블랙 카키 커플 항공 롱 점퍼 안,51600,41280,-10320
2018-06-01,1234856760,L021030,가방,13인치14인치15인치 노트북 맥북 파우치 슬리브 가방,15900,15900,0
2018-06-01,896579824,F012020,생리대,[LG]바디피트 귀애랑 중형 (18P),6690,4480,-2210
2018-06-01,896579825,F012020,생리대,[LG]바디피트 귀애랑 소형 (18P),6390,4480,-1910
2018-06-01,896010296,C012020,원피스,[리리앤코]남심저격원피스/44-110/빅사이즈/플라워,38800,27800,-11000
2018-06-01,475094676,C013050,운동복,[인앤테크] (색상 : 오렌지) 도어가드원4M ㅣ 문콕방,23770,21660,-2110
2018-06-01,896579823,F012020,생리대,[LG]바디피트 귀애랑 대형 (18P),7990,4480,-3510
2018-06-01,1385853865,A011160,빵,안흥찐빵마을 수제 찐빵 500g(10입) 3봉 수제찐빵 주,33660,33660,0
2018-06-01,963901021,L021030,가방,[비너스]비너스 볼륨 업 메모리 패드(VAC3700)[갤러리아],9000,6750,-2250
2018-06-01,2121251101,A012010,국산쇠고기,[무항생제] 이유식용 우둔살 300g 2등급,17800,17800,0
2018-06-01,1320749106,C011050,남자내의,[리바이스]34505-0166 남성505쿨맥스 레귤러핏 반바지,69000,58650,-10350
2018-06-01,1010171728,A022020,두유,연세 소이밀크오리지널 1L,1850,1850,0
2018-06-01,1704393305,A022050,탄산음료,진로 토닉워터 300ml×24펫 캐나다드라이/진저엘/탄산,15500,15500,0
2018-06-01,492694944,C012060,여자내의,[블루종]야자수 나염 뒷밴딩 스커트_[B1806SK073B]/ 블루종,55000,44000,-11000
2018-06-01,633812858,F012010,종이기저귀,에코튜드 센서티브 옥수수 울트라씬 기저귀 4팩,37900,35900,-2000
2018-06-01,5438546,A017090,열무,[거시기장터2018년 수확! 햇 레드비트 3kg/5kg,10900,10900,0
2018-06-01,1170143068,C011030,남자학생복,밀란시아 원버튼 클래식조끼 sh1201-001 남성베스트,54650,49190,-5460
2018-06-01,1948598059,E031070,에어컨,신일 리모컨 벽걸이선풍기 SIF-16WRA 가정용 사무실,55500,55500,0
2018-06-01,1080761312,C013040,청바지,제이엠스네일 어린이 멜빵 청바지 블랙진,35000,33000,-2000
2018-06-01,1033277383,A019060,된장,[사조해표] 순창궁 재래식된장 500g x10개,23800,23800,0
2018-06-01,921982132,C012020,원피스,[보니알렉스](보니알렉스)오버사이즈 코트(BCHY105A),35500,31240,-4260
2018-06-01,1033277384,A019080,고추장,[사조해표] 태양초고추장14kg(캔),40500,40500,0
2018-06-01,1033277385,A019080,고추장,[사조해표] 순창궁 태양초고추장 6.5kg x2개,24900,24900,0
2018-06-01,1033277386,A019080,고추장,[사조해표] 순창궁 우리햅쌀고추장 1kg x3개,25600,25600,0
2018-06-01,1430704645,D031010,주택수선재료,AURO 아우로 투인원 오일 No.129 750ml 가구 마루,51700,50300,-1400
2018-06-01,309120286,C011030,남자학생복,[예작셔츠]남성 반소매 일반핏 모달 솔리드 YJ8MBR208,30000,25500,-4500
2018-06-01,1033277387,A019080,고추장,[사조해표] 순창궁 우리햅쌀고추장 500g x4개,17300,17300,0
2018-06-01,42630712,A011070,혼식곡,Only Price 밀가루(1KG),1000,1000,0
2018-06-01,446494163,C011050,남자내의,[무료배송]팀 클럽 커프 팬츠(658679050) 팬츠 스포츠,57550,57550,0
2018-06-01,446494162,C012030,여자상의,[무료배송]빅사이즈 DNB0074R 다운 플라워 프릴 원피,46630,46630,0
2018-06-01,1427776183,C012040,여자학생복,[쥬시쥬디]반넥스트라이프 블라우스(HSBL320H)(강남점),48300,41060,-7240
2018-06-01,1163209488,C013010,점퍼,바람막이 옷 수선 접착 테이프 패치 패딩 방수 점퍼,9000,9000,0
2018-06-01,677848356,F012010,종이기저귀,[롯데공식수입] 메리즈 기저귀 팬티/밴드 모음,33900,33900,0
2018-06-01,563671096,E011050,책상,/코너워크스테이션 블랙브라운 미케 100x142 cm/ 디자,289540,257700,-31840
2018-06-01,2057705272,C013040,청바지,[series] HIPSTER 셀비지 다크 데님팬츠 [SAPDM17011GYD](본점),99500,82050,-17450
2018-06-01,895831079,F012020,생리대,[P&G]위스퍼 보송보송 울날오버 14P,4890,4890,0
2018-06-01,2118626859,A012010,국산쇠고기,[무항생제] 양지 600g 2등급,37700,37700,0
2018-06-01,1902263474,I012010,컴퓨터,2018년형 삼성노트북3 NT300E5S-KD5A Win7가능 재고有,671580,638000,-33580
2018-06-01,1960856452,F011150,건강기능식품,뉴트리 미국 천연 비타민 피로회복 종합 멀티 영양제,28000,28000,0
2018-06-01,1380895279,F011150,건강기능식품,3년숙성/강화사자발약쑥/강화약쑥/약쑥진액 오리지널 60팩/강화마니/마니수/티백/수제,39900,39900,0
2018-06-01,1288821227,C021040,실내화,여성 키높이 슬립온,30500,29800,-700
2018-06-01,1264318643,A011080,밀가루,옛날국수 구포국수 메밀국수 콩국수 소면/중면,4800,4800,0
2018-06-01,1050922013,I031040,생화,CQ-C110 접식식 안마의자/안락의자/휴식의자/캠핑의자,44000,36710,-7290
2018-06-01,1654508293,L012010,면도기,도루코 페이스4 x10개 페이스6 x10개/일회용면도기,5900,5900,0
2018-06-01,442909287,A013060,게,한치 마른화살오징어(S 40미)1kg 2개,224970,224970,0
2018-06-01,1108034456,A011170,떡,아올 제주 오메기떡 15개/20개/30개/국내산팥 재료,24500,21500,-3000
2018-06-01,2118181742,C013010,점퍼,아둘 패밀리룩 여름 반팔 조던 쥬니어 상하세트 34,15900,15900,0
2018-06-01,1082881970,C012060,여자내의,SK934-데일리 20대 30대 예쁜스커트 레더 지퍼 플레어,27090,27090,0
2018-06-01,364743529,A022050,탄산음료,스프라이트 185ml x60can/박스포장,27500,27500,0
2018-06-01,1120270828,E031080,선풍기,이노크아든_ 원통형 나노카본 전기히터 온풍팬장착 IA-2800F (2800W),118000,118000,0
2018-06-01,533401452,C013010,점퍼,여성 셔링 포켓 포인트 후드 롱 점퍼(TUMAD2142)/ 비키,263000,236700,-26300
2018-06-01,1120270827,E031080,선풍기,파이로 원적외선 세라믹 가스히터 ZAFHT0101,44100,44100,0
2018-06-01,1120270829,E031080,선풍기,이노크아든_ 원통형 카본히터 온풍팬장착/리모콘형 IA-2800EF (2800W),138000,138000,0
2018-06-01,1120270826,E031080,선풍기,한솔일렉트로닉스_PTC 전기온풍기 HSH-P300F 히터 이동식 고효율,178000,178000,0
2018-06-01,1159478880,I031040,생화,릴렉사 야전 캠핑 침대,64900,58790,-6110
2018-06-01,1783179291,E011030,거실장,로딘 세인트 4인 식탁세트,705000,705000,0
2018-06-01,798923020,E031130,보온매트,[한일의료기] 편백 싱글 전기매트 HL-01SM /매트/선물/,158200,158200,0
2018-06-01,798923022,E031130,보온매트,[한미의료기] 캠핑 전기매트 HM-7700 (500x1550) /매트/선물/,47000,47000,0
2018-06-01,1783179295,E011030,거실장,로딘 알마니 4인 식탁세트,485000,485000,0
2018-06-01,870283734,E021010,침구,2018여름이불자체생산 친환경쿨소재(패드/베개커버),37800,37050,-750
2018-06-01,868002594,E031130,보온매트,전기요 GF-200 [전자파안심 / 순면 / 황토 / 물세탁 / 전기요(싱글)],73000,73000,0
2018-06-01,903975231,A015010,참기름,[고소하고 진한 참기름1L] 참맛기름 들기름 참깨 들깨,7900,7900,0
2018-06-01,868002597,E031080,선풍기,EMK 판넬히터 EMH-P302M [ 마이카서믹 시스템(대류＋복사) / 60mm 슬림 사이즈 ],59520,59520,0
2018-06-01,868002596,E031080,선풍기,EMK PTC히터 EPH-S3318M [2단계 온도조절 / 풍속조절 / 전도 안전장치],55710,55710,0
2018-06-01,99218405,E021020,커튼,암막커튼/커텐 거실 창문 안방 햇빛 가리개 방한 방풍,10000,9110,-890
2018-06-01,1210388972,C013040,청바지,[쿠키세븐]P6546 데미지 컷팅 세미 부츠컷진(S.M.L),43800,41610,-2190
2018-06-01,1216703509,A016060,감,달콤샤르르 자연그대로 만든 아이스 홍시 18개(컵)/개,26330,23700,-2630
2018-06-01,868002591,E031130,보온매트,초극세사 전기요 GF-201 [싱글 / 물세탁 / 3중안전장치],95000,95000,0
2018-06-01,1136962875,A013070,굴,두레생협 손질꽃게(500g) 튀김용꽃게 탕용손질꽃게 찌,52820,52820,0
2018-06-01,868002590,E031080,선풍기,HOMY 고효율 카본히터 HCH-N07BR [온도조절 2단 / 안전장치],39000,39000,0
2018-06-01,942826229,A011130,시리얼,혼합감자맛전분(화미 1k)X20 가루분말 분말가루 감자,59100,59100,0
2018-06-01,868002593,E031130,보온매트,초극세사 전기요 GF-202 [더블 / 물세탁 / 3중안전장치],89000,89000,0
2018-06-01,868002592,E031130,보온매트,전기요 GF-300 [전자파안심 / 순면 / 황토 / 물세탁 / 전기요(더블)],95000,95000,0
2018-06-01,1322279876,A019060,된장,신송 재래된장 6.5kg,11600,11600,0
2018-06-01,549344083,C013040,청바지,[더레이어]뉴신상 히든포켓/컷팅진/짱짱스판28~40까지,9900,9900,0
2018-06-01,894498690,C013010,점퍼,[인터페이스]바람막이 야상 블루종점퍼 후드내장 멋쟁,37700,37700,0
2018-06-01,686259,L021030,가방,[헬렌카민스키] 카릴로 HPSBR100310(강남점),390000,340470,-49530
2018-06-01,370173805,E031110,청소기,[블랙앤데커]스팀청소기 FSM1610 / FSM1605 / FSM1620,107000,99000,-8000
2018-06-01,998974456,A022050,탄산음료,[코카콜라]코카콜라제로 250mlx30캔/제로/라이트,23500,23500,0
2018-06-01,866043960,C014010,아동복,아동 셔츠모음/아동 남방모음/옥스포드셔츠/체크셔츠/스트라이프셔츠/기본남방/흰남방,21800,21800,0
2018-06-01,115827591,C011030,남자학생복,오마샤리프 깅엄 체크셔츠 블루컬러 남자셔츠/30357NA,18800,18800,0
2018-06-01,906343106,C014020,유아복,두툼! 한겨울 여아 패딩점퍼_유아동 패딩_여아 아우터,39900,39110,-790
2018-06-01,1062693001,F011150,건강기능식품,[삼성제약] 까스 명수 75ml x100병,52000,52000,0
2018-06-01,425143454,E031130,보온매트,일월 소형 온열매트 3인용 방석/전기장판 전기매트,29000,21250,-7750
2018-06-01,1016762031,F012020,생리대,유기농본생리대 본골드 골라담기/100%순면커버,2900,2900,0
2018-06-01,1557324522,A012030,돼지고기,(고기천국)쫄깃고소한 대패삼겹살500g/목살/돼지고기,4900,4900,0
2018-06-01,2048150960,A017040,양배추,수입산 사상자70g 뱀도랏 사상자 뱀도랏 토사자 미나,3040,2740,-300
2018-06-01,608630523,C013020,티셔츠,커터앤벅 남성 스판카라 반팔티셔츠 - 1472-101-63,44900,39900,-5000
2018-06-01,1034203756,A019060,된장,[권기옥명인] 꽁보리 막장 450g,11200,11200,0
2018-06-01,972447477,E061010,세탁세제,NEW 컴플리트 퍼실/ 컬러젤 /1.8Lx6개/2.7Lx4개/특가,43000,42500,-500
2018-06-01,1034203757,A019060,된장,[권기옥명인] 된장 골라담기 (메주된장/쌈장/막장),13900,13900,0
2018-06-01,505753085,C011050,남자내의,(3+1) 남녀 냉장고바지 밴딩 팬츠 여성 빅사이즈,4800,4800,0
2018-06-01,1180775664,C013050,운동복,230_고구마베이비 아기옷- 진그린 코끼리 민소매 상하,10910,10590,-320
2018-06-01,537193914,C011030,남자학생복,오투웜발열점퍼-A타입] 발열조끼 등산 낚시 야영,58600,58600,0
2018-06-01,1318965395,L012040,치약,메디안 치석케어 치약 120g x 9개  페리오 2080 죽염,10800,10800,0
2018-06-01,2031675449,C013040,청바지,제이로드 810 남자 청바지/스키니/카고바지/찢어진/면,29900,29900,0
2018-06-01,209433267,G011070,자전거,시애틀레이디7+무료배송 삼천리 여성용7단26인치,139000,125100,-13900
2018-06-01,1384203915,C011050,남자내의,9900원~조거 팬츠 바지.배기.트레이닝.츄리닝.밴딩,28000,19800,-8200
2018-06-01,2071851252,C012040,여자학생복,데님 연청 청조끼 LDZ241 데님 데님조끼(YA02004) /,113000,99440,-13560
2018-06-01,683871868,C013010,점퍼,[대구백화점 I관] [레코브]피유블루종(LY317ZJP518X),64000,60800,-3200
2018-06-01,530321337,A011010,쌀,ORGA 쌀가루 고운입자(유기농 18g,3900,3900,0
2018-06-01,2002730890,A019020,참깨,고운 들깨가루 (한1K) X10,98510,87680,-10830
2018-06-01,901253013,A012060,햄및베이컨,동원 리챔 기획 (340G*3입+1입),14800,12990,-1810
2018-06-01,367534928,C011050,남자내의,BASIC 2H LINE COTTON SHORTS BLACK,39000,39000,0
2018-06-01,2077817340,C013010,점퍼,[셀덴] 여바람막이EDJA72352S_NC아울렛,19900,9900,-10000
2018-06-01,43616602,A011010,쌀,임금님표 이천쌀5kg,21900,21900,0
2018-06-01,164476354,C013060,등산복,여름 신상품 기능성 스판 일자 등산바지 카고 작업복,19800,19800,0
2018-06-01,2048412086,L021060,유모차,세스토에스S 샤이닝에디션 엄마가 만족하는 유모차,498000,498000,0
2018-06-01,849650956,C011030,남자학생복,[리바이스] 리바이스/긴팔셔츠/청남방 0313CC DARK RINCE,55000,55000,0
2018-06-01,1067504089,A011090,국수,[농심]컵라면12~24개입/신라면/컵누들/왕뚜껑/사발면,8900,8900,0
2018-06-01,1999066511,C012060,여자내의,[대구백화점 I관] [멜로디가든]파이4부반바지(M8M4P18),32000,28800,-3200
2018-06-01,329315121,C013010,점퍼,[무료배송]푸조 남녀공용 기모 양털 후드집업(FZ324-1,42700,42700,0
2018-06-01,1225130929,C013060,등산복,WD쿨기본 밴딩바지 남성 여름 트레이닝 고무바지 등산,12800,12800,0
2018-06-01,1639897567,C012040,여자학생복,[르샵][17 여름] 밑단+소매플레어 블라우스(LH6BL868)[갤러리아],41400,33120,-8280
2018-06-01,120875990,L012040,치약,인사덴트 닥터 치약/듀오클린 두줄치약/리필/매스미르,5700,5700,0
2018-06-01,387394683,C015040,장갑,[프로스펙스] (SIZE : LXL) 핑거 메이저 2 니트 글러브(GR,8740,8740,0
2018-06-01,1997935098,L021030,가방,제이벤 천연 소가죽 서류가방 천연가죽가방,83000,73000,-10000
2018-06-01,1185572060,C014020,유아복,아동바지 매화 미니쥬리 팬츠 KIDBOK-26 바지 아동면,10630,10630,0
2018-06-01,346881593,G011070,자전거,삼천리자전거/하로GS26 26인치 삼천리 접이식자전거,134000,120600,-13400
2018-06-01,990094673,A013060,게,[청산바다]국내산 돌문어 800~1.2kg (1~2마리),48000,45000,-3000
2018-06-01,990094672,A013060,게,[청산바다]국내산 돌문어 500~800g (1~2마리),38000,35000,-3000
2018-06-01,784578102,A019080,고추장,청정원 순창 찰고추장 (봉)(500G),5600,5600,0
2018-06-01,1833218586,A011090,국수,오뚜기 컵누들 골라담기,790,790,0
2018-06-01,608544193,C011030,남자학생복,[빈폴][빈폴] 네이비 코튼 베스트 (BC7151A51R)_Y9Z8,106800,89720,-17080
2018-06-01,1265004866,C013010,점퍼,반폴라보아털집업 GY1712 털집업 캐쥬얼집업 집업 여,50570,50570,0
2018-06-01,369855405,C021020,구두,남성구두 정장구두 건강에어구두 천연가죽 9020d 정장,82850,82850,0
2018-06-01,1269719276,C013050,운동복,트레이닝/반바지/헬스/런닝/나시/무지/하의/팬츠/스판,6000,5900,-100
2018-06-01,1140656226,L012040,치약,2080 진지발리스 치약 120g+20g x 9개/잇몸/미백/칫솔,9900,9900,0
2018-06-01,1495262286,A014030,치즈,코리원/코다노 후레쉬모짜렐라 슬라이스치즈 1kg/피자,13200,13200,0
2018-06-01,200929754,A022040,기능성음료,ION the FIT 이온더핏 410mlx20 이온음료 무칼로리,11900,11900,0
2018-06-01,582750250,I012010,컴퓨터,LG총판 LG데스크탑 B70EV-AR7506 i5-7500 1TB Win10,839360,789000,-50360
2018-06-01,1045518916,C013010,점퍼,[모다아울렛][후라밍고]누빔패딩점퍼(FMD71039브라운)),70000,61600,-8400
2018-06-01,613350669,E031110,청소기,유진로봇 로봇청소기 아이클레보 오메가 YCR-M07-10,549000,549000,0
2018-06-01,272761982,C015020,모자,엠블럭[3층X3칸 9칸형]모자걸이 정리대 보관함 진열장,38400,36480,-1920
2018-06-01,183878059,A022010,주스,코코팜/사이다/자몽소다/레몬에이드/커피/갈아만든배,10500,10500,0
2018-06-01,348335798,C012040,여자학생복,[대구백화점 II관] [ab.f.z]폴리오픈형롱가디건(AFS3GY11G),29000,24940,-4060
2018-06-01,433680619,A018030,껌,자일리톨 알파 오리지날 리필 98g,2700,2700,0
2018-06-01,1140644248,L012090,기초화장품,홀츠포맨 남성 워터드롭 수분크림 보습크림,16800,16800,0
2018-06-01,420755952,C012020,원피스,울 앙고라코트 MQDAWL1450/ 미니멈,429000,377520,-51480
2018-06-01,416055604,C013010,점퍼,바람막이 야상 WS-JM21 바람막이 야상 점퍼 남자야상,36350,35630,-720
2018-06-01,597743028,I011030,사진기,소니 정품 A6500 (본체+18-135mm 렌즈포함/공식대리점,1963800,1884200,-79600
2018-06-01,2121458920,A012010,국산쇠고기,[무항생제] 잡뼈 2kg 1등급,21600,21600,0
2018-06-01,1461300905,C012040,여자학생복,빅사이즈 캐주얼 후드 조끼,38020,38020,0
2018-06-01,2084633736,C013010,점퍼,아르크네 양털 무스탕 DM-4044-양털무스탕자켓 양털,20750,18470,-2280
2018-06-01,563056164,C012060,여자내의,더 아이잗 와이드 버클장식 바지 IH4M0SL76,49000,40180,-8820
2018-06-01,897527307,A018090,잼,복음자리 딸기쨈 (640G),7300,7300,0
2018-06-01,320209544,A013070,굴,[요코몰]영덕게살 90g/YD/영덕농수산/영덕대게/성게알통조림/대게살/게간장/게액장/지,8000,7600,-400
2018-06-01,1120270886,E031080,선풍기,한솔 넥스코 원적외선 세라믹 벽걸이 선풍기히터 HSN-W900CL,32500,32500,0
2018-06-01,1120270885,E031080,선풍기,한솔 넥스코 할로겐 벽걸이 선풍기히터 HSN-W900HL,33900,33900,0
2018-06-01,1120270888,E031080,선풍기,한솔 넥스코 원적외선 세라믹 스탠드 선풍기히터 HSN-S900CL,33500,33500,0
2018-06-01,1120270887,E031080,선풍기,한솔 넥스코 할로겐 스탠드 선풍기히터 HSN-S900HL,35000,35000,0
2018-06-01,784578168,A019080,고추장,청정원 순창 찰고추장(1KG),13300,13300,0
2018-06-01,167979584,E041010,식기,칠기 멜라민그릇 우동그릇 우동기 라면그릇 면기,1000,880,-120
2018-06-01,177197487,A022020,두유,서울대공동개발 약콩두유 190mlx24팩,19900,19900,0
2018-06-01,312098751,C013020,티셔츠,여름 남자 M 아이스 냉감 쿨 목긴팔티 등산 작업복티,8900,8900,0
2018-06-01,665404685,A012060,햄및베이컨,햄(런천미트 대상 340g)X20 / 대상 /(참고) 런천미트,138900,122240,-16660
2018-06-01,1289232934,A017250,고사리,아스파라거스모종 2년생 1주(1포기),5000,5000,0
2018-06-01,1053294669,C012040,여자학생복,[럽스]1+1사은품/자체생산/조끼/신상/롱/니트/리본,9900,9900,0
2018-06-01,834691553,E051030,디지털도어록,무료설치 BEE 전자키4개+번호키 디지털도어락 현관문,127000,113720,-13280
2018-06-01,798321237,C012040,여자학생복,[로엠][로엠] 소매 플라워 블라우스 RMBL523R23,8900,8460,-440
2018-06-01,1305534545,A019040,소금,[삼보죽염]9회 자죽염 분말 110g×3개,93000,93000,0
2018-06-01,1264717976,D031010,주택수선재료,원목사용 조립식 마루 아시아월넛 9장/1박스 바닥재,27800,27800,0
2018-06-01,1034203730,A019080,고추장,[권기옥명인] 보리 고추장 500g,14900,14900,0
2018-06-01,452888365,C013050,운동복,여름시원한 트레이닝 상하세트,30000,30000,0
2018-06-01,1034203726,A019080,고추장,[권기옥명인] 고추장 골라담기 (찹쌀/볶음/매실),14900,14900,0
2018-06-01,1034203727,A019080,고추장,[권기옥명인] 매실 고추장 500g,15900,15900,0
2018-06-01,1044495599,A013070,굴,[새우몰]양념꽃게용 절단 꽃게 3팩/꽃게,6900,6900,0
2018-06-01,1034203728,A019080,고추장,[권기옥명인] 한우볶음 고추장 500g,15900,15900,0
2018-06-01,1034203729,A019080,고추장,[권기옥명인] 보리 고추장 980g,26500,26500,0
2018-06-01,599777354,L021030,가방,투카노 SMILZA 스밀자 15인치 슬림 노트북가방,39000,39000,0
2018-06-01,2017192196,E031030,전자레인지,[매직쉐프] 20L 전자식 전자레인지 MEM-G20EW (본사),79000,79000,0
2018-06-01,381449579,C013020,티셔츠,언발빅골지목폴라티 GO1711 여자폴라티 빅골지폴라티,30070,30070,0
2018-06-01,1932486262,F012030,안경,수제 안경/국산 안경테/메탈/콤비/뿔테/안경/안경테,19800,19800,0
2018-06-01,798321246,C012040,여자학생복,[로엠][로엠] 플라워 망사 배색 블라우스 RMBL523R11,8900,8460,-440
2018-06-01,1545110821,I031010,장난감,ps2 플스2 플레이스테이션2 게임시디 게임소프트 CD,10000,10000,0
2018-06-01,459347381,C015040,장갑,핫팩 방한방수 벙어리 남성장갑 스노우보드장갑 남자,19600,19600,0
2018-06-01,1760325520,A021010,커피,[맥널티]아이스커피 230mlx10개입x3세트+컵10개 증정,16060,15100,-960
2018-06-01,1034203733,A019080,고추장,[권기옥명인] 찹쌀 고추장 500g,14900,14900,0
2018-06-01,1034203734,A019060,된장,[권기옥명인] 쌈장 500g,12900,12900,0
2018-06-01,1034203731,A019080,고추장,[권기옥명인] 찹쌀 고추장 2kg,52900,52900,0
2018-06-01,1568674236,C021010,아동화,[아디다스키즈] 샌달펀 I (BY2240),39000,35100,-3900
2018-06-01,1339219295,E041020,컵,핸즈홈/에말리아 법랑머그 350ml 5종(일자형) 법랑컵,7800,7800,0
2018-06-01,2058679003,A011130,시리얼,오뚜기 초간편 김치전믹스 360gx 3/부침가루/코스트코,12990,12990,0
2018-06-01,1034203732,A019080,고추장,[권기옥명인] 찹쌀 고추장 980g,26500,26500,0
2018-06-01,603047974,A014020,분유,후디스 초유밀 플러스 2단계 100g,14900,14900,0
2018-06-01,383036411,C013050,운동복,[컬리수]쿨냉장고10부팬츠_CNM0XQPT82,15900,15900,0
2018-06-01,1168179460,A013150,어묵,다인 피쉬볼 500g 모음 샤브샤브 어묵전골 오뎅탕,4000,4000,0
2018-06-01,984520685,A016160,과일가공품,스위티오 바나나 (1.08KG내외/봉),4490,4490,0
2018-06-01,503419674,C013050,운동복,[무료배송]44~77까지/트레이닝세트/트레이닝복/츄리닝,22900,22900,0
2018-06-01,747613077,C013010,점퍼,걸크러쉬 슬림 가죽 자켓-m1071 (블랙) 가죽자켓 여성,58520,52090,-6430
2018-06-01,1730393414,L012060,샴푸,올뉴TS샴푸500ml/100ml/ts트리트먼트/뉴프리미엄ts,20900,20900,0
2018-06-01,386395635,C012020,원피스,하드커팅슬림스키니 RIN0367RM805 빅사이즈,56430,53050,-3380
2018-06-01,283881528,L012090,기초화장품,생활정원 태자록20ml*30포/태자삼(증량),62500,62500,0
2018-06-01,1061914984,G011070,자전거,[삼천리] 시애틀레이디7 18년 여성용자전거 7단26인치,129000,116100,-12900
2018-06-01,204599667,C012020,원피스,[망고]트림 트위드 재킷 Balboa (2307572399),79000,75050,-3950
2018-06-01,1548175061,E021010,침구,굿몽 순면 차렵이불 토퍼 사계절 요 베개 세트,49900,49900,0
2018-06-01,1120270893,E031080,선풍기,니코 시력보호 2구 욕실히터 UMH-7023B,35900,35900,0
2018-06-01,1120270894,E031080,선풍기,니코 시력보호 3구 욕실히터 UMH-7033B,42700,42700,0
2018-06-01,1756411578,I031040,생화,폴딩파라솔/파라솔/모기장/야외/테이블/그늘막,74800,66950,-7850
2018-06-01,391088015,L021060,유모차,마루스 쌍둥이유모차/쿨키즈 T4 쌍둥이유모차/T5,96000,96000,0
2018-06-01,938794507,C013010,점퍼,[닉앤니콜](닉앤니콜)A.MA-1 Leather JP,430000,408500,-21500
2018-06-01,868002588,E031080,선풍기,HOMY 스탠드형 카본히터 HCH-N2055 [180분타이머 / 예약기능 / 화력조절 2단],32900,32900,0
2018-06-01,868002589,E031080,선풍기,HOMY 할로겐히터 BHH-12NB [3단계 온도조절 / 좌우 자동회전],55000,55000,0
2018-06-01,1867700170,C011020,남자상의,여름정장세트/캐주얼자켓/남자여름자켓/남성수트/코디,20000,16900,-3100
2018-06-01,1400179083,E031110,청소기,[카처]다목적 스팀청소기 SC2 영국알러지인증 99%살균,209000,159000,-50000
2018-06-01,1169007198,I012010,컴퓨터,[E]B70EV-AR77S3/7세대/i7/16G/512+1TB/키보드+마우스,1370000,1301500,-68500
2018-06-01,1417954111,F012010,종이기저귀,하기스 보송보송 드라이 2~6단계(팬티-4팩/밴드-3팩),32800,32800,0
2018-06-01,1356435819,A019040,소금,순대양념일회용소금3gX200포,3430,3430,0
2018-06-01,123879214,A014030,치즈,무배 미국 메세나 파마산 치즈 분말 파우더 227g 4개,36170,36170,0
2018-06-01,613132344,C011050,남자내의,[30%쿠폰] 신상 베스트코디 티셔츠/셔츠/팬츠/청바지,5800,5800,0
2018-06-01,1093230927,C012060,여자내의,시크폭스 뉴이레 린넨밴딩팬츠/ 시크폭스,31700,24730,-6970
2018-06-01,325623109,C012060,여자내의,[스타일빅걸]린넨 포켓 점프수트 MSM1519,45770,43940,-1830
2018-06-01,1110205506,A012030,돼지고기,프리미엄 오겹살500g 구이용/수육용 선택가능,5300,5300,0
2018-06-01,82891304,I012060,저장장치,로지텍코리아 로지텍G G102 PRODIGY 마우스 정품벌크,23290,21900,-1390
2018-06-01,895894597,A011080,밀가루,[샘표]잔치국수 (113G),990,990,0
2018-06-01,895894598,A018060,스낵과자,[크라운]죠리퐁(74G),1280,1280,0
2018-06-01,895894599,A018060,스낵과자,[크라운]크라운 콘칩 군옥수수맛 (70G),1300,990,-310
2018-06-01,689715524,C013020,티셔츠,콜핑 이월상품 티셔츠 반팔/긴팔 카라티 모음,13000,13000,0
2018-06-01,1464186438,A017300,미역,정직한수산 원초부터다른 고소한 돌김자반 40gX5팩,4900,4900,0
2018-06-01,1120270831,E031080,선풍기,이노크아든_ 원통형 근적외선 홍관히터 온풍팬장착 IA-9000FN (2500W),138000,138000,0
2018-06-01,1069492620,E011050,책상,1~8인/포밍테이블/프레임책상/컴퓨터책상/이반가구03,55900,55900,0
2018-06-01,1944678467,I012010,컴퓨터,(E)DM500T7A-A54-S2/7세대/i5/8G/SSD256G+1TB/윈10,1240000,1240000,0
2018-06-01,1120270830,E031080,선풍기,이노크아든_ 원통형 나노카본 전기히터 온풍팬장착 IA-7000FC (2500W),118000,118000,0
2018-06-01,2129396273,A011010,쌀,17년 햅쌀/김제 공덕농협 그린숯미20kg(백미)/신동진,48900,48900,0
2018-06-01,1120270832,E031080,선풍기,코멕스 근적외선 히터 CM-6088S,82900,82900,0
2018-06-01,2051099001,C013010,점퍼,지프라브 남자 빅사이즈 무지 와인색 블루종 항공점퍼,49900,48900,-1000
2018-06-01,1178494179,C014010,아동복,[BEANPOLE KIDS] 레드 빈폴 코어 칼라 티셔츠 (BI8442B016),78000,74100,-3900
2018-06-01,412312067,C011030,남자학생복,(남자옷도매) FS-184 브라운버튼 데님셔츠 (M) 진청,50570,50570,0
2018-06-01,1201710974,A013040,고등어,노르웨이고등어(특대)150-180gx10팩,15900,15900,0
2018-06-01,1201734929,C011050,남자내의,BL 여름카고바지 남자작업복바지 여름건빵바지,14800,14800,0
2018-06-01,653971013,A013070,굴,러시아대게5Kg /7-8명/스노우크랩/대게/냉동대게,170000,170000,0
2018-06-01,868002562,E031130,보온매트,KAPPA 전기요 DB-1523S [싱글 / 면혼방 / 3중안전장치 / 취침 모드 기능],49000,49000,0
2018-06-01,868002561,E031130,보온매트,한화 전기매트 HH-8800 [더블 / 전자파 자기장파 전기장파 ZERO / 친환경 쟈가드 원단],109250,109250,0
2018-06-01,765019740,C013010,점퍼,코스트코 아이더 남아 방풍 재킷 바람막이 후드점퍼,63990,63990,0
2018-06-01,868002564,E031130,보온매트,KAPPA 전기요 DB-1522D [더블 / 9단계 온도조절 / 낮은 소비전력 / 고온모드],54000,54000,0
2018-06-01,868002563,E031080,선풍기,KAPPA 컨벡션 히터 스탠드 벽걸이겸용 KA-C16 [생활방수 / 무소음 무취 / 과열방지장치],79000,79000,0
2018-06-01,868002566,E031080,선풍기,HOMY 전기 라디에이터 HR-S309T [자연대류형 / 화력조절 3단],109000,109000,0
2018-06-01,868002565,E031080,선풍기,HOMY 전기히터 HPH-EW4100 [세라믹 히터 / 벽걸이형 / 좌우회전기능],39800,39800,0
2018-06-01,344449568,L012030,칫솔,오랄비 x 8개 칫솔 x 35개 2080 리스테린 가그린 치약,10900,10900,0
2018-06-01,2140303099,A022040,기능성음료,포카리스웨트 245mlx30캔/파워에이드/이온음료/음료수,17300,17300,0
2018-06-01,1397355171,E041010,식기,수지씨앤엘_타공채반/양수채반/스텐바구니/스테인레스,5500,5060,-440
2018-06-01,1308494302,C012040,여자학생복,MJ_1220 브라운 양털 조끼 털조끼 남성조끼 여성털조,29430,29430,0
2018-06-01,1514188323,E061010,세탁세제,라브르베르 섬유 찌든때 제거제 740ml 2개 코스트코,12460,12460,0
2018-06-01,1438923886,A012050,소시지,롯데 키스틱 빅팜 불닭 1case (60g x 20개입),9350,9350,0
2018-06-01,868002560,E031130,보온매트,한화 전기방석 HH-600 [1인용 / 쟈가드원단 / 2중안전장치 / 전자파차단],34000,34000,0
2018-06-01,1088869287,A019110,드레싱,[CJ직배송] 키위샐러드소스250gX4개,12480,12480,0
2018-06-01,1088869286,A019110,드레싱,[CJ직배송] 오리엔탈드레싱 260gX4개,12480,12480,0
2018-06-01,1088869289,A019110,드레싱,[CJ직배송] 요거트드레싱245gX4개,12480,12480,0
2018-06-01,1088869288,A019110,드레싱,[CJ직배송] 파인애플샐러드소스250gX4개,12480,12480,0
2018-06-01,1088869283,A019110,드레싱,[CJ직배송] 백설스테이크소스310gX4개,13480,13480,0
2018-06-01,1088869282,A019110,드레싱,[CJ직배송] 백설돈카츠소스315gX4개,13480,13480,0
2018-06-01,1120270863,E031080,선풍기,대웅 3단 석영관히터 DWH-KQ5600,30500,30500,0
2018-06-01,1088869285,A019110,드레싱,[CJ직배송] 참깨드레싱240gX4개,12480,12480,0
2018-06-01,1430670634,A018100,꿀,(4204) 한국양봉농협 아카시아 벌꿀 2kg,59200,52200,-7000
2018-06-01,1088869284,A019110,드레싱,[CJ직배송] 백설허니머스터드 소스320gX4개,14980,14980,0
2018-06-01,868002559,E031130,보온매트,국일 전기매트 KI-430JS [더블 / 황토원단 / EMI EMF 인증 / 온도조절 8단계],27810,27810,0
2018-06-01,1120270860,E031080,선풍기,SK매직_ 디지털 컨벡터 히터(리모컨) CRH-C200HH (2KW),148000,148000,0
2018-06-01,868002558,E031130,보온매트,국일 전기매트 KI-470 [더블 / 참숯＋황토 / 3중 안전장치 / 전자파안심],199000,199000,0
2018-06-01,518234855,C012040,여자학생복,[쏭바이쏭]비츠버블 체크 블라우스,26000,26000,0
2018-06-01,1548633184,E021010,침구,겨울왕국 면기모 패드 - 뷰티선샤인 (064187) 침구 캐,61730,56240,-5490
2018-06-01,400844046,C011030,남자학생복,남자 셔츠 남방 남성 와이셔츠 체크남방 스트라이프,15900,14900,-1000
2018-06-01,784578196,A019080,고추장,청정원 순창 찰고추장(500G),8300,8300,0
2018-06-01,1219242852,C013050,운동복,[카렉스] 프론트 리어 범퍼 가드 보호대 몰딩 화이트 범퍼가드,21730,19800,-1930
2018-06-01,1525191699,C011030,남자학생복,남자가디건 남성가디건 롱가디건 후드 골지 숄 봄자켓,54500,54500,0
2018-06-01,891249859,A017050,미나리,[꼬레촌엽채]양배추 4통 최상품 10kg이상,13800,13800,0
2018-06-01,607449398,A017170,풋고추,새콤 달콤 아삭한 오이피클,7900,6900,-1000
2018-06-01,2143086920,C012060,여자내의,[마일리지][마일리지] 골지니트주름하이웨스트스커트 SK033D7,24800,23560,-1240
2018-06-01,1002924770,L021020,장신구,원더 스타 목걸이 플라워 여자친구선물 별 큐빅 저렴,25240,25240,0
2018-06-01,868002557,E031130,보온매트,국일 전기매트 KI-420JS [싱글 / 황토원단 / EMI EMF 인증 / 온도조절 8단계],65000,65000,0
2018-06-01,1555870166,E061010,세탁세제,에코튜드 우먼즈시크릿 안심 세탁세제/속옷 면생리대,21000,14900,-6100
2018-06-01,1669636168,A018010,초콜릿,롯데)드림카카오72%x12통/초콜릿(유통기한:2019년2월),20400,20400,0
2018-06-01,893475603,C012040,여자학생복,[CC콜렉트]브이넥 칠부 가디건 (C162KSL034)(센텀시티점),39000,34810,-4190
2018-06-01,36825146,C021040,실내화,[페이퍼플레인] 운동화/에어운동화/커플신발/학생신발,14800,14800,0
2018-06-01,1034203700,A019060,된장,[권기옥명인] 황토방 청국장 800g,17900,17900,0
2018-06-01,1120270857,E031080,선풍기,이노크아든_ 탄소섬유발열 파티션히터 소형 K&C-710T,124000,124000,0
2018-06-01,1034203701,A019060,된장,[권기옥명인] 황토방 청국장 200g,5600,5600,0
2018-06-01,1120270856,E031080,선풍기,런던필_ 욕실난방기 3구 F-57-1,56000,56000,0
2018-06-01,1120270859,E031080,선풍기,SK매직_ 디지털 컨벡터 히터(리모컨) CRH-C160HH (1.6KW),128000,128000,0
2018-06-01,1120270858,E031080,선풍기,이노크아든_ 탄소섬유발열 파티션히터 대형 K&C-1101T,171000,171000,0
2018-06-01,2120203080,A018070,파이,풍년제과 우리밀 수제초코파이 아몬드화이트붓세 10개,18000,18000,0
2018-06-01,1143751904,C012040,여자학생복,[피그먼트] 푸룬롱 가디건,22000,19140,-2860
2018-06-01,1120270855,E031080,선풍기,런던필_ 욕실난방기 2구 SH-F53,46000,46000,0
2018-06-01,1120270854,E031080,선풍기,코멕스 근적외선 벽걸이 히터 CM-3800W,65900,65900,0
2018-06-01,1027499705,C013020,티셔츠,RT6 빅사이즈 노카라차이나워싱반팔남방셔츠(남),72700,71250,-1450
2018-06-01,1975127407,A017150,버섯,대용량 / 일자 콩나물 3.5kg 아이스박스쿨팩 무료배송,9500,9500,0
2018-06-01,1529798441,E041070,밀폐용기,죽용기/일회용/전자렌지/밀폐용기/그릇/도시락/반찬통,15400,15400,0
2018-06-01,1503707889,A022010,주스,[해태htb] 해태 포도봉봉 340ml*24캔,12500,12500,0
2018-06-01,1908325232,E011020,침대,가구야 싱글/슈퍼 일반/서랍 베스트침대!(매트포함),128000,128000,0
2018-06-01,2075944903,A021020,차,매일 엑센트 커피크림 5ml x 30개 (1봉지) / 액상크림,1500,1500,0
2018-06-01,1010350472,A019180,즉석식품,CJ 비비고 소고기무국 500G,4980,4980,0
2018-06-01,1925746929,E031120,믹서,[NUC] [신세계상품권3만원증정]엔유씨고속블렌더 NPB-253K,279000,259000,-20000
2018-06-01,1122444046,C013010,점퍼,엄마옷 메쉬집업점퍼-XJP805013-/ 마담4060,119000,110670,-8330
2018-06-01,326998659,A013080,조개,두레생협 논우렁살(200g/마산푸드) 논우렁살 우렁살,13860,13860,0
2018-06-01,1175583129,C012060,여자내의,SK1162-롱플레어 융기모 밴딩스커트 기모치마 밴딩치,20220,19210,-1010
2018-06-01,710607794,A019060,된장,ⓒ 해찬들 그대로 끓여먹는 된장찌개 (청양초)(450G),5750,5750,0
2018-06-01,999804934,A012040,닭고기,[굽네] 훈제/수비드/소시지/큐브 닭가슴살 15+1 특가!,21500,21500,0
2018-06-01,1175571153,E061010,세탁세제,LG테크 한장빨래 화이트플러스 9박스 (45매입*9박스 405회분)+샤프란3+주방세제2+울드,68800,68800,0
2018-06-01,281449642,C012060,여자내의,[다바걸]바람부는살랑스컷,44000,41800,-2200
2018-06-01,2083984563,C012030,여자상의,TL_ID004 플라워 플리츠 원피스 /(참고)플라워 원피스,37900,33360,-4540
2018-06-01,1441669591,I031040,생화,US익스트림콜드 거위털 침낭 오리털 고급 군용침낭,98000,98000,0
2018-06-01,876286637,C013040,청바지,[컨셉원] 117508 히든 사이드밴딩 TR 슬랙스 10117508/10117506,38000,31160,-6840
2018-06-01,371798572,C013010,점퍼,#NAME?,44260,44260,0
2018-06-01,1242619849,C012040,여자학생복,[무료배송]옆트임리본롱조끼 ZYD_1802 캐주얼조끼 조,16510,16510,0
2018-06-01,1452153983,C012060,여자내의,크로커다일레이디스 CL7M PT202 냉감 산소 일자형팬츠(여름),39000,36270,-2730
2018-06-01,1311637187,C012060,여자내의,여성데님스커트(CKED31)/ 뱅뱅,29900,27510,-2390
2018-06-01,1179759755,C012060,여자내의,[케네스레이디]컬러배색 플리츠 니트스커트[EKSKHD0100](의정부점),38000,30820,-7180
2018-06-01,521715485,A011090,국수,종가집 쌀국수 멸치/얼큰/해물 12개 /컵라면/즉석식품,18900,18900,0
2018-06-01,488079974,E041010,식기,복을 기원하는 특별한 집들이 선물 대박기원 개업선물,82300,80660,-1640
2018-06-01,1287016789,C012040,여자학생복,[체리코코][CHERRYKOKO] scentist  blouse,33000,33000,0
2018-06-01,1086764258,I012010,컴퓨터,LG전자 B50 3D 게이밍 컴퓨터 PC,455000,455000,0
2018-06-01,1124802070,A019060,된장,명인 제 37호 권기옥의 궁중장 황(皇)/국내산 장세트 선물세트,209800,209800,0
2018-06-01,1807833231,C012040,여자학생복,랄프로렌 구제매니아 여성 XL 깊은 브이넥 면 니트,25000,24750,-250
2018-06-01,2010696125,L012090,기초화장품,[BRTC][박싱데이] [1+1]파워 옴므 올인원 솔루션 200ml +200ml,29800,22350,-7450
2018-06-01,190273739,C012040,여자학생복,[H스타일]H스타일(PD)벌집하프가디건빅사이즈니트가디건가오리아우터카디건,53900,48510,-5390
2018-06-01,441032455,C013010,점퍼,(남자옷도매) MJ-1012 박시한 데님코트 (M-L) 박시청,52610,52610,0
2018-06-01,1650975564,F012050,의료측정기,독일로슈정품 New 아큐첵 액티브 혈당계 혈당측정기,23100,21390,-1710
2018-06-01,1543822309,C021020,구두,탠디 남자 캐쥬얼화 515522 C-1019 아이보리,368000,305440,-62560
2018-06-01,1528234835,C013050,운동복,디어포스 사슴표 페파 / 천사포 50장 1권/페파/빼빠/,45080,45080,0
2018-06-01,958448970,A012020,수입쇠고기,E-멕시코산 냉장 돈목심(100G),1390,1000,-390
2018-06-01,705018374,C011030,남자학생복,MCD-917 빈티지 스타일 롱가디건 후드가디건 가을가디,48360,48360,0
2018-06-01,952213051,F012050,의료측정기,카스 비접촉식 체온계 HB500 사은품=건전지5개/메모리,49000,39990,-9010
2018-06-01,1687501970,C011030,남자학생복,남성 골지 롱가디건 숄 자켓 후드 아우터 봄 간절기,54500,54500,0
2018-06-01,416080495,C015040,장갑,란체티 체크가죽 남성 순모장갑 TL-6603 남성장갑 남,27850,27850,0
2018-06-01,1124802063,A019060,된장,명인 제 37호 권기옥의 전통장 난(蘭)/설선물 명절선물세트,53200,53200,0
2018-06-01,1124802062,A019060,된장,명인 제 37호 권기옥의 전통장 청풍(淸風)/설선물 선물세트,47700,47700,0
2018-06-01,1124802065,A019060,된장,명인 제 37호 권기옥의 전통장 지고(至高)/설선물 선물세트,84000,84000,0
2018-06-01,1124802064,A019060,된장,명인 제 37호 권기옥의 전통장 지순(至順)/설선물 선물세트,60600,60600,0
2018-06-01,384238058,C011030,남자학생복,봄신상 남자 셔츠 체크남방 오버핏 스트라이프 남성,18000,11900,-6100
2018-06-01,1124802067,A019060,된장,명인 제 37호 권기옥의 궁중장 제(帝)/국내산 장세트 선물세트,125400,125400,0
2018-06-01,1011060658,A016060,감,냉동과일3종기획(블루베리+망고+딸기 각300G/봉),9900,9900,0
2018-06-01,723399146,C013010,점퍼,[데일리스트/앤섬] 원버튼 캐주얼 하프 자켓 MDBFUSM3311,35800,33660,-2140
2018-06-01,1124802066,A019060,된장,명인 제 37호 권기옥의 궁중장 왕(王)/국내산 장세트 선물세트,112800,112800,0
2018-06-01,1124802069,A019060,된장,명인 제 37호 권기옥의 궁중장 궁(宮)/국내산 장세트 선물세트,137200,137200,0
2018-06-01,437587274,L012030,칫솔,페어리루/터닝메카드 어린이칫솔 12개+증정,14100,14100,0
2018-06-01,25355323,E011040,소파,소프시스 어린이/키즈 소파 모음전,35900,35900,0
2018-06-01,1124802068,A019060,된장,명인 제 37호 권기옥의 궁중어육장/국내산 장세트 설선물세트,135500,135500,0
2018-06-01,1437997830,E031120,믹서,필립스 블랜더 Blender GO HR3556/00 / 오늘발송,114870,114870,0
2018-06-01,570271994,A017140,콩나물,도라지즙 아기배즙 생강즙 도라지 배 생강 탄닌성분,45900,45900,0
2018-06-01,1239846257,C011030,남자학생복,(색상 : 화이트) FSS18046 스트라이프 걸,26500,26500,0
2018-06-01,897527374,A018090,잼,복음자리 포도쨈 370G,5090,5090,0
2018-06-01,2068284184,I031040,생화,레트로 감성 침낭 트윈연결 사계절 실내외겸용 캠핑,32900,29940,-2960
2018-06-01,1242499756,C013020,티셔츠,아스토레 골프 폴로티셔츠 GRPI LSTW10036 스포츠티셔,70920,70920,0
2018-06-01,1984071373,L021010,손목시계,돈보스코손목시계 남성시계메탈시계 남자시계가죽시계,26900,26900,0
2018-06-01,1339858174,C011050,남자내의,변필남 여름/린넨/밴딩/슬랙스/조거/카모/바지,8900,8900,0
2018-06-01,1250116427,A012040,닭고기,[무배]마테차숙성 new하나푸드 훈제닭가슴살3kg(200gx15팩)소금무첨가/체중조절/헬스/,32840,24900,-7940
2018-06-01,298911594,C012040,여자학생복,[비키]컬러 스티치 트리밍 코튼 가디건 (TMCCB7910)_K5W8,24900,23660,-1240
2018-06-01,1240837295,C013050,운동복,아스토레 쉘 4 우븐자켓(D.OR)-레인자켓 트레이닝운동,58250,58250,0
2018-06-01,1491041873,L021010,손목시계,NIBOSI 메탈 손목시계 메쉬메탈 No.2321 로즈골드,54900,54900,0
2018-06-01,1065692944,L021010,손목시계,[CASIO]카시오 여성용 하트별초침 가죽시계 18종 1택,31900,31900,0
2018-06-01,2057840633,C013060,등산복,봄.여름 등산복 등산바지 골프웨어 작업복 단체복전문,18900,16760,-2140
2018-06-01,2087434206,A017080,무,영인팜［사자발쑥 진액100 80ml*60포］3년 숙성 강화약쑥 100%/사자발약쑥 엑기스/진액,80000,79200,-800
2018-06-01,1065692941,L021010,손목시계,[CASIO]카시오 여성용 가죽밴드 패션시계 4종 1택,29900,29900,0
2018-06-01,1065692940,L021010,손목시계,[CASIO]카시오 여성용 파스텔 가죽밴드 12종 1택,29900,29900,0
2018-06-01,1065692943,L021010,손목시계,[CASIO]카시오 심플 여성용 패션시계 8종 1택,19900,19900,0
2018-06-01,1065692942,L021010,손목시계,[CASIO]카시오 여성용 우레탄밴드 패션시계 12종 1택,29900,29900,0
2018-06-01,954791279,E061060,살충제,에프킬라 무향3입 (500ml*3),12500,9900,-2600
2018-06-01,437252878,C014010,아동복,[프렌치캣] 핑크 레이스 원피스 Q62DKO300P1,33000,28050,-4950
2018-06-01,419571873,C012040,여자학생복,[구제]임페리얼 집업니트/여성L/가디건/골프/NG5261,19900,19900,0
2018-06-01,931128721,A011170,떡,다인 오색경단 과일경단 두텁떡 찹쌀떡 경단 1kg,5900,5900,0
2018-06-01,492809085,C012060,여자내의,쉬즈굿닷컴 SK4682/그라데이션 플리츠스커트/ 쉬즈굿닷컴,100100,85090,-15010
2018-06-01,351456685,C012040,여자학생복,[공구우먼] 베이빈 언발 체크 남방 29743 빅사이즈 여성의류 셔츠,29000,29000,0
2018-06-01,717957164,E011040,소파,보니타빈백 블루밍 B807 쇼파/1인용쇼파/쇼파베드,92900,92900,0
2018-06-01,1395541740,F012020,생리대,[특가]좋은느낌 유기농순면 중형/대형 모음전/생리대,10900,10900,0
2018-06-01,557785422,C012040,여자학생복,[오플]어반시크릿 썸머 블라우스 5종세트,49800,49800,0
2018-06-01,1967545516,L012010,면도기,쉬크면도기10p/일회용면도기/면도/제모/여행용면도기,1890,1890,0
2018-06-01,1011444230,I012010,컴퓨터,삼성 게이밍데스크탑 ODYSSEY DM800V7A-A716A/DN,2207360,2097000,-110360
2018-06-01,1010408290,E061010,세탁세제,[LG]LG)테크액체일반리필기획(베이킹소다)2L+2L,8900,8900,0
2018-06-01,1827972636,C011050,남자내의,여름신상 남자 슬랙스/정장바지/체크/밴딩,15800,14800,-1000
2018-06-01,208566027,C012040,여자학생복,예스라인 정장베스트/롱조끼/베스트원피스,26800,26800,0
2018-06-01,2083188492,A022040,기능성음료,포카리스웨트 분말 1L용X5팩/물병증정이벤트,4890,4890,0
2018-06-01,1010408293,E061020,섬유유연제,피죤옐로미모사용기2.8L,2990,2250,-740
2018-06-01,975373984,C012060,여자내의,PT1312-하이웨스트 골드버튼 롤업 팬츠,15210,15210,0
2018-06-01,1658927838,C021040,실내화,[리복] 신상품 시즌오프 특가!! 런닝화 프린트 라이트 BS8481,79000,39500,-39500
2018-06-01,151804430,A017090,열무,전라도 햇 무우 16kg 8kg,15900,15900,0
2018-06-01,2005940193,C013020,티셔츠,[이유까까] 여름 아동복 상하세트/티셔츠/바지/나시,8000,7900,-100
2018-06-01,366775158,C012060,여자내의,mano  skirt(C804MASK2)/제작스커트/플라워/h라인/슬림(Q2-2-4)/ 체리코코,37000,37000,0
2018-06-01,74368886,E031120,믹서,[NUC] [신세계상품권3만원증정]엔유씨고속블렌더 NPB-210K,269000,259000,-10000
2018-06-01,78829160,L012090,기초화장품,WHIP 클렌징크림 2개 / C2Y 폼클렌징 퍼펙트휩 스크럽,12900,12900,0
2018-06-01,1678002651,A017010,배추,인빌푸드 참살이 무청 시래기 1kg,33900,33900,0
2018-06-01,567581067,C012060,여자내의,[아이잗바바]폴리소재 8부기장 bh5 a0 sl76,95400,90630,-4770
2018-06-01,378162927,C013020,티셔츠,폴로랄프로렌 남성 와플 V넥 반팔티셔츠,19800,19800,0
2018-06-01,2136981136,C013020,티셔츠,[나인스텝](18 S/S) 엔젤 소매프릴 티셔츠 N18NT8228R[갤러리아],15000,12900,-2100
2018-06-01,2070007059,C013030,스웨터,러블리 헤비 니트 LBR0282 여자니트 여자라운드티 /,86500,76120,-10380
2018-06-01,2085436102,C012060,여자내의,[에이스하트] 프리 밴딩 슬랙스 ~3XL 편한 팬츠 빅사이즈,31800,29800,-2000
2018-06-01,1820414496,A013130,오징어채,[가온애]대용량 진미채 1kg 오징어채 오징어 백진미채,25800,25800,0
2018-06-01,1306616328,A011010,쌀,맛있는 밥! 17년 햅쌀 주부의米 쌀20kg 당일도정,44900,44900,0
2018-06-01,1014487027,C012040,여자학생복,수지네 일본 빈티지 uniqlo 갈색 다운 베스트 여성 S,32480,32480,0
2018-06-01,468325143,E031040,전기레인지,차량 휴대용 냉온장고 175x320x315 7.5L 차량냉장고,74760,74760,0
2018-06-01,1676932214,E021010,침구,금주특가}청량감 좋은 소재 이불/여름이불/패드/베개,19900,12790,-7110
2018-06-01,1129894588,C015020,모자,빈티지한 느낌의 워싱처리가 된 군모워싱캡 캐주얼군,18450,18450,0
2018-06-01,13802421,C011050,남자내의,카고바지/면바지/조거/카모바지/건빵바지/빅사이즈,23900,23900,0
2018-06-01,253924986,A012010,국산쇠고기,순우리한우 1++등급 등심 400g 모음전,25900,25900,0
2018-06-01,954876785,A019070,양념소스,청정원 닭 한마리 양념 볶음탕용 (270G),2990,2990,0
2018-06-01,317874712,C013040,청바지,남자스키니청바지 9부바지 9부청바지 스키니바지 슬림,22000,22000,0
2018-06-01,674925337,C015030,넥타이,고급 넥타이 500종/수동 자동 일반폭 좁은폭 넥타이,2800,2800,0
2018-06-01,981848311,C013010,점퍼,더액션 남녀공용 청자켓/봄자켓/커플자켓,14900,10900,-4000
2018-06-01,1163560172,A022030,생수,풀무원샘물 500ml/2L/생수/퓨어라이프/아이시스/물,5800,5800,0
2018-06-01,544822032,C011030,남자학생복,[스파오(SPAO)][스파오] 남성 이지케어셔츠A(레귤러) (SPDR7A3M01),10900,10580,-320
2018-06-01,1146576479,A021010,커피,아이수 페루산 카카오닙스200g,12590,12220,-370
2018-06-01,580874440,C013010,점퍼,봄 후드 가죽자켓 PU03 A WS 남성재킷 남성점퍼 후드,127570,127570,0
2018-06-01,2039806254,C012040,여자학생복,[핑크시슬리]썬글미키 린넨 롱가디건 [화이트]/ 핑크시슬리,34300,27440,-6860
2018-06-01,1062599811,L021060,유모차,엑스랜더 2018년 절충형 디럭스 신생아 유모차,880000,591000,-289000
2018-06-01,1066448800,C014020,유아복,아동복/상하복/번개맨/번개걸/아이언맨/스파이더맨/옷,29900,29900,0
2018-06-01,2045466352,E031080,선풍기,귀뚜라미 펠릿열풍기 KRPS-20PA 펠렛난로 펠릿난로,1598000,1598000,0
2018-06-01,41981403,C011050,남자내의,남자 쿨링 마반바지 스판면반바지 린넨반바지 밴딩5부,16800,14800,-2000
2018-06-01,282904215,C014020,유아복,[모노블랙]라그랑 자수티(기획) 52MTS911,7400,7030,-370
2018-06-01,1238898706,C011020,남자상의,[무료배송]FREE 루즈딱떨어짐핏롱모직코트(남) 남성코,94280,94280,0
2018-06-01,64186909,E011040,소파,1인용쇼파 쇼파 에어쇼파 캠핑용품 매트 쇼파베드,25900,25900,0
2018-06-01,2111396876,E031110,청소기,[악팩+필터5]아이클레보 로봇청소기 오메가YCR-M07-20,549000,549000,0
2018-06-01,1261429133,A021010,커피,이오빈 60ml x 20포 (당일발송),99000,99000,0
2018-06-01,2128676689,C014010,아동복,휠라키즈 (K2RSZ101X/108F) 아동 3단 블럭 배색 반팔 티셔츠 2종 택1(그레이/핑크) FI,20000,17400,-2600
2018-06-01,1040355367,E061020,섬유유연제,샤프란 아로마시트 섬유유연제 50매X4개~6개~2개 모음,12600,12600,0
2018-06-01,1671868417,C014010,아동복,[아이러브제이] 여름 레인보우 스마일 티셔츠 JPUTO73-DA1C,13440,12160,-1280
2018-06-01,117693630,A013020,명태,(맛나)나막스(대)/태산,15800,14220,-1580
2018-06-01,1831029704,C012020,원피스,베니토 퀸즈 원피스/슬림/가오리핏/롱/린넨/스판/하객,67000,67000,0
2018-06-01,335580691,C011030,남자학생복,할인쿠폰! 봄 여름 오버핏 연예인 롱 가디건 숄 남자,17800,17800,0
2018-06-01,1250383484,I031040,생화,2층방수 파라솔 특대형 파라솔/파라솔세트/낚시파라솔,16900,15130,-1770
2018-06-01,1378822987,E041010,식기,안성/방짜/유기/손조각/오첩/5첩/반상기/세트/셋트/혼수/예단/선물/외국인/식기/추천/,1580000,1580000,0
2018-06-01,58154960,I031040,생화,국산전선릴/전기릴선/작업릴선/캠핑릴선/30M/50M,34500,30880,-3620
2018-06-01,1103029353,C013020,티셔츠,뒷면레이스망사나시티/민소매/섹시/무지/면/기본/망고,6900,6900,0
2018-06-01,1323636173,C013050,운동복,득템찬스.파격특가.추가금없는 자체제작.빅사이즈,26900,26900,0
2018-06-01,1733133152,A012030,돼지고기,[임규율고기마을]국내산 돼지목살 500g/로스용 보쌈,9400,8900,-500
2018-06-01,2119721845,E061010,세탁세제,울샴푸 스포츠 기능성 세제 800ml x2개/스포츠웨어,16600,16600,0
2018-06-01,1548358703,E031020,가스레인지,린나이 RBR-P2501D 빌트인 가스렌지 2구 쿡탑,230700,219070,-11630
2018-06-01,1004090562,L021020,장신구,도리스 진주 초커 목걸이 초커네크리스 여성스러운목,11290,11290,0
2018-06-01,1003668201,A017220,양파,꼬레촌조미 파(흙대파)최상품 1kg/10단,34900,34900,0
2018-06-01,690334734,C011020,남자상의,(AGC바바리 코트 2016 파일지 코트 가을코트 트렌치코,230700,230700,0
2018-06-01,498441380,E061030,전구,오스람 FPX 13W 삼파장 전구 FDX FDL 18W 26W 형광등,1080,980,-100
2018-06-01,1756797348,F012010,종이기저귀,하기스 매직기저귀 밴드 3단계-5단계(3팩)/ 매직팬티,56800,55800,-1000
2018-06-01,1622750742,C012020,원피스,무지대형 숄목도리 겨울 목도리 머플러 남성자목도리 목도리 무지대형숄 남성자목도리,28820,25650,-3170
2018-06-01,382039950,C014010,아동복,여름신상 불빛번개맨옷 번개걸원피스 아동복 아이언맨,11400,11400,0
2018-06-01,1010229602,A018050,비스킷,오리온 고소미 6P 240G,3600,3600,0
2018-06-01,245701711,C011030,남자학생복,쿨링프리미엄 얼음조끼 머플러세트형,50780,50780,0
2018-06-01,1800990391,A014050,달걀,궁궐 오골계 14호 1350g 삼계탕 백숙 무항생제,16000,16000,0
2018-06-01,1010408286,A011090,국수,풀무원 생면식감 탱탱비빔쫄면 492G,4980,4290,-690
2018-06-01,2069317070,C012040,여자학생복,빅사이즈/팀/오픈/니트/조끼 / 참고 팀오픈니트조끼,55700,49020,-6680
2018-06-01,234399441,E031010,전기밥솥,쿠쿠압력밥솥패킹 CCP-06/CCP-08/CCP-10 쿠쿠패킹,4700,4700,0
2018-06-01,58766188,C013050,운동복,냉장고반바지/냉장고긴바지/밴딩반바지/츄리닝반바지,8900,8900,0
2018-06-01,1010408289,E061010,세탁세제,[LG]LG)테크액체드럼리필기획2L+2L,8900,8900,0
2018-06-01,550119481,C011050,남자내의,[캘빈클라인진] 남성용 로고 프린트 반팔 티셔츠(4AOKQ95),39000,33150,-5850
2018-06-01,1832342732,L021060,유모차,타고난 편의성 기내반입 티크미니 휴대용 포켓유모차,260000,260000,0
2018-06-01,570907558,C012060,여자내의,그라데이션 플리츠 와이드팬츠[D2864]/ 아티젠,9800,7650,-2150
2018-06-01,1231001020,C012040,여자학생복,펀칭미니가디건 (J11PCD077)/ 매그제이(MAGJAY),27000,24300,-2700
2018-06-01,2039001808,A018020,사탕,마이쮸 대용량 328g x 5봉 골라담기 사탕/젤리/간식,14700,14700,0
2018-06-01,1226067727,C011020,남자상의,MJSF18001 블랙 코튼 베이직 코트 기본남자코트 남자,91960,91960,0
2018-06-01,900388172,L012010,면도기,쉬크 하이드로5면도기(1입),10900,8790,-2110
2018-06-01,379518221,C014020,유아복,주니어 어린이 순면 블루 반팔티 반팔 티셔츠 여아,10880,10880,0
2018-06-01,1230393961,E031010,전기밥솥,CRP-QS1010FG/CRP-QS1010FS/쿠쿠/전기압력/10인용/GH,173000,152840,-20160
2018-06-01,1010229605,A018050,비스킷,오리온 다이제 351G,3600,3600,0
2018-06-01,1877282495,C013050,운동복,차량용선글라스거치대/자동차선글라스클립/,1500,1380,-120
2018-06-01,1623193438,A011050,콩,[슈퍼넛츠 시리즈] 타이거넛/브라질넛/카카오닙스,16900,16900,0
2018-06-01,1175524878,A018040,아이스크림,얼려먹는쭈쭈바/폴라레티후르트 40mlX70입/코스트코,15490,15490,0
2018-06-01,2070129431,A014030,치즈,[SEE] 자연치즈 모짜렐라 피자치즈1kg 무료배송,12250,12250,0
2018-06-01,626480399,C013020,티셔츠,+여름 반팔티+ 빅사이즈77-99 롱/루즈핏/스트라이프,16900,16900,0
2018-06-01,2018240764,A017280,김,[하선정] CJ 하선정 4무 슬라이스 단무지 2.7kg,5600,5600,0
2018-06-01,92662002,C011030,남자학생복,디테일 가디건 조끼 모음전 바람막이니트 모두의 스타,17700,17700,0
2018-06-01,1158610192,C013010,점퍼,[역시즌특가]가벼운 양피사용 퀼팅 아카이브형 가죽자켓 ASXL401/ 프랑코페라로,792000,673200,-118800
2018-06-01,3081497,A014040,발효유,서울우유 떠먹는 비요뜨 5종 10개,10500,10500,0
2018-06-01,394834958,C012060,여자내의,[시슬리(SISLEY)]셔링스커트 SASK01741(경기점),109000,97280,-11720
2018-06-01,998793418,A014050,달걀,자연방사토종닭유정란/부화용20알/계란/달걀/하늘농장,20000,20000,0
2018-06-01,2002619607,A022010,주스,딸기농축액(참존 835ml)X12 농축액 딸기음료 식당 딸,43190,43190,0
2018-06-01,2078867930,C012040,여자학생복,[오조크][18여름]러블리 프릴 블라우스(84484),69000,61610,-7390
2018-06-01,1924011552,C021040,실내화,정품/2018 신상 아디다스 운동화 모음/슈퍼스타/스탠,64500,57730,-6770
2018-06-01,749767021,L012030,칫솔,애터미 칫솔/콤팩트/치약/오랄케어/에이필드/암웨이,7600,7600,0
2018-06-01,855329217,A022020,두유,서울대 약콩두유 프리미엄약콩100 검은콩두유,28900,28900,0
2018-06-01,1952251962,E061080,키친타월,크리넥스 안심 3겹 뽑아쓰는 키친타올 140매4개입,8900,8900,0
2018-06-01,604925799,F012010,종이기저귀,[토디앙] LG 토디앙 자운보본초 기저귀 공용 중형 60매x3팩,33900,33900,0
2018-06-01,1277884891,A017110,감자,유기농 제주산 흙 당근 5kg 유해물질ZERO 안심 당근~,10000,9900,-100
2018-06-01,1080702946,C015020,모자,빈티지 워싱 군모 / 남자 여자 커플 무지 밀리터리캡,6000,4900,-1100
2018-06-01,1976885180,A011010,쌀,농협 친환경 무농약 유기농 쌀 현미 잡곡 10kg 20kg,28900,28900,0
2018-06-01,877560182,E061010,세탁세제,신형 슈퍼타이 10kg x 2개 스파크 비트 수퍼타이 테크,23900,23900,0
2018-06-01,861893212,C013020,티셔츠,[MLB]엠엘비 8종택1 남여공용 스몰와펜 MLB 반팔티셔츠(31TSD1831),33000,28050,-4950
2018-06-01,741925573,E061020,섬유유연제,소프트빈스 섬유유연제 1Box (2Lx6개),24900,24900,0
2018-06-01,2081974261,A011040,보리쌀,18년 국산 햇 완두콩 2kg (껍질포함),12900,12900,0
2018-06-01,1958313851,A013100,마른멸치,완도산 참전복14마리-25마리 1kg 산지당일배송,43000,41000,-2000
2018-06-01,484468157,G011070,자전거,베리벨로 프라임GS 26 18년형 21단 접이식자전거,94330,94330,0
2018-06-01,631946264,A016060,감,달콤샤르르 자연그대로 만든 아이스 왕 홍시 30개(컵),60900,53600,-7300
2018-06-01,1206763865,A017150,버섯,해물찜 삼겹살 비빔밥과 찰떡궁합 일자콩나물 3.5Kg,5120,5120,0
2018-06-01,1158673748,C013010,점퍼,엠폴햄 남여공용 다운점퍼 3종 택1 (EPX4JD1672/JD1681/JD2611),80000,65600,-14400
2018-06-01,1939187618,E061020,섬유유연제,(FC 베이비전용 섬유유연제 bottle) 아동세탁세제 유,19950,19950,0
2018-06-01,975104181,C013050,운동복,미르웨이 후사경 : 싼타페 투싼 싼타모 갤로퍼 테라칸 트라제 쏘렌토 뉴스포티지 그랜,27000,24350,-2650
2018-06-01,1313322515,C011030,남자학생복,밀란시아 비지니스캐쥬얼 3버튼 베스트 sh171-002 남,41630,40800,-830
2018-06-01,754296471,C014010,아동복,정품 여름신상 반팔_번개맨옷 번개걸옷,11400,11400,0
2018-06-01,547649250,C011030,남자학생복,[홈런]와이셔츠/솔리드/체크/남방/반팔/남성/남자정장,10800,10800,0
2018-06-01,1290233429,F011120,인삼,(추천)강원산삼 2년근 어린야생 새싹삼 대 100뿌리 당일채취 소양호 호수위 해발 700m,100000,99000,-1000
2018-06-01,510955156,E061050,청소용세제,주방을 부탁해~아스토니쉬 곰팡이제거 찌든때,9900,9900,0
2018-06-01,1001201477,E011050,책상,[리퍼스] 초특가 편수책상 모음전 아망떼 /H형책상,170900,157900,-13000
2018-06-01,1227343792,L012040,치약,ZOMBIE 셀프 치아미백 2주 풀 패키지,35000,35000,0
2018-06-01,416055575,C015040,장갑,란체티 아이글러브 남성 니트장갑 I-Glove 남성니트장,27850,27850,0
2018-06-01,550435929,L012060,샴푸,려샴푸 자양윤모 샴푸 5종 400mlx2개+180mlx3개/한방,13900,13900,0
2018-06-01,1280606947,C021040,실내화,리복 남여 인기 운동화 스니커즈 단화 런닝화,24800,24800,0
2018-06-01,1914203956,F011120,인삼,(장생농산장수산삼 8년근 5주(5뿌리) 스승의날 부모님,248640,241190,-7450
2018-06-01,1064933775,C013040,청바지,[CAMBRIDGE] 자카드 치노 팬츠 MYPNS17106BLU,79000,67150,-11850
2018-06-01,1330680156,C013010,점퍼,빅사이즈 집업후드 니트가디건~140 큰옷[더블온스],36900,36900,0
2018-06-01,2005939233,A018100,꿀,잡화꿀 (오뚜기 1k) X6,220720,196450,-24270
2018-06-01,1985454137,D031010,주택수선재료,어디에나 시공 가능한 초간단 만능풀바른합지벽지,3300,3300,0
2018-06-01,1010171849,A018030,껌,롯데 죠스바왓따 껌 23G,400,400,0
2018-06-01,632414310,I031040,생화,바다원투대/NS서프/바낙스 왕캐스터/다이와릴/선택1,48000,48000,0
2018-06-01,511667986,C021040,실내화,L걸스 여성운동화 슬립온 스니커즈 여자신발 키높이,29500,28500,-1000
2018-06-01,657364633,C011020,남자상의,빅사이즈 봄 여름 정장바지 남자 남성 바지 슬랙스,19800,19800,0
2018-06-01,1267107311,C012040,여자학생복,빅사이즈 DWW001A 편한 데님 롱 셔츠 802 여성셔츠 청,65400,65400,0
2018-06-01,368119089,C013020,티셔츠,(3+1) 비비안 임산부용 팬티스타킹/레깅스 (3개 구매시 1개 더 드려요),7900,7800,-100
2018-06-01,902976221,F012050,의료측정기,아큐첵 액티브 혈당측정기+시험지60+호환침100+솜100,42000,39060,-2940
2018-06-01,1053750091,I011020,영상음향기기,HaiWay H3200-안드로이드 운영체제 스마트 빔프로젝터,259500,259500,0
2018-06-01,1059696914,C012040,여자학생복,스카시나시니트 (J11PNT177)/ 매그제이(MAGJAY),16000,14400,-1600
2018-06-01,300570868,C012040,여자학생복,[카라]KARRA 포인트넥라인자수블라우스_KBI6BL228A,30800,29260,-1540
2018-06-01,361242865,E031120,믹서,[신일산업] 국산 신일 SMX-6500JS 4L 대용량믹서기,95000,89900,-5100
2018-06-01,1059696912,C012040,여자학생복,슬림레이스원피스 (J11POP079)/ 매그제이(MAGJAY),69900,62910,-6990
2018-06-01,1272383255,C013020,티셔츠,jj76 홈쇼핑 하운드 기모 스판 롱티_블랙44-88 긴팔티,18420,18420,0
2018-06-01,1427259874,E011020,침대,레아 삼나무원목 평상형 침대프레임 Q 침대깔판 원목,280970,280970,0
2018-06-01,749853469,F012050,의료측정기,녹십자 로즈맥스 체온계 모음(귓속형  비접촉식 이마),39000,39000,0
2018-06-01,1886416331,C012020,원피스,MSG (대원미 대원 3K),16380,16380,0
2018-06-01,1293927338,C013010,점퍼,아스토레 6018(CHA) 골프 캐주얼 남성 경량 다운자켓,191200,191200,0
2018-06-01,463634038,C015040,장갑,리본 모직 장갑 모장갑 리본장갑 패션장갑 캐주얼장갑,21390,21390,0
2018-06-01,1124287721,L021030,가방,맥북 11인치 13인치 15인치 노트북파우치 가방 케이스,13900,13900,0
2018-06-01,1619144110,C013010,점퍼,마르잔 자켓 바람막이 LM5340 바람막이 점퍼 빅사이즈자켓 자켓 등산자켓,90510,80560,-9950
2018-06-01,1383505886,E061010,세탁세제,오리지널 과탄산소다 산소계표백제 5kg 과탄산나트륨,6700,6700,0
2018-06-01,1319046020,C011050,남자내의,남자 박스핏 교복셔츠 교복몰 셔츠 교복조끼 교복치마,32240,32240,0
2018-06-01,661460739,C013010,점퍼,브랜드특가 기모야구점퍼/후드점퍼/스타디움점퍼/야구,29800,29800,0
2018-06-01,1034203696,A019060,된장,[권기옥명인] 궁중장 어육된장 450g,23900,23900,0
2018-06-01,1034203697,A019060,된장,[권기옥명인] 황토방 청국장 골라담기 (청국장/청국장가루/청국장환),5600,5600,0
2018-06-01,455246801,A014040,발효유,카스피해 요거트/유산균/요구르트 종균(무배),12800,12800,0
2018-06-01,1034203694,A019080,고추장,[권기옥명인] 궁중장 약고추장 450g,20900,20900,0
2018-06-01,1034203695,A019060,된장,[권기옥명인] 궁중장 덧된장 450g,20900,20900,0
2018-06-01,1650383108,A021020,차,기라델리/기라델리소스/카라멜/초콜렛/화이트/ 펌프,20000,19800,-200
2018-06-01,1938284216,A011030,찹쌀,남외정미소 2018년 찰보리쌀10kg찰보리쌀,21500,21500,0
2018-06-01,310691342,C012060,여자내의,[악녀일기]뉴엔체크원피스(S~L),76160,66280,-9880
2018-06-01,174321294,C013050,운동복,타이어펑크씰/송곳/바늘/펑크수리셋트/빵꾸씰/씰(지렁이)/낱개/셋트판매/,1000,900,-100
2018-06-01,702626534,C012030,여자상의,신상/린넨원피스/플라워원피스/데님원피스/롱원피스,19800,19800,0
2018-06-01,34988914,C013040,청바지,로디아 8부 일자팬츠[428]/ 핑크시슬리,34400,27520,-6880
2018-06-01,1500880262,C011030,남자학생복,[빅사이즈][미스터빅]특양면 조끼집업후드(1XL~3XL)-ION0118,34200,34200,0
2018-06-01,467135415,C013050,운동복,차량햇빛가리개 그린필드 uv차단형 자동차햇빛가리개,20250,18230,-2020
2018-06-01,6680677,F011150,건강기능식품,곡물명가 블랙푸드 20곡 미숫가루 1kg x 3봉 선식,10900,10900,0
2018-06-01,1418519517,A019180,즉석식품,추천/탕 모음전/갈비탕 600g/갈비탕/육개장/즉석탕/,1300,1300,0
2018-06-01,766897225,A013160,맛살,올리브녹차 돌자반 70gx20개 입안에서 살살녹는 고,57600,57600,0
2018-06-01,1615165917,D031010,주택수선재료,KCC 우레탄 옥상방수 모노탄 하도/중도/상도,59900,59900,0
2018-06-01,45467176,C013020,티셔츠,후드티 후드끈 금속벨 다양한 후드종 금속팁 철팁,750,750,0
2018-06-01,1298271639,C011050,남자내의,[크리스크리스티] 스판 기본 슬랙스 팬츠,14800,14800,0
2018-06-01,1343474724,C013020,티셔츠,[체리온]여름신상 빅사이즈 롱티/박스티/임부복/반팔,10000,9900,-100
2018-06-01,125588461,C011050,남자내의,트레이닝반바지커플반바지 비치반바지 3부5부빅사이즈,8800,8800,0
2018-06-01,1324104293,E021020,커튼,에쿠스 암막 콤비블라인드 특대형 1 플러스 1 암막커,164460,159530,-4930
2018-06-01,1034203698,A019060,된장,[권기옥명인] 황토방 청국장환 300g,19900,19900,0
2018-06-01,1034203699,A019060,된장,[권기옥명인] 황토방 청국장가루 200g,19900,19900,0
2018-06-01,1992619915,C012040,여자학생복,[대구백화점 I관] [보니알렉스]브이넥메탈가디건(BBWB511),55200,49130,-6070
2018-06-01,933090495,C021040,실내화,[나이키] AIR JORDAN 12 RETRO BG 3.5Y 에어 조단 153265 007,199000,99000,-100000
2018-06-01,260145470,F012010,종이기저귀,LG 마미포코 골드퍼피 에디션 팬티기저귀 3팩,35900,34900,-1000
2018-06-01,409156202,C013010,점퍼,초겨울 라이더 자켓 가죽점퍼 15_5 K2 남성점퍼 남성,154680,154680,0
2018-06-01,989137358,F012020,생리대,내추럴코튼팬티라이너20P,1000,1000,0
2018-06-01,989137357,F012020,생리대,내추럴코튼울트라날개대형6P,1000,1000,0
2018-06-01,1747360492,I031010,장난감,[당일발송] NEW 베베포레 물놀이 스티커,9200,9200,0
2018-06-01,2024849465,A015020,식용유,콩식용유(백설 0.5L)X20 식용유통 콩기름 cj식용유 식,56060,56060,0
2018-06-01,635602255,A018100,꿀,명인 도라지청 600g/조청 꿀/조청분야식품명인 강봉석,15000,15000,0
2018-06-01,442789190,C013040,청바지,키즈 여아 로우헴 워시드 데님 쇼츠 5218232621051/ 갭 키즈,45000,38250,-6750
2018-06-01,234941324,C015030,넥타이,(색상 : 와인) BTIE_107 미로 패턴 보타이,13420,13420,0
2018-06-01,986084809,A013040,고등어,노르웨이 정품 순살 고등어[대] 1Kg(7~8팩),12900,12900,0
2018-06-01,364344340,E061060,살충제,바퀴벌레약/맥스포스셀렉트겔/DA킬라맥스,10000,2500,-7500
2018-06-01,203659435,E041010,식기,고백자 멜라민그릇 면기 라면그릇 볼 라면기 우동그릇,1650,1500,-150
2018-06-01,354343593,A018020,사탕,시크릿쥬쥬립스틱사탕 립글로즈사탕 1박스/무료배송,18900,18900,0
2018-06-01,1219964408,C013040,청바지,[디젤]남성 테파 디스트로이드 TEPPHAR 084LR(131-81-10-902),215200,172160,-43040
2018-06-01,47646520,E011050,책상,다니카 책상/학생의자/사무용의자 베스트23종,19000,19000,0
2018-06-01,1017751891,C013050,운동복,두줄띠트레이닝set/상하세트/체육복/여아생활복,19500,19500,0
2018-06-01,1480871289,C013020,티셔츠,[프렌치캣][이월특가] 옐로우 티셔츠(Q73DAT150)[갤러리아],29000,23200,-5800
2018-06-01,2097521410,C013010,점퍼,야상자켓/야상점퍼/항공점퍼/블루종/간절기야상,48900,48900,0
2018-06-01,1963838065,E061020,섬유유연제,샤프란 3100ml x4개/2100x6개 피죤 섬유유연제 다우니,11800,11800,0
2018-06-01,981631191,A011040,보리쌀,콩가루 볶음콩가루 생콩가루 인절미가루 팥빙수떡고물,4000,4000,0
2018-06-01,2059967001,C013020,티셔츠,[무료배송] 챔피온 반팔티 / 반팔 티셔츠 /무지 로고티 모음 T425/ 비바스튜디오,9900,8910,-990
2018-06-01,1280932849,C012060,여자내의,지오 와이드 팬츠 LRP011 통바지 와이드팬츠(YA02004),33730,29690,-4040
2018-06-01,615541927,E061010,세탁세제,레더클린 1000ml 가죽세탁 가죽관리 가죽세제 드라이,29800,26800,-3000
2018-06-01,1149534123,E031010,전기밥솥,쿠첸 WM-2003//20인용 업소용 전기보온밥솥/뜸기능,68000,68000,0
2018-06-01,786686857,A018070,파이,[캔디마을]오리온초코파이1박스 12입x8곽 바나나 간식,28900,28900,0
2018-06-01,1009299630,F011130,홍삼,[풍기인삼] 5년근 난발삼 500g (2-3뿌리),62000,62000,0
2018-06-01,1617836723,C014020,유아복,[디플랜][디플랜] 퐁퐁티셔츠,4900,4660,-240
2018-06-01,2051440979,C011020,남자상의,국내제조 봄 여름 정장자켓 콤비자켓 린넨 스판 체크,49800,49800,0
2018-06-01,1617836725,C014020,유아복,[디플랜][디플랜] 루즈티셔츠,6500,6180,-320
2018-06-01,631200734,F012020,생리대,좋은느낌/화이트 입는오버나이트 X2팩+증정,15900,15900,0
2018-06-01,1980618358,A016150,아몬드,산과들에 17년 캘리포니아산 구운 볶음 햇 아몬드 1kg,9900,9900,0
2018-06-01,396237092,A013170,생선통조림,유동 자연산 골뱅이 230g x1캔 /s/번데기/안주/비빔면,4270,4270,0
2018-06-01,387524335,C013010,점퍼,2018신상 블레이저/자켓/남자/수트/세미정장/결혼식,59900,59900,0
2018-06-01,451118618,A019010,고춧가루,B한식 고추가루 1kg2개 가루 고추가루 한식 한식고추,37220,33500,-3720
2018-06-01,299437008,A016030,복숭아,100% 강원도 야생 개복숭아 10kg 5kg,28000,28000,0
2018-06-01,1327088120,E021010,침구,무독성 PE놀이방매트 애니멀프렌즈 200×150 모서리보호대/ 어린이집놀이방매트 놀이방,47600,42780,-4820
2018-06-01,964405209,A015020,식용유,백설 카놀라유 900ml x 3개 /해표 카놀라유500ml x4개,9900,9400,-500
2018-06-01,452071933,C013010,점퍼,남녀공용 DS쪼끼패딩 2컬러 조끼 포근한 점퍼 베스트,25080,25080,0
2018-06-01,1630670559,E011020,침대,철제1층침대+기본매트리스포함/기숙사/사무실/원룸/,159000,159000,0
2018-06-01,229148585,C012020,원피스,[올리비아하슬러]탈부착후드 누빔 코트_B5W2,18900,17960,-940
2018-06-01,616466636,A019100,식초,오뚜기 짐승용량 케찹 3.3kg 대용량 or 고소한 골드 마요네즈 3.2kg 사용편한 파우치형,7000,6900,-100
2018-06-01,488633734,C013010,점퍼,여름 마자켓 린넨자켓 남자아우터 정장자켓 832JK03,24800,24800,0
2018-06-01,119953201,A016030,복숭아,100% 자연산 야생 개복숭아/10kg/경북 청도,39900,39900,0
2018-06-01,1979314489,F012020,생리대,무료배송 순 슬림 오버나이트 20P X 3팩 + [순한순면중형1팩(2개입)증정]/ 예지미인,9800,9310,-490
2018-06-01,994628225,E011040,소파,할인! 레이디가구 카누 원목 1 2 3 인 거실 쇼파 소파,160210,144190,-16020
2018-06-01,1637924699,C014010,아동복,스팽글샤원피스 /공주드레스/연주회원피스/쉬폰망사,9900,9900,0
2018-06-01,1866267007,C013050,운동복,[앨빈클로]브랜드 정품! 신상 트레이닝 SET/후드티/,24900,11900,-13000
2018-06-01,41488906,A022010,주스,킹아일랜드 코코넛워터 330ml 12팩,16900,14900,-2000
2018-06-01,1100698484,I031010,장난감,와우토이즈 맥스 모터바이크 장난감 완구 어린이 아,39190,39190,0
2018-06-01,1849259233,E041010,식기,멜라민그릇 면기 라면그릇 우동그릇 볼 업소용 식기,500,450,-50
2018-06-01,1349318483,C012040,여자학생복,빅토리아-자수퍼프가디건 플라워가디건 여자가디건 롱가디건 자수퍼프가디건 니트가디,23420,20850,-2570
2018-06-01,372484848,C013050,운동복,804392-010 나이키 클럽 프렌치 테리 풀 집 후드집업남성,46000,46000,0
2018-06-01,1976848184,L021030,가방,[칼린(Carlyn)]칼린 뉴헤스터New Hester H77362010+리미티드 키링SET(인천점),278000,242700,-35300
2018-06-01,1009299629,F011130,홍삼,[풍기인삼] 5년근 난발삼 500g (4-5뿌리),54000,54000,0
2018-06-01,1009299628,F011130,홍삼,[풍기인삼] 5년근 난발삼 500g (6-7뿌리),48000,48000,0
2018-06-01,958172989,E061010,세탁세제,[제이원]베이킹소다(미국산)5kg/과탄산소다/구연산5kg,6200,5900,-300
2018-06-01,1009299627,F011130,홍삼,[풍기인삼] 5년근 난발삼 500g (11-12뿌리),46000,46000,0
2018-06-01,1419460808,A017160,오이,착한송이버섯(송향) 실속형500G,13000,11700,-1300
2018-06-01,1093734393,D031010,주택수선재료,[노루]팬톤페인트1L 조색무료 프리미엄 벽지/가구방문,19260,18360,-900
2018-06-01,2072162063,C013030,스웨터,민자 니트 반폴라 티셔트 MRO 남자반폴라 목티 남성반,49040,49040,0
2018-06-01,1999739262,E011050,책상,스테이 서랍책상 컴퓨터책상 테이블 벤치의자 식탁,71000,69000,-2000
2018-06-01,154715458,E061010,세탁세제,퍼실 파워젤 1.5Lx2개 하이진젤 세탁세제 일반 드럼,14000,12500,-1500
2018-06-01,1459608084,A016160,과일가공품,블루베리안주 (소울 350g),26950,23990,-2960
2018-06-01,193074377,E031110,청소기,18년 싹스 로봇물걸레청소기 샤오미 LG 삼성 로봇청소,278000,278000,0
2018-06-01,896580753,A011100,라면,[오뚜기]오뚜기 옛날 자른당면 (300G),3990,3990,0
2018-06-01,288136228,A013090,전복,신선급냉시킨 통영 홍가리비(급냉)1kg,3900,3900,0
2018-06-01,1631328187,C013050,운동복,특가!5900원!/헬스복/반바지/반팔티/트레이닝/운동/복,6000,5900,-100
2018-06-01,1047428296,A013070,굴,도매 냉동 절단꽃게 실중량 450gX12팩 S~3L,39500,39500,0
2018-06-01,1275752290,G011070,자전거,알톤 접이식자전거 미니벨로 20인치 엑스티드20GS 7단,97000,87300,-9700
2018-06-01,1009299603,F011130,홍삼,[풍기인삼] 백미삼 300g,110000,110000,0
2018-06-01,1009299602,F011130,홍삼,[풍기인삼] 홍미삼 300g (3등급),100000,100000,0
2018-06-01,993017933,I031040,생화,은박담요 비상용 응급 텐트 체온유지 일회용 침낭,900,740,-160
2018-06-01,385502128,C011030,남자학생복,모노 프린팅 오픈카라 반팔셔츠,32580,30630,-1950
2018-06-01,1496417466,L021010,손목시계,패션브랜드 20대남자 명품가죽메탈 오토매틱 손목시계,120000,107900,-12100
2018-06-01,983978257,L012110,색조화장품,DHI 썬스틱 20g 1+1/선스틱/스틱 썬크림/자외선차단제,16500,16500,0
2018-06-01,1508700803,C011030,남자학생복,셔츠 남방 와이셔츠 여름 남자 남성 정장 린넨 스판,11900,11900,0
2018-06-01,261469466,C013010,점퍼,[바비앤펌킨][바비앤펌킨] 안감까지러블리한 항공점퍼,83900,75510,-8390
2018-06-01,61890730,C011020,남자상의,(AGC패딩 코트 PD23 WS패딩코트코트남자코트트랜치코,149150,149150,0
2018-06-01,604925741,F012010,종이기저귀,[마미포코] 마미포코 쿨썸머그린 밴드기저귀 대형 50매x2팩,36900,36900,0
2018-06-01,1790357999,A011170,떡,현미가래떡/현미흑미가래떡/현미쑥가래떡/현미떡/현미떡국떡,8600,8600,0
2018-06-01,947443646,A013170,생선통조림,고추참치캔(오뚜기 150g)X36 물참치캔 업소 can 참치,90670,90670,0
2018-06-01,1684151681,E011050,책상,310N/컴퓨터책상/데스크/책상/테이블/노트북,28900,28900,0
2018-06-01,685779738,E061020,섬유유연제,샤프란 아로마시트 30매 x3개 시트형 섬유유연제 티슈,14150,14150,0
2018-06-01,310224783,C013050,운동복,여름/트레이닝바지/츄리/조거/운동복/남자/남성,13800,13800,0
2018-06-01,1659710434,E041020,컵,리자인 예쁜 커피잔 에스프레소잔 찻잔 30종 모음,2200,2090,-110
2018-06-01,170991318,G011070,자전거,시애틀모던F+무료조립배송 하이브리드 60mm하이림21단,154000,138600,-15400
2018-06-01,414449165,E011030,거실장,600TV/800다용도이동TV대/29인치TV다이/거실장/테이블,17800,17800,0
2018-06-01,1970516919,I053010,공책,신학기 과목노트(한문)(10개입)-랜덤 학생노트 한자노,11720,11720,0
2018-06-01,2030786696,A011020,현미,혼합찹쌀가루 (초야 300g) X25,49430,44000,-5430
2018-06-01,1233911252,C011020,남자상의,(여름)LIO싱글레어 쿨정장바지 남자신사기지양복바지,17800,17800,0
2018-06-01,1499070163,E041070,밀폐용기,락앤락 아이스큐브/얼음틀 아이스트레이,8900,8190,-710
2018-06-01,155369945,E031070,에어컨,신일 벽걸이 선풍기 리모컨 업소용 SIF-14WKP,45800,45800,0
2018-06-01,1006734787,L021020,장신구,11mm천연진주반지/화이트골드/pearl ring/LE308,595000,595000,0
2018-06-01,536172016,C012040,여자학생복,[쉬즈미스]2018 SSKCDI20020 오픈프론트반팔가디건,79000,67150,-11850
2018-06-01,1213598104,A017010,배추,대용량 태양건조 무말랭이 건나물 반찬 식자재,20500,20500,0
2018-06-01,1442694030,C012030,여자상의,여름신상! 달리샵 원피스/블라우스/프릴/셔링/팬츠,6900,6900,0
2018-06-01,689576396,C012040,여자학생복,[하루메이비] A345 루즈핏 체크 롤업소매 롱 셔츠,39900,39900,0
2018-06-01,1943556013,I053020,스케치북,내손에 캘리그라피 패드 모음전 캘리그라피종이,14210,13930,-280
2018-06-01,1011123340,A019110,드레싱,CJ 참깨피넛드레싱 240G,5590,5590,0
2018-06-01,1097061898,E031080,선풍기,대호플러스_모찌 발난로 B형,68000,68000,0
2018-06-01,959377176,L012010,면도기,도루코 페이스 XL 면도기 (1입),13800,13800,0
2018-06-01,988000527,E041060,수저,초L) 셰프 볶음 스푼,4900,4900,0
2018-06-01,152823762,L021050,우산,MLB 우산 특가展 :: 3단우산/ 장우산/ 자동우산/ 우산,10900,10900,0
2018-06-01,1097061899,E031080,선풍기,대호플러스_모찌 발난로 A형,53200,53200,0
2018-06-01,859058812,A021010,커피,(우체국배송)당일발송 네스프레소 정품 캡슐,5800,5800,0
2018-06-01,1915816773,C011050,남자내의,[남성 골덴바지]겨울/기모/골덴/중년/남자/골프/정장/신사/기지/바지/방한/방한복/면바,19800,19800,0
2018-06-01,651276527,A017150,버섯,[엉클팜]싱싱한 삼색 혼합 파프리카 1.5kg / 무료배송,13900,13210,-690
2018-06-01,1208727590,C013040,청바지,[까르뜨블랑슈]18년 여름 신상 솔리드 스판 팬츠 CMM8WP87BE-B,89000,72980,-16020
2018-06-01,981658826,A013110,마른오징어,안심 볶음조림용 멸치 150G,7990,7990,0
2018-06-01,1384640065,C013020,티셔츠,여성/남자/면반팔/라운드/티셔츠/커플/빅사이즈/S-4XL,9900,9900,0
2018-06-01,1541763425,C011020,남자상의,패딩 코트 레이어드 PD05 WS패딩코트코트남자코트트랜,160310,160310,0
2018-06-01,1101693862,A013170,생선통조림,유동 번데기캔 280g X 24EA_1BOX 번데기식품 번데기음,50880,50880,0
2018-06-01,564457950,I031040,생화,정품 COGHLAN'S - 캐나다 명품 코글란 - 미니 다용도 고무줄 고정끈 고정줄 6개 1set,17960,16440,-1520
2018-06-01,1530588577,C012020,원피스,MELODY F102 블랙/코트/여자코트/겨울코디/겨울코트/자켓/점퍼 미국 여성토탈브랜드 멜,39700,39700,0
2018-06-01,1841766938,E011020,침대,삼나무 마루형 깔판 프레임/슈퍼싱글/퀸사이즈,97000,97000,0
2018-06-01,1136832119,A022030,생수,디아망/350ml x24/자몽 라임 탄산음료/탄산수,13200,13200,0
2018-06-01,1993603976,E021020,커튼,룸메이트 먼지없는 암막커튼/고급커튼/거실/창문/방한,28500,28500,0
2018-06-01,88824485,C012040,여자학생복,[MLB]엠엘비 3종택1 남여공용 소매박스로고 MLB 후드집업(31TRS1811),79000,67150,-11850
2018-06-01,1097061872,E031080,선풍기,대호플러스_팬더 발난로 A형,60300,60300,0
2018-06-01,1097061871,E031080,선풍기,대호플러스_팬더 발난로 B형,78000,78000,0
2018-06-01,1097061874,E031080,선풍기,대호플러스_핑크곰돌이 발난로 A형,60300,60300,0
2018-06-01,1944681972,F012010,종이기저귀,[유한킴벌리] [2018]하기스 에어솔솔 썸머 밴드 3단계 공용 144매,40200,40200,0
2018-06-01,227995329,A012040,닭고기,[러브잇] 훈제 슬라이스 닭가슴살 1팩 모음/추가증정,1600,1600,0
2018-06-01,1097061873,E031080,선풍기,대호플러스_핑크곰돌이 발난로 B형,72200,72200,0
2018-06-01,742460725,C013050,운동복,카본 범퍼윙 가드 대 중 소 중 택1 차량용범퍼가드 범,20450,18630,-1820
2018-06-01,920388091,C013010,점퍼,인기신상 자켓 린넨 로브 조끼 여름가디건 특가모음전,22900,22400,-500
2018-06-01,1862897024,C013040,청바지,[제이로드]카고바지/남자청바지/스키니/빅사이즈/작업,29900,29900,0
2018-06-01,353429052,A012010,국산쇠고기,대관령한우 프리미엄 4호,330840,330840,0
2018-06-01,1097061870,E031080,선풍기,케이테크_모찌 발난로 C형,60300,60300,0
2018-06-01,1540173223,C014010,아동복,[꼬망스]여아베이직러블리티셔츠 (C1825T553_01),13500,12150,-1350
2018-06-01,649645152,A019180,즉석식품,[동원]심야식당*3+군만두300g+강호동보틀(골라담기),13410,13410,0
2018-06-01,1097061876,E031080,선풍기,대호플러스_리본곰돌이 발난로 A형,60300,60300,0
2018-06-01,1097061875,E031080,선풍기,대호플러스_리본곰돌이 발난로 B형,78000,78000,0
2018-06-01,988000503,A014010,우유,초L세)우유 930ML,1890,1890,0
2018-06-01,982705579,A017150,버섯,CJ 행복한콩국물 (350G*2),3790,3790,0
2018-06-01,1151517210,E021020,커튼,창안애 실커튼 1위 실커텐/커튼봉/가리개/비즈발/문발,3300,3200,-100
2018-06-01,692998072,I012010,컴퓨터,NEW 삼성노트북5 NT550EAA-K54A WIN10.듀얼하드 가능,1009470,959000,-50470
2018-06-01,139909618,A011140,부침가루,두레생협 호두파이(200g),25000,24250,-750
2018-06-01,691687626,I011010,TV,[LG전자]공식인증점(LG특급) 울트라HD TV 55UJ7220,1205310,1157100,-48210
2018-06-01,1431098126,C013010,점퍼,루즈슬림절개시크자켓 IR1710 여성자켓 슬림자켓 중간,115780,115780,0
2018-06-01,1451460210,C012060,여자내의,[보니알렉스](보니알렉스) 절개 디테일 밴딩 니트 스커트(BCWZ221A),15500,13640,-1860
2018-06-01,1554878114,C013010,점퍼,어린이다운점퍼 주니어패딩점퍼 오리털점퍼 겨울점퍼,31000,28000,-3000
2018-06-01,242416731,C012030,여자상의,[메이메이]공주 프릴 원피스(5color),58000,58000,0
2018-06-01,496863001,C011020,남자상의,체크 밍크털 코트 남성코트 털코트 캐주얼코트 남성용,107100,107100,0
2018-06-01,1202664434,C014020,유아복,아둘 가족티 여름 유아 뽀빠이 여름 반팔 티셔츠 12,11100,11100,0
2018-06-01,1172736406,C013040,청바지,봄신상 하이웨스트/청바지/스키니진/청바지/여성바지/,18000,16900,-1100
2018-06-01,30848721,A013090,전복,국내산 새꼬막 1.5kg (상) 새벽조업후 발송 산지,32970,32970,0
2018-06-01,1202664438,C014020,유아복,아둘 가족티 여름 유아 뽀빠이 여름 반팔 티셔츠 11,11100,11100,0
2018-06-01,986276554,A011120,두부,농심 켈로그 리얼 그래놀라 400G,8250,5990,-2260
2018-06-01,1061877369,G022020,자동차타이어,넥센타이어 고급형 CP672 215/55R17 정품 무료배송,64700,54570,-10130
2018-06-01,1831950323,F011150,건강기능식품,암웨이 비타민 모음전 뉴트리라이트 더블엑스 외 41종,56000,56000,0
2018-06-01,352550048,E061050,청소용세제,[무료배송] 곰팡이제거제 + 곰팡이방지제 2종세트 곰팡이코팅제 베란다 벽지 곰팡이제,24100,21400,-2700
2018-06-01,969265634,E031090,공기청정기,LG 공식인증점 퓨리케어 공기청정기 AS112VDS 38㎡,261000,249000,-12000
2018-06-01,898372641,G022020,자동차타이어,[전국 무료장착] 2018 넥센타이어 신상품 깜짝 특가,50000,50000,0
2018-06-01,472382791,C013040,청바지,DDP-024 진청 포인트스크레치 반바지 남자바지 청데님,25190,25190,0
2018-06-01,204367495,C012040,여자학생복,c001 여성 체크티 줄무늬 셔츠 등산 여행 남방 슬림핏,17900,17900,0
2018-06-01,576847330,E061100,습기제거제,제습제/습기제거제/옷장/주방/욕실/5개세트,4900,4900,0
2018-06-01,784545396,A019060,된장,청정원 순창메주콩된장(900G),4680,4680,0
2018-06-01,1113204246,C013050,운동복,PEACE트레이닝세트/운동복세트/밴딩팬츠/오버핏박스티,9900,9900,0
2018-06-01,1209404839,C013040,청바지,[Blouson]썸머 린넨 글렌체크 슬랙스_[B1806PT056B],57000,50670,-6330
2018-06-01,2124262773,C014020,유아복,[릴리푸리]볼륨원피스(오렌지),9900,9410,-490
2018-06-01,1807406918,D031010,주택수선재료,[모아실]변성실리콘실란트MR-1000 보수전용 실란트 내,3500,3500,0
2018-06-01,473441440,C012060,여자내의,포근 양털 반바지 겨울 핫팬츠 숏팬츠 여성 캐주얼,11240,11240,0
2018-06-01,106937789,A016110,딸기,23311307/ 냉동가당딸기(1kgX15개)-청솔,85580,85580,0
2018-06-01,1042541577,E061030,전구,남영전구 삼파장전구 11w15w20w 삼파장램프 전구,2100,2100,0
2018-06-01,1278364391,A011050,콩,[가온애]바나나칩 대용량 1kg/600g 스낵류 주전부리,3900,3900,0
2018-06-01,232901305,F012010,종이기저귀,메리즈기저귀 일본내수용 밴드형/팬티형 모음,33900,33900,0
2018-06-01,1011123306,L021050,우산,[로보카폴리] 썸머케어패치 (8매입x3장)- 5개(소풍  야외활동),25000,10500,-14500
2018-06-01,988000564,A011170,떡,초이스L)우리쌀 떡볶이떡 400G,2180,2180,0
2018-06-01,988000563,A011170,떡,초이스L)우리쌀 떡국떡 700G,3180,3180,0
2018-06-01,988000562,F012020,생리대,초L프) 텐셀 팬티라이너롱 26P,1990,1990,0
2018-06-01,294076183,C012040,여자학생복,[코코애비뉴]웬디나염로브_80504,53350,48830,-4520
2018-06-01,1011123303,L021050,우산,[로보카폴리] 모물케어액(볼타입  벌레물린곳) - 5개,30000,12500,-17500
2018-06-01,975185585,E061030,전구,LED센서등 LED직부등 LED현관등 베란다등 욕실등 복도,7800,7800,0
2018-06-01,1652801261,C014010,아동복,[팬콧키즈] 여름준비! 키즈 귀요미 상하의 66종 택_1,7900,7900,0
2018-06-01,1494944348,E011040,소파,[잉글랜더]NEW휴스턴 4인 라텍스 가죽 소파,433000,389000,-44000
2018-06-01,1775790222,E011030,거실장,동서가구 WB멀바우 피팅드레스룸 2000옷장 DF637811,627000,627000,0
2018-06-01,1509550591,D031010,주택수선재료,캐노픽스 규격:1000 X 2000 렉산 폴리카보네이트 캐노피 눈 비가림 렉산 PC 밴딩 차양,209000,209000,0
2018-06-01,1782313488,E011030,거실장,로딘 오로라 2인 식탁세트,186000,186000,0
2018-06-01,416702026,C011020,남자상의,레드 체크 밍크털 코트 퍼코트 남성털코트 남자코트,99980,99980,0
2018-06-01,562673992,A014020,분유,[LG생활건강]베비언스 액상분유 6-12개월(2단계)48개입 (니플미포함),73380,69700,-3680
2018-06-01,1016272530,L012090,기초화장품,헤라 지일 오데 퍼퓸 40ml /오 드 보떼 블라썸 스위티,26500,26500,0
2018-06-01,1242884832,A016150,아몬드,팜앤팜 17년 캘리포니아산 당일가공 볶음 구운 아몬드,12900,12900,0
2018-06-01,1010255369,A019170,냉동식품,요리하다 곡금초대가탕수육 500G,6480,6480,0
2018-06-01,954040802,E061060,살충제,컴배트 개미용 수성 에어졸 450ml,5900,5900,0
2018-06-01,487052097,C012040,여자학생복,수지네 구제 코오롱 핑크 조끼 여성 S 16-26,17430,17430,0
2018-06-01,988000556,A018060,스낵과자,초이스L) 갈릭 새우칩 75G,990,990,0
2018-06-01,1433282789,A012010,국산쇠고기,[무항생제] 꼬리반골 1kg 1+등급,21200,21200,0
2018-06-01,1505871116,E021020,커튼,세진아트 목각비즈발/문발/대나무발/갈대발/그림발,11900,11900,0
2018-06-01,2121042340,C013010,점퍼,AGC여성 후드 롱자켓 KK 버켄훌 CT 여자후드자켓 여성,79840,79840,0
2018-06-01,803490233,A012050,소시지,사조 소시지 1kg/숯불갈비/청양/옥수수/모듬 소세지,5900,5900,0
2018-06-01,408593865,C012060,여자내의,[루시제이]쉬폰 밴딩 치마바지,17000,14960,-2040
2018-06-01,1782313489,E011030,거실장,로딘 메이 2인 식탁세트,181000,181000,0
2018-06-01,113206168,A021010,커피,[당일출고]맥심 아이스커피믹스 110T/블랙100T+사은품,15900,15900,0
2018-06-01,376073120,E031030,전자레인지,[LG전자] LG전자 MW23WD 인버터 전자레인지 LG공식판매점(대명),159500,146000,-13500
2018-06-01,412317619,A017080,무,햇 마늘쫑 특품 2kg-1묶음,14900,14900,0
2018-06-01,1385860836,A011160,빵,안흥찐빵마을 수제 슈크림 찐빵 500g(10입) 2봉 수제,43460,43460,0
2018-06-01,1309760137,I031040,생화,(단품)야외 파라솔 테이블 의자 국내생산,44000,40480,-3520
2018-06-01,978151685,A013030,조기,[영광굴비] 영광굴비/법성포굴비/국산굴비/참조기/조기/명절선물,126900,126900,0
2018-06-01,1356275522,C011030,남자학생복,(YA02004)빅오버핏 롱가디건 BMD0052 남자가디건 남성,58400,51400,-7000
2018-06-01,915843641,C014020,유아복,[키키제제]유아 여아 반팔티/ 원피스/ 상하복/ 맨투맨,10900,10900,0
2018-06-01,2143790284,A022010,주스,웅진)(6입)자연은 포도100-1.5L 포도주스 과일주스 주,31750,31750,0
2018-06-01,190992363,E021020,커튼,북유럽 화이트커튼 거실 안방 침실 작은창 커튼 면,23800,21900,-1900
2018-06-01,533365859,I053040,기타문구,3M 포스트잇 30%~ DC 노트 플래그 큐브 팝업 SSN 슈퍼,1120,1120,0
2018-06-01,517738867,C013050,운동복,커스커즈 3D 루프백 대용량 수납공간 320L 차량루프백,228190,207840,-20350
2018-06-01,526107952,L012030,칫솔,어린이칫솔 5개/유아동/아기/피규어/캐릭터/치약/뽀로,9500,9500,0
2018-06-01,308235970,C011020,남자상의,[찐링]95~110국내산 남성콤비자켓/남성마이/캐쥬얼,68000,68000,0
2018-06-01,1690418678,E031070,에어컨,히트상품/프리미엄 타워형선풍기/3단조절기능/냉풍기,35800,35800,0
2018-06-01,492069644,E041060,수저,리멤버 레이저 부부수저+받침 세트/ 골든벨,10130,9020,-1110
2018-06-01,589831190,E031050,냉장고,LG공식[주]삼정 K337W11 김치냉장고 신모델,1120000,1070000,-50000
2018-06-01,1053402277,A021010,커피,카누 다크/마일드 미니 150T+다크미니5T 증정,26300,26300,0
2018-06-01,1395515363,C012030,여자상의,에레나 반팔 청원피스 예쁜 스커트 STLD-6287,30000,28500,-1500
2018-06-01,270313356,A011170,떡,[신기한떡] 카스테라 찰떡3종 35gX40팩 [초코15+딸기15+녹차10],27000,27000,0
2018-06-01,2066582999,G011070,자전거,시애틀모던F 삼천리자전거 하이브리드 21단 하이림,118200,106380,-11820
2018-06-01,1838724028,F012010,종이기저귀,[15%쿠폰] NEW 치쿨 여름용 기저귀 울트라씬 4팩,22800,22800,0
2018-06-01,176189483,E031130,보온매트,일월 워셔블 잘자요 황금매트 세트 (싱글+더블),130000,130000,0
2018-06-01,176189482,E031130,보온매트,일월 양면 기모 극세사 워셔블 매트 (싱글),70800,70800,0
2018-06-01,541838888,C015020,모자,골프캡 썬캡 골프 볼마커 모자 캘러웨이 르꼬끄바지,26000,26000,0
2018-06-01,267299216,C013020,티셔츠,추가금없는 무조건 이가격.44-120사이즈.하이 퀄리티,19900,19900,0
2018-06-01,176189481,E031130,보온매트,일월 양면 기모 극세사 워셔블 매트 (더블/투난방),82200,82200,0
2018-06-01,176189480,E031130,보온매트,일월 양면 기모 극세사 워셔블 매트세트 (싱글+더블),153000,153000,0
2018-06-01,620292329,A014030,치즈,일회용 파마산가루 4g 500개 치즈가루 파마산치즈분말,66400,66400,0
2018-06-01,1594161639,L012090,기초화장품,싸이닉 [대용량]싸이닉 더 심플 카밍 토너 300ml/약산성,16900,16900,0
2018-06-01,2114832842,E041060,수저,[리빙앳홈] 루스 커트러리 디너세트,5900,5900,0
2018-06-01,440289815,A015020,식용유,(무)해표 포도씨유250mlx30개(box)해표 카놀라유 식용,113400,99800,-13600
2018-06-01,1400968474,C011020,남자상의,잭필드 여름 숨쉬는 자켓 2종,59800,56800,-3000
2018-06-01,1876258598,E061010,세탁세제,) 식소다1kg x 24,64410,64410,0
2018-06-01,1063816079,E031130,보온매트,한일의료기 온돌마루100 난초/전기매트/온열매트,64680,64680,0
2018-06-01,1063816078,E031130,보온매트,한일의료기 온돌마루150 난초/전기매트/온열매트,84920,84920,0
2018-06-01,259573949,A013170,생선통조림,유동 번데기캔 130g X 48EA_1BOX 맛있는번데기캔 유동,52850,51270,-1580
2018-06-01,1010409061,E061060,살충제,에프킬라리퀴드무향45일*3,14900,11920,-2980
2018-06-01,1063816077,E031130,보온매트,한일의료기 온돌마루230 난초/전기매트/온열매트,113080,113080,0
2018-06-01,1063816076,E031130,보온매트,한일의료기 온돌마루270 난초/전기매트/온열매트,122760,122760,0
2018-06-01,1652756978,F012020,생리대,[화이트] 생리대 시크릿홀 슬림 수퍼롱 8개입 x5개,18500,18500,0
2018-06-01,1063816075,E031130,보온매트,한일의료기 온돌마루300 난초/전기매트/온열매트,137720,137720,0
2018-06-01,394206892,C012060,여자내의,[키이스][키이스]세일러단품_K7MA381,157000,157000,0
2018-06-01,791396896,E031130,보온매트,한일꽃잠 절전형 전기장판 전기카페트 5인용 기획상품,150000,135000,-15000
2018-06-01,1107959644,E061030,전구,장수 30W 삼파장 전구 45W 55W 형광등 램프 우리조명,3000,3000,0
2018-06-01,894306182,C011050,남자내의,TBJ/ANDEW 남녀 여름 베스트 단독 특가 4 500원~,9000,9000,0
2018-06-01,989854455,A019110,드레싱,풀무원 바지락냉이된장찌개양념 130G,1650,1650,0
2018-06-01,498566782,A017280,김,이엔슬라이스단무지 1kgX10개슬라이스 식품 단무지 이,87200,76740,-10460
2018-06-01,1244585936,A016070,귤,[곱들락][제주남원농협] 곱들락 하우스감귤 3kg (32-42과내) / 실중량,37900,37900,0
2018-06-01,855510183,I031040,생화,썬파인 왕특대 더블해먹 / 아빠어디가에 나온 해먹 풀세트 무지개 오렌지 블루 해먹스,39800,35700,-4100
2018-06-01,1753068939,A018070,파이,삼립 미니꿀약과 1kg x 2개,9700,9700,0
2018-06-01,1306615795,C013030,스웨터,티티뱅크 도트 터틀넥 후드 지퍼 집업후드 후드점퍼,22250,22250,0
2018-06-01,1770437359,E061040,부엌용세제,편백 항균 주방세제 4L 1+1/가정용/대용량/세탁세제,9300,9300,0
2018-06-01,508238462,E021020,커튼,아라크네 실커튼 1위 실커텐 커튼/커튼봉/문발,4800,4800,0
2018-06-01,336709990,C013010,점퍼,[정상가 : 239 000] 셀럽롱다운(AH4PDW02)/ 랩,119500,101580,-17920
2018-06-01,1010409095,A013140,북어채,황태채 300G/봉,13900,13900,0
2018-06-01,851980874,E011060,의자,VENUS 침대형의자 특가전/중역의자/사무용/컴퓨터//,79000,79000,0
2018-06-01,1985620267,C013010,점퍼,땡..추가금없는 무조건 이가격 마지막 선착순 주문..,19900,19900,0
2018-06-01,631202539,A016060,감,경북청도 껍질없는 아이스 홍시 15개(컵)/개당80 100g,59800,50830,-8970
2018-06-01,1063816081,E031130,보온매트,한일의료기 온돌마루300 친환경/전기매트/온열매트,137720,137720,0
2018-06-01,643944726,C011050,남자내의,아디다스 여성 에센셜 리니어 타이츠 ( BR2523 ),45490,45490,0
2018-06-01,313851628,E061020,섬유유연제,샤프란 꽃담초 섬유유연제 연꽃향 1Lx5개,11900,11900,0
2018-06-01,559995882,C013060,등산복,남 여 스트라이프 박스로고 반팔 티셔츠 (DMRT7I731 DWRT7J731)/ 디스커버리,29400,25880,-3520
2018-06-01,1063816080,E031130,보온매트,한일의료기 온돌마루70 난초/전기매트/온열매트,51920,51920,0
2018-06-01,838741525,E041030,솥,누룽지 이중압력돌솥 압력솥/압력밥솥/밭솥/스텐돌솥/,98900,98900,0
2018-06-01,176189478,E031130,보온매트,일월 뉴극세사 전기방석 3인용 (50x150),43200,43200,0
2018-06-01,176189477,E031130,보온매트,일월 극세사 전기방석 (발방석 44x44),23300,23300,0
2018-06-01,2109072743,F012020,생리대,화이트 수퍼롱오버나이트 생리대 (8+2)px24팩,86900,86900,0
2018-06-01,426580623,A022050,탄산음료,라무네사이다 200mlx6병 구슬사이다 포도맛/딸기맛,10900,10900,0
2018-06-01,380904262,I012060,저장장치,브랜드정품 게이밍 마우스 PC방 노트북 오버워치 FPS,37800,18900,-18900
2018-06-01,1538461614,A021010,커피,[당일출고/무료배송]카누디카페인 100T+사은품,18900,18900,0
2018-06-01,1072790694,C013020,티셔츠,아메리칸어패럴 정품 AA 티셔츠 반바지 크롭티 모음,11900,11900,0
2018-06-01,422829836,A019030,생강,하지카미 (생강순 605g),33930,30200,-3730
2018-06-01,954818285,E051020,건전지,에너자이저 알카라인건전지A76(4입),3990,3990,0
2018-06-01,92227802,A013100,마른멸치,완도 활 전복 특가세일 / 1kg 14-15미,34900,34900,0
2018-06-01,460431046,E031070,에어컨,신일 벽걸이 선풍기 리모컨 업소용 가정용 사무실,48000,45800,-2200
2018-06-01,561575641,C013010,점퍼,[핏셀]아동 주니어바람막이 F272JK301NA 주니어집업,20900,20900,0
2018-06-01,1629188935,A016110,딸기,코리원/논산 냉동딸기(국내산)1kg/A급/딸기/과일/쥬스,4400,4300,-100
2018-06-01,2096309406,E041010,식기,안성/방짜/유기/단/반상기/세트/셋트/혼수/예단/선물/외국인/식기/추천/가격/파는곳/V,698000,698000,0
2018-06-01,176189449,E031130,보온매트,일월 M2 워셔블 온열매트 (더블/투난방/손세탁가능),198000,198000,0
2018-06-01,176189445,E031130,보온매트,일월 양모힐링 온열매트 세트 (싱글 + 더블),179000,179000,0
2018-06-01,440289847,A015020,식용유,(무)해표 카놀라유250mlx30개(box)포도씨유 해표 올리,67500,59400,-8100
2018-06-01,733944165,A021020,차,[동서식품] 프리마 자판기용 1kg/고급커피/자판기/국산차/종이컵/설탕,3660,3660,0
2018-06-01,1099229897,C011020,남자상의,프리미엄 원단 지지아노 슬림핏수트/정장세트,49900,49900,0
2018-06-01,1010410024,E061020,섬유유연제,[LG]LG)AURA섬유유연제기획(비마이스위티)1L+1L,8900,7900,-1000
2018-06-01,483914089,E041050,냄비,카라신/스텐/냄비/통3중/양수/편수/인덕션/후라이팬,40000,40000,0
2018-06-01,302123834,L012090,기초화장품,헤라 씨씨크림 35ml/ 어반베일CC / 미네랄 멀티비비,27500,27500,0
2018-06-01,1464746854,A022010,주스,[무료배송]봉봉 238ML 24캔 과즙음료 캔음료 과일주스,23320,23320,0
2018-06-01,897707913,A019090,카레,청정원 카레여왕(분말) 구운마늘&양파 108G,3650,3650,0
2018-06-01,224812466,A019070,양념소스,백설 양념장 5종 / 불고기 / 떡볶이 / 오징어볶음,1500,1500,0
2018-06-01,806262081,A013090,전복,정성드리 하동 재첩국 500gX6팩 / 속풀이에 탁월한 재첩국 /섬진강 재첩국,39000,37500,-1500
2018-06-01,1566056007,L021020,장신구,(핸드메이드) (실버) 피칸 목걸이,35500,35500,0
2018-06-01,504802872,C013030,스웨터,양브이 스카시 니트 EB1706 무지니트 여름니트 여성니,31940,31940,0
2018-06-01,1509067004,A017220,양파,(맛나)#깐쪽파(국산.단),12600,11340,-1260
2018-06-01,1079289846,L021050,우산,VIP 의전용 고급 대형 장우산 골프우산 15종 모음,11000,9900,-1100
2018-06-01,1768735059,A018080,설탕,설탕/갈색설탕/15kg/황설탕/백설탕/매실/10kg/3kg,15400,15400,0
2018-06-01,356841201,C012020,원피스,[르샵]밑단앞뒤언발 프릴 롱원피스 (LI5OP751)(대구신세계),69000,61580,-7420
2018-06-01,1903412731,C013060,등산복,기어엑스 냉감내의-언더레이어 남자 여성 헬스복,13900,13900,0
2018-06-01,1193174518,C012060,여자내의,[대구백화점 I관] [4CUS]스트링 점프수트(FM8E7PT05594),29000,26970,-2030
2018-06-01,1210383943,C013020,티셔츠,[트레몰로][TREMOLO] 남성 경량 우븐 절개패치 터틀 티셔츠_TRSALTSC491,52000,49400,-2600
2018-06-01,954904710,A012050,소시지,CJ 더건강한 그릴후랑크 (300G),6280,4290,-1990
2018-06-01,998571197,C011050,남자내의,리얼스판 남자 밴딩팬츠/스판밴딩바지/면바지/슬림핏,21800,18800,-3000
2018-06-01,954904715,A014010,우유,[부산]축협 우유기획(900ML*2입),3880,3590,-290
2018-06-01,176189450,E031130,보온매트,일월 M2 워셔블 온열매트 세트 (싱글+더블/손세탁가능),330000,330000,0
2018-06-01,1238012115,C012060,여자내의,[홈쇼핑히트]NnF 여성 쿨컬러 썸머팬츠 세트 3종,39000,37050,-1950
2018-06-01,896634538,A018030,껌,[롯데]롯데 ID 믹스베리 껌(27G),1000,1000,0
2018-06-01,176189423,E031130,보온매트,일월 양모힐링 온열매트 (더블/ 투난방),109000,109000,0
2018-06-01,176189422,E031130,보온매트,일월 양모힐링 온열매트 (싱글/원난방),79100,79100,0
2018-06-01,1122621796,E041010,식기,스테인레스 직사각 쟁반/대/소/위생쟁반/식기테이블/,34500,32780,-1720
2018-06-01,1597028212,A017080,무,(바로수확한)유기농 여주 생여주 여주열매 건여주,19800,12800,-7000
2018-06-01,878275759,E011060,의자,비올렛 체어 카페 의자 식탁 학생 책상 업소 인테리어,23900,21510,-2390
2018-06-01,2009664708,C013050,운동복,인기 빅사이즈 트레이닝세트/여성의류/운동복,27800,24800,-3000
2018-06-01,76975910,A019050,간장,샘표 금F간장1.8LX2개 몽고진간장1.8LX2개 간장모음,11300,11300,0
2018-06-01,1398375707,A019130,스프,보노스프 골라담기/15초면 완성/치즈/간식/시리얼/죽,2280,2280,0
2018-06-01,1449265040,C012030,여자상의,청 데님 레이어드 캐쥬얼 브이넥 포켓 나시원피스,15900,15900,0
2018-06-01,1056308553,E031110,청소기,[단후이]시즌2 로봇청소기+물걸레겸용 up그레이드출시,298000,298000,0
2018-06-01,543118940,F012010,종이기저귀,리베로기저귀 밴드형/팬티형 2팩,31600,31600,0
2018-06-01,489823455,C012060,여자내의,빅사이즈/제이스타일 레디펄 워싱 밴드 배기팬츠/ 제이스타일,34300,26420,-7880
2018-06-01,1313873709,C012060,여자내의,SK1621-티라미슈 플레어 미디스커트 FREE(44~66) 플레,40320,40320,0
2018-06-01,87187312,C011030,남자학생복,[지오다노]여 코튼 린넨 셔츠 348510(강남점),39800,32820,-6980
2018-06-01,373278997,C013020,티셔츠,전품목세일/민소매나시티셔츠/린넨/라운드/여자,7900,7900,0
2018-06-01,696868179,L012040,치약,애터미 치약 플러스/에이필드 치약/암웨이 치약,16800,16800,0
2018-06-01,1859270091,E031010,전기밥솥,CRP-HUB1080SR/쿠쿠/IH압력/10인용/음성/GH,211900,194860,-17040
2018-06-01,143119646,E031020,가스레인지,매직 안심센서 고화력 화이트 2구 가스렌지 GRA-813SR,130000,119000,-11000
2018-06-01,308967528,C011030,남자학생복,남성 투 포켓 린넨 셔츠 T172SH110P/ 티비제이,10000,10000,0
2018-06-01,686924994,C013040,청바지,벨트 하이웨스트 복고풍 일자 데님 팬츠 청바지,22900,22900,0
2018-06-01,1308615443,C011020,남자상의,MJ_1135 블랙 더블트렌치 트렌치코트 하프트렌치코트,212590,212590,0
2018-06-01,341123431,A013170,생선통조림,(특가) 유동번데기/골뱅이/꼬막/꽁치/통조림/고등어,12900,12900,0
2018-06-01,990170207,I031040,생화,충전식 캡라이트 LED 헤드랜턴 등산 낚시 캠핑 랜턴,9600,8740,-860
2018-06-01,2004429015,E031070,에어컨,보국전자 벽걸이 리모컨 선풍기 BKF-40RW37,68700,38500,-30200
2018-06-01,2125695654,C013030,스웨터,KJN-NW100 남자레쉬가드요가복후드집업상의 운동복 남,31820,31820,0
2018-06-01,988242853,A018060,스낵과자,농심 새우깡 90G,980,980,0
2018-06-01,1944571480,I031040,생화,차량겸용간이침대 폴딩베드 접이식 썬텐베드 등산,54000,49590,-4410
2018-06-01,2117256500,A013100,마른멸치,완도생산자직송/완도 전복1kg(대/중/소)당일조업,26900,26900,0
2018-06-01,1755740246,I031040,생화,세진아트 탄탄 접이식의자/스툴/캠핑의자/간이의자/보조의자/다용도의자/캠핑/낚시/야,3500,3400,-100
2018-06-01,1995867352,I031040,생화,콘츠 트라보 침낭/버팔로 삼계절 침낭 낚시 캠핑용품,27000,22830,-4170
2018-06-01,1911356330,C011030,남자학생복,여름 린넨출시 BEST 솔리드/셔츠/남방/데님/와이셔츠,9800,9800,0
2018-06-01,1266753322,C013020,티셔츠,아스토레 JSG-LSTW10006 골프 캐주얼 카라티셔츠(PP),68190,68190,0
2018-06-01,1528705522,C012020,원피스,[이사베이]배색 포인트 원버튼 롱 자켓 (VQJAB2185)_M8R2,49000,46550,-2450
2018-06-01,282441186,A017200,토마토,[무료배송] 산지직송 웰빙 천연 가지 20개,16000,16000,0
2018-06-01,254270998,C013010,점퍼,[올젠]18 S/S 초경량 바람막이 점퍼 5종 택1(ZPY2JJ1501)(강남점),79000,65140,-13860
2018-06-01,1378866567,C011050,남자내의,남성 연청 슬림 스키니 팬츠 남자청바지 편한청바지,135100,135100,0
2018-06-01,760434499,A013160,맛살,(냉장)한성통통맛살H(1kg)x5개,35000,34650,-350
2018-06-01,981656189,A018020,사탕,[롯데]롯데 폭신폭신 말랑 카우 (63G),1990,1990,0
2018-06-01,772226871,C013010,점퍼,[포에버21]스트라이프 새틴 봄버 자켓/FOREVER21/점퍼/블루종,43900,21950,-21950
2018-06-01,1693254984,C013060,등산복,네파 CUMEN 팬츠 7AA1693 남성용/ 네파,40000,34000,-6000
2018-06-01,1241979954,F011150,건강기능식품,블랙선식/미숫가루/선식/검은콩 검은쌀 검은깨/대용식,18400,18400,0
2018-06-01,234171549,C013010,점퍼,bb99 숨김 원버튼 fur 도톰 자켓 크림 겨울자켓 퍼자,48030,48030,0
2018-06-01,232531949,E031080,선풍기,닥터훅_전기스토브(일반) NS-7207L (1.9KW),57500,57500,0
2018-06-01,470620714,C013050,운동복,[스타일리쉬위즈] (색상선택 : 화이트) 3M 자동차 문콕 방지,11810,10770,-1040
2018-06-01,232531948,E031080,선풍기,닥터훅_전기스토브(황토보빈) NS-7007 (3KW),61200,61200,0
2018-06-01,396975094,I012010,컴퓨터,[특가 57만!] 무료퀵 삼성데스크탑5 DM500S7A-A24BA,651570,651570,0
2018-06-01,232531947,E031080,선풍기,닥터훅_전기스토브(황토보빈) NS-7008 (3.1KW),67500,67500,0
2018-06-01,1237940745,C013030,스웨터,시보리 긴소매 니트 캐주얼,25570,25570,0
2018-06-01,232531946,E031080,선풍기,후지카_번갯불 순간히터 욕실램프 NC-H3A(3구형)-적색,139600,139600,0
2018-06-01,232531945,E031080,선풍기,후지카_번갯불 순간히터 욕실램프 NC-B2(2구형)-적색,99800,99800,0
2018-06-01,1833976655,A013070,굴,[빙장]자연산 햇 꽃게 1.2kg (대/중) 가덕도 산지직송,39900,39900,0
2018-06-01,718911443,C021040,실내화,[푸마]PUMA SMASH V2 L 365215-01 화이트,69000,59340,-9660
2018-06-01,1270237042,C013040,청바지,[루미씨] 와이드 밴딩 블랙 코튼팬츠 ver.303,23000,20960,-2040
2018-06-01,682633727,F012020,생리대,[바디피트] 엘지 쏘피 바디피트 귀애랑 안심숙면 420 수퍼롱 8p,4500,4500,0
2018-06-01,321964590,C013040,청바지,MPS18020 페니 워싱 디스 진 남자워싱청바지 슬림핏남,45240,45240,0
2018-06-01,56083271,C015040,장갑,국내브랜드 내구성 등산장갑 모음/시원한장갑/기능성/,7500,7500,0
2018-06-01,994328540,A017200,토마토,(무)(면)냉동삶은감자1kgX10개,37590,37590,0
2018-06-01,1083734183,A018020,사탕,츄파춥스미니100입 막대사탕 캔디 간식 화이트데이,7500,7500,0
2018-06-01,300515067,A012060,햄및베이컨,지키미 베이컨 1kg2개 베이컨 냉동식품 간편식품 지키,42850,38570,-4280
2018-06-01,504706987,C013040,청바지,지퍼 포켓 청반바지 데님반바지 포켓청반바지 패션청,15730,15730,0
2018-06-01,1024578851,A011140,부침가루,백설 컵케익 (쵸코) 55g,1860,1860,0
2018-06-01,231827084,F011120,인삼,(장생농산장수산삼 10년근 3주(3뿌리) 산삼 선물용 선,274450,266220,-8230
2018-06-01,686682048,A018020,사탕,대용량 마이쮸(1박스 10봉)무료배송 사탕 캔디 과자,29800,29800,0
2018-06-01,2079972210,C021040,실내화,리복 정품 BD5861 소우컷 0 5 고어텍스,73900,73900,0
2018-06-01,583251295,C012040,여자학생복,여성 니트/가디건/겨울니트/세터/롱가디건/여자,48950,48950,0
2018-06-01,994328548,A017200,토마토,(무)(면)냉동청학 애호박1kgX10개,33830,33830,0
2018-06-01,897658440,A017220,양파,농우 야채 채소 대파 청양고추 감자 시래기 볶음밥,2900,2900,0
2018-06-01,232531954,E031080,선풍기,닥터훅_고구마 전기스토브(영업용) NS-9293 (1.4KW),70000,70000,0
2018-06-01,232531953,E031080,선풍기,닥터훅_고구마 전기스토브(영업용) NS-9292 (3.1KW),81200,81200,0
2018-06-01,232531952,E031080,선풍기,나산_카본 전기스토브(가정용) NS-9100 (1.3KW),67500,67500,0
2018-06-01,232531951,E031080,선풍기,나산_카본 전기스토브(업소용) NS-9000 (2.8KW),85000,85000,0
2018-06-01,232531950,E031080,선풍기,닥터훅_전기스토브(황토보빈) NS-7307L (1.4KW),55000,55000,0
2018-06-01,1226799207,E031080,선풍기,최신형펠렛난로 KRPS-20PA/PAS(저소음)/난로/열풍기,1598000,1582020,-15980
2018-06-01,1724611229,G011070,자전거,알톤 베네통 L2.0 S 시마노7단 여성용 자전거 바구니,199000,149910,-49090
2018-06-01,1433593375,A022010,주스,제주감귤 2L 6펫 과즙음료 페트음료 과일주스 음료수,21400,21400,0
2018-06-01,2051594183,E021020,커튼,/롤러블라인드 베이지 스콕스클뢰베르 120x195 cm/ 블,63870,56850,-7020
2018-06-01,1230032246,A011170,떡,[영의정]제주 오메기떡/못난이떡/찹쌀떡/간식/전통떡,9900,9900,0
2018-06-01,493527914,A011170,떡,떡볶이떡 1kg X 10개입 / 태광식품(HanGlobal),29200,25700,-3500
2018-06-01,1100282411,A011110,당면,웅부도토리 묵말랭이 250g-국내산 도토리,32930,32930,0
2018-06-01,423793112,C013010,점퍼,리스판스 후드 윈드 자켓 트랙자켓 후드자켓 남성용자,98860,96890,-1970
2018-06-01,989939860,A014050,달걀,초L프레시)무항생제계란 (20입/대란),11990,1890,-10100
2018-06-01,671253640,E011050,책상,NOOMA TOP컴퓨터책상/본체가있는1인용2인용컴퓨터책상,62000,61000,-1000
2018-06-01,495405103,C013050,운동복,에이몬 V739 반사광 도어가드 레드 리플렉터 2P,5500,5400,-100
2018-06-01,110302581,A011170,떡,제라헌 제주 바나나떡! 고급선물포장,27000,27000,0
2018-06-01,1101269299,A013080,조개,왕중왕 해물나라 900g2개,36190,36190,0
2018-06-01,651421824,C013020,티셔츠,남자나시티/민소매/반팔티/국내생산/무료배송/균일가,8900,8900,0
2018-06-01,1266070710,C012030,여자상의,[트위] 레이첼 원피스 (TGEBFOP064),63900,63900,0
2018-06-01,958451734,A018050,비스킷,[해태]해태 크림 미니 웨하스 102G,1490,1490,0
2018-06-01,1689983521,C011030,남자학생복,[TATE]테이트 남여공용 루즈핏 롱 가디건(KA7F7-UKC020),20000,18000,-2000
2018-06-01,294042731,C012020,원피스,엄마옷 데드라 YY-SW175 썸머무드래쉬가드,52700,47640,-5060
2018-06-01,896548053,E061090,방향제,세차 어플리 케이터 패드,6600,6600,0
2018-06-01,2026205760,A018050,비스킷,삼립식품 누네띠네 12g x 100개 /밤만쥬/무료배송,10700,10700,0
2018-06-01,1216698796,A016060,감,달콤샤르르 자연그대로 만든 아이스 홍시 50개(컵)/개,64600,58140,-6460
2018-06-01,1321431169,A017020,상추,꽃섬적축면상추씨앗 3g - 봄가을파종꽃상추씨앗,1000,1000,0
2018-06-01,474178778,C013050,운동복,[인앤테크] (색상 : 실버) 도어가드원4M ㅣ 문콕방지,23770,21660,-2110
2018-06-01,1425061953,C011020,남자상의,쇼윈도매장/여름정장세트/남성수트/남성정장/조끼,68800,68800,0
2018-06-01,176189514,E031130,보온매트,일월 초절전 온열매트 70w 싱글 (70*170),45000,45000,0
2018-06-01,1742972061,C013020,티셔츠,[빈폴아웃도어]블랙 여성 스트라이프 피케 원피스 (BO8342C075),97300,76870,-20430
2018-06-01,176189513,E031130,보온매트,일월 워셔블 잘자요 황금매트 (싱글),56800,56800,0
2018-06-01,176189512,E031130,보온매트,일월 워셔블 잘자요 황금매트 (더블/투난방),73800,73800,0
2018-06-01,288531888,A012050,소시지,[목우촌] 주부9단 프랑크 소시지 500g,6190,5710,-480
2018-06-01,867735478,C014010,아동복,여름/원피스/아동/아동옷/아동의류/아동복/여아/반팔,14400,14400,0
2018-06-01,1193894196,C013010,점퍼,PTU1819 커플남자블루종항공점퍼자켓-빅사이즈110까지,35650,35650,0
2018-06-01,1228488312,C012040,여자학생복,(919) 레이온스판롱조끼/주머니롱조끼/여름롱조끼,18800,18800,0
2018-06-01,2126876845,A018050,비스킷,로투스 씽글팩 1Box300개/원두커피 커피과자 계피과자,13900,13900,0
2018-06-01,1961090438,C013040,청바지,[물건팜] (해외직배송)봄신상 여아 패션 멜빵바지 청,81240,81240,0
2018-06-01,949719550,E041010,식기,[덴비] 헤리티지 라일락 액센트 스몰 사각 플래터,70000,58100,-11900
2018-06-01,1500555197,C015040,장갑,커피색 북극곰 장갑 귀여운장갑 따뜻한장갑 북극곰끈,16180,16180,0
2018-06-01,1946188661,C012060,여자내의,허리 턱 볼륨 스커트(PJ2WS468)/ 플라스틱아일랜드,53100,43550,-9550
2018-06-01,437247043,C013030,스웨터,백지퍼단가라니트(RMD_1602) 라운드넥 라운드 빅사이,17260,17260,0
2018-06-01,232531976,E031080,선풍기,열모아 화로식 적외선 전기난로 /담요증정,45000,45000,0
2018-06-01,961368523,G022010,자동차용품,불스원 스프레이 체인 (500ml),6990,6990,0
2018-06-01,1968501421,F012020,생리대,좋은느낌 매직쿠션/좋은순면/오가닉순면+10P 증정!,15900,15900,0
2018-06-01,959343726,E061100,습기제거제,홈스타 습기를부탁해(1입),1300,1300,0
2018-06-01,959343727,E031070,에어컨,신일SIF-LP140 35CM,49900,49900,0
2018-06-01,961368527,G022010,자동차용품,불스원 체인 성에 기획상품,10900,10900,0
2018-06-01,233795393,E061030,전구,두영 FPL 36W 삼파장 전구 장수 PL 55W 형광등 램프,830,830,0
2018-06-01,237099194,C021040,실내화,나이키 에어맥스 97 울트라,128000,128000,0
2018-06-01,944044510,C013020,티셔츠,여름 반팔카라티 pk티셔츠 남자 남성 카라넥 반팔티,17800,17800,0
2018-06-01,1314682750,C012060,여자내의,SK1101-기하학 패턴 미디 플레어스커트 플레어치마 주,20830,20830,0
2018-06-01,1293843579,C013010,점퍼,푸조 큘팅 자켓(FZ715-2) 남성누빔자켓 깔깔이 남성겨,50730,50730,0
2018-06-01,1296186920,C012060,여자내의,[밸리걸] 플라워프린트 점프수트 249430,29900,25420,-4480
2018-06-01,1626869432,C011050,남자내의,~3XL 남자 린넨바지/마바지/쿨팬츠/밴딩바지/빅사이즈,23800,22800,-1000
2018-06-01,1954757488,C013010,점퍼,아디다스 ZNE 후드집업 자켓 점퍼 스포츠 트레이닝,119800,119800,0
2018-06-01,653553340,C013010,점퍼,써스데이아일랜드 (T184MJK233) 린넨 스트라이프 자켓,239000,191200,-47800
2018-06-01,1542080712,C015020,모자,남자 군모 여자 밀리터리 남성 낚시 등산 캡 모자,7000,6900,-100
2018-06-01,1817953547,D031010,주택수선재료,[본덱스]본덱스오일스테인5리터/창립20주년기념이벤트,72000,72000,0
2018-06-01,900270841,L012060,샴푸,애경 케라시스 볼륨클리닉 린스 (750ML),13500,4990,-8510
2018-06-01,1514024623,E011040,소파,플로바움 프린스 3인용 쇼파,235000,235000,0
2018-06-01,900270842,L012060,샴푸,애경 케라시스 데미지 린스 (750ML),13500,4990,-8510
2018-06-01,1777153159,C013030,스웨터,봄 여름/남성/남자/집업/가디건/터틀넥/스웨터/니트,49800,49800,0
2018-06-01,300539056,A013060,게,인풍 오징어채 1kg2개 오징어 오징어채 건어물 찢은오,31740,28570,-3170
2018-06-01,1377817832,E021010,침구,곰돌이3 아동 아사 60수 리플 여름 홑이불 베개 세트(,34300,30620,-3680
2018-06-01,1153869705,C013040,청바지,[쿠키세븐]P6547 언발 컷팅 슬림 스트레이트진 (S.M.L),39800,37810,-1990
2018-06-01,720721674,C012060,여자내의,빅사이즈/로즈/레이스/스커트 빅사이즈,45630,44270,-1360
2018-06-01,450993757,C013050,운동복,스트레치 자켓 MK1532-1533 마크 자켓 남성점퍼 숏점,97890,97890,0
2018-06-01,959343731,E061010,세탁세제,홈즈 퀵크린 세탁 조크리너 500ML,4900,4900,0
2018-06-01,1218348292,C014010,아동복,한국 왕관 토끼 상하복 2종세트 노랑(3-24개월)800011,57620,55900,-1720
2018-06-01,270734315,A011160,빵,[무배]코알라 뉴모듬빵 40개 1박스/단체간식/간식빵,19900,19900,0
2018-06-01,389803789,A013090,전복,잠수부가채취한큰왕바지락/요리용으로좋은바지락~,6900,6900,0
2018-06-01,988156425,A017070,부추,초L프라임)유기농 추부깻잎(3입/봉),2490,1490,-1000
2018-06-01,572894372,L012060,샴푸,애터미 한방 샴푸/컨디셔너,11700,11700,0
2018-06-01,1181695366,C013050,운동복,21_고구마베이비 아기옷-무형광 슬라브 아이보리 민소,19110,18540,-570
2018-06-01,960452598,L012060,샴푸,LG 오가니스트 체리블라썸 샴푸(500ML),13000,6990,-6010
2018-06-01,1570204559,C011050,남자내의,빅사이즈 28-44 링클프리 면바지 스판 남자 남성 바지,15800,15800,0
2018-06-01,232531919,E031080,선풍기,한솔 넥스코 카본히터 HNK-1000WF (1000W),59500,59500,0
2018-06-01,582300808,A017150,버섯,콩나물콩 리필 콩나물 콩 키우기 집에서 키우는 백태,4460,4460,0
2018-06-01,1521507077,C011030,남자학생복,(선물포장가능)신사의품격 시원한 여름용 레귤러핏 긴팔셔츠(아사)/ 닥스(셔츠),60000,60000,0
2018-06-01,1380267706,L021020,장신구,게르마늄 반지 은반지 실버반지 순은반지,18000,18000,0
2018-06-01,1596932963,L012090,기초화장품,아이오페 모이스트젠 아이크림 스킨 하이드레이션 25m,53510,51910,-1600
2018-06-01,300625400,C012040,여자학생복,[모다아울렛][탑걸]후드 롱 가디건(TIZ4GD708F),39000,35100,-3900
2018-06-01,1368521141,A011030,찹쌀,국산 찰보리5kg/쌀보리/늘보리,12600,12600,0
2018-06-01,232531922,E031080,선풍기,후지카_번갯불 순간히터 욕실램프 NC-B2(2구형)-금색,79800,79800,0
2018-06-01,1949957212,E011050,책상,대나무 원목 베드 트레이 노트북 좌식 책상 밥상 독서,13900,13900,0
2018-06-01,232531920,E031080,선풍기,한솔 넥스코 카본히터 HNK-2000WF (2000W),80600,80600,0
2018-06-01,1714860872,C012060,여자내의,[이사베이]언발란스 헴 사이드 슬릿 팬츠 (VQPAD2234)_Y4F3,27000,25650,-1350
2018-06-01,1272384003,C013020,티셔츠,jj75 홈쇼핑 기모 스판 롱티셔츠_그린44-88 여성긴팔,18420,18420,0
2018-06-01,1103536729,C013010,점퍼,바람막이 옷 수선 접착 테이프 패치 패딩 다운 점퍼,9000,9000,0
2018-06-01,117174143,F012010,종이기저귀,[VIP 5%쿠폰]팸퍼스 프리미엄 크루저 기저귀 3~6단계,49900,49900,0
2018-06-01,232531923,E031080,선풍기,후지카_번갯불 순간히터 욕실램프 NC-H3A(3구형)-금색,119600,119600,0
2018-06-01,1399351582,C015020,모자,신상 스냅백/힙합모자/뉴에라/야구모자/힙합/볼캡/MLB,5900,5900,0
2018-06-01,722194561,C012020,원피스,[다바걸][다바걸] 폭스퍼포켓코트,73500,69830,-3670
2018-06-01,946658592,C011050,남자내의,아이스팬츠/냉장고바지/국내산/밴딩형/사방스판,15800,15800,0
2018-06-01,1112338910,E041050,냄비,도깨비에 나오는 락앤락 미니멀 냄비 후라이팬 모음,27500,27500,0
2018-06-01,1010135424,A018010,초콜릿,트윅스 미니스 500G,10500,10500,0
2018-06-01,364905137,A013090,전복,자로티 봉골레 130g 이탈리아 바지락 모시조개 파스타,6500,5850,-650
2018-06-01,2110022218,F011150,건강기능식품,NK타히보 숙취해소 농축액 GMP최상품원료 30mlX10포,25000,25000,0
2018-06-01,630468952,A019180,즉석식품,비비고 6개/4종2개씩/육개장 소고기미역 설렁탕닭곰탕,16900,16900,0
2018-06-01,1284849692,A019140,이유식,엘빈즈 클래식 이유식 죽2단계(만 7개월~10개월)/ 엘빈즈,3380,3080,-300
2018-06-01,99819543,A011010,쌀,그린올린 2017년산 고시히카리10kg / 경기미,32500,32500,0
2018-06-01,1494283144,C021010,아동화,[리복/아디다스]키즈 아동 샌들 운동화 아쿠아슈즈,16000,16000,0
2018-06-01,158056217,C013010,점퍼,[ELOQ]_E172MJP153W_(여) 루즈핏 메쉬 믹스 점퍼/ 엘록,46900,43620,-3280
2018-06-01,308448031,C021040,실내화,[컨버스로우] 척테일러/잭퍼셀/기본코어 12종모음전,41900,41900,0
2018-06-01,1029495198,I031040,생화,LED/작업등/충전식/충전식LED작업등/LED작업등/캠핑,18000,16560,-1440
2018-06-01,1508848208,E061020,섬유유연제,다우니 섬유유연제 에이프릴후레쉬3.06L2개 5.03L2개,23900,23900,0
2018-06-01,1729532629,E011070,식탁,2인용식탁 접이식테이블 밥상 식탁 세트 다용도책상,29500,26550,-2950
2018-06-01,997162309,L021050,우산,[선물케이스]패션일러스트우산 3단/5단/자동 미니 UV,12000,11800,-200
2018-06-01,313106943,C012020,원피스,[베스트]빅사이즈/결혼식원피스/블라우스/스커트/코트,14800,14800,0
2018-06-01,989915831,A013110,마른오징어,한끼 멸치볶음 68G,1990,1990,0
2018-06-01,484027594,F012020,생리대,[특가]좋은느낌 팬티라이너 일반/롱 3팩 모음전,10000,10000,0
2018-06-01,989915833,A013110,마른오징어,한끼 새우볶음 48G,1990,1990,0
2018-06-01,819898707,L012110,색조화장품,NEW시즌4 AHC 선스틱 22gx2/썬스틱/선크림/선스프레이,20600,20600,0
2018-06-01,1849925505,A022010,주스,Dole 돌 180ml 주스 24팩 파인애플 망고,16900,16900,0
2018-06-01,388166518,C015030,넥타이,(색상 : 세피아) BTIE_112 땡땡이 두꺼운 니,15140,15140,0
2018-06-01,315430187,C015040,장갑,리본 모직 장갑 여성장갑 겨울장갑 리본장갑 패션장갑,22070,22070,0
2018-06-01,193695842,E041010,식기,[십장생 은수저4P(녹색케이스)] 스푼세트 수저세트 숟가락세트 부부수저세트 예쁜수저,48800,47700,-1100
2018-06-01,244259034,E031010,전기밥솥,CRP-FHR0610FD/쿠쿠/IH압력/6인용/GH,330000,303420,-26580
2018-06-01,815507117,C014020,유아복,넥진주끈프릴상하set/유아set/반바지/여름옷/외출복,9900,9900,0
2018-06-01,1953708754,C013050,운동복,타이어공기주입기 에어컴프레셔 바람주입기 공기압,37200,37200,0
2018-06-01,1321431101,A017020,상추,상록청치마상추씨앗 6g,2000,2000,0
2018-06-01,366175270,E011020,침대,[동서가구]LV 프리미엄 흙침대 8종택1 DF908309,489000,489000,0
2018-06-01,439610325,A018090,잼,리고마말레이드오렌지잼 907gX12개리고마 잼 오렌지잼,138100,121530,-16570
2018-06-01,104577931,E011020,침대,효암 흙소파 HM3000GSP 4종모음/돌침대 황토 흙침대,1040000,990000,-50000
2018-06-01,194752022,A017180,호박,청피망(상/특) 10kg 신선농장 국내산 생피망 피망고추,22000,22000,0
2018-06-01,1815951157,E061100,습기제거제,시즌특가! 생활공작소 제습제 520ml x 24입/ 생활공작소,19900,19900,0
2018-06-01,447989547,C013020,티셔츠,언더레이어티셔츠(사계절_스트링형_여성용_화이트) 티,113580,113580,0
2018-06-01,536054835,C013010,점퍼,국산 기본자수 빅사이즈팬티 허리38이상 주문하세요.,4120,4120,0
2018-06-01,1542631483,L021030,가방,(해피퐁퐁) 단독특가 단한번의 기회 !한정수량,31000,31000,0
2018-06-01,311559184,C013050,운동복,중형 차량커버 외장커버 차량용커버 세차 황사 차커버,63000,62370,-630
2018-06-01,1482385623,C014010,아동복,(숲자람) 기능성 키즈 바람막이 어린이옷 어린이바람,70370,70370,0
2018-06-01,1054536680,C013010,점퍼,[플레이팝][플레이팝]나염항공점퍼,31900,29350,-2550
2018-06-01,1248587925,C011020,남자상의,(색상 : 블랙 | 사이즈 : XL) WMJ-009 지,88300,88300,0
2018-06-01,1077645001,A017210,파,추가증정! 충남 부여 대추 방울토마토2kg(소과),6900,6900,0
2018-06-01,427386001,I053010,공책,모닝)초등 1-2 무제노트(남)-팩(10권입) 초등노트 노,11150,11150,0
2018-06-01,1309593397,C013050,운동복,안전삼각대 LED경광봉(5종중선택)지시봉/비상등/차량안전용품/안전봉/경광봉/교통신호,3300,2630,-670
2018-06-01,212062997,C012030,여자상의,nn66 스트랩 베이직 린넨원피스 - 네이비 여성긴팔원,35130,35130,0
2018-06-01,1877692397,I031040,생화,K4camp 접이식 캠핑의자 낚시의자 릴렉스체어,12900,12900,0
2018-06-01,370178497,E011070,식탁,아리아퍼니쳐 4인 식탁테이블/의자/벤치/식탁세트,199000,149000,-50000
2018-06-01,1156461152,A013040,고등어,제주간고등어1kg(7-8팩)2kg 3kg/제주산지직배송,22000,22000,0
2018-06-01,1395179213,A012010,국산쇠고기,대관령한우 육포세트 1호,76440,76440,0
2018-06-01,596586819,E041070,밀폐용기,10개묶음/더치병/더치커피병/페트병/생수병,3300,3040,-260
2018-06-01,311560181,C013050,운동복,특대형 차량커버 외장커버 차량용커버 세차 황사,69010,69010,0
2018-06-01,1326099342,C011030,남자학생복,[백화점SAY][예작]모달스트라이프 프린트 YJ8MBR229-블루 바이올렛,30000,21530,-8470
2018-06-01,152003128,A013160,맛살,한성 크래미(F2) 1kg2개,52180,52180,0
2018-06-01,860549169,E011030,거실장,[풀씨]300x1550 오마쥬 스탠딩 에칭 전신거울,24900,24900,0
2018-06-01,1025133522,E051020,건전지,삼성 18650충전지/리튬이온배터리/고방전/HG2/ 충전기,6950,6950,0
2018-06-01,1613766734,C013010,점퍼,[게스키즈] 게스 키즈 와펜 장식 데님자켓 G66KAJ030,176000,88000,-88000
2018-06-01,1098746867,A011090,국수,삼육 우리밀 채식라면 16봉/감자라면/ 짜장면/컵라면,18400,18400,0
2018-06-01,2145924962,I031040,생화,룹스해먹 해먹 캠핑 그네 침대 해먹풀세트 캠핑용품,18900,18900,0
2018-06-01,1095492507,D031010,주택수선재료,[무료배송][노루페인트] 수성 광택스페인트 - 18L 백색반광 (복도/베란다/건물 내외부,95000,95000,0
2018-06-01,1416511930,C013010,점퍼,[블랙야크키즈]역시즌 특가! BK럭키 다운자켓 (강남점),130000,107190,-22810
2018-06-01,1961209830,E031140,비데,이누스 방수비데 IS-27D (정품필터30개월분증정),239000,199000,-40000
2018-06-01,1628980579,E011060,의자,마스터 체어 카페 학생 책상 의자 식탁 업소 인테리어,19900,19900,0
2018-06-01,1814279768,A011040,보리쌀,2017년산 국산 백태 10kg(2kgx5개) 메주콩/두유,52300,52300,0
2018-06-01,1230369364,I031040,생화,SWISSMILITARY 스테인레스 스포츠물병/9종/정품/백화점 판매용,9900,9110,-790
2018-06-01,1121043538,E031080,선풍기,신일산업 히터/할로겐/타이머기능/회전기능 SEH-800HCH,55500,55500,0
2018-06-01,580586342,A011140,부침가루,Gildo 티라미수케익 (500g x 2팩) 드라이아이스포장,16690,16690,0
2018-06-01,772179832,F011150,건강기능식품,까스활75ml*20병,16000,16000,0
2018-06-01,1321022010,A012060,햄및베이컨,동원 비엔나1kg,5400,5400,0
2018-06-01,1612509025,C013020,티셔츠,국내생산 남성나시/기본나시/나시티/망고나시/롱나시,6900,6900,0
2018-06-01,1010231469,A019170,냉동식품,요리하다 바삭야채김말이 400G,2980,2980,0
2018-06-01,1233658010,C013010,점퍼,빅사이즈 여성 패딩점퍼 점퍼 WC 내피 탈부착 패딩점,124620,122130,-2490
2018-06-01,2114555618,E011050,책상,컴퓨터책상 사무실 철제 가구 1인용 DIY 테이블 선반,22900,22900,0
2018-06-01,860549170,E011030,거실장,[풀씨]루트 파인 600x400 다용도 상 소,12400,12400,0
2018-06-01,305857523,C013040,청바지,남여 인기 데님팬츠 8종택1(J304344외7종)/ 캘빈클라인 진,82440,70080,-12360
2018-06-01,1248622759,C012060,여자내의,여성 여자 헤짐 스판 검정 검은 블랙 검은색 핑크 핑크색 하얀 흰 화이트 흰색 숏 반바,19800,19800,0
2018-06-01,221175687,C012060,여자내의,RT5 V넥 롱셔츠 캐주얼 여성 V넥티셔츠,34170,33490,-680
2018-06-01,984396783,A022050,탄산음료,코카 씨그램 플레인 350ML,1000,600,-400
2018-06-01,901162867,A011090,국수,[농심]농심 올리브짜파게티 140G*5입,3890,3890,0
2018-06-01,2005566932,F012010,종이기저귀,18년형 군기저귀 밴드형3팩/팬티형3팩,42900,42900,0
2018-06-01,40624065,C011020,남자상의,슬림핏 남성정장/수트/세미/투버튼/자켓/셔츠/슬랙스,26800,26800,0
2018-06-01,1572160940,E021010,침구,[아망떼] 순면 라이트 차렵이불/간절기이불,32900,27510,-5390
2018-06-01,1693085715,I011030,사진기,캐논 EOS M100+15-45+22mm+고래파우치+SD32G+리더기,800000,736000,-64000
2018-06-01,1097061869,E031080,선풍기,케이테크_팬더 발난로 C형,68000,68000,0
2018-06-01,1928055468,E031120,믹서,HMF-3000S/HMF-3100S 벽돌까지 갈수있는 한일 대용량 파워 믹서기,74500,74500,0
2018-06-01,469751411,F012010,종이기저귀,(공식) 18년 군기저귀 오리지널 3팩 / 밴드  팬티,42900,42900,0
2018-06-01,1305938510,C013010,점퍼,남자 바람막이 야상 JM12 WS바람막이점퍼야상남자 바,96580,96580,0
2018-06-01,1010255425,E061040,부엌용세제,프릴베이킹소다(와일드베리)750ML,6500,6500,0
2018-06-01,984396784,A022050,탄산음료,코카 씨그램 라임 350ML,1000,600,-400
2018-06-01,1109671027,C014020,유아복,아둘 가족티 유아 커플룩 단가라 스누피 티셔츠 11,11100,11100,0
2018-06-01,130496336,L021010,손목시계,균일가 남자 가죽시계 손목시계 실용적 남성시계,10900,10900,0
2018-06-01,1778588658,L021020,장신구,[바보사랑]복을 물고오는 부엉이 목걸이 골드,14000,14000,0
2018-06-01,195321351,E061010,세탁세제,애경 울샴푸 (리필) 캡1.3L x 9개,36470,36470,0
2018-06-01,1074814851,E021010,침구,겨울왕국 면기모 패드 - 뷰티선샤인 (064187) 까는이,57680,52550,-5130
2018-06-01,949009361,C013050,운동복,H3]자동차 비상용 안전삼각대 IE553/접이식/안전용품,5000,4900,-100
2018-06-01,1109671029,C014020,유아복,아둘 가족티 유아 커플룩 단가라 스누피 티셔츠 12,11100,11100,0
2018-06-01,1795945061,A018080,설탕,에리스리톨 위드 스위트 스테비아 설탕 500g 가루,15900,15900,0
2018-06-01,985443369,A016090,참외,성주꿀참외 5kg 랜덤발송,45900,37900,-8000
2018-06-01,1679845886,E051030,디지털도어록,[고급]보조키/현관보조키/현관문열쇠/현관자물쇠/자물쇠/열쇠/현관열쇠/방화문보조키/,9600,8740,-860
2018-06-01,1867731094,L021060,유모차,예약판매 세스토라이트 BE 휴대용유모차 기내반입,348000,348000,0
2018-06-01,1123057719,C015040,장갑,에트나 여성 스키보드 벙어리 장갑 EN-320_RD,28410,28410,0
2018-06-01,1048567239,C012060,여자내의,[포에버21]풀 링 미니 스커트/FOREVER21/스커트/치마/A라인 스커트,26900,13450,-13450
2018-06-01,2006530772,A011090,국수,짜장불닭/까르보/스리라차 볶음면 큰컵 16개,17500,17500,0
2018-06-01,1899646884,C013020,티셔츠,[필골드] SLKN502 글라데이션 오버핏 폴라니트,37800,37800,0
2018-06-01,1554724933,A021020,차,시럽펌프/소스펌프/스무디펌프/에이드펌프/펌프모음전,5000,5000,0
2018-06-01,997906396,E031090,공기청정기,샤오미 공기청정기 미에어2 국내발송 국내A/S가능,136800,136800,0
2018-06-01,1844575698,I012010,컴퓨터,Z50 인텔 코어I5-2500/DDR3-8G/SSD-120G/DVD/WIN10 64,319000,319000,0
2018-06-01,1002105576,C015040,장갑,실버D 국내제조 성인용 손싸게 2개 1세트 할머니장갑,94130,94130,0
2018-06-01,751345773,A018030,껌,[캔디마을][롯데]후라보노 1곽(15개입) 금연 껌 홍보 판촉 영업 자일리톨,7200,7200,0
2018-06-01,1761023363,A021010,커피,네스카페 클래식 500g 마일드 블랙커피 자판기용커피,6420,6420,0
2018-06-01,994328511,A017200,토마토,(무)(면)냉동청양고추1kgX10개,108980,108980,0
2018-06-01,1723287300,E041030,솥,PN풍년 압력밥솥부속/고무패킹/손잡이/신호추/바킹/AS,4000,4000,0
2018-06-01,994328514,A017200,토마토,(무)(면)냉동청학 시금치1kgX10개,30150,30150,0
2018-06-01,441060444,A018090,잼,오뚜기딸기쨈850g,14480,14480,0
2018-06-01,2052354254,A017200,토마토,말린가지 20Kg /건가지/산지직송,299000,299000,0
2018-06-01,1360925350,C013060,등산복,남성/빅사이즈/등산바지/등산복/작업복/아웃도어/여름,21000,18800,-2200
2018-06-01,391373670,L021060,유모차,페도라 S7 전용 시력보호 모기장,20000,20000,0
2018-06-01,1011123275,L021050,우산,[타요] 냉각시트(6매입)_3개,18000,9900,-8100
2018-06-01,1011123276,L021050,우산,[소피루비] 썸머쿨액(볼타입) - 5개,30000,13900,-16100
2018-06-01,931144417,A017170,풋고추,산지직송! 경남 합천 해와인 가시오이 5kg,11800,11800,0
2018-06-01,1097061843,E031080,선풍기,엠엔 카본 히터 MKS-C30W,64600,64600,0
2018-06-01,1010255402,E061040,부엌용세제,프릴베이킹소다(퓨어레몬)750ML,6500,6500,0
2018-06-01,1097061842,E031080,선풍기,엠엔 할로겐 히터 MKS-H30QA,46400,46400,0
2018-06-01,574510437,A022010,주스,두레생협 생생사과즙(30개)박스 생생사과즙 사과즙 두,52050,52050,0
2018-06-01,1097061844,E031080,선풍기,엠엔 할로겐 히터 MKS-H30QG,46400,46400,0
2018-06-01,551293869,A019130,스프,청정원 우리쌀 콘크림 컵수프 60g(20g x 3개입) X 24E,89570,89570,0
2018-06-01,1073812430,C012020,원피스,프레임직사각쟁반 중,23910,23910,0
2018-06-01,285347588,A022050,탄산음료,[동원]미네마인 스파클링 워터 500mlx40병(20입x2),14500,14500,0
2018-06-01,1963680417,C014020,유아복,데님스판 포그니 퍼팬츠 겨울아동복 아동겨울옷 유아,7000,6790,-210
2018-06-01,1326724623,C013010,점퍼,윈드 에디션 지퍼 점퍼 (아이보리) 봄가을용 패션점퍼,17020,17020,0
2018-06-01,73118798,A018110,물엿,[오뚜기] 오뚜기 옛날 조청쌀엿 2.5kg,9200,9200,0
2018-06-01,1056046983,L012060,샴푸,프리미엄TS샴푸500g/올뉴TS샴푸500g/트리트먼트500ml,25900,25900,0
2018-06-01,1231288994,C012030,여자상의,[공구우먼] 스티벨 브이넥 원피스 29378 빅사이즈여성의류 하객룩,39000,39000,0
2018-06-01,1097061837,E031080,선풍기,코멕스 선풍기형 히터 CM-140S,25400,25400,0
2018-06-01,1175209731,I012010,컴퓨터,슈퍼위크 125만원+MS오피스/삼성노트북 NT900X3T-K58A,1450530,1349000,-101530
2018-06-01,300170436,E021010,침구,순면침구세트(이불커버+매트커버+베개커버)/이불솜,40700,40700,0
2018-06-01,436477380,C012040,여자학생복,[A+G]엣지 SUMMER18 썸머 에센셜 가디건 4종+스카프,78000,78000,0
2018-06-01,1096024950,E031080,선풍기,사파이어 전기오일라디에이터(타이머) SF-005T (1200W),44100,44100,0
2018-06-01,1096024951,E031080,선풍기,사파이어 전기오일라디에이터 SF-015TF (2800+300W),87200,87200,0
2018-06-01,2007098840,C014020,유아복,[압소바] 스펠키토7부우주 AO310606 7부우주복 NC아울렛,45000,13500,-31500
2018-06-01,93166268,C012020,원피스,[로엠][로엠] 페미닌 배색 패턴짜임 퍼 후드 코트 RMJH44V1G1_51,31900,30310,-1590
2018-06-01,407196884,C013030,스웨터,후드집업 MJ5002_5009 후드티집업 후드점퍼 남성점퍼,56080,56080,0
2018-06-01,1096024949,E031080,선풍기,사파이어 전기오일라디에이터(타이머) SF-007T (1500W),49300,49300,0
2018-06-01,451895268,L021030,가방,미코카 에코백/베이직/데일리/포켓/빈티지/메쉬 77종,4900,4900,0
2018-06-01,556560847,D031010,주택수선재료,[물에빠진벽지]봄꽃화이트2롤,59600,52450,-7150
2018-06-01,33560176,A011180,파스타면,프레스코 스파게티면 토마토 까르보나라 치즈크림소스,1790,1790,0
2018-06-01,1262043990,C021020,구두,VA-130 남성 워킹화 등산화 효도신발 로퍼 구두 캐주,67740,67740,0
2018-06-01,954040900,A013160,맛살,대림 실곤약(200G),980,980,0
2018-06-01,988242762,F012020,생리대,내추럴 코튼 울트라 날개 중형 8P,1000,1000,0
2018-06-01,1096024948,E031080,선풍기,사파이어 전기오일라디에이터(타이머) SF-009T (2000W),57200,57200,0
2018-06-01,101908268,A017080,무,자연애 토종새싹삼 100+100뿌리 산양삼 새싹인삼 인삼,39900,39900,0
2018-06-01,314853963,A011020,현미,혼합찹쌀가루 (초야 300g) X25,49420,43990,-5430
2018-06-01,205477656,E061050,청소용세제,특가국민락스 대용량 18L 살균소독표백악취욕실청소,7900,7900,0
2018-06-01,50150069,C011030,남자학생복,인터페이스 제작 특양면가디건 With me 후드집업자,29700,29700,0
2018-06-01,984345013,A019150,김치,CJ 하선정 포기김치 3.5KG,30800,21900,-8900
2018-06-01,984345012,E061010,세탁세제,테크 진드기 걱정끝 리필 4.5KG,10900,10900,0
2018-06-01,1199923729,C013010,점퍼,남자 바람막이 점퍼 블루종 잠바 바람부는날 입기 좋,34700,34700,0
2018-06-01,1382520428,E041070,밀폐용기,국산/정품/ 글라스락 유리밀폐용기/담금주병/유리병/,4000,3590,-410
2018-06-01,1440765134,A016090,참외,달콤한 성주 꿀참외8kg,9500,9500,0
2018-06-01,78806638,A019030,생강,건갈랑가 500g/300g,29900,29900,0
2018-06-01,2137544077,I031010,장난감,점보 지프와 피규어 기사놀이장난감 아빠놀이장난감,56150,56150,0
2018-06-01,1476321918,F012010,종이기저귀,하기스 네이처메이드 팬티/밴드 0~6단계 3팩-1박스,39800,39800,0
2018-06-01,1096024952,E031080,선풍기,사파이어 전기오일라디에이터 SF-015 (2800W),77800,77800,0
2018-06-01,1096024953,E031080,선풍기,사파이어 전기오일라디에이터 SF-011 (2200W),61100,61100,0
2018-06-01,1096024954,E031080,선풍기,사파이어 전기오일라디에이터 SF-009 (2000W),45400,45400,0
2018-06-01,570389947,A011010,쌀,2017년 햅쌀 프리미엄 농협쌀 20kg 모음전,50800,50800,0
2018-06-01,1096024955,E031080,선풍기,사파이어 전기오일라디에이터 SF-007 (1500W),45400,45400,0
2018-06-01,1355332082,C013010,점퍼,빈폴 아웃도어 공용 SUPER DOWN STANDARD 3종택1 3종택1,92800,92800,0
2018-06-01,1096024956,E031080,선풍기,사파이어 전기오일라디에이터 SF-005 (1200W),40200,40200,0
2018-06-01,1382039528,C012060,여자내의,핑크멜빵h치마/데님스커트/청치마/점프수트/오버핏.,9900,9900,0
2018-06-01,1096024957,E031080,선풍기,후지카_ 캠핑용 심지식 석유난로 FU-4863,86000,86000,0
2018-06-01,489823551,C013020,티셔츠,빅사이즈/제이스타일 페론델 스트라이프 언발 티셔츠/ 제이스타일,22800,17560,-5240
2018-06-01,11617318,A019180,즉석식품,육개장 내장탕 해장국 갈비탕 뼈해장국 설렁탕,2700,2700,0
2018-06-01,1319047980,C011050,남자내의,너무편한 교복 생활복 반바지 츄리닝 반바지 교복넥타,14450,14450,0
2018-06-01,619531407,L021020,장신구,스와로브스키 은침귀걸이 이어링 귀고리 유색 크리스탈 실버침 여성악세사리선물 패션,12500,12130,-370
2018-06-01,993581428,L021050,우산,레인가드 이중방풍우산 UV코팅/골프우산/장우산,14900,14900,0
2018-06-01,1551565554,I031010,장난감,[태성토이즈]유아전동오토바이BMW K1300S 유아전동차,189000,189000,0
2018-06-01,2083172712,C013010,점퍼,스테판조셉 프린티드 레인코트 요트A (택1) /(참고)레,86800,76390,-10410
2018-06-01,1875271659,I053040,기타문구,1000투명점착메모지2탄/투명포스트잇 필요한곳에중요,1000,1000,0
2018-06-01,1755500443,C013030,스웨터,(774) 스트링 스카시(망사) 니트,26800,26800,0
2018-06-01,1087496058,A017020,상추,깻잎 1200장내외 깻순 야채 쌈 상추 도라지 홍매실,26000,26000,0
2018-06-01,1349438775,E031080,선풍기,한빛 원적외선 전기온풍기 hv-3150(3.5kw) - 전기히터,562640,500750,-61890
2018-06-01,948022344,F012020,생리대,좋은느낌 좋은순면 울트라 날개 중형 대형 4팩,16500,16500,0
2018-06-01,1096024920,E031080,선풍기,사파이어 미니 전기오일라디에이터 HJO-M09(900W),36300,36300,0
2018-06-01,789031366,E061080,키친타월,천연펄프 키친타올 130매 6롤X2팩(1560매)/각티슈휴지,11900,11900,0
2018-06-01,1096024921,E031080,선풍기,사파이어 미니 전기오일라디에이터 HJO-M07(600W),33700,33700,0
2018-06-01,1096024922,E031080,선풍기,사파이어 미니 전기오일라디에이터 HJO-M05(500W),31400,31400,0
2018-06-01,1096024923,E031080,선풍기,사파이어 전기오일라디에이터(타이머) SF-15TR (2800W),139500,139500,0
2018-06-01,1096024924,E031080,선풍기,사파이어 전기오일라디에이터(타이머) SF-15T (2800W),80700,80700,0
2018-06-01,1096024925,E031080,선풍기,사파이어 전기오일라디에이터(타이머) SF-013T,70200,70200,0
2018-06-01,1096024926,E031080,선풍기,사파이어 전기오일라디에이터(타이머) SF-011T (2200W),65000,65000,0
2018-06-01,271051715,C013010,점퍼,가죽/패딩점퍼/패딩무스탕/무스탕/가죽자켓/가죽점퍼,127900,127900,0
2018-06-01,609633580,L012030,칫솔,20%쿠폰! [오랄비X리스테린]소프트 패키지+증정,22000,22000,0
2018-06-01,195548229,C012040,여자학생복,끌로에 구제매니아 여성 S - M 울 니트 볼레로 가디건,49000,48510,-490
2018-06-01,339829196,C011050,남자내의,DON1844 남자워싱스판면바지(-3XL) 일자바지 남자청바,27690,27690,0
2018-06-01,1218086708,C011050,남자내의,코디세트 기본 라운드 반팔 티셔츠 밴딩 린넨 반바지,19900,19900,0
2018-06-01,888822734,L012090,기초화장품,[에뛰드하우스] (1+1) 베이킹 파우더 클렌징폼/스크럽,13900,13900,0
2018-06-01,275366662,A014020,분유,일동후디스 프리미엄산양분유 1 2 3 4단계 (800gX1캔),40000,40000,0
2018-06-01,470465840,E041010,식기,델키 로터스 쿨러/맥주/스텐 맥주/와인쿨러/아이스버,67800,66450,-1350
2018-06-01,2113195829,E061040,부엌용세제,참그린 녹차 500g x 4개 순샘 트리오 퐁퐁 주방세제,5900,5900,0
2018-06-01,574654481,L021010,손목시계,알마니 시계 여성용 18ss 국내재고 백화점 동일구성,98000,98000,0
2018-06-01,1970516823,I053010,공책,신학기 과목노트(한문)(10개입)-랜덤 학생노트 한자노,11720,11720,0
2018-06-01,899492402,A013020,명태,노르웨이 자반고등어 (2마리/1손),7990,7990,0
2018-06-01,334482941,F012050,의료측정기,케어센스N 혈당시험지 4박스 200매+솜100매+침100개,62000,62000,0
2018-06-01,32006458,A016160,과일가공품,[베리필드]A등급 아이스 블루베리 1kg x 3봉/무료배송,22500,21830,-670
2018-06-01,1845874202,I012010,컴퓨터,[특가134만] 오피스증정 삼성노트북9 NT900X5T-K58A,1546310,1469000,-77310
2018-06-01,1112312190,C014010,아동복,한국생산 숄카라 유아정장 5종세트(3-36개월) 202808,70670,70670,0
2018-06-01,1164635601,C012040,여자학생복,마린밴딩팬츠 (J11PPT154)/ 매그제이(MAGJAY),27900,25110,-2790
2018-06-01,954039966,A011090,국수,[오뚜기]오뚜기 참깨라면 용기(110G),1050,1050,0
2018-06-01,1022564628,A011010,쌀,더든든 곤약쌀 곤약미 250g 300g 포만감업 칼로리다운,7600,7600,0
2018-06-01,631202635,A016060,감,경북청도 껍질없는 아이스 홍시 10개(컵)/개당80 100g,45100,38340,-6760
2018-06-01,1188217361,L021020,장신구,(1차)피어싱 남녀공용 귀걸이 NO 알러지 연예인피어,3000,2970,-30
2018-06-01,1782913107,L021030,가방,리바케이스 7860 17.3인치 게이밍 노트북가방/백팩,129000,126420,-2580
2018-06-01,871557161,G011070,자전거,무료조립 삼천리 아젠타 피스타 크로몰리 픽시 자전거,400000,216000,-184000
2018-06-01,990064846,A017280,김,초L)10분간편김밥재료모음 245G,4280,3690,-590
2018-06-01,1096024986,E031080,선풍기,유로파_ 캠핑용 석유난로 EPH-8800,169000,169000,0
2018-06-01,1096024988,E031080,선풍기,홍진테크_ 사파이어 석유난로 SF-2300OH,74800,74800,0
2018-06-01,1639816337,C011020,남자상의,봄여름 노턱 원턱 슬랙스 정장바지 남성 신사바지,17800,17800,0
2018-06-01,1736045956,C013010,점퍼,와펜시보리점퍼/초등점퍼/주니어/항공점퍼/아동점퍼/,21900,21900,0
2018-06-01,467724136,C013020,티셔츠,남성 PAT 쿨썸머 카라티셔츠 5종,69900,68900,-1000
2018-06-01,592895589,C011030,남자학생복,특가 남자가디건 남성 집업 니트 니트 후드 롱 커플,16800,16800,0
2018-06-01,285132891,C011030,남자학생복,남자 데님남방 청남방/연청 진청 데님셔츠 남성,19800,19800,0
2018-06-01,1583141316,A017280,김,화풍 사천 짜사이 1kg,1500,1500,0
2018-06-01,1658421545,L021010,손목시계,캐시비시계/교통카드+패션시계/졸업 입학선물/캐시비,30000,30000,0
2018-06-01,365966006,E061010,세탁세제,세탁세제 브라이트 드럼 5.5kg x 2개(11kg),15900,15900,0
2018-06-01,1759418740,A013040,고등어,[여수고기]국내산 갈치/고등어 2kg/삼치 2kg/아귀 1kg,9900,9900,0
2018-06-01,1609523823,A015010,참기름,백설 오뚜기 참기름 500ml x 3개 식용유 카놀라유,11900,11900,0
2018-06-01,1996387323,C011050,남자내의,여름 남자면바지/빅사이즈/카고스판/슬랙스/린넨/바지,17700,17700,0
2018-06-01,1303662514,L021030,가방,타거스 TBB566AP 16인치 노트북가방 Backpack,100000,99000,-1000
2018-06-01,1648777761,E011020,침대,보니 내츄럴 평상형 원목침대프레임 슈퍼싱글/퀸,103000,98800,-4200
2018-06-01,1614693172,A017020,상추,모듬 쌈채소 모듬쌈 2kg내외 특수야채 최상품(7ㅡ9종),23900,23900,0
2018-06-01,530566351,A018110,물엿,9번구운 전통개암죽염분말250g(사은품15g) 황토죽염,72260,70100,-2160
2018-06-01,1303385572,A019160,밑반찬,아삭아삭한 강화도 순무김치 개운한맛 강화순무김치,22900,22900,0
2018-06-01,85366313,C012020,원피스,[샤틴]심플 캐주얼 롱코트(S181P703A카키),152600,125140,-27460
2018-06-01,1295206383,C013010,점퍼,지홍 66~빅사이즈/루즈핏/롱코트/야상/패딩/자켓/점퍼,79800,79800,0
2018-06-01,638471122,C012020,원피스,프레임직사각쟁반 중,30390,30390,0
2018-06-01,1073562664,A019090,카레,코리원/오뚜기 카레/스프 1kg/대용량/양송이/쇠고기,4500,4400,-100
2018-06-01,379543026,C014020,유아복,아동 어린이 여자 여아 나시 세트 핑크 반바지 세트,9210,9210,0
2018-06-01,1326349116,E021010,침구,무독성 PE놀이방매트 얼반파크 200×180 모서리보호대/ 어린이집놀이방매트 놀이방매트,58700,53000,-5700
2018-06-01,1761023516,A021010,커피,맥스웰 오리지날 커피믹스 900g 자판기용 믹스커피,4700,4700,0
2018-06-01,2027349275,C021010,아동화,[팁토이조이] 걸음마신발 아기구두 돌리,55250,46970,-8280
2018-06-01,1554783157,F012050,의료측정기,녹십자 혈압계 BPM-642 혈압측정기 대박사은품3종,45000,45000,0
2018-06-01,999188616,I031010,장난감,놀이친구 뽀로로 / 뽀로로 쌓기분수목욕,28900,28900,0
2018-06-01,1852879467,A011090,국수,컵라면1박스/육개장사발면/신라면/진라면/삼양,17400,17400,0
2018-06-01,60265047,I011020,영상음향기기,UHD빔프로젝터/4K빔프로젝터/4K/뷰소닉/PX727-4K/ABC,1494500,1299990,-194510
2018-06-01,954040926,A018030,껌,[롯데]롯데 자일리톨 F24G,900,900,0
2018-06-01,138537830,C013010,점퍼,[테이트] 여성 사파리점퍼 KA4S1WGJ100390,34000,30600,-3400
2018-06-01,1130073329,C012030,여자상의,DGY1490 펄민 원피스 803S 여성용원피스 여성원피스,60720,60720,0
2018-06-01,2099647183,C021010,아동화,핑크 리본 빅 도트 유아신발(130-150mm) 900033 아기,25470,25470,0
2018-06-01,1673060707,C012030,여자상의,셀프웨딩드레스 만삭드레스 돌잔치드레스 작은결혼식,39900,39900,0
2018-06-01,2014582305,C013020,티셔츠,[공구우먼] 코디빅크 나시 27957 빅사이즈여성의류 루즈핏 티셔츠,7000,7000,0
2018-06-01,1096024980,E031080,선풍기,후지카_ 캠핑용 심지식 석유난로 FU-4861,108000,108000,0
2018-06-01,1096024981,E031080,선풍기,후지카_ 캠핑용 심지식 석유난로 FU-4868,123000,123000,0
2018-06-01,82028852,C012060,여자내의,[물건팜] 해외직배송 2018 봄 신상 여 캐주얼 하이,54120,54120,0
2018-06-01,448196379,C013020,티셔츠,[무료배송]숏베이직폴라1 여자목폴라티 폴라티셔츠 긴,9410,9410,0
2018-06-01,1096024982,E031080,선풍기,후지카_ 캠핑용 심지식 석유난로 FU-4865,218000,218000,0
2018-06-01,2034510434,C013010,점퍼,봄 여름 항공점퍼 블루종 야상 바람막이 시보리 단체,31800,31800,0
2018-06-01,1096024983,E031080,선풍기,후지카_ 근적외선 좌석용 히터 FU-4882,108000,108000,0
2018-06-01,195274497,F011150,건강기능식품,쌍마환/의성마늘안동참마/2달분,75000,73000,-2000
2018-06-01,1546476138,E021010,침구,국내산 사계절 요 토퍼 이불세트 침구세트 이불,49900,49900,0
2018-06-01,199193770,E041010,식기,청동/조각/반상기/반상기/방짜/유기/식기/추천/파는곳/참/전통방식/놋쇠/선물/신제품/,520000,520000,0
2018-06-01,36468816,C013010,점퍼,아디다스 아디제로 트랙자켓 ( S99687 ),150630,134070,-16560
2018-06-01,87728689,C013050,운동복,여름신상 트레이닝복세트/츄리닝/남자옷운동복,32700,32700,0
2018-06-01,985130181,E021020,커튼,난또 실커튼 우수디자인 모음 커튼 비즈발 블라인드,5000,4950,-50
2018-06-01,1096024979,E031080,선풍기,후지카_ 캠핑용 심지식 석유난로 FU-4860,108000,108000,0
2018-06-01,1973349828,C012060,여자내의,[나이스크랍] 예쁜 머메이드 스커트 a182psd203 [nc중계점],129000,77400,-51600
2018-06-01,416246225,A017010,배추,무우 제주도 무 특품 10kg 5kg내외 세척무우,11900,11900,0
2018-06-01,2050352145,C012060,여자내의,[대구백화점 II관] [레코브]린넨 스커트(LU1185SK003X),39800,36620,-3180
2018-06-01,675723370,E011040,소파,[막스앤 핸드메이드]맞춤소파 아르지오 4인용 카우치형 이태리 천연면피 가죽소파,1380000,1311830,-68170
2018-06-01,1280992678,C012060,여자내의,와이드 린넨 팬츠 LRP018 통바지 여자바지(YA02004),67480,59390,-8090
2018-06-01,796590476,A019060,된장,해찬들 재래식된장(2KG),11880,11880,0
2018-06-01,2094322669,C014010,아동복,[알로봇]로비포켓티셔츠184B9-332-04컬러:그린,19000,15200,-3800
2018-06-01,1451521610,A013070,굴,국내산 홍게살 1kg / 깝질을 벗긴 홍게 다리살 파지 /,29000,29000,0
2018-06-01,401985740,A019030,생강,하지카미 (생강순 605g),33940,30210,-3730
2018-06-01,1939337389,E011020,침대,[안전한 베디스]데이지 수납형침대+ 파워본넬매트,176900,176900,0
2018-06-01,545659370,A014020,분유,[아이배냇] 순 산양분유 1단계~4단계 800g 3캔/유아식,98700,98700,0
2018-06-01,1145504936,A012030,돼지고기,(두메촌) 국내산 한돈 냉장 돼지 등심 500g / 생고기,4500,4500,0
2018-06-01,2123874534,I012010,컴퓨터,LG데스크탑 Z70EV-AR7506 코어i5 4G 1TB 윈도우10,839360,789000,-50360
2018-06-01,1170460616,C012030,여자상의,루즈핏 캉캉 플레어 민소매 나시 원피스 비치웨어,19900,19900,0
2018-06-01,1137219359,I031010,장난감,아프라모 목욕놀이 스티커/목욕완구/물놀이완구,9900,9800,-100
2018-06-01,1847347660,L021030,가방,패셔너블한 노트북 파우치 케이스 포켓형 노트북가방,36000,36000,0
2018-06-01,379604715,C014020,유아복,여아 여자 아이 아동 어린이 민소매 여름 반바지 세트,10440,10440,0
2018-06-01,1190409137,A016100,수박,(비파괴 당도선별)국내산 애플수박 5kg/2.5kg(2~3개),16900,16900,0
2018-06-01,898514283,E061080,키친타월,스카트 행주전용 타올 (45매*2롤),6990,6190,-800
2018-06-01,1209284530,C013040,청바지,[세컨플로어] [여성] 옆트임 와이드 팬츠 SWMS2WP31200034,140000,134560,-5440
2018-06-01,466002120,C012040,여자학생복,[빌드]BIMN105 스카시 하프 가디건/빅사이즈/미시,24000,24000,0
2018-06-01,1123189546,A013080,조개,왕중왕 해물나라 900g2개,33280,33280,0
2018-06-01,494983300,A011170,떡,(냉장)별가식품 쌀떡볶이1.5kg(구멍)X10개분식 식품,65400,55590,-9810
2018-06-01,797276098,C011020,남자상의,봄여름/골프바지/면바지/청바지/스판/허리밴딩/30-42,19800,19800,0
2018-06-01,1278484075,E041070,밀폐용기,프리파라 밀폐유리병 밀페보관용기 원두커피보관통/함,12000,11040,-960
2018-06-01,1784362018,E061060,살충제,맥스포스 셀렉트 이지 겔 230g 바퀴벌레 개미 쥐 약,17500,17500,0
2018-06-01,1967897080,A019010,고춧가루,로즈마리분(TRI 250g)X12 로즈마리 식당 믹스분말 로,75170,75170,0
2018-06-01,910057014,E041070,밀폐용기,[이지앤프리] 이지앤프리 전자렌지용기 12p 냉동밥 자취용품 혼밥,7500,6900,-600
2018-06-01,2032137732,E031070,에어컨,날개없는 선풍기 SF-T3811RJ 타워팬 LG전자 2년서비스,149000,141550,-7450
2018-06-01,2145564982,C012020,원피스,MSG (대원미 대원 3K),16410,16410,0
2018-06-01,1965212968,D031010,주택수선재료,순앤수4L 2급 친환경수성페인트 벽지대용페인트,14800,14800,0
2018-06-01,1953275254,C012060,여자내의,[스파오(SPAO)]버튼 다운 랩 스커트_SPWH824G71,39900,39900,0
2018-06-01,1959098103,C013020,티셔츠,[로엠걸즈]로엠걸즈 PNC02 어깨 구멍 반팔 티셔츠 rgra82304c,19900,19510,-390
2018-06-01,633755121,L012110,색조화장품,30%+5%쿠폰! 포피네 패밀리선케어1+1+1 ~81%,11900,11900,0
2018-06-01,1087435064,C012020,원피스,코트 WS CT 01 윈드브레이커 싱글 코트 반코트 봄코트 바바리 롱코트,90870,80880,-9990
2018-06-01,1501991799,A018080,설탕,핀란드산100% 롯데 자일리톨100 스틱 60g/110g/가루,10900,7900,-3000
2018-06-01,310606045,I031040,생화,사랑손님 야전삽/작은삽 /모종삽/휴대용,10800,10800,0
2018-06-01,592041286,C011030,남자학생복,와이셔츠/빅사이즈/차이나셔츠/정장/턱시도/남성/셔츠,12900,12900,0
2018-06-01,318637567,C011030,남자학생복,2018신상 남자셔츠/체크/남방/남성/와이셔츠/봄,13900,13900,0
2018-06-01,459069033,G011070,자전거,무료조립 삼천리 24인치 하이브리드 자전거 리버스24,170000,155480,-14520
2018-06-01,335996209,C012060,여자내의,빅사이즈 DSS0024R 밴딩 니트 미디 스커트 801 빅사이,20300,20300,0
2018-06-01,1341527125,C013010,점퍼,푸마 여성용 파운데이션 엑티브 후드집업 자켓/점퍼/,58900,58900,0
2018-06-01,1996422247,A016160,과일가공품,블루베리안주 (소울 350g),26930,23970,-2960
2018-06-01,1047148880,I031070,애완동물관리비,이런스포츠]대한피구협회공인구/공인닷지볼/피구공,23000,23000,0
2018-06-01,1157414473,D031010,주택수선재료,젯소NO바니쉬NO!! 방문/가구/철재/목재/친환경/콩기름/유성/중금속無/노루페인트/에나,14000,12000,-2000
2018-06-01,1430399332,E021010,침구,돌체 순면100%고밀도 60수샤틴 바로크 차렵이불,88000,80960,-7040
2018-06-01,689442028,A013070,굴,[우리가락]랍스타 1미 (특대),81700,78920,-2780
2018-06-01,2121042247,C015040,장갑,란체티 체크가죽 남성 순모장갑 TL-6603 남성용장갑,26500,26500,0
2018-06-01,426651354,A014030,치즈,코리원/zuger 모짜렐라 블럭치즈 500g/실린더/치즈,8500,8400,-100
2018-06-01,1825236274,C013010,점퍼,(44~99) 당일발송 1만원추가할인 자켓/울코트/털코트,34990,34990,0
2018-06-01,896634443,A013150,어묵,[대림]대림 마당놀이 (200G),1280,990,-290
2018-06-01,632900663,A012010,국산쇠고기,(목우촌 선물세트)맛있는 햄 3호 고급 쇼핑백 포함 /,64100,56410,-7690
2018-06-01,2133914136,A018030,껌,롯데제과 자일리톨 껌 리필 5000X3개+ 증정3개,9890,9890,0
2018-06-01,1269704020,C013010,점퍼,레이딘 후리스 집업점퍼 S-3XL SD-6628 여성점퍼 집업,46760,46760,0
2018-06-01,2143535098,C012060,여자내의,[라탭][AK수원점][라탭]마티니 와이드팬츠 LH6PT006Z,10000,10000,0
2018-06-01,1884129079,L021030,가방,접이식백팩 백팩가방 백팩 여행용백팩 보조가방 배낭,24000,23500,-500
2018-06-01,885783174,C014020,유아복,[모다아울렛][리틀밥독](울산모다점) 바닐라스토리 비치타올,15000,15000,0
2018-06-01,1210395828,C012060,여자내의,[공구우먼] 뉴이프 투버튼 데님스커트 29793 빅사이즈 여성의류,28000,28000,0
2018-06-01,1278014035,A016090,참외,성주참외 3.5kg 랜덤크기/당일수확/당도짱,12000,7900,-4100
2018-06-01,30258228,L012090,기초화장품,비오템 옴므 아쿠아파워 모이스처라이저 75ml/로션,40900,40900,0
2018-06-01,539343374,C013050,운동복,안전 경광봉 100개 / 차량 지시봉 / 도매판매 / 2기능(불/깜빡깜빡),460000,450000,-10000
2018-06-01,190882076,L021030,가방,런샵 호마노=호박 신주브로치 목걸이 팬던트 공예 악세사리 진주브로치 - H39,25500,22440,-3060
2018-06-01,1285490556,E011070,식탁,(착불)폰테 4인 원목 식탁세트(의자/벤치),399000,399000,0
2018-06-01,1654095334,E061010,세탁세제,[피죤고농축증정]*액츠 고농축솔루션 세탁세제 2.0Lx2,16900,16900,0
2018-06-01,880972020,E031130,보온매트,한일 웰빙금사 매트 2인용,108000,108000,0
2018-06-01,988156271,A014010,우유,덴마크 커핑로드 꼬르따도 300ML,2180,1580,-600
2018-06-01,1563237748,E061010,세탁세제,E [넬리] 친환경 천연소다 산소계표백제 900g/세탁세제/소다세제/소다/천연세제/표백제,14990,14990,0
2018-06-01,1090438155,E011020,침대,[홈잡스]정품단면매트리스/발통포함(무료반품),65000,59700,-5300
2018-06-01,1520304680,D031010,주택수선재료,삼화페인트 아이생각 수성내부프로 페인트 4L 무광,10900,10900,0
2018-06-01,2139764876,A018100,꿀,다시보탬 스페인산 꿀벌화분 비폴렌 1kg 실속구성,31900,31900,0
2018-06-01,439191214,F012020,생리대,[릴리안] 릴리안 초흡수 파우더향 중형(16P)3팩+대형(14P)1팩,9900,9900,0
2018-06-01,237976171,C011030,남자학생복,니트/가디건/스웨터/모음/짚업가디건/짚업자켓/목폴라,35000,35000,0
2018-06-01,89153521,C012060,여자내의,[루시다][루시다]TH2 SK3462솔리드 밴딩 니트 스커트,28200,25100,-3100
2018-06-01,835511800,I053040,기타문구,3M 포스트잇 1+1행사 점착형 메모지 노트 사무용품,2800,2800,0
2018-06-01,1333695901,A022050,탄산음료,일화 천연사이다 190ml x30캔 / 탑씨 음료수 캔음료,6410,6410,0
2018-06-01,1600589605,C011050,남자내의,[휴아이지옴므][무료배송] 시원한 한 여름 전용 바캉스룩 팬츠 총집합!,12900,12900,0
2018-06-01,376193102,I031040,생화,[신일산업] 신일 차량용 냉온장고 33리터 SCR-S65NO 레져용 33L 차량용냉장고 휴대용냉,168000,154560,-13440
2018-06-01,333250106,E041060,수저,[답례품/선물]H.jin진공금수저세트/방짜유기/가족수저,78000,78000,0
2018-06-01,1832398526,L021060,유모차,신상품 기내반입 티크미니 휴대용 초슬림 포켓유모차,260000,260000,0
2018-06-01,618374221,I012010,컴퓨터,[가온씨앤씨] 2015 NEW iMac 5K 디스플레이 MK482KH/A 27형 6세대 코어i5/8GB램/2TB퓨,3070000,3070000,0
2018-06-01,1096024919,E031080,선풍기,청풍무구_ 카본 장구히터 CH-1370(레드),115000,115000,0
2018-06-01,180986703,E031080,선풍기,SAPA 세티즈 전기라디에이터 대형 KBR-30S/SPH-115 (15핀/3KW),93300,93300,0
2018-06-01,423504409,A013160,맛살,올리브녹차 돌자반 70gx20개 입안에서 살살녹는 고,57540,57540,0
2018-06-01,74887295,C011030,남자학생복,[제이브로스]사슬 라운드 니트 조끼,16800,15960,-840
2018-06-01,407280795,A013160,맛살,사조대림 맛살 크라비아 160g+80g 크래비아/크래미,2290,2290,0
2018-06-01,100463133,E011050,책상,텐더 각도조절 2인용 책상/책장/책꽂이/이인용/2인,148900,148900,0
2018-06-01,1637194875,C011050,남자내의,와이드/밴딩/면바지/데님/팬츠/빅사이즈/변필남,10700,10700,0
2018-06-01,1294279433,C013010,점퍼,MJ-967 배색컬러 라인 패딩점퍼 (M-XL) 네이비,91280,91280,0
2018-06-01,1266008743,A017160,오이,[남도장터]장흥 건표고 버섯/표고버섯가루/국물용 팩,5900,5900,0
2018-06-01,381451660,A013080,조개,국내산 새꼬막1.5kg (중품) 새벽조업후 발송 산지,28000,28000,0
2018-06-01,962728608,I031040,생화,특대 나무 해먹 그물 침대 간이 스탠드 캠핑용품 야전,19300,17670,-1630
2018-06-01,619915625,A019180,즉석식품,[대복]사골도가니탕12팩+수육4팩(한복선의 궁중비법),39900,39900,0
2018-06-01,896634418,A018060,스낵과자,[오리온]오리온 닥터유 에너지바(4입/160g),4390,3490,-900
2018-06-01,1340023199,C015040,장갑,클래식 양피장갑(남성) 신사용가죽장갑 양가죽장갑 남,15910,15910,0
2018-06-01,1563225746,F012020,생리대,화이트 가든프레시 무향 18매X2팩 생리대 (+견본증정),10600,10600,0
2018-06-01,1062772897,G022020,자동차타이어,넥센타이어 고급형 CP672 235/55R17 정품 무료배송,70100,59160,-10940
2018-06-01,1167444115,I011030,사진기,소니 알파 A7R III 본체 + 상품권 3만원 명품,3569280,3569280,0
2018-06-01,1312080607,A012050,소시지,동원 조이락비엔나kg/진주 줄줄이비엔나kg,5350,5350,0
2018-06-01,1372585061,A016160,과일가공품,새동네팜 재배한 국내산 아이스 새동네 블루베리 1kg,15000,15000,0
2018-06-01,1123550671,E021010,침구,수퍼클래스 1.5cm 3D MESH 유아동매트 SCS13-1116,127800,114060,-13740
2018-06-01,989168329,A018090,잼,초L 국내산딸기잼 1KG,9900,9900,0
2018-06-01,501028163,C011050,남자내의,남성배기바지 면바지 카고바지 밴딩 데님팬츠w077,16000,15800,-200
2018-06-01,1268899445,C011050,남자내의,팀 클럽 커프 팬츠(658679050) 트레이닝팬츠 스포츠바,63270,63270,0
2018-06-01,1973183862,C014020,유아복,[밀리밤]라 배색프릴 나시티 MLRN18452,7900,7900,0
2018-06-01,132028530,C011050,남자내의,남성프리미엄팬츠/28-46/봄여름/레저등산복바지,11800,11800,0
2018-06-01,511925478,C011030,남자학생복,90~130까지 빅사이즈까지 완벽한 반팔/긴팔 와이셔츠,12900,12900,0
2018-06-01,897707818,A017150,버섯,풀무원 숙주나물 270G,2190,2190,0
2018-06-01,920498468,A011170,떡,노릇노릇 구워먹는 일본 정통 찰떡 키리모찌 1kgx1봉,13900,13900,0
2018-06-01,795107339,I012010,컴퓨터,Apple 공인판매점 2017 iMac [MNDY2KH/A] 21.5형,1588600,1509170,-79430
2018-06-01,1201497781,C013040,청바지,일자청바지 세미부츠컷 바지 하이웨스트 반하이 여자,19900,19900,0
2018-06-01,1153784025,C013060,등산복,여름 등산바지 등산복 등산티 아웃도어 작업복 남자,8900,8900,0
2018-06-01,1405513340,C013060,등산복,남성용 쿨360 티셔츠 KMM17281/ 케이투,34000,28220,-5780
2018-06-01,321988647,C012020,원피스,더블버튼 슬림핏 자켓IW8SJ1750/ 코인코즈,82000,65600,-16400
2018-06-01,880972019,E031130,보온매트,한일 웰빙금사 매트 1인용,95000,95000,0
2018-06-01,1922856248,C013050,운동복,(1+1 EVENT) 16ss 첨이첨이 미니트립3부유아복 레이온 유아동의류 아동의류 공용 상하,28220,28220,0
2018-06-01,1376960212,A011050,콩,햇 브라질너트 500g+500g/카카오닙스/햄프씨드,25900,25900,0
2018-06-01,1259111360,L012060,샴푸,[팬틴]NEW 팬틴 Pro-v 에센스/트리트먼트 모음전,5600,5600,0
2018-06-01,1123523078,C012060,여자내의,[지오다노]컬러추가[여성]부츠컷 팬츠(05418506)(418506)[갤러리아],39800,33830,-5970
2018-06-01,1794935936,L012010,면도기,[도루코 일회용 면도기 100개입] 페이스4/페이스6/터치3/706/705/704/쉐이코/면도용품,6500,6500,0
2018-06-01,1395432472,C012040,여자학생복,베니타 청롱남방 DM-5671/롱청남방 데님롱남방 데님남,60280,57270,-3010
2018-06-01,370671202,I011030,사진기,캐논 정품 EOS 6D Mark II 바디 명품마을,2008400,1847640,-160760
2018-06-01,478793439,A011050,콩,(100%국내산/산지직송) 해풍맞은 생땅콩 1kg,15900,15900,0
2018-06-01,2054873364,C013020,티셔츠,[모드니]/남대문핫브랜드/여름신상품특가!,7900,7900,0
2018-06-01,321988672,C012040,여자학생복,털방울포인트 핸드메이드롱베스트IZ8SV5010 @악세서리/ 코인코즈,70000,56000,-14000
2018-06-01,2051846273,C013010,점퍼,따뜻한 후리스자켓/집업조끼/양털후리스 55~88,11500,9900,-1600
2018-06-01,1287671358,A021010,커피,내추럴라이즈 이지 다이어트 CLA포르테 1000mgx180정 홍화씨유 다이어트 다이어트식품,45000,44550,-450
2018-06-01,385908693,E011050,책상,[e스마트] 1인실 그랜드 1600 독서실책상,267500,267500,0
2018-06-01,1687751079,L012090,기초화장품,앙스샵 앙머시쩡 다운펌 (전용빗 장갑 포함),14800,14800,0
2018-06-01,404853608,C013050,운동복,남성 M~4XL 트레이닝팬츠 냉장고 린넨 반바지 7부5부,10900,10900,0
2018-06-01,659618942,C012060,여자내의,[a.t.corner(앳코너)]절개장식 언발 데님 스커트(ATSK8B304)(영등포점A),85000,70090,-14910
2018-06-01,73202680,A013170,생선통조림,[동원] EPA참치 150g*8캔 + 카놀라유 500ml,15900,15900,0
2018-06-01,290157209,C013020,티셔츠,루즈핏 후드 77 88 빅 사이즈 스트라이프 롱 티셔츠,21900,21900,0
2018-06-01,1226067509,C011020,남자상의,MJSF18003 차콜 코튼 베이직 코트 기본남자코트 남자,91960,91960,0
2018-06-01,1902818194,C013010,점퍼,아디다스 유소년 콘디보16 스타디움자켓 (AB3152 ),151840,135140,-16700
2018-06-01,438321348,C013020,티셔츠,단가라레이스티(MYD_1605) 라운드티 여성큰사이즈단가,18820,18820,0
2018-06-01,63652337,E021020,커튼,[비즈발]구슬 커튼 실커튼 창문커튼 창문발 봉 인테리어 무지개 블라인드 암막 안방 주,8600,8600,0
2018-06-01,1486473900,E011060,의자,무료반품 랭킹1위 컴퓨터/책상/학생/메쉬/사무용의자,36900,36900,0
2018-06-01,1484900093,E011070,식탁,[파파나무]캠핑 아웃도어 피크닉테이블/4~8인용테이블,159900,159900,0
2018-06-01,512881909,A018040,아이스크림,업소용/아이스크림/라벨리/아이스캔디 골고루100개,46000,46000,0
2018-06-01,910299638,A019080,고추장,초이스엘 우리쌀 한우볶음고추장(180G),5900,5900,0
2018-06-01,1434725680,E031080,선풍기,한빛 공기청정슬림형 전기온풍기hv-2500(3.0kw) - 전,462130,411300,-50830
2018-06-01,27269588,A011180,파스타면,한성 스파게티210gx6봉 치즈크림/토마토 전자레인지용,10900,10900,0
2018-06-01,321988669,C012020,원피스,심플 더블버튼 숏 자켓IW8SJ1710/ 코인코즈,82000,65600,-16400
2018-06-01,1152953523,E031130,보온매트,한솔 KCC 온돌마루 전기 카페트매트 거실 전기장판,148000,148000,0
2018-06-01,2094165551,C013040,청바지,[가이스토리]신상반바지! 청반바지 면반바지 밴딩바지,12800,12800,0
2018-06-01,378653760,L021020,장신구,(큐빅 블랙 귀걸이) 데일리 쥬얼리 연예인 패션 정장,16800,15120,-1680
2018-06-01,896609400,A013160,맛살,[한성]한성 속살의 美(미) (90G),1380,1380,0
2018-06-01,1999727890,A019020,참깨,검정깨가루 (한1K) X10,195230,173760,-21470
2018-06-01,1570912070,I031010,장난감,Step2 이인용 밴 지붕차유아자동차 장난감 유아승용완,255030,255030,0
2018-06-01,20674618,I031010,장난감,[요고요] 레고판 - 레고 및 듀플로 놀이판 밑판 모음,1100,1100,0
2018-06-01,1355767757,C014020,유아복,[모노블랙][모노블랙] 가이롯바장식 맨투맨티 53MTS442,7000,6650,-350
2018-06-01,1244737231,C012040,여자학생복,[키이스][키이스]뱅크시P/T_K7SB937,120000,120000,0
2018-06-01,1890064723,E021020,커튼,화이트 쉬폰 커튼 [맞춤제작],25000,25000,0
2018-06-01,222163563,A021010,커피,원두커피 1kg 대용량/3kg무배/당일로스팅/홀릭커피,8900,8900,0
2018-06-01,2054946806,C013010,점퍼,남자자켓 와일드 라이더 레자자켓 가죽자켓 레자자켓,121770,121770,0
2018-06-01,1948585297,C013040,청바지,남자바지 클래식 체크 핀턱 와이드 팬츠 와이드바지,60510,60510,0
2018-06-01,2121428975,A012010,국산쇠고기,[무항생제] 잡뼈 2kg 1+등급,22100,22100,0
2018-06-01,1594895675,C011030,남자학생복,75종 흰색 반팔 긴팔와이셔츠 95~130 남자 남성셔츠,15900,14900,-1000
2018-06-01,1554494221,I031040,생화,루멘코리아 에어베개 이탈방지 에어베개 차량등받이/,19000,16470,-2530
2018-06-01,396857803,C012060,여자내의,뱅뱅 여성 점프 수트 (CPE321)/ 에이니,39900,35910,-3990
2018-06-01,1690441148,C013050,운동복,카베리 당일발송 자체제작 남성 트레이닝복세트,24800,24800,0
2018-06-01,1522088182,A022030,생수,피지워터(330ml*36병/500ml*24병/1000ml*12병),26800,26800,0
2018-06-01,1011186798,F011150,건강기능식품,[대웅] 가네파워 (식물성캡슐 + 11종 복합기능  800mgX30캡슐) - 2박스,60000,36900,-23100
2018-06-01,1052561932,A013160,맛살,한성 크래미(F2) 1kg2개,52180,52180,0
2018-06-01,1011186796,F011150,건강기능식품,[종근당] 오메가3 탑 (1 000mgX180캡슐) - 1박스(총3개월분),180000,99000,-81000
2018-06-01,1011186797,F011150,건강기능식품,[대웅] 가네파워 (식물성캡슐 + 11종 복합기능  800mgX30캡슐) - 1박스(총1개월분),30000,19900,-10100
2018-06-01,989878260,L012040,치약,메디안 미니언즈 치약 체리쥬빌레 75G*2*4,12600,11500,-1100
2018-06-01,2087583698,A015020,식용유,(CJ공식샵) 백설 포도씨유 500mlx5개/식용유,14500,14500,0
2018-06-01,1262175631,E031130,보온매트,일월 온돌마루 온수 카페트매트140*183/전기장판 방석,139000,137230,-1770
2018-06-01,1944749056,C015040,장갑,남성용 가죽장갑 남자 겨울용 고급 방한용 디자인 선,24110,24110,0
2018-06-01,325569364,C013040,청바지,[셀덴] 여아데님오버올EDOW82451S_NC아울렛,49900,34900,-15000
2018-06-01,989878258,L012030,칫솔,메디안 미니언즈칫솔3단계_2입 (여아)*4,12600,11500,-1100
2018-06-01,989878259,L012040,치약,메디안 미니언즈 치약 초코민트 75G*2*4,12600,11500,-1100
2018-06-01,542322800,C013010,점퍼,[대구백화점 I관] [베이직코데즈]체크후드탈부착점퍼(BZA-JPC22M1),20000,18400,-1600
2018-06-01,812520682,C013040,청바지,[젤리스푼]마린5부해지데님팬츠_MO,16900,15210,-1690
2018-06-01,749197014,A011140,부침가루,[삼립] 삼립 티라미스무스 조각케익 (80g 5입) 케이크,13000,12870,-130
2018-06-01,1164635572,C012040,여자학생복,버튼라미스커트 (J11PSK117)/ 매그제이(MAGJAY),39900,35910,-3990
2018-06-01,1043974291,C013040,청바지,30%쿠폰!원플 남자 청바지 /스판/워싱/밴딩/9부/면바,10900,10900,0
2018-06-01,1075900966,A017300,미역,소문난오부자 도시락김 5gX36봉-재래김/대천김/광천김,10900,10900,0
2018-06-01,1366151979,A018040,아이스크림,업소용/아이스크림/대용량/10리터/5리터/카페/팥빙수,20000,20000,0
2018-06-01,1740839597,G011070,자전거,시애틀모던M 60mm하이림 21단26인치 하이브리드자전거,124000,111600,-12400
2018-06-01,1676180111,C013020,티셔츠,[다바걸][다바걸] 슬림키튼슬링백슈(C738),34000,32300,-1700
2018-06-01,570233837,A016040,포도,[크라운제과] 크라운 마이쭈 자일 용기형복숭아 110g x 12개 맛있고,59100,59100,0
2018-06-01,1605700504,A015020,식용유,[세렌디브] 세렌디브 엑스트라 버진 코코넛 오일 캡슐 바디오일,5910,5910,0
2018-06-01,1385931631,A019050,간장,[샘표] 양조간장 진간장 국간장 1.8L 골라담기,6500,6500,0
2018-06-01,2123811023,L012040,치약,2080 퓨어 마운틴 솔트 치약 120g x6개,8900,8900,0
2018-06-01,1522654407,I031040,생화,세이즈 전기릴선 코드릴 릴선 캠핑용품 전선릴 방호형,17000,14730,-2270
2018-06-01,563697721,I031010,장난감,물놀이 보트 아동장난감 행동발달장난감 물놀이보트,8050,8050,0
2018-06-01,1254770512,E031110,청소기,[단후이로봇청소기 S100]시즌3 카메라맵핑+up그레이드,439000,439000,0
2018-06-01,867517260,L021030,가방,보정속옷 코튼 올인원,47500,47500,0
2018-06-01,1758166441,A016150,아몬드,[아몬드협회공급]1등급 2017가을 햇 구운아몬드 800g,9900,9900,0
2018-06-01,1097061906,E031080,선풍기,후지카_ 전기라디에이터 (할로겐히터겸용) FU-09HR (9핀),139000,139000,0
2018-06-01,488081961,E041010,식기,문창탑/문창필통/풍수지리/인테리어/소품/합격기원,138100,135340,-2760
2018-06-01,1097061905,E031080,선풍기,후지카_ 전기라디에이터 (할로겐히터겸용) FU-07HR (7핀),129000,129000,0
2018-06-01,1636875041,C014010,아동복,셔츠망사자수ops/청해지배색원피스/칼라TAPE드레스/,9900,9900,0
2018-06-01,1718933573,A012060,햄및베이컨,코리원/청정원 고소하고 바삭한 베이컨 1kg/삼겹살,11500,11500,0
2018-06-01,660750378,C021040,실내화,푸마 여성용 바스켓하트 페이던트 왕리본 363073 01 02,54500,45240,-9260
2018-06-01,310080431,A017170,풋고추,싱싱한 백오이10kg 피클 장아찌 소박이용,16500,16500,0
2018-06-01,1097061907,E031080,선풍기,후지카_ 전기라디에이터 (할로겐히터겸용) FU-11HR (11핀),149000,149000,0
2018-06-01,1184526283,C013010,점퍼,남여공용 덕다운 롱패딩 2종택1 EPX4JD1800 EPX4JD1902/ 엠폴햄,49900,49900,0
2018-06-01,1921927452,I031040,생화,5종풀세트 릴대2+릴2/은성 순풍 원투낚시세트,34000,26680,-7320
2018-06-01,2097708971,C011030,남자학생복,남자셔츠 슬림핏 도트 와이셔츠 남성패션와이셔츠 남,28900,28900,0
2018-06-01,1334658918,L012010,면도기,무배 도루코 페이스6 휴대용 면도기 1통(10개입),11600,11600,0
2018-06-01,1451521542,A013090,전복,[유진수산] 다슬기 / 자연산 청정 올갱이살,15350,15350,0
2018-06-01,823682040,F012020,생리대,에리에르 엘리스 생리대 골라담기 메가미&메가미슬림,3900,3900,0
2018-06-01,1241581077,I053010,공책,근영사)아이디얼 양장노트(무지_그린)박스(24개입) 미,125470,125470,0
2018-06-01,334360526,C012040,여자학생복,(217) 스트링망조끼 레이어드룩의망사조끼,20800,20800,0
2018-06-01,1097061902,E031080,선풍기,대호플러스_땡땡이 멀티 발난로 B형,65000,65000,0
2018-06-01,1097061901,E031080,선풍기,대호플러스_챠밍 발난로 A형,53200,53200,0
2018-06-01,1097061904,E031080,선풍기,대호플러스_눈꽃 발난로 B형,53200,53200,0
2018-06-01,1097061903,E031080,선풍기,대호플러스_땡땡이 베이직 발난로 B형,60300,60300,0
2018-06-01,488081958,E041010,식기,결혼기념/선물/대박재물/풍수지리/인테리어/소품,62800,61550,-1250
2018-06-01,1097061900,E031080,선풍기,대호플러스_챠밍 발난로 B형,68000,68000,0
2018-06-01,471847372,C013020,티셔츠,루미씨 패션24시30%쿠폰 티셔츠/니트/가디건/자켓,7500,7500,0
2018-06-01,1011186791,F011150,건강기능식품,[닥터.오베론] 맘스 케어 벨리 크림 (임산부크림  100g) - 1개,40000,13900,-26100
2018-06-01,296524902,C012040,여자학생복,[포에버21]오픈 숄더 후드 니트/FOREVER21/니트/스웨터/후드니트,43900,13170,-30730
2018-06-01,947058482,C014010,아동복,[남아양복]아동정장 남아정장 주니어17호까지-단체복,69900,69900,0
2018-06-01,1269731676,C012040,여자학생복,ee43 자수레이스 뷔스티에 핑크 캐주얼조끼 캐주얼베,13680,13680,0
2018-06-01,2135294868,A021010,커피,맥스웰 마일드 커피믹스 1박스 네슬레 네스카페,46060,43300,-2760
2018-06-01,1560872570,C011050,남자내의,[폴햄] 남여공용 5부 롤업 청반바지 (PHX2DH1012),19000,15770,-3230
2018-06-01,2117653424,C012030,여자상의,롱원피스 이쁜 핏 핫아이템 외출복 몸매 실루엣,29000,29000,0
2018-06-01,409013175,C011020,남자상의,바바리 코트 2016 파일지 코트 남자트랜치코드 가을코,226910,226910,0
2018-06-01,1714860966,C012060,여자내의,[이사베이]밴딩 솔리드 와이드 팬츠 (VQPAD2245)_T7G6,39000,35100,-3900
2018-06-01,984431464,A011040,보리쌀,RF)기장(봉)/450G,7990,7990,0
2018-06-01,1011186789,F011150,건강기능식품,일양약품] 모나세르 아토피 비누 - 3개,45000,9900,-35100
2018-06-01,710436110,A019110,드레싱,큐피 참깨 드레싱(1L),9990,9990,0
2018-06-01,324411089,C011050,남자내의,TBJ 남성 면스판 올밴딩 팬츠 T172PT260P,15770,15770,0
2018-06-01,1392694274,C013050,운동복,나이키/아디다스/7부/트레이닝복/바지/단체/티셔츠,35000,32000,-3000
2018-06-01,897622357,F011150,건강기능식품,[고려인삼][선물세트] 고려 천종산삼 배양근 (20ML*20입),59000,59000,0
2018-06-01,1112410689,A015020,식용유,코코라이프 유기농 코코넛오일 쿠킹오일 500ml × 2개,24900,12450,-12450
2018-06-01,338350372,A018030,껌,[롯데]자일리톨알파파워민트 약150개입 판촉용 껌,8900,8900,0
2018-06-01,897622356,F011150,건강기능식품,[고려인삼][선물세트] 고려 천종산삼 배양근 20ML*30입,85000,85000,0
2018-06-01,260692380,I031040,생화,캠핑테이블/피크닉/접이/휴대용/야외/레져/키친/랜턴,46000,42140,-3860
2018-06-01,513313078,C014010,아동복,[닉스키즈][닉스키즈]*2018년 신상품 후드집업 바람막이 FKMECUN907M,19000,19000,0
2018-06-01,106073906,A013090,전복,국내산 새꼬막 1.5kg (상) 새벽조업후 발송 산지,32970,32970,0
2018-06-01,2095153069,C013050,운동복,유비콘솔박스 중 / 차량용 트렁크콘솔박스 / 트렁크,18340,18340,0
2018-06-01,107120394,C021040,실내화,아디다스 페이스 VS(AW4594)_흰/검,53700,53700,0
2018-06-01,1694553309,A018030,껌,롯데 자일리톨 100g x 3개/리필 160g x3개 목캔디,11900,11900,0
2018-06-01,430617711,C021010,아동화,섀르반 핫서머 패턴 조리 (K14D5AE877)/ 섀르반,11250,9000,-2250
2018-06-01,335852493,C012060,여자내의,핫팬츠 면바지 P 6612 하이웨스트워싱면스판3부 3부,14890,14890,0
2018-06-01,438298476,C013010,점퍼,노딕 블랙라벨 (화이트 ) 캐주얼점퍼 여성점퍼 여성잠,20370,20370,0
2018-06-01,1872281455,I031070,애완동물관리비,뉴발란스 아디다스 슬리퍼 모음,17900,17900,0
2018-06-01,1540628334,C013010,점퍼,[series](SAUDS17131NYD)빈티지 양가죽 자켓형 점퍼,359600,287680,-71920
2018-06-01,1375697955,C013010,점퍼,초특가/후드바람막이/트렌치코트/캐주얼점퍼/자켓남방,9900,9900,0
2018-06-01,2044170610,E061010,세탁세제,면생리대 필수품모음/전용세제 파우치 건조대 세탁통,4000,4000,0
2018-06-01,420756760,C012020,원피스,체크 패턴 알파카 울코트 MQDAWL1250/ 미니멈,399000,351120,-47880
2018-06-01,1566022785,A013130,오징어채,무료배송 땅콩버터오징어채 400g / 맥반석 / 참스틱,8000,6900,-1100
2018-06-01,1208054477,C013010,점퍼,세젤예 블루종 항공점퍼 항공자켓 여성블루종 여성자,20580,18120,-2460
2018-06-01,1366246729,A014030,치즈,코리원/임실 생 모짜렐라 블럭치즈 1kg/피자/국내산,20800,20800,0
2018-06-01,1226271489,C013010,점퍼,AS W NK 드라이 플래시 ELMNT 탑 HZ(856609010) 남성,115190,115190,0
2018-06-01,1527490299,F012020,생리대,템포 / 화이트탐폰 / 체내형 생리대 / 레귤러 / 슈퍼,11900,11900,0
2018-06-01,984431441,A011040,보리쌀,RF)수수(봉)/450G,7990,7990,0
2018-06-01,1045518885,C013010,점퍼,[모다아울렛][후라밍고]누빔패딩점퍼(FMD71039네이비),70000,61600,-8400
2018-06-01,984431442,A011040,보리쌀,RF)차조(봉)/450G,8990,8990,0
2018-06-01,1308617903,C013020,티셔츠,[인스턴트펑크(INSTANTFUNK)][Funk Or Funk]걸즈 숏슬리브 티셔츠(강남점),55000,49500,-5500
2018-06-01,1011186767,F011150,건강기능식품,[이메로스] 컬러웁스 블랙빼기 - 2박스,40000,14500,-25500
2018-06-01,1460742255,C013060,등산복,[머렐] polo 기능성 반팔 티셔츠 8종 모음 1택 균일가(대구신세계),20000,16150,-3850
2018-06-01,641521367,A013070,굴,(전남오픈마켓/목포꽃게장)간장돌게장2kg 15~20마리,24300,24300,0
2018-06-01,984431440,A011040,보리쌀,RF)백태(봉)/450G,7990,7990,0
2018-06-01,1252371251,C011030,남자학생복,바람조끼/쿨링/아이스조끼/냉풍조끼/얼음/여름/조끼,183900,174710,-9190
2018-06-01,1431711421,C013020,티셔츠,[게스]18SS] 남녀 로고 반팔티셔츠 17종 택1,17500,17500,0
2018-06-01,1388500703,A014050,달걀,100% NON-GMO 곡물을 급이한 친환경 포프리 계란,14000,14000,0
2018-06-01,1011186765,F011150,건강기능식품,[비타하임(VitaHEIM)] 발포 비타민C500 (독일산 발포비타민C 4300mgX20정) -10통,50000,27900,-22100
2018-06-01,645910803,A011130,시리얼,백설 부침가루 500gx20개,42660,42660,0
2018-06-01,1291289644,A019090,카레,오뚜기 3분 쇠고기카레 쇠고기짜장 200g 24개,15840,15840,0
2018-06-01,1261700175,E041050,냄비,로벤탈&에드워드권 스텐냄비 6종세트 외 후라이팬구성,14900,14900,0
2018-06-01,959343661,A018060,스낵과자,오리온 오감자딥 양념바베큐맛 (70g),1300,1300,0
2018-06-01,1068255099,A013050,오징어,꽁치캔(천일염 유동400g)X24/RhdclxhdwhflaWlro,61590,61590,0
2018-06-01,1405576894,C013020,티셔츠,지아넷 인기 데일리 니트 가디건 후드티 트레이닝세트,11900,11900,0
2018-06-01,963537609,A011040,보리쌀,캐나다 화이트네이비빈 흰강낭콩 2kg/4kg,9000,8900,-100
2018-06-01,985203953,A012010,국산쇠고기,[평창영월정선축협]대관령명품 스페셜 1호 1.8kg,334100,257000,-77100
2018-06-01,1782313464,E011030,거실장,로딘 케빈 2인 식탁세트,175000,175000,0
2018-06-01,1222401968,C014010,아동복,(숲자람) 기능성 키즈 바람막이 어린이옷 아이바람막,71120,71120,0
2018-06-01,1782313463,E011030,거실장,로딘 제시카 대리석 2인 식탁세트,426000,426000,0
2018-06-01,1782313466,E011030,거실장,로딘 코코 2인 식탁세트,186000,186000,0
2018-06-01,1782313465,E011030,거실장,로딘 땅콩 2인 식탁세트,215000,215000,0
2018-06-01,956556484,E031140,비데,[SK매직] SK매직 스마트클린 비데 BID-5215N (택배발송),300000,296000,-4000
2018-06-01,1782313462,E011030,거실장,로딘 케빈 대리석 2인 식탁세트,258000,258000,0
2018-06-01,1397542490,A011010,쌀,[17년 햅쌀]뒤주표 고시히카리 20kg / 안중농협,60700,58900,-1800
2018-06-01,1782313461,E011030,거실장,로딘 케빈 하이그로시 2인 식탁세트,175000,175000,0
2018-06-01,1317535024,C012030,여자상의,[화이트폭스] 여름신상 레이스원피스/롱/미니/캐주얼,13000,13000,0
2018-06-01,1541728959,C013040,청바지,(SR)MHA700 남자기모빅사이즈스판기모본딩청바지 남성,49130,49130,0
2018-06-01,335193588,L021010,손목시계,로제타 여성 손목시계 FW-22 팔목시계 팔찌 티켓팅시,14970,14970,0
2018-06-01,1650703004,C012030,여자상의,샤인 멜빵 데님 스커트,28750,28750,0
2018-06-01,2131721398,C012040,여자학생복,[갖고파]스트라이프남방/봄신상/여자/셔츠/블라우스,12900,12900,0
2018-06-01,983622404,F012010,종이기저귀,하기스 매직기저귀 2단계 남아용 (64P),23800,17900,-5900
2018-06-01,1199959667,C013020,티셔츠,여성 여름 스트라이프 긴기장티셔츠(P0X1204)/ 임페리얼,39200,32930,-6270
2018-06-01,605991487,C014010,아동복,[MLB키즈] 여름 반팔 티셔츠(택1) 71TSD4831,29000,24650,-4350
2018-06-01,929779356,E021010,침구,[아망떼] 시원한 리플 여름이불/패드세트/토퍼세트,32900,30900,-2000
2018-06-01,592303054,C014010,아동복,[미니로이]여아아동복/원피스/레깅스/티셔츠/아동복,9900,9900,0
2018-06-01,495429022,C012020,원피스,(더틸버리) 트위드 시보리 점퍼 TI3M0JP01/ 더틸버리,131400,118260,-13140
2018-06-01,983622403,F012010,종이기저귀,하기스 매직기저귀 1단계 공용 (70P),23800,17900,-5900
2018-06-01,1483684021,E011020,침대,[베드넷퍼니처]합리적인가격!싱글침대 SET(매트포함),99000,77000,-22000
2018-06-01,619327981,F012020,생리대,템포 레귤러/슈퍼 100p+60p 라이너 증정 체내형 탐폰,29900,29900,0
2018-06-01,1086508531,A014040,발효유,리얼 카스피해유산균 그릭요거트 스타터 1박스,12900,12900,0
2018-06-01,989974482,A017150,버섯,CJ)유기농콩나물 270G,1990,1990,0
2018-06-01,784545518,A019060,된장,청정원 안심 생된장(2KG),11700,11700,0
2018-06-01,2141114082,A013070,굴,제철 서해안 햇 꽃게 1kg 생물암꽃게 3~5마리 내외,39800,39800,0
2018-06-01,821562333,L021020,장신구,레터링 우정 민자 무광 은반지,10000,10000,0
2018-06-01,169269816,C015020,모자,군모 야구모자 볼캡 메쉬캡 골프 여름 여성 남자 모자,10000,10000,0
2018-06-01,1158365066,E041020,컵,커피잔모음 유리잔 찻잔 내열유리컵 뚜껑머그컵유리컵,7900,7900,0
2018-06-01,1097061930,E031080,선풍기,핫똘이_1초 난방기 트리플 3구 GNGB-3A,79800,79800,0
2018-06-01,496755360,E041010,식기,[한국도자기][모노화이트/프레지던트/로맨틱/누보] 단품판매/공기/대접/접시/찬기/구프,6000,5520,-480
2018-06-01,63111525,E031120,믹서,[NUC] 엔유씨 3000cc 믹서기 NFM-8860,119000,104000,-15000
2018-06-01,386453333,C021020,구두,산드라 샌들 LKR2732 여자샌들 여성샌들(YA02004),64700,60820,-3880
2018-06-01,1342292927,C012040,여자학생복,수지네 구제 르꼬끄 네이비 리버시블베스트 여성 M 19,33760,33760,0
2018-06-01,526671212,C013050,운동복,선글라스클립 안경클립 홀더 차량용 선글라스 거치대,1300,1300,0
2018-06-01,573845066,C011030,남자학생복,95~130 반팔 남자 남성 와이셔츠 셔츠 남방,12800,12800,0
2018-06-01,1917686692,A011120,두부,[당일출고/무료배송]포스트 콘푸라이트 660gx3개+증정,12500,12500,0
2018-06-01,1097061929,E031080,선풍기,핫똘이_1초 난방기 듀얼 2구 GNGB-2A,49800,49800,0
2018-06-01,591521655,C015030,넥타이,STIE_017 네이비 꽃문양 수트악세서리세트,31680,31680,0
2018-06-01,1997135432,C013010,점퍼,초경량자켓/바람막이/윈드자켓/골프자켓/빅사이즈,40800,32800,-8000
2018-06-01,5051442,C021040,실내화,[리복] 클라우드 라이드 DMX 2.0 BD5722 BD7812 2종 택1/ 리복,40000,38400,-1600
2018-06-01,838887934,L012090,기초화장품,싸이닉 [집나간 탄력]바이오 콜라겐 탄력 스킨/로션/크림,10900,10900,0
2018-06-01,869363228,C015020,모자,남여공용 볼캡/야구모자/빈티지/남성/여성/스냅백,4500,4500,0
2018-06-01,1146538358,C013040,청바지,18SUMMER 가바 쿨맥스 데님 남자 2종,98000,98000,0
2018-06-01,667130672,C013020,티셔츠,[네파](남성여름긴팔티셔츠) 프로비도 자외선 차단용 긴팔 짚업 티셔츠[7D35438],71400,60690,-10710
2018-06-01,2063913392,L021060,유모차,에시앙 P-Edition 프리미엄 아기의자 풀세트,86400,86400,0
2018-06-01,1013859732,I031040,생화,CREE 정품 헤드랜턴/줌/LED랜턴/3000루멘/18650배터리,17900,17900,0
2018-06-01,1319361875,C013010,점퍼,[올리비아로렌][올리비아로렌] 후드 탈착 바람막이 조끼 4VVCQCQM3161,32900,31260,-1640
2018-06-01,389117692,C015030,넥타이,(색상 : 블랙) BTIE_116 작은점 와이드 보타,15140,15140,0
2018-06-01,515090838,A014010,우유,멸균우유 매일우유 흰우유 200ml x 48팩,25800,25800,0
2018-06-01,1827755629,A015020,식용유,CJ 압착올리브유 900mL*2입,15400,15400,0
2018-06-01,1996519596,E061020,섬유유연제,피죤 건조기용 시트 섬유유연제 드라이시트 40매,4000,4000,0
2018-06-01,935773982,E011040,소파,로코코 1인용/2인용/3인용 인조가죽 원목 소파/쇼파,120000,108000,-12000
2018-06-01,585157576,C011050,남자내의,쿨웨어/바지/쿨바지/여름/여름바지/커플/냉감/시원,6900,6900,0
2018-06-01,262008933,C013050,운동복,트레이닝바지/홈웨어/스키니/일자/빅사이즈/휘트니스,9800,9800,0
2018-06-01,1597089042,F011130,홍삼,정관장정 홍삼쿨(2G*50입),42500,42500,0
2018-06-01,1168711783,C014010,아동복,한국 리본베어 체크 유아정장5종세트(3-36개월)202810,65600,64290,-1310
2018-06-01,960452693,A016150,아몬드,초이스L프라임 프리미엄 믹스넛(800G),22900,22900,0
2018-06-01,2143141678,A022010,주스,웅진)초록매실(병) 180ml12개입 매실주스 주스 초록매,16080,16080,0
2018-06-01,839670346,A016070,귤,당도높은 하우스감귤3kg(41~50개입),53900,52070,-1830
2018-06-01,1533204701,C013030,스웨터,드리밍마켓] 여름니트/ 비치웨어/ 시스루니트(2color),23000,23000,0
2018-06-01,149462936,C013050,운동복,트레이닝복/커플/트레이닝복세트/운동복/추리닝/팬츠,19800,19800,0
2018-06-01,1436463468,C013020,티셔츠,에스닉시스루티/자수티셔츠/망사티셔츠/레이스티,9900,9900,0
2018-06-01,689170847,C012040,여자학생복,수지네 구제 밀레 브라운 등산조끼 여성 S 5-18,25350,25350,0
2018-06-01,180120614,C012040,여자학생복,[제쉬나인][제쉬나인]플라워 로브 가디건롱가디건쉬폰가디건,27600,24840,-2760
2018-06-01,527624895,C021040,실내화,나이키 운동화 인기/런닝화/신발/에어맥스/남성/남자,42300,42300,0
2018-06-01,1256013377,D031010,주택수선재료,순앤수4L KS정품 친환경페인트벽지대용,14900,14900,0
2018-06-01,1629260894,A011100,라면,구포국수500g/소면/메밀국수/콩국수/중면/대면/국수,990,990,0
2018-06-01,1295387147,E061030,전구,오스람 FPL 32W 삼파장 전구 36W 55W 형광등 램프 PL,1300,1300,0
2018-06-01,653036370,A011130,시리얼,백설 부침가루 500gx20개,48650,48650,0
2018-06-01,577994556,A012010,국산쇠고기,뉴카놀라유사조해표 답례품기념품500mlX3입선물세트식,8180,8180,0
2018-06-01,472357647,I031040,생화,애완동물 자동차시트패드 애견패드,47250,43040,-4210
2018-06-01,895801352,A019110,드레싱,[CJ]CJ 다진 마늘 (250G),6890,6890,0
2018-06-01,280959916,C011030,남자학생복,[백화점SAY][예작]호리존탈패턴 YJ8MBS975-블루,30000,21530,-8470
2018-06-01,2076837026,D031010,주택수선재료,실버블라썸 접착식벽지/붙이는풀바른셀프시트지스티커,31310,31310,0
2018-06-01,1564766501,C011030,남자학생복,[ab.f.z]스트라이프 포켓 셔츠블라우스(AFQ3GB52),9000,7920,-1080
2018-06-01,850928257,I012060,저장장치,COX CK700 라이트닝 카일 광축 게이밍 기계식 키보드,58400,54900,-3500
2018-06-01,1093249705,E031080,선풍기,후지카_ 카본 전기난로 DD-3500 (2.4kw),82300,82300,0
2018-06-01,676603268,C013010,점퍼,[대구백화점 I관] [클라이드]남여공용 숏기장 항공점퍼(CHCJP531U),62800,53380,-9420
2018-06-01,1011186701,A018100,꿀,[일동후디스]아티키 그릭허니 (ATTIKI GREEK HONEY) 250g,49000,49000,0
2018-06-01,1093249704,E031080,선풍기,후지카_ 카본 전기난로 DD-1800 (1.8kw),77000,77000,0
2018-06-01,1011186702,A018100,꿀,[일동후디스]아티키 그릭허니 스마트팩 (ATTIKI GREEK HONEY SMART PACK) 100g,19000,19000,0
2018-06-01,669418550,C011030,남자학생복,남자여자하와이안셔츠/꽃남방/꽃반바지/바캉스셔츠,12000,12000,0
2018-06-01,1771905171,A011020,현미,유기농 찹쌀 5kg / (친환경농산물/친환경인증),30400,30400,0
2018-06-01,974604717,E061050,청소용세제,에어컨 탈취제 300ml 자동차 차량 냄새 제거방법 청소,10000,9500,-500
2018-06-01,285359467,C014020,유아복,엠보선인장 레깅스 유아레깅스 유아레깅스 유아바지,5390,5230,-160
2018-06-01,1903206557,C011030,남자학생복,티비제이 7부 코튼린넨 스트라이프 풀오버 셔츠 T182SH210P,39900,33520,-6380
2018-06-01,468822559,C015030,넥타이,[나쁜남자]모직넥타이 코튼 울타이 남자 캐주얼넥타이,7900,7900,0
2018-06-01,1781168285,E041010,식기,도기야 페일블루/단품골라담기/공기/대접/접시/찬기,6900,6900,0
2018-06-01,1919410787,C011050,남자내의,[바지킹]30%할인! 슬랙스/면바지/밴드바지/빅사이즈,11900,11900,0
2018-06-01,822552986,C013050,운동복,차량용선반.컵홀더.차량용테이블.컵홀더.차량용거치대,13800,13800,0
2018-06-01,544635738,C012060,여자내의,[모라도](M.MORADO) 트위드 H라인 니트 스커트 [MES1SK200핑크],30000,28500,-1500
2018-06-01,197178225,F012020,생리대,위스퍼 코스모 메모리폼 2팩/4팩+피부애 중형 30P,16900,16900,0
2018-06-01,1351694723,C013020,티셔츠,[무료배송]반폴라 스튜디오 티셔츠 긴팔폴라티 공용폴,10330,10330,0
2018-06-01,1317082761,C021020,구두,VA-146 수제화 남성구두 핸드메이드 캐주얼화 스니커,50640,50640,0
2018-06-01,1778650999,L021020,장신구,[바보사랑]925실버볼 드롭이어링 10종 택1,29900,29900,0
2018-06-01,1778650998,L021020,장신구,[바보사랑]925실버 십자가 드롭이어링 10종 택1,29900,29900,0
2018-06-01,519427792,C013050,운동복,자동차 삼각대 안전접이식삼각대 반사판 사고예방,9320,8580,-740
2018-06-01,1778650997,L021020,장신구,[바보사랑]925실버볼 심플목걸이,23900,23900,0
2018-06-01,984962901,C011050,남자내의,[필골드] CHP03 기모디자인 클라이밍팬츠,29800,29800,0
2018-06-01,416021973,C013010,점퍼,코팅 자켓 20-3-JP GM 남자점퍼 점퍼 매터자켓 남자점,38990,38220,-770
2018-06-01,839670376,A016070,귤,당도높은 하우스감귤3kg(31~40개입),51000,49270,-1730
2018-06-01,90129704,L021060,유모차,[도노도노]쿨 쿠션 라이너-디자인선택 유모차 카시트겸용,34900,34900,0
2018-06-01,680920552,A016040,포도,씨없는 청포도 2kg 탐슨시들러스,13900,13900,0
2018-06-01,1488485491,A011160,빵,코리원/새롬푸드 슈가파우더 3kg/케익/베이커리/빵,5700,5600,-100
2018-06-01,1234553595,C011030,남자학생복,오버핏 후드집업가디건 is172-001 남성캐쥬얼 캐쥬얼,40850,40040,-810
2018-06-01,236173628,L021010,손목시계,Nibosi 남성 메탈 손목시계 크로노기능 No.2313블랙,59900,59900,0
2018-06-01,1980713455,C014010,아동복,펑키 로봇 후드 티셔츠(3-24개월)201965 티셔츠 유아,13340,13340,0
2018-06-01,1220303598,E031020,가스레인지,[SK매직][신세계백화점] [무료설치] SK매직 9+1 3구 하이라이트 전기레인지 ERAF305E,445000,415660,-29340
2018-06-01,1778650985,E011030,거실장,레이디가구 글로리 전체 LPM 거실장 1200 1800 TV다이,75160,67650,-7510
2018-06-01,983622426,F012010,종이기저귀,하기스 매직기저귀 2단계 여아용 (64P),23800,17900,-5900
2018-06-01,1180778609,C013050,운동복,228_고구마베이비 아기옷-무형광 하마 끈 민소매 상하,10910,10590,-320
2018-06-01,554579033,C013050,운동복,트레이닝복세트구성/여름츄리닝복/반팔 반바지운동복,18900,18900,0
2018-06-01,1741707403,L021050,우산,F563- 오토바이우비 퀵 mc1000 제비표 비옷 우의 우비,31800,31800,0
2018-06-01,94590514,A022020,두유,삼육두유 검은콩 칼슘 두유 195ml X 60팩,28900,28900,0
2018-06-01,385561524,C012030,여자상의,마 끈나시 원피스 NN2231M805 빅사이즈,41000,38540,-2460
2018-06-01,1943931646,A016150,아몬드,[백세식품] 페루산 사차인치 1kg 18년5월 통관제품,37900,37900,0
2018-06-01,2084015601,C012060,여자내의,다니엘 카라 롱자켓- 카라자켓 원피스자켓 롱자켓 롱,51400,43690,-7710
2018-06-01,1755587909,I053040,기타문구,북유럽에서 온 신기한 포스트잇 마그네틱 노트/패드,2800,2250,-550
2018-06-01,498410884,C012060,여자내의,A_라인 랩 스커트 미니,25450,24690,-760
2018-06-01,775128008,A018070,파이,롯데 초코파이420gx8개/몽쉘/오예스/간식/과자/초콜릿,15900,15900,0
2018-06-01,1819823713,L012030,칫솔,2080 유아/어린이 칫솔 x12개/3~5세/6~9세,13900,13900,0
2018-06-01,889183004,E031080,선풍기,PTC 중형 히터 LE-5323P [24시간 타이머 / LED디스플레이 / 리모컨],79000,79000,0
2018-06-01,889183003,E031130,보온매트,하이메이드 극세사요 HM-C150W [ 더블 / 9단계 온도조절 / 무전자계 EMF인증 / 미끄럼 방지 ],60450,60450,0
2018-06-01,896668176,A012030,돼지고기,E-국내산 냉장 돈 앞다리 찌개용 100G,1590,1190,-400
2018-06-01,897705094,E061080,키친타월,[유한킴벌리]유한킴벌리)크리넥스안심키친타올120매*4,3200,3200,0
2018-06-01,896668174,A012010,국산쇠고기,E-한우 1등급 양지 국거리용 100G,7990,5871,-2119
2018-06-01,309982742,A018070,파이,오예스336gx4곽 카스타드 초코파이 몽쉘 간식 과자,11900,11900,0
2018-06-01,513518356,C013020,티셔츠,[빈폴아웃도어]블랙 여성 브이넥 실켓 티셔츠 (BO8342C045),49000,38710,-10290
2018-06-01,1018727379,E011020,침대,인쏘노 싱글침대 : 침대프레임 매트리스 베스트 특가,150000,138570,-11430
2018-06-01,895835048,L012060,샴푸,댕기머리 명품샴푸 500ML,27900,9900,-18000
2018-06-01,896668179,A012030,돼지고기,E-국내산 냉장 돈 앞다리 보쌈용 100G,1590,1190,-400
2018-06-01,1231742015,C012060,여자내의,밴드시보리 스판 기모바지 JE-2890 캐주얼의류,7010,7010,0
2018-06-01,989073100,A013150,어묵,CJ 삼호어묵 오색어묵탕 395G,4490,3490,-1000
2018-06-01,1665847480,A016070,귤,[물건팜] 제주감귤 천혜향 특품 선물용 6kg/제주귤/제,78530,78530,0
2018-06-01,1009832937,E021020,커튼,[더자리] 활용도UP!에코항균 여름이불/스프레드,10900,9940,-960
2018-06-01,1509790445,A012050,소시지,돈육같은 식감 프랑크 닭가슴살 소시지 3종 (120g*1팩)/ 아임닭,2350,2350,0
2018-06-01,440060772,L012010,면도기,안티프라그 여행용세트/칫솔치약/치약칫솔/칫솔/치약,700,700,0
2018-06-01,454478616,C012060,여자내의,트임에이치스커트 MYD_1712 니트스커트 니트치마 패션,17930,17930,0
2018-06-01,75767322,E031010,전기밥솥,CRP-P1010FD/쿠쿠/10인용/풀스텐/음성/GH,162600,149500,-13100
2018-06-01,684344067,F011150,건강기능식품,락피도엘 락피도 유산균 60포 70포,34900,34900,0
2018-06-01,385776493,I011030,사진기,(컴온탑)니콘정품 D750 BODY (18년3월/캐시백),1542390,1419000,-123390
2018-06-01,620522937,L021020,장신구,스와로브스키스톤 귀걸이 이어링 귀고리 은침 비즈 실버 유색 실버침 악세사리 패션쥬,11700,11350,-350
2018-06-01,631106457,C013020,티셔츠,엄마옷티셔츠 중년여성 빅사이즈 할머니아줌마 60대,29800,29800,0
2018-06-01,509324505,C012040,여자학생복,[2ME][2ME] 훌 가디건 TMCK82501C,59900,52120,-7780
2018-06-01,1554099444,C012060,여자내의,청치마/청스커트/데님스커트/롱스커트/플레어스커트,24900,24900,0
2018-06-01,1049736567,C012040,여자학생복,[제쉬나인][제쉬나인]쉬폰페이즐 로브 가디건,24300,21870,-2430
2018-06-01,1017622891,C021020,구두,[루플랫] 1326813 (해외) 18SS 크리스찬 루부탱 그레고 스웨이드 옥스포드 슈즈,832900,718100,-114800
2018-06-01,2108550431,C014010,아동복,[남아남방셔츠]티셔츠 긴팔와이셔츠 카라티 주니어17,27900,27900,0
2018-06-01,391708461,C013040,청바지,[클라이드앤][클라이드앤] 데님 다크블루 오버롤 멜빵 숏팬츠(CIBOR711F)#소녀감성#러,69800,59330,-10470
2018-06-01,1017622889,C021020,구두,[루플랫] 1326812 (해외) 18SS 크리스찬 루부탱 소피터 트레드 솔 레더 더비 슈,1016900,876790,-140110
2018-06-01,1691950712,A019160,밑반찬,베르껭 과일 맛 소프트캔디 1908g 베르깽 / 코스트코,20170,20170,0
2018-06-01,1214143376,C013050,운동복,식물성 에탄올 워셔액 1박스 1.8L X 12EA,18200,16750,-1450
2018-06-01,1558474895,C012020,원피스,[비지트인뉴욕]후드 더플 코트(VTBHCG1),74500,70780,-3720
2018-06-01,1547588748,C012040,여자학생복,[제쉬나인][제쉬나인]심플 브이넥 5부 니트반팔니트,17600,15840,-1760
2018-06-01,1469940558,A013070,굴,(맛나)박스/홍새우살(70-100)220g*10,55800,50220,-5580
2018-06-01,1518518643,A013130,오징어채,정화 버터진미 오징어 ( 채 ) 30g x 5.,22060,19640,-2420
2018-06-01,1597271376,F011130,홍삼,정관장 홍삼정진 DUALSET,128000,128000,0
2018-06-01,2104417870,C013010,점퍼,빅사이즈 야상 피쉬 오버코트 야상바람막이점퍼남자,117440,117440,0
2018-06-01,912361829,C021040,실내화,테안스 단화AL032 F05 2컬러 스니커즈 단화 슬립온,28650,21490,-7160
2018-06-01,398402965,C013010,점퍼,장수 LED 4등기구 60W,61190,61190,0
2018-06-01,286502207,F012010,종이기저귀,[최저가] 일본내수용 메리즈기저귀 밴드형L(54매) 4팩,61900,61900,0
2018-06-01,2128658315,A011010,쌀,17년 햅쌀/김제 공덕농협 그린숯미10kg(백미)/신동진,26900,26900,0
2018-06-01,897502382,A015020,식용유,[해표]해표 대두유 1.5L,6600,6600,0
2018-06-01,897502380,A015020,식용유,[해표]해표 옥수수유 1800ml,6900,6900,0
2018-06-01,719646376,C021040,실내화,나이키 에픽 리액트 플라이니트 AQ0067-002,169000,169000,0
2018-06-01,1404684617,E061040,부엌용세제,메소드 주방세제 리필 800ml x 4개 외,9900,9900,0
2018-06-01,988986640,A018070,파이,롯데 명가찰떡초코 375G,4800,2400,-2400
2018-06-01,341198880,I031040,생화,더 넓어진 고급 광폭 캠핑테이블/캠핑용품 모음전,50000,28890,-21110
2018-06-01,1122679302,E041010,식기,루미낙 루미락 나뭇잎 접시24중6p,42200,40090,-2110
2018-06-01,1308674002,C012040,여자학생복,[레코브]블라썸 가디건(LU3186CD508X)(하남점),31800,26220,-5580
2018-06-01,1743217793,E061020,섬유유연제,F C 베이비전용 섬유유연제 bottle 아기 세탁 유아 세,21730,21300,-430
2018-06-01,1425624572,C013050,운동복,야토 자동차 루프백 NW300L RV용 캠핑 가방 캠핑용품,86070,78400,-7670
2018-06-01,1417775795,D031010,주택수선재료,리베론피니싱오일250ml/가구보호오일,18000,18000,0
2018-06-01,896668142,A012030,돼지고기,E-국내산 냉장 돈 목심 보쌈용 100G,2490,2183,-307
2018-06-01,1112409967,E061020,섬유유연제,F C 베이비전용 세탁세제 refill 유아세제 유아세정제,22210,22210,0
2018-06-01,615866536,C013050,운동복,레이싱카플래그 자동차 문콕방지 도어가드 4P,9510,9510,0
2018-06-01,1068737370,E011020,침대,조타 저상형 수납/원목 사각 침대프레임 수납형,94000,94000,0
2018-06-01,1651695493,A022020,두유,서울대공동개발 배로 맛있는 약콩두유 190mlx24팩,20900,20900,0
2018-06-01,1812647155,A016160,과일가공품,[베리필드]A등급 아이스 블루베리2kg(1kgx2ea),16000,15520,-480
2018-06-01,77241756,C013010,점퍼,[크루클린]남녀공용후드집업/기모/오버핏/맨투맨/무지,19800,13800,-6000
2018-06-01,896668148,A012010,국산쇠고기,E-한우 1등급 설도 불고기용 100G,6500,2992,-3508
2018-06-01,889183002,E031130,보온매트,하이메이드 극세사요 HM-C100W [ 싱글 / 9단계 온도조절 / 무전자계 EMF인증 / 미끄럼 방지 ],63000,63000,0
2018-06-01,58937305,E041070,밀폐용기,스텐 큐브 김치통 모음/4.7~11.2L/밀폐용기/사은품,34100,34100,0
2018-06-01,112363336,C012040,여자학생복,마조끼 여름썸머린넨지퍼자켓롱베스트 빅사이즈조끼,25900,25900,0
2018-06-01,889183000,E031080,선풍기,한일 헬로키티 이동형 미니 탁상용 전기 온풍기 히터 HEF-600HK [PTC 세라믹 히터],39000,39000,0
2018-06-01,528827405,L021030,가방,30%쿠폰! 오르비 여성가방/에코백 2018 S/S 특가세일,10000,9900,-100
2018-06-01,713367553,C012060,여자내의,컨택유 슬릿 마가렛 린넨 스커트 #5744/ 컨택유,34400,27180,-7220
2018-06-01,2083172616,C013010,점퍼,스테판조셉 프린티드 레인코트 인어공주B (택1) /(참,86800,76390,-10410
2018-06-01,830340860,F011150,건강기능식품,산과들에 21가지 곡물 함유 바른생활미숫가루 2.1kg,10900,10900,0
2018-06-01,350310905,C013010,점퍼,T2137-여성 데일리 보송 후리스 반 집업 양털집업 포,49420,49420,0
2018-06-01,537989116,C013010,점퍼,빅사이즈 DCH1594 심플 투버튼 자켓 803S 빅사이즈 여,75050,75050,0
2018-06-01,895683957,A016060,감,참외 (2KG/박스),19900,19900,0
2018-06-01,331744914,C012040,여자학생복,[메이비베이비] Source (nb) -3colors,44500,44500,0
2018-06-01,434811459,A012050,소시지,하림 요리 비엔나 1kg x 2개/칼집낸/참맛/후랑크/햄,10300,10300,0
2018-06-01,371673516,L021020,장신구,초커목걸이 체인초커 가죽초커 레이스초커 태슬초커 F,12950,12950,0
2018-06-01,886687441,C021040,실내화,아디다스 키즈 스포츠패션/반팔티/반바지/운동화,19900,19900,0
2018-06-01,2143307439,E061030,전구,LED바/국산5050칩/LG칩/12V 24V 5V/50cm/PCB LEDbar,2330,2300,-30
2018-06-01,802396971,A016030,복숭아,산초가루(금하 40g)/산초 산초가루 산초분말 산초파우,2880,2710,-170
2018-06-01,390963926,C013050,운동복,푸조 남여공용 니트 트레이닝 세트(FZ133-3) 트레이닝,65310,65310,0
2018-06-01,1354307307,C013020,티셔츠,심플 후드집업 LLTT0042 후드집업 트레이닝복,24820,24330,-490
2018-06-01,276844088,E061010,세탁세제,(10.5kg+10.5kg) 슈퍼크린X2개/스파크/가루/세탁세제,12500,10900,-1600
2018-06-01,2078538597,F012020,생리대,[화이트] 화이트 입는 오버나이트 대형 8pX2개 팬티형 생리대,18900,18900,0
2018-06-01,896274756,A017110,감자,국내산 흙당근-5kg.10kg.20kg,24900,24900,0
2018-06-01,671062657,A012010,국산쇠고기,축협 1등급 구이 한우선물세트 1.8kg 등심+채끝+안심,240000,237600,-2400
2018-06-01,1283908460,L021020,장신구,꽃디자인 침귀걸이/양장형/시그니티세팅/jc,240000,240000,0
2018-06-01,440290688,A018090,잼,오뚜기 블루베리잼500gX12개(1박스)잼 블루베리잼 포,139200,122500,-16700
2018-06-01,1088871204,E011030,거실장,[채우리] 나나 라운드 접이식테이블,75000,75000,0
2018-06-01,2104381324,C012030,여자상의,여성 스텔라 골지 V넥 니트V넥 니트니트골지니트여자,57980,57980,0
2018-06-01,163529901,C021040,실내화,바니걸 7cm 키높이 통굽 운동화 스탠딩콘서트 데일리,34000,34000,0
2018-06-01,1088871202,E011030,거실장,[채우리] 나나 원형 접이식테이블,87000,87000,0
2018-06-01,715396,C011030,남자학생복,봄신상 체크남방/체크셔츠/헨리넥/남자남성셔츠난방,10900,8900,-2000
2018-06-01,620314403,C013010,점퍼,[캣츠원피스]봄자켓 블루종 네오프렌,25800,24510,-1290
2018-06-01,207561061,C013020,티셔츠,[앨빈클로]고퀄리티 무지 후드집업 후드티 맨투맨 티,29000,19900,-9100
2018-06-01,376301192,C013010,점퍼,[코코애비뉴][코코애비뉴]트렌드롱무스탕_71201,192500,184800,-7700
2018-06-01,1309507226,A017170,풋고추,맛있는 오이 5kg 10kg 20~30과내외,13900,13900,0
2018-06-01,1005237001,L021030,가방,[LAP X 현대백화점] 심플 숄더백 AJ2ABS6M (AH4ABF6E 리오더),44100,38810,-5290
2018-06-01,440289663,A015020,식용유,(무)해표 포도씨유900mlx12개(box)카놀라유 포도씨유,116200,102260,-13940
2018-06-01,1747340512,C012060,여자내의,핏예뻐 입는순간 반해~세련된 여성 슬랙스 S~빅사이즈,27800,27800,0
2018-06-01,1530564334,C012020,원피스,MELODY F3 아이보리/코트/여자코트/겨울코디/겨울코트/자켓/점퍼 미국 여성토탈브랜드,54700,54700,0
2018-06-01,391466032,A016110,딸기,풀무원/아사이/베리/수퍼베리/80mlx30포/폴리페놀/,90000,90000,0
2018-06-01,559549674,E021020,커튼,워싱이 좋아! 선염 면 워싱커튼 거실 안방 침실 커튼,21800,21800,0
2018-06-01,300170739,C013050,운동복,신상/트레이닝세트/와이드팬츠/단가라/레이어드,24800,24800,0
2018-06-01,1308399434,C013020,티셔츠,미키티/원피스형롱티/루즈핏박스티/롱원피스티/반팔,7900,7900,0
2018-06-01,2020321582,A014050,달걀,두레생협 올레길깐볼(250g/제주),17410,17410,0
2018-06-01,896668111,A012030,돼지고기,E-국내산 냉장 돈 목심 (구이용/100G),2490,2183,-307
2018-06-01,896668117,A012030,돼지고기,E-국내산 냉장 삼겹살 (보쌈용/100G),2490,1571,-919
2018-06-01,116461117,C013050,운동복,자동차 성에방지커버/유리/보호/성에제거기/차량용,4900,4900,0
2018-06-01,1538869454,A021010,커피,맥심 아이스 커피믹스160T/220T,23500,23500,0
2018-06-01,896668115,A012010,국산쇠고기,E-한우 1등급 앞다리 불고기용 100G,6500,2992,-3508
2018-06-01,1540112077,C011050,남자내의,지오다노 여 버뮤다 숏 407501,11050,11050,0
2018-06-01,1364053643,A013160,맛살,도매 이게조아F 540gX5 게맛살 크래미,44500,44500,0
2018-06-01,1218733040,E031140,비데,{사은품 증정} 노비타 스마트 비데 BD-AE500,189000,189000,0
2018-06-01,259561740,C013020,티셔츠,[하프클럽/르오트]데일리 슬럽 피그먼트 티셔츠 4종택일,3900,3710,-190
2018-06-01,1943101440,A013090,전복,(맛나)참소라(슬)200g,8700,7830,-870
2018-06-01,691469562,A012010,국산쇠고기,축협 1등급 갈비선물세트 2.4kg 한우갈비 한우선물set,205000,202950,-2050
2018-06-01,1455329124,C013010,점퍼,봄여름 항공자켓 남녀공용 항공잠바 간절기 자켓,29900,29900,0
2018-06-01,151544329,A012040,닭고기,[허닭] 닭가슴살 32종 골라담기!금액대별 사은품 증정,1450,1450,0
2018-06-01,88792987,C011030,남자학생복,[MLB]엠엘비 2종택1 남여공용 하이넥 경량퀼팅 MLB 조끼(31VTC1811),90300,76760,-13540
2018-06-01,963180991,E021010,침구,겨울왕국 면기모 패드 - 뷰티선샤인 (064187) 까는이,60730,54200,-6530
2018-06-01,2005552160,F012020,생리대,릴리안 팬티라이너슈퍼롱40px5팩/최대240매+사은2가지,12500,12500,0
2018-06-01,1910358871,C013010,점퍼,JJ지고트 레이스 여름점퍼 GH5A0JP50,41160,41160,0
2018-06-01,2143789064,A017100,당근,알타리 5Kg내외,18970,18970,0
2018-06-01,1096024860,E031080,선풍기,코멕스_ 욕실난방기 3구 CM-T30,49800,49800,0
2018-06-01,1096024861,E031130,보온매트,한일의료기_전기장판 한화 소나무(대_분리난방),143000,143000,0
2018-06-01,148303959,A018110,물엿,왕비천하늘 수수조청 600g/국내산/전통방식/울진/명인,24900,24900,0
2018-06-01,1267645193,C013020,티셔츠,아스토레 골프 반지퍼티셔츠 NA LSTM10015 골프캐쥬얼,74460,74460,0
2018-06-01,1394684104,C013010,점퍼,더블버튼 누빔 롱코트 예쁜여성코트 DM-4042,109800,104310,-5490
2018-06-01,2143789069,A017100,당근,알타리 5Kg내외×2박스,34040,34040,0
2018-06-01,896668108,A012010,국산쇠고기,E-한우 1등급 목심 국거리용 100G,6500,2992,-3508
2018-06-01,1778141290,A016120,바나나,[hm] [바나나케이스] !!바나나통 바나나도시락 용기 과일용기 일본히트상품 아이디어상,3000,2970,-30
2018-06-01,896668109,A012030,돼지고기,E-국내산 냉장 삼겹살 (구이용/100G),2490,1571,-919
2018-06-01,285360268,C014020,유아복,엠보도트 레깅스 유아레깅스 유아레깅스 유아바지 아,5390,5230,-160
2018-06-01,1010351406,A019170,냉동식품,CJ 비비고 새우볶음밥 630G,7990,6990,-1000
2018-06-01,336146932,C014010,아동복,어린이 방한 마스크 MV0086 캡틴아메리카,8720,8720,0
2018-06-01,898538160,A011120,두부,동서 포스트 오곡코코볼 570G,5990,5990,0
2018-06-01,820983465,C011050,남자내의,905/레이스자수호피 허리 고무밴딩 스프사 9부 파자마,12640,11250,-1390
2018-06-01,1321433952,A017020,상추,홍빛적치마상추씨앗 3g,1000,1000,0
2018-06-01,1096024859,E031080,선풍기,코멕스_ 욕실난방기 2구 CM-T20,39800,39800,0
2018-06-01,1509439292,A015020,식용유,[사조해표]해표 포도씨유 900mlx2병+카놀라유900mlx2병 (총4병),11800,11800,0
2018-06-01,1401920155,I012010,컴퓨터,[특가 153만] 무료퀵 삼성노트북 Pen NT930QAA-K58A,1735780,1649000,-86780
2018-06-01,1468171694,C013010,점퍼,캡스록 여성 초경량 바람막이 자켓(CSR-4025) 여성바,34390,34390,0
2018-06-01,1349137690,A011010,쌀,2017년농협햅쌀 섬진강메뚜기쌀20kg/신동진쌀/10+10kg,50900,50900,0
2018-06-01,152125335,A013070,굴,와이에스 냉동절단꽃게M 450gx12개,62160,62160,0
2018-06-01,848614290,C013010,점퍼,[데일리씨스터즈][데일리씨스터즈] 포인트 자수 유니크 패치 블루종 항공 점퍼 자켓,36800,34960,-1840
2018-06-01,765558927,F011130,홍삼,[선물세트] 인삼명장 김정환홍삼정 240g,159000,159000,0
2018-06-01,530507912,C012060,여자내의,허리조절 기모 스판 교복치마 차콜 교복 예쁜교복 교,49840,48350,-1490
2018-06-01,985408865,L012040,치약,[LG]LG 페리오토털7 스트롱 90G,1000,1000,0
2018-06-01,351611518,A012030,돼지고기,100% 세보데깜보 이베리코 흑돼지 꿀목살 1kg,26500,26500,0
2018-06-01,1121657708,E031020,가스레인지,2구/가스렌지/자동불꽃센서/가스레인지/RT-1004J,110000,102600,-7400
2018-06-01,502836790,E041050,냄비,델티 통 3중 스테인레스 편수 냄비 16cm 가정용냄비,47830,47830,0
2018-06-01,364895473,C012040,여자학생복,[모다아울렛][나인스텝]N18NJ8224(세로무늬 슬릿로브가디건),39000,35490,-3510
2018-06-01,314912733,I031010,장난감,벤츠/벤틀리/슈퍼윙스/자동차/포크레인/붕붕카/자전거,39900,39900,0
2018-06-01,1107191786,A022050,탄산음료,코카콜라185ml 캔 조지아 칠성사이다 미니캔 탄산음료,6900,6900,0
2018-06-01,292918805,C013020,티셔츠,[레드페이스] 쿨사각메쉬요꼬칼라하프티셔츠 REWMTSM18210/ 레드페이스,29000,24940,-4060
2018-06-01,886830117,E031010,전기밥솥,CRP-JHR0620FD 쿠쿠 6인용 IH압력밥솥/전기밥솥/ens,379000,348590,-30410
2018-06-01,29284749,C013010,점퍼,[BANG BANG][뱅뱅] 여성 배색프린트 홑겹 점퍼,15000,14250,-750
2018-06-01,556680339,C013010,점퍼,AG 가죽자켓 라이더자켓 가죽점퍼 P173 남성용라이더,96160,96160,0
2018-06-01,197372489,C012060,여자내의,RT5 언발란스 쉬폰스커트 JE-2568 치마 롱치마 스커트,11500,11270,-230
2018-06-01,989073193,A022010,주스,롯데 콜드(오렌지)기획 950ML*2,4980,4980,0
2018-06-01,989073192,A014040,발효유,덴마크 비플레인QUARG 450G,2500,2500,0
2018-06-01,139910425,A011140,부침가루,두레생협 호두타르트(60g 2개),15000,14550,-450
2018-06-01,650813044,E031140,비데,[2만원추가할인]블루밍 리모컨 방수비데 ICON-R321,169000,169000,0
2018-06-01,280009985,C013050,운동복,K-345 스타렉스 2004후사경 후사경커버 차량후사경커,24720,22530,-2190
2018-06-01,579849201,E041010,식기,한국도자기 생활반상기 세트 예단무료포장,240000,240000,0
2018-06-01,747714995,A022050,탄산음료,롯데칠성몰 탄산 트레비 300mlx20펫(라임/자몽),11900,11900,0
2018-06-01,910456657,E011040,소파,레이디가구 엠버 2인 용 소파 패브릭 가죽 쇼파,117200,105480,-11720
2018-06-01,1455236841,C013020,티셔츠,(4926상)랩스타일 산전산후 수유가능한 면스판 임부상,17810,17810,0
2018-06-01,1427408980,A018070,파이,파이/초코파이/몽쉘/오리온후레쉬베리/오예스카스타드,2400,2400,0
2018-06-01,271197824,E061030,전구,최저가 LED전구 볼전구 형광등 LED램프 전등 LED조명,1120,1120,0
2018-06-01,334805923,C013040,청바지,남자 스판 청바지 밴딩바지 스키니진 찢청 조거 데님,21800,17800,-4000
2018-06-01,1503690346,C014010,아동복,[베네통키즈]QATSY5831 (박스포인트크롭티셔츠) 100~155,21000,16800,-4200
2018-06-01,1468531249,A012010,국산쇠고기,[무항생제] 불고기샤브샤브 300g 2등급,15300,15300,0
2018-06-01,886085007,C013020,티셔츠,빅사이즈 롤업심플스판폴라티 WW03609 빅사이즈 미시,8330,8330,0
2018-06-01,853860484,A013100,마른멸치,[농부마음]산지직송 완도산 꼬마 활전복 1kg(45-60미)[갤러리아],21900,21900,0
2018-06-01,1504486048,L012060,샴푸,[바닐라블라썸] 단백질 샴푸/트리트먼트/에센스 1+1+1,10900,10900,0
2018-06-01,1602925039,C013010,점퍼,Vintage 야상 자켓/여성 S/밀리터리/점퍼/중고 구제,25000,25000,0
2018-06-01,1802465949,L012060,샴푸,하수오 한방 두피케어 대용량 쿨샴푸 1500g X 2개,16900,16900,0
2018-06-01,198612907,C013020,티셔츠,[러브앤쇼]브이넥언발티셔츠802-T003[갤러리아],38000,32300,-5700
2018-06-01,1172751807,A021010,커피,베트남커피ARCHCAFE/아치카페/콘삭/consoc/코코넛커피,6200,6200,0
2018-06-01,520499469,A019030,생강,적초생강 (참존 1.2k) X10,41770,37180,-4590
2018-06-01,648033736,F012010,종이기저귀,킨도 독일 프리미엄 기저귀 밴드형 4단계 (48매x3팩),50700,50700,0
2018-06-01,488081934,E041010,식기,결혼기념/선물/부부화합/대박재물/풍수지리/인테리어,167400,164060,-3340
2018-06-01,496961244,C012040,여자학생복,MJ_1221 카키 양털 조끼 여성털조끼 양털조끼 남여공,30370,30370,0
2018-06-01,3014403,A022010,주스,[보해] 보해 매원 1.5L,5900,5900,0
2018-06-01,858500582,I053040,기타문구,트레이드원) 크라프트지 포스트잇 멀티 노트,1000,980,-20
2018-06-01,1675828139,C013040,청바지,[버커루(브이아이피)]남여공용 SPAN 밴딩 배기팬츠 바지(B172PT475P),30000,24600,-5400
2018-06-01,402985866,I031070,애완동물관리비,브론슨 미니당구대 시리즈 (실전연습용),470000,415950,-54050
2018-06-01,1472247828,E061080,키친타월,모나리자 각티슈 24개 1BOX 곽티슈/사각티슈/크리넥스,19500,19500,0
2018-06-01,895860069,E061030,전구,[GE삼성]에디슨프리미엄콤팩트25W주광2입,19200,19200,0
2018-06-01,789248780,E061080,키친타월,업소용 흡수패드 box 4종/ 정육용 흡수패드/드라이록,113500,113500,0
2018-06-01,1268598565,C013040,청바지,[루미씨] 데미지 컷팅 슬림 데님,36000,32800,-3200
2018-06-01,452163164,C013050,운동복,다용도 비상망치 후레쉬 차량용품 손전등 자동차안정,12480,11380,-1100
2018-06-01,1385739726,C013010,점퍼,ACC 필골드 SL1003 프리미엄 프린트 네오프랜 블루종,56640,56640,0
2018-06-01,1641962119,C011050,남자내의,미키정품/냉감바지/쿨팬츠/여름바지/냉장고/남자,7900,7900,0
2018-06-01,1437811625,C013030,스웨터,MTSSF18013 지구촌 후드 남자후드 남성용후드티셔츠,40580,40580,0
2018-06-01,1428239400,C014020,유아복,아둘 패밀리룩 가족티 FLORIDA 56 유아반팔 티셔츠 11,9600,9500,-100
2018-06-01,440946091,C012040,여자학생복,[위쉬몰]BG 시스루 소매 가디건(2051H805),42840,37760,-5080
2018-06-01,955280560,E011020,침대,인쏘노 패밀리침대 스너그온 + 전용 패드 증정 (Q+SS),510570,510570,0
2018-06-01,839261775,L021030,가방,리바케이스 8550 17.3인치 노트북가방/숄더/서류가방,59000,57820,-1180
2018-06-01,423349537,A019090,카레,카레(매운맛 SB 240g)X60,420580,420580,0
2018-06-01,1010410248,L012090,기초화장품,베비언스 베이비 선크림 60ml (핑크퐁),14900,8900,-6000
2018-06-01,174320324,A022050,탄산음료,환타 오렌지 파인애플 600ml x24pet,29300,29300,0
2018-06-01,988962649,E061100,습기제거제,샤프란 꽃담초 섬유탈취제 복숭아향 400ML,6900,3300,-3600
2018-06-01,54058887,G011070,자전거,삼천리 나비드IRO/MTB 접이식자전거,248000,223200,-24800
2018-06-01,1150613046,C012020,원피스,[플러스에스큐]더블 하프 코트(LU1HC01),69900,66410,-3490
2018-06-01,1368521322,A011030,찹쌀,국산 보리쌀 4kg모음/국내산 보리 무료배송,10800,10800,0
2018-06-01,183744081,C013040,청바지,[저스트원] 봄신상/스키니/청바지/배기/자체제작,22900,18900,-4000
2018-06-01,1353057546,D031010,주택수선재료,모아코트 만능우레탄 1.6L 욕실 타일 화장실 페인트,24800,24800,0
2018-06-01,568506536,E011060,의자,[시니프]로보의자/책상의자/학생의자/아동의자,74600,67140,-7460
2018-06-01,292037116,C012040,여자학생복,크로커다일레이디 여성 마름모프린트 블라우스 CL7MBL116,46550,46550,0
2018-06-01,555055830,F012010,종이기저귀,군기저귀 슬림앤드라이 밴드/소프트 팬티 6팩 모음,46900,46900,0
2018-06-01,445517015,C012020,원피스,체크 옆트임 코트 (Z174MSG527)/ 쥬크,219000,186150,-32850
2018-06-01,445517014,C012020,원피스,A라인 더블 버튼 코트(Z174MSG525)/ 쥬크,219000,186150,-32850
2018-06-01,1500053723,A012010,국산쇠고기,찜갈비세트1호 3.5lg 한우찜갈비세트 한우2등급갈비,537800,537800,0
2018-06-01,2039957325,I011020,영상음향기기,PJM-1500W 가성비굿! USB연결 빔프로젝터 미니빔,98000,98000,0
2018-06-01,1731976168,C014020,유아복,조단 아기 아동 나시상하세트 패밀리룩 민소매 반바지,16000,16000,0
2018-06-01,1318491279,C011050,남자내의,[쇼타임] PR.9부쿨린넨팬츠 남자 남성 여름 마바지 밴딩,19800,19800,0
2018-06-01,1154054895,C012060,여자내의,블랙 허리라인 플레어 스커트 (VQSAB2301)/ 이사베이,29000,26100,-2900
2018-06-01,1530588390,C012020,원피스,MELODY F101 아이보리/코트/여자코트/겨울코디/겨울코트/자켓/점퍼 미국 여성토탈브랜,64700,64700,0
2018-06-01,1201652854,A018020,사탕,멜랜드 디저트캔디3kg/2.3kg/업소용/사탕/고객홍보,10000,9900,-100
2018-06-01,350958226,E031120,믹서,[쇼특]일렉트로룩스 블렌더 EBR7804S,112800,104910,-7890
2018-06-01,445603531,C013020,티셔츠,베이직폴라티(블랙) 목폴라 심플 여성 목폴라 티셔츠,24480,24480,0
2018-06-01,1657470782,I011010,TV,55인치TV UHD TV LEDTV 삼성패널 돌비24W 직영AS 설치,535780,509000,-26780
2018-06-01,2007652999,C013010,점퍼,[구김스]구김스 176_ 플라이 후드 집업 자켓,89000,84550,-4450
2018-06-01,130787929,A018010,초콜릿,[초특가]abc초콜릿1박스 65g/200g 간식 초콜렛,20900,20900,0
2018-06-01,486931998,C012040,여자학생복,수지네 일본 빈티지 아디다스 베이지 조끼 여성 S 16-,21590,21590,0
2018-06-01,981852930,C013010,점퍼,르젠 후드레이어드 퀄팅 융털 가죽자켓(LNPD278PR)/ 르젠옴므,62800,59660,-3140
2018-06-01,1010410271,L012090,기초화장품,보습 베이비 선 메탈쿠션 15g(핑크퐁),27500,14000,-13500
2018-06-01,885132148,I031040,생화,[콜맨] 컴포트 마스터 버터플라이 테이블 2000033137,143500,140630,-2870
2018-06-01,391804399,C013010,점퍼,아디다스 티로17 트레이닝자켓(BJ9294) 트레이닝자켓,73920,71710,-2210
2018-06-01,1928525765,C013020,티셔츠,MRBOB 신상 기모 후드티 후드집업 빅사이즈 M~3XL,24800,24800,0
2018-06-01,356159910,C013050,운동복,액티언 스포츠 리무진 콘솔박스 팔걸이 쿠션 차량콘솔,61430,55960,-5470
2018-06-01,151331897,C012040,여자학생복,44~100셔츠레이온면학생남방화이트빅사이즈무지유니폼,11900,11900,0
2018-06-01,1244750303,C013030,스웨터,남자 니트 라운드 꽈배기 엠보 보카시 기본 무지 울,24000,15800,-8200
2018-06-01,370901870,C013040,청바지,레깅스 골드 쓰리버튼 기모 가죽 레깅스 치마레깅스,41420,41420,0
2018-06-01,122336912,C011050,남자내의,[르젠(LeGEN)]르젠 베이직 링클프리 스판 9부/10부 슬랙스 2종 택1(LNPJ_SJ),14800,14060,-740
2018-06-01,1917157513,A018050,비스킷,맥비티 오리지날 다이제스티브 250g 통밀비스킷,1600,1600,0
2018-06-01,749197112,A011140,부침가루,삼립 치즈케익 480g/조각케익 (5입) 6가지/케이크,12000,12000,0
2018-06-01,411366508,C012040,여자학생복,빅사이즈 쉬폰배색조끼 IR1705 빅사이즈 여성의류 미,59000,57820,-1180
2018-06-01,1185337584,C013040,청바지,여아청반바지 구제숏 아동청바지,22800,22800,0
2018-06-01,119597331,A017250,고사리,[참맘] 냉동 브로콜리-1kg/브로커리 드라이아이스포함,3450,3450,0
2018-06-01,1431159495,G011070,자전거,[삼천리]접이식 여성자전거/미니벨로 바구니 자전거,120000,108000,-12000
2018-06-01,1034342008,A012060,햄및베이컨,청정원 참나무로훈연한 베이컨 1kg 청정원베이컨 냉동,46630,46630,0
2018-06-01,261322967,C013020,티셔츠,[블루페페]꽃자수 두겹블라우스[P172MSC050],50700,48170,-2530
2018-06-01,1235240592,C011020,남자상의,MJ_1138 베이지 더블트렌치 남자트렌치코트 베이지코,216140,216140,0
2018-06-01,1074141823,I053020,스케치북,1000 2000 스케치북 무선 종합장 모닝글로리 아트모아,490,430,-60
2018-06-01,101840969,E011020,침대,효암 흙침대 싱글 HM2000GS 3종모음/돌침대 황토침대,740000,690000,-50000
2018-06-01,1508067494,C013020,티셔츠,쿨라운드 빅사이즈- 코오롱 기능성원단-반팔 단체티 행사티 단체복 등산복.회사유니폼,7000,6900,-100
2018-06-01,1963028018,L021030,가방,윤스미스옴므+키홀더 비지니스 서류가방 크로스백,17900,17900,0
2018-06-01,896575884,A019080,고추장,[청정원]청정원 순창 초고추장 1KG,6690,3490,-3200
2018-06-01,424854378,E031140,비데,[본사직영점] 노비타비데 BD-CB387R /스테인리스노즐,219000,199000,-20000
2018-06-01,1126143664,A013080,조개,왕중왕 해물나라 900g2개,36190,36190,0
2018-06-01,1632537495,C012020,원피스,[쉬즈넘버나인]N17WCT012 마넷 체크 카라 코트,74800,71060,-3740
2018-06-01,1815808879,L021060,유모차,[엘르펀트 슈퍼조거 유모차] 휴대용유모차 삼륜유모차 신생아유모차 미니유모차 휴대유,238100,238100,0
2018-06-01,1208331348,C011050,남자내의,빅사이즈 남자/남성의류/바지/면/청바지/슬렉스,29800,29800,0
2018-06-01,1406468577,L021050,우산,여성레인코트 여자판쵸우의 여행용 비옷 골프등산우의,29000,28000,-1000
2018-06-01,1751030861,L021010,손목시계,Calvin Klein K5A31146 캘빈클라인 CK 여성 메탈밴드 패션시계,299000,299000,0
2018-06-01,1974482604,C013050,운동복,모비스 크루저 루프백 자동차캠핑용품 차량용캠핑용품,261900,238550,-23350
2018-06-01,987000470,A022020,두유,찬슬 삼콩두유/무첨가/분말 생두유/약콩/단백질쉐이크,19800,19800,0
2018-06-01,1812275175,I031040,생화,(무료배송) 폴딩파라솔/파라솔/야외/가든/캠핑,64000,58880,-5120
2018-06-01,862060663,L012030,칫솔,오랄비 크로스액션 프로엑스퍼트X10개/오랄비칫솔,18900,18900,0
2018-06-01,1361673198,A013070,굴,(주전부리)코주부육포 30g x 10봉,21900,21900,0
2018-06-01,862143617,C013010,점퍼,메쉬 집업 후드 점퍼 (CL7MTS911)/ 크로커다일 레이디,19000,17670,-1330
2018-06-01,987264563,A012010,국산쇠고기,[해밀농장]청정한우 1등급 명품정육세트2호 (불고기500g+국거리500g+사태500g),109900,86800,-23100
2018-06-01,1969405750,C014010,아동복,셀덴 199 앵커 바람막이 EDJA72301A,10000,10000,0
2018-06-01,398894282,C012040,여자학생복,여성빅사이즈/여성티셔츠/롱티/반팔티/후드티/박스티,20200,14900,-5300
2018-06-01,326488848,I031040,생화,3단 캠핑의자 간이침대 야외 낚시 캠핑체어 야전침대,23900,21280,-2620
2018-06-01,241705847,C011030,남자학생복,[앨빈클로] AZH-597K Determine 양면 양털 조끼,33900,33900,0
2018-06-01,1505092851,C013010,점퍼,후드 탈부착 경량자켓/바람막이/트레이닝복/여행/선물,13800,13800,0
2018-06-01,1398047223,A011020,현미,두레생협 찹쌀백미(2kg 유기) 찹쌀백미 백미 주방용찹,27530,27530,0
2018-06-01,371998660,C021040,실내화,정품 나이키운동화 150종 파격가/당일무료배송/나이키,65000,58180,-6820
2018-06-01,1866922004,E011050,책상,이지심플/우드책상/선반책상/L형책상/컴퓨터책상/책상,25900,25900,0
2018-06-01,440082093,C013050,운동복,아스토레 쉘 4 우븐자켓(D.OR)-레인자켓 우븐자켓 트,61140,61140,0
2018-06-01,1912212522,C012040,여자학생복,쿨젠.쉬폰나시블라우스 오프숄더.민소매.시스루린넨,27800,25800,-2000
2018-06-01,982551516,C013040,청바지,[게스]여성 블랙블랙 반바지(YI2D9951),58000,49300,-8700
2018-06-01,257318724,A012060,햄및베이컨,(냉동)CJ 쉐프솔루션 맛있는베이컨1kg CJ 쉐프솔루션,31080,31080,0
2018-06-01,1813831430,E021010,침구,[올리비아데코] 인기 차렵패드세트(Q) 20종 풀구성,69900,69900,0
2018-06-01,2056897413,A011170,떡,전북고창 울어매 모시잎송편(2팩) 복분자송편(2팩)/10,63640,63640,0
2018-06-01,1002071754,C015040,장갑,실버D 통기성이 좋은 성인용 매쉬 손싸게 어른손사께,57470,57470,0
2018-06-01,769294166,F011150,건강기능식품,은행마죽 버섯더덕마죽골드1.2kg아침식사대용 선식/미,16900,16900,0
2018-06-01,1601878811,C012020,원피스,[플리츠미] 큐브라 보리통 팬츠,69000,55200,-13800
2018-06-01,1011475946,F012030,안경,국내제작 메탈 안경 모음전 남자 여자 금속 안경테,11500,11300,-200
2018-06-01,1203399332,C013020,티셔츠,지오다노 01018501 반팔 피케 폴로(솔리드) 018501,15800,13120,-2680
2018-06-01,2050785336,A011160,빵,[무료배송] 삼립 냉동꼬마호빵6입X2봉/단팥/야채/우유,6900,6900,0
2018-06-01,370514605,C013050,운동복,[쇼타임] PR.9부슬림 트레이닝바지/츄리닝/추리닝/남자/남성,14800,14800,0
2018-06-01,2006843890,C012060,여자내의,서머리 냉감 통바지 DM-6358,11700,10420,-1280
2018-06-01,246357486,C012060,여자내의,파우더 벨트세트 가죽반바지 SD-5058 래더팬츠 가죽스키니 기모가죽바지 가죽바지 가죽,28140,25050,-3090
2018-06-01,1056129529,C014010,아동복,아둘 쥬니어 반팔티 랍바 핫팬츠 미키 상하세트 64,19100,19100,0
2018-06-01,1975349645,E011050,책상,발편한삼나무발판 책상발판 발받침대 책상발받침대 발,28810,28810,0
2018-06-01,490920014,A011140,부침가루,백설 컵케익 (쵸코) 55g,1860,1860,0
2018-06-01,379978965,E061060,살충제,바퀴벌레약 페스트세븐겔맥스포스셀렉트겔 끈3줄,12000,2500,-9500
2018-06-01,1015402765,C012040,여자학생복,수지네 빈티지 네이비패턴 오픈형베스트 여성 M 3-15,12080,12080,0
2018-06-01,602391760,C012040,여자학생복,LIST 여성 95 카라 블라우스 찰랑하늘하늘 여름 봄 짱,29610,29610,0
2018-06-01,313429879,C011020,남자상의,스타일멤버스 스트레치 쿨자켓 2종,89000,86000,-3000
2018-06-01,548804525,C011050,남자내의,(남자옷도매) DP-247 린넨마 ST팬츠 (S-XL) 베이지 패,32430,31460,-970
2018-06-01,784726882,C014010,아동복,[M.K] 한국 아기정장 블랙곰돌이 5종세트(3-36개월) 203121,80510,71660,-8850
2018-06-01,1947152716,C013010,점퍼,[모다아울렛][TBJ]TBJ (티비제이)여성 네오프렌 항공점퍼-T181JP710P,89900,85410,-4490
2018-06-01,1349367922,A013170,생선통조림,유동 고등어캔 (400g) x24,60000,60000,0
2018-06-01,517256075,C013010,점퍼,[보리보리/클랜씨]클랜씨 바람이 솔솔 집업점퍼 C744M034-RE,19350,13550,-5800
2018-06-01,477661414,F011150,건강기능식품,온가족용 프리미엄종합비타민미네랄330일분+휴대용기,26900,25560,-1340
2018-06-01,1432845506,E061060,살충제,알델리트]새집증후군/원인해결/알데히드 원천 제거제,35000,35000,0
2018-06-01,1570206983,A017090,열무,버섯세트/말린표고버섯/표고버섯채/백화고/명품2호/,79900,79900,0
2018-06-01,1975734192,I031040,생화,한양MSL 정품 캠핑 다용도 야전삽 휴대 비상용 멀티삽,22900,21070,-1830
2018-06-01,984490151,A018040,아이스크림,쿠키오 10개,12000,7000,-5000
2018-06-01,1382410389,C015040,장갑,남녀공용 패션 프리미엄 털장갑 AG1716018 고급장갑,17720,17720,0
2018-06-01,422923370,C013050,운동복,우먼스 ZNE 후디 2 LS 블랙 트레이닝점퍼 스포츠집업,152200,149160,-3040
2018-06-01,2109299778,E061060,살충제,효과①위 개미약/맥스포스퀀텀/바이엘공식대리점!!!,9900,5700,-4200
2018-06-01,1825358602,A017110,감자,장흥표고_분말세트1호건강식품 명절선물세트 특산품 추석선물세트 효도선물 표고세트,42170,42170,0
2018-06-01,1135435528,C013050,운동복,유비콘솔박스 중 차량용 트렁크콘솔박스 트렁크정리함,19730,19140,-590
2018-06-01,522906155,A015020,식용유,무배)올리타리아 엑스트라 버진 올리브유1Lx2병/오일,25000,25000,0
2018-06-01,343725330,A017170,풋고추,국내산 둥글레 결명자 / 볶은둥글레차 볶은결명자차,6500,6400,-100
2018-06-01,502077006,A022030,생수,풀무원샘물 500ml x40개/20개 생수/퓨어라이프 500ml,11600,11600,0
2018-06-01,703602691,E031130,보온매트,한일의료기 한일꽃잠 절전형 프리미엄 온열매트 모음,150000,128000,-22000
2018-06-01,2000057557,C014010,아동복,아둘 가족티 쥬니어 옐로우 페미니스트 반팔티 28,9600,9500,-100
2018-06-01,744219493,C012030,여자상의,[여름신상]XL까지~정장원피스/빅사이즈/하객룩/정장,14800,14800,0
2018-06-01,2016356993,L021030,가방,유니크한 력셔리 맥북백 포켓형 노트북가방 넷북가방,36000,36000,0
2018-06-01,1690551641,C011030,남자학생복,[빅브라더]빅사이즈남방4XL 드레스/반팔/긴팔/청남방,36300,36300,0
2018-06-01,984490185,A018040,아이스크림,거북알 10개,7000,4500,-2500
2018-06-01,1011088612,A014020,분유,[베베쿡] 처음 먹는 요리가케 닭고기와 된장 1개,5500,4000,-1500
2018-06-01,349345977,C013040,청바지,멜빵4종 HKOW73831B NC아울렛,39900,19900,-20000
2018-06-01,1432808572,A017210,파,[미친특가][정품]영양만점 찰토마토 5kg,8900,8900,0
2018-06-01,966659813,C015030,넥타이,패션넥타이1위/자동/수동/리본/지퍼/보타이/나비/니트,12900,12900,0
2018-06-01,1011088614,A014020,분유,[베베쿡] 처음 먹는 요리가케 콩고기와 다시마 1개,5500,4000,-1500
2018-06-01,1011088615,A014020,분유,[베베쿡] 처음 먹는 어린이 김 당근 1BOX(10봉),5500,4000,-1500
2018-06-01,1169601432,E061060,살충제,클레어 살균소독제크린 유아용(500ml) - 유아용 탈취,22210,19770,-2440
2018-06-01,1132577111,E011050,책상,[박사몰] 지오 데스크 좌식 h형 책상 컴퓨터 학생 일자 테이블,29900,29900,0
2018-06-01,698883262,L021030,가방,투미 가방 보야져 할레 백팩 484758D,203000,203000,0
2018-06-01,859370630,A013120,낙지,맛있게 구운 오징어채 250g/국산오징어 100%/코스트코,21970,21970,0
2018-06-01,2103562920,A018040,아이스크림,업소용 비유지방 10리터/5리터/3색/아이스크림,15500,15500,0
2018-06-01,849498891,F011150,건강기능식품,숙취해소제 멀쩡환 1갑(3gx10포) 스무살의 아침으로,14900,14900,0
2018-06-01,1650703383,A013090,전복,강원 인제 박계신의 황태포/황태채/통황태,12900,12900,0
2018-06-01,2137485420,C012060,여자내의,론츠린넨랩스커트/ 엔비룩,27000,22680,-4320
2018-06-01,623389572,I031040,생화,특대형 해먹 풀세트 캠핑/2인용/야전/로프/침대/그물,15900,15900,0
2018-06-01,628130845,E031010,전기밥솥,CRP-EHS0310FW/쿠쿠/3인용/IH압력/GH,265000,234050,-30950
2018-06-01,940874969,C015020,모자,30% 쿠폰! 스탠드업 볼캡 49종/모자 야구모자 스냅백,22950,22950,0
2018-06-01,1266153903,E021020,커튼,/롤러블라인드 화이트 스콕스클뢰베르 120x195 cm/ 블,63870,56850,-7020
2018-06-01,632924811,C012020,원피스,빅사이즈/테잎/오픈/롱/가디건 빅사이즈,53780,51630,-2150
2018-06-01,415995963,C015020,모자,스냅백 볼캡 빅사이즈 면무지볼캡 모자 큰모자 빅볼캡,19420,19040,-380
2018-06-01,1342118084,C013050,운동복,모비스 크루저 루프백차량용품/ 차량용루프백 자동차루프백 차량루프백 캠핑루프백 루,246100,246100,0
2018-06-01,843516510,I031040,생화,GDF 그라비티 C-582S 선상 문어낚시대 / 쭈꾸미낚시대,65000,65000,0
2018-06-01,353420996,E021010,침구,뱀부시어서커 여름이불(홑/양겹/누빔)+베개커버 세트,26900,26900,0
2018-06-01,261586681,C013010,점퍼,[바비앤펌킨][바비앤펌킨] 런던홀릭 무스탕자켓,113400,102060,-11340
2018-06-01,710666533,C013040,청바지,[지오다노] 117546 라이트웨이트 스키니 데님 팬츠,25000,20000,-5000
2018-06-01,1054548409,E061040,부엌용세제,암웨이 세제모음 디쉬드랍스 다목적세정제 프리워시,8400,8400,0
2018-06-01,1089822502,E031130,보온매트,일월_ 잘자요 워셔블 온열매트 싱글,82770,82770,0
2018-06-01,1435235883,L021020,장신구,은가락지 나비문 게르마늄 은반지 SGS인증,70000,70000,0
2018-06-01,1089822501,E031130,보온매트,일월_ 잘자요 워셔블 온열매트 더블,92070,92070,0
2018-06-01,1089822500,E031130,보온매트,일월_ 잘자요 워셔블 온열매트 세트 (싱글+더블),148000,148000,0
2018-06-01,498351733,E011040,소파,삼익가구 버나드 거위털 천연소가죽 4인용 소파/쇼파,443000,398700,-44300
2018-06-01,1654441134,I031040,생화,캠핑테이블/캠핑용품/캠핑의자/접이식테이블/가판대,21070,21070,0
2018-06-01,854426290,E031080,선풍기,[흥신] 전기컨백터히터 PVH-1250 (2~3평형 온도조절 동파방지) 1.25KW,123700,123700,0
2018-06-01,1011003707,C013050,운동복,dd98 슬림핏 트레이닝복 네이비 추리닝상의 트레이닝,19560,19560,0
2018-06-01,854426291,E031080,선풍기,[흥신] 전기컨백터히터 PVH-1500 (3~4평형 온도조절 동파방지) 1.5KW,123700,123700,0
2018-06-01,1457810100,C011050,남자내의,[상세페이지참조] 푸마 트레이닝 팬츠(65382437),58600,58600,0
2018-06-01,979968877,C012060,여자내의,[오조크][오조크] 오조크 스모크 주름 스커트715-74373 (P000331769),39000,34320,-4680
2018-06-01,1063267608,C021010,아동화,프로스펙스아동화모음 아동운동화 유아동화 키즈신발,38000,36000,-2000
2018-06-01,1011088621,A014020,분유,[베베쿡] 처음 먹는 어린이 김 양파 1BOX(10봉),5500,4000,-1500
2018-06-01,2008289169,C012020,원피스,더블버튼 슬림핏 자켓IW8SJ1750/ 코인코즈,178000,151300,-26700
2018-06-01,1913633423,C012040,여자학생복,프렌치커넥션 구제매니아 여 XS 앙고라 니트 볼레로,35350,35350,0
2018-06-01,1431990897,E011050,책상,집중력 독서실 우등생 책상 LED등기구,73300,73300,0
2018-06-01,1396650999,E011040,소파,CUPID 빈백 스툴 페브릭 안락 의자 발받침 보조의자,38900,38900,0
2018-06-01,1499608095,C014010,아동복,유아 아기 아동 키즈 남아 여아 어린이 상하복 세트,19900,19900,0
2018-06-01,1543836396,L021030,가방,투미 가방 보야져 칼라이스 백팩 484707D,240000,240000,0
2018-06-01,394027906,C012060,여자내의,[NamuGRim/나무그림] 수지 C18MMS2C045P4/ 나무,29000,26100,-2900
2018-06-01,1381759662,A011120,두부,포스트 콘푸라이트1.1kgx2개+증정[시리얼/씨리얼],14500,14500,0
2018-06-01,1814255555,C013020,티셔츠,나이키골프 정품/골프웨어 모음/언더아머/아디다스,49000,43610,-5390
2018-06-01,1498118628,C012060,여자내의,빅사이즈/벨리/레이스/스커트 벨리레이스스커트 빅사,29640,29640,0
2018-06-01,854426285,E031080,선풍기,[흥신] 전기라디에타 타이머형 ERT-30BST(15핀 6~8평형),221600,221600,0
2018-06-01,1689104199,A022050,탄산음료,나랑드사이다 1.5LX12개/180mlX30/245mlX30 제로사이,12400,12400,0
2018-06-01,470849897,C013040,청바지,[뱅뱅]뱅뱅 PNC02 남성 여름용 기본핏 블랙진 NQE250,29900,29900,0
2018-06-01,476852370,C013050,운동복,[무료배송]차량용 와인 멀티 콘솔박스 인조가죽콘솔박,30980,28230,-2750
2018-06-01,985766267,A017110,감자,하우스 햇 못난이 흙당근 5kg,6800,6800,0
2018-06-01,1480072500,C012040,여자학생복,여름 블라우스/원피스 균일가로 준비하기!/ 쿠기,14800,13770,-1030
2018-06-01,1298243097,A011170,떡,신선한 먹거리 쌀떡 3kgX5개(한박스) 떡 수제비 조랭,83350,73350,-10000
2018-06-01,1786856528,C021040,실내화,아디다스 레알 마드리드 18-19 저지 V넥 반팔 CW8646,59900,53530,-6370
2018-06-01,150400244,A013090,전복,해성 냉동홍합(그린) 800g2개,49920,49920,0
2018-06-01,1983791887,E031070,에어컨,신일 리모컨 타워팬 선풍기 SIF-TJ30R,77500,77500,0
2018-06-01,473402165,C012040,여자학생복,[KEITH]R(3H1)리노CD K7MD9H1-65,171000,160740,-10260
2018-06-01,266493811,L021020,장신구,[폭스타일] [실버] 스쿨투라 큐빅 반지,9000,8190,-810
2018-06-01,1664499651,A017280,김,초생강(적색 참존 1.2k)X10,33110,33110,0
2018-06-01,553905937,I012010,컴퓨터,2015년형 APPLE iMac MF886KH/A 레티나 5K 디스플레이/SG/빠른배송,2559180,2559180,0
2018-06-01,1321433983,A017020,상추,홍빛적치마상추씨앗 6g,2000,2000,0
2018-06-01,1619720539,E031110,청소기,삼성 핸디 진공청소기 VC-H20/무선청소기/VCH20,26000,26000,0
2018-06-01,1011088644,A014020,분유,[베베쿡] 처음 먹는 어린이 김 오리지널 1BOX(10봉),5500,4000,-1500
2018-06-01,2126911437,C012060,여자내의,[플라스틱아일랜드] 플라워 프린트 롱 스커트(PJ2WS563)/ 플라스틱아일랜드스토리,80100,68090,-12010
2018-06-01,1870699223,A022030,생수,안심박스)다이아몬드EC 생수 로라 300mlx60/500mlx40,7480,7480,0
2018-06-01,1500555350,C015040,장갑,화이트 북극곰 장갑 털장갑 손가락장갑 화이트장갑 예,16180,16180,0
2018-06-01,1692046395,F012020,생리대,릴리안 초흡수 무향 대형 14P x 1팩,2200,2200,0
2018-06-01,57347199,I012010,컴퓨터,[E]B70EV-AR73S1/7세대/i3/8G/SSD128G/키보드+마우스,790000,750500,-39500
2018-06-01,1173787537,C013060,등산복,[빈폴아웃도어]Unisex 네이비 여름 솔리드 바람막이 (BO8339P31R),139000,109810,-29190
2018-06-01,794154290,E031080,선풍기,[다우하이텍] 나노카본 온풍히터 DWH-2400S /난방/히터/,121100,121100,0
2018-06-01,1776584068,A016030,복숭아,경산 하우스 천도복숭아 1kg (10~15과),34900,34900,0
2018-06-01,1024853107,C013020,티셔츠,T693-세련된 여성 데일리 티셔츠 릴리t 긴팔티셔츠 프,20140,19140,-1000
2018-06-01,794154291,E031080,선풍기,[다우하이텍] 세라믹 온풍히터 DWH-4000S /난방/히터/,136500,136500,0
2018-06-01,1203833401,C012030,여자상의,오브제 셔링 랩원피스,62600,62600,0
2018-06-01,2043346133,G011070,자전거,알톤 베네통 피버 5.0 /시마노풀셋,205000,180810,-24190
2018-06-01,2098312989,E041010,식기,청동/방짜/유기/쌍학/반상기/세트/셋트/혼수/예단/선물/외국인/식기/추천/가격/파는곳,460000,450000,-10000
2018-06-01,1811601927,I031010,장난감,레고 호환 리필블럭 듀플로 통큰블럭 클래식 벌크블록,12200,12200,0
2018-06-01,2025058124,C011030,남자학생복,데님셔츠 셔츠 긴팔 BW 1416 RLFC NB - 데님셔츠 셔츠,83400,74230,-9170
2018-06-01,1010172686,A018100,꿀,초L프 잡화꿀 300G,7490,7490,0
2018-06-01,385573830,A022010,주스,스위트컵 농축액/스위트컵 농축에이드 모음- 2개셋트,42000,42000,0
2018-06-01,1133901081,L012060,샴푸,댕기머리 오현 샴푸500mlx4개/샴푸샘플20매증정/,21500,21500,0
2018-06-01,1649450185,E031010,전기밥솥,쿠첸 명품철정 10인용 IH압력밥솥 CJH-CT1040iD,203000,203000,0
2018-06-01,2026986030,C011050,남자내의,여름 링클프리/면바지/원턱/남성바지/빅사이즈w019,13900,13900,0
2018-06-01,1693911119,C013010,점퍼,[구김스] 1177_ 텔레포트 그레이트 블루종 점퍼,82000,57400,-24600
2018-06-01,279511132,E021010,침구,굿몽 여름 이불세트 이불 요커버 요솜 베개커버 세트,49500,49500,0
2018-06-01,1010169029,A016160,과일가공품,후르츠컵파인애플 150G,1790,1790,0
2018-06-01,1253792045,E031110,청소기,LG 코드제로R9 로봇청소기 R958DA,1290000,1290000,0
2018-06-01,42614201,F012020,생리대,화이트 시크릿홀 울트라 날개 중형(견본품)2pX40개입-,8900,8900,0
2018-06-01,565719040,I053030,복사용지,한솔 A4 복사용지(A4용지) 75g 2500매 1BOX/더블에이,18400,16010,-2390
2018-06-01,203379727,L012090,기초화장품,[닥터자르트]포맨 비비 블록 50ml(강남점),26100,22790,-3310
2018-06-01,896668082,A012010,국산쇠고기,E-한우 1등급 채끝 구이용 100G,12500,12500,0
2018-06-01,1207869196,L021060,유모차,킨즈웨건2 유아웨건 접이식 캠핑웨건 쌍둥이 유모차,348000,348000,0
2018-06-01,400096907,F011150,건강기능식품,[1+1] 프로바이오틱스 생유산균 100포 + 루테인 30정,19700,19700,0
2018-06-01,81229272,C013010,점퍼,[에이비에프지]ab.f.z 야상점퍼 AFR3GU01,79000,75050,-3950
2018-06-01,895776243,A022050,탄산음료,[코카콜라]코카 파워에이드 마운틴블라스트 (1.5L),2770,1300,-1470
2018-06-01,2121017538,C015040,장갑,란체티 등큘팅퍼 여성 순모장갑 TL-5604 따뜻한장갑,32320,32320,0
2018-06-01,2067364758,C013040,청바지,[레노마키즈]남아 5부 시보리데님팬츠 (R1721Q203_36),17100,15390,-1710
2018-06-01,298032501,A011170,떡,떡장인 명미당 밥알떡 세트 1박스 2박스,21900,21900,0
2018-06-01,439610517,A013160,맛살,(냉동)대림선프리미엄집게맛살 1kgX8개집게맛살 대림,114100,100410,-13690
2018-06-01,1842862805,F012020,생리대,릴리안 롱라이너40px3팩+포켓티슈15매,8900,8900,0
2018-06-01,1794969464,A019170,냉동식품,아하만두/1.4kg대용량/튀김만두/꼬물이/만두/샘플증정,9500,9500,0
2018-06-01,1794489149,F012010,종이기저귀,[에코제네시스 밴드형4팩]뉴본/인펀트/토들러/주니어,75500,75500,0
2018-06-01,1730799794,A018050,비스킷,커피과자 델로스315g(500입)카푸치노/오리지널/로투스,26800,26800,0
2018-06-01,1863069271,C015020,모자,군모 캡 남자 여성 낚시 골프 등산 모자 빈티지모자,7000,6900,-100
2018-06-01,125312474,C013020,티셔츠,남 솔리드 크루넥 반팔 티 028250/ 지오다노,8000,6560,-1440
2018-06-01,1457271270,C013050,운동복,툴앤툴 컴팩트 팜 광택기 6인치/3종,21900,21900,0
2018-06-01,1010172663,A018100,꿀,초L 사양벌꿀 600G*2,10900,10900,0
2018-06-01,540177575,C013020,티셔츠,게스키즈1 게스로고 티셔츠G74KDT711-B1 W1,15200,15200,0
2018-06-01,1010172664,A018100,꿀,초L프 아카시아꿀 300G,8490,8490,0
2018-06-01,771777075,A014040,발효유,수제요거트 플레인/유자/아로니아요거트 500ml,4800,4800,0
2018-06-01,896668077,A012010,국산쇠고기,E-한우 1등급 등심 구이용 100G,9980,7048,-2932
2018-06-01,145840197,L021020,장신구,영이모 투명귀걸이0.8mm일반귀걸이싸이즈,1000,1000,0
2018-06-01,475480484,A022010,주스,코카콜라 미닛메이드 홈스타일 자몽 300ml 24개 주 쥬,30200,29300,-900
2018-06-01,1985886842,C011030,남자학생복,빅사이즈 7부 반팔 남방105~150 4XL까지/[더블온스],30900,29900,-1000
2018-06-01,717034479,C013040,청바지,[하프클럽/INTERFACE]여름 신상 노턱 여름용 케쥬얼 정장팬츠 남성수트하의 RO15,24800,24060,-740
2018-06-01,878501031,A018040,아이스크림,(2개이상무료배)업소용/아이스크림/라벨리/프리미엄4L,18000,18000,0
2018-06-01,773564918,C013050,운동복,자동차 타이어 밸브캡 보호캡 에어밸브캡 4개1세트,3200,3200,0
2018-06-01,1926846076,C011030,남자학생복,BW 패션숄패딩조끼 안감패딩,88900,88900,0
2018-06-01,83978603,A021010,커피,아이수 페루산 카카오닙스500g,18380,17830,-550
2018-06-01,1979964244,C013010,점퍼,[콩스타일] 페이스트리  자켓,44500,44500,0
2018-06-01,726316990,E041050,냄비,네오플램 IH인덕션냄비/인덕션후라이팬,26900,26900,0
2018-06-01,1103921470,D031010,주택수선재료,노루페인트 순앤수100 친환경 수성페인트 18L 무광,36500,36500,0
2018-06-01,432259687,E061030,전구,2년 현장방문AS/아크로 국산슬림형/LED투광기/35W/50W,27000,27000,0
2018-06-01,1103629115,C013010,점퍼,사파리 옷 수선 접착 패치 테이프 고어텍스 야상 점퍼,9000,9000,0
2018-06-01,505202845,I031040,생화,녹스기어4/ 녹스기어6 캠핑LED랜턴 +(NEW업그레이드),59000,52810,-6190
2018-06-01,1010172659,E061100,습기제거제,[P&G]P&G)페브리즈가벼운허브향370ML,5900,5900,0
2018-06-01,135907401,C012060,여자내의,시원한 린넨 와이드 멜빵바지 점프수트 [썸띵]/ 아티젠,18800,14290,-4510
2018-06-01,1031002196,A017300,미역,삼부자 도시락김5gx72봉 식탁김15gx30봉,21500,21500,0
2018-06-01,1010172655,E061100,습기제거제,[P&G]P&G)페브리즈다우니향370ML,5900,4690,-1210
2018-06-01,1438774057,E031010,전기밥솥,SK매직 CRC-750E/대형/전기밥솥/50인용/국내최대/업소,390000,390000,0
2018-06-01,248252402,L021050,우산,사랑스토어 장우산 3단 5단등70여종 우산모음,5500,5500,0
2018-06-01,944791535,A013080,조개,건해삼(채 미국 600g)X3 건해삼채 자숙해삼 냉동해삼,274630,274630,0
2018-06-01,2030257668,A017020,상추,양상추 반박스(6~8입) / 국내산,33860,33860,0
2018-06-01,1110290547,C013010,점퍼,다양한 봄 아우터 바람막이 점퍼 자켓 21종 무료배송,48000,45900,-2100
2018-06-01,1565813403,A011160,빵,우리밀*3종오믈렛빵(17gX21개)/빵 간식 선물,11900,11900,0
2018-06-01,1627282357,I031040,생화,카멜 사계절침낭 동계침낭 천연코든 목화솜CS-024,43000,39560,-3440
2018-06-01,329317167,C013010,점퍼,[무료배송]푸조 남녀공용 기모 양털 후드집업(FZ324-2,42700,42700,0
2018-06-01,410413963,E011050,책상,철제프레임책상 회의용테이블 사무실용가구 컴퓨터,230000,223100,-6900
2018-06-01,1063816109,E031080,선풍기,신일산업 팬히터/석유난로/온풍기 SFH-1200IR,432080,432080,0
2018-06-01,1063816108,E031080,선풍기,신일산업 팬히터/석유난로/온풍기 SFH-1200SV,427240,427240,0
2018-06-01,1317889911,C011030,남자학생복,18년 SUMMER 반소매 슬림핏/노멀핏 24종택 1/ 란체티(셔츠),13800,11730,-2070
2018-06-01,1063816103,E031130,보온매트,한일의료기 온돌마루270 친환경/전기매트/온열매트,122760,122760,0
2018-06-01,1063816107,E031130,보온매트,한일의료기 온돌마루70 친환경/전기매트/온열매트,51920,51920,0
2018-06-01,1063816106,E031130,보온매트,한일의료기 온돌마루100 친환경/전기매트/온열매트,64680,64680,0
2018-06-01,1063816105,E031130,보온매트,한일의료기 온돌마루150 친환경/전기매트/온열매트,84920,84920,0
2018-06-01,1063816104,E031130,보온매트,한일의료기 온돌마루230 친환경/전기매트/온열매트,113080,113080,0
2018-06-01,1057369206,C011050,남자내의,남성M~4XL여름 면 반바지 밴딩 린넨 와이드 5부7부,11800,11800,0
2018-06-01,747163825,C013020,티셔츠,[크리비아] (4926상)랩스타일 산전산후 수유가능한 면스판 임부상,17290,17290,0
2018-06-01,919206354,A022010,주스,착한푸드 깔라만시원액 페트 1000ml x 2병,11900,10820,-1080
2018-06-01,225633848,E011050,책상,강화유리책상 사이드철제테이블 사무실컴퓨터책상세트,92000,89240,-2760
2018-06-01,1319084713,C011050,남자내의,베이직 그레이 스판 9부 슬랙스 린넨스타일_AJ7802 5,25580,25580,0
2018-06-01,440290749,A013170,생선통조림,삼포자연산골뱅이 140gX48개골뱅이 식품 자연산 식자,254200,216070,-38130
2018-06-01,827902671,C011050,남자내의,뱅뱅 남녀공용 테이퍼드구제 스판청바지 CQE186,52720,52720,0
2018-06-01,428435534,A019040,소금,[사비니 타르투피] 트러플 소금 100g,34000,32390,-1610
2018-06-01,53489321,C014010,아동복,리틀래빗 유아동 상하복 SS OPEN,10000,8900,-1100
2018-06-01,686096642,L021060,유모차,코지 디럭스유모차NEW /접이식 초경량유모차 시크블랙,138000,136000,-2000
2018-06-01,739062919,E061010,세탁세제,비트 가루세제 2.5kg x 4개 세탁 세제,18900,18900,0
2018-06-01,566350401,A014010,우유,연세흰우유200ml x24입/바나나/흰/딸기/초코/멸균우유,12900,12900,0
2018-06-01,439308480,C012040,여자학생복,[다바걸]홀릭홀터블랑,23000,21850,-1150
2018-06-01,1137954501,C021040,실내화,아디다스 반팔 반바지 슬리퍼 운동화는 여기 다있어요,19900,19900,0
2018-06-01,1865958331,A021010,커피,[냉커피] 아이스 커피 1kg 또는 100T/국산차/냉커피/,5200,5200,0
2018-06-01,1894017796,L012090,기초화장품,[피지오겔]공식판매 NEW 카밍 릴리프 클린저 200ml,22000,22000,0
2018-06-01,1279209879,A012010,국산쇠고기,[명절선물 Best][프리미엄 한우선물세트 3호 3.2kg]1+,380000,376200,-3800
2018-06-01,49403482,C013050,운동복,트레이닝 세트 운동복 상의 하의 빅사이즈 허밍퍼플,20000,19800,-200
2018-06-01,1359466068,C021040,실내화,[나이키] 에어 맥스 97 W (921733-600),234800,223060,-11740
2018-06-01,1011088587,A014020,분유,[베베쿡] 처음 먹는 요리가케 연어와 치즈 1개,5500,4000,-1500
2018-06-01,520825866,C011030,남자학생복,여름추천 데일리 반팔셔츠/셔츠/하와이안/린넨셔츠,16900,16900,0
2018-06-01,316047507,C015040,장갑,남녀공용 지그재그 배색 니트 장갑 예쁜장갑 겨울장갑,10790,10790,0
2018-06-01,1243701174,C012060,여자내의,CSK1306-플리츠 주름 롱 스커트,64720,64720,0
2018-06-01,660918320,C013010,점퍼,[써스데이아일랜드](T184MJK233W) 린넨 스트라이프 쟈켓,239000,215100,-23900
2018-06-01,1063816111,E031080,선풍기,신일산업 팬히터/석유난로/온풍기 SFH-C904DMA,359480,359480,0
2018-06-01,717465245,C013020,티셔츠,(4926상)랩스타일 산전산후 수유가능한 면스판 임부상,18130,18130,0
2018-06-01,989051893,A021020,차,[동서식품]미떼 핫초코 마일드지관 430g,6900,6900,0
2018-06-01,989051894,A021020,차,[동서식품]미떼 핫초코 오리지날지관 430g,6900,6900,0
2018-06-01,1195343852,A022030,생수,무료배송 스파클 2박스 (500ml X 40개입) 생수 모음전,8600,8600,0
2018-06-01,2076081461,C013020,티셔츠,빅사이즈 남자/남성의류/티셔츠/셔츠/카라티/모음,24800,24800,0
2018-06-01,1063816110,E031080,선풍기,신일산업 팬히터/석유난로/온풍기 SFH-C909MVP,408500,408500,0
2018-06-01,1922856467,C013050,운동복,(2+1 EVENT) 16ss 첨이첨이 플라워가든3부세트 듀퐁 유아동의류 아동의류 공용 상하복,17730,17730,0
2018-06-01,1488725533,E051020,건전지,무료배송 파나소닉정품 에네루프 AA/AAA 충전지,13900,13900,0
2018-06-01,406593879,A015020,식용유,올리타리아 포도씨유 1L 올리브유 오일 식용유,7680,7680,0
2018-06-01,272327795,C013020,티셔츠,[쿠비코][쿠비코]꽈배기 어깨 패치 차이나 폴라 니트 NMGB522,42800,34240,-8560
2018-06-01,1334632153,A022030,생수,공식수입/페리에 (자몽 플레인 레몬 라임) 330ml*24병,26900,26900,0
2018-06-01,1193607782,E031130,보온매트,NEW 라꾸라꾸침대(싱글 더블) 접이식침대 사은품증정,119800,119800,0
2018-06-01,205955150,C013010,점퍼,[백화점SAY][르블랙]남성 양가죽 지퍼포인트 라이더자켓(SY003),174000,128070,-45930
2018-06-01,562982002,C011020,남자상의,남성 여름 시어서커자켓/스트라이프/정장수트/반바지,15000,15000,0
2018-06-01,1503317965,C013050,운동복,핑크시슬리 트레이닝복/디즈니의류/,23800,23800,0
2018-06-01,716142618,E011040,소파,보니타빈백 LC507 빈백/소파/쇼파베드/1인용쇼파,126900,126900,0
2018-06-01,989075853,E061040,부엌용세제,참순수한 베이킹소다 2KG,7900,7900,0
2018-06-01,1860958783,A016030,복숭아,백도캔(백도 2절 펭귄 400g)X24/복숭아캔 푸드피아백,41550,39060,-2490
2018-06-01,489766887,C012060,여자내의,매킷 헤지 청반바지 여성바지 데님반바지 패션파지 반,17870,17870,0
2018-06-01,439034442,C013010,점퍼,아디다스 TND 트랙탑(S44543) 블루 져지 트레이닝상의,69890,69890,0
2018-06-01,246536021,C013010,점퍼,빅사이즈 걸스링점퍼 MS1703 빅사이즈 여성의류 미시,55120,54020,-1100
2018-06-01,231193096,A015020,식용유,폰타나포도씨유500ml 요리유 포도씨유 식자재 식품 폰,13880,13880,0
2018-06-01,456417892,C013050,운동복,배틀킹 자동차 파워핸들/메탈 그립 보조핸들봉 파워봉,6470,6280,-190
2018-06-01,1921000161,C013050,운동복,소프트99 글라코 유막제거제/발수코팅제/세차용품,12500,12500,0
2018-06-01,881697579,F012020,생리대,위스퍼 보송보송 울트라 중형날개 36P+18P,10400,10400,0
2018-06-01,2045253190,C013040,청바지,[더루비]주니어/청바지/롱티/티셔츠/맨투맨,11800,11800,0
2018-06-01,1010999286,E061050,청소용세제,(2+2)유한락스 욕실청소용 500mlx4/펑크린/곰팡이제거,9800,9800,0
2018-06-01,440289756,A015020,식용유,(무)해표 포도씨유500mlx20개(box)해표 올리브유 포도,112400,98920,-13480
2018-06-01,603197826,F012010,종이기저귀,[마미포코] 마미포코 쿨썸머그린 팬티기저귀 대형 여아 34매x3팩,36900,36900,0
2018-06-01,1219841284,L021050,우산,고급 우의/우비/레인코트/비옷/작업용 배달 오토바이,14900,14900,0
2018-06-01,1902542405,E011020,침대,로니 수납형 침대/서랍침대/슈퍼싱글/침대프레임,79900,79900,0
2018-06-01,436046737,C012060,여자내의,트임에이치스커트 MYD_1712 H치마 니트스커트 여성스,19560,19560,0
2018-06-01,821900853,C013020,티셔츠,[애프리콧] 5900원균일가 여름신상 티셔츠/롱티/반팔,5900,5900,0
2018-06-01,2060949489,C013010,점퍼,빅사이즈 더블포켓 청자켓ca921-332 / 데님셔츠 남방 청자켓 남성캐쥬얼 남자셔츠,54990,54990,0
2018-06-01,264263856,A021010,커피,마이카페 초특가 트롬베타 네스프레소호환캡슐100개,49500,47500,-2000
2018-06-01,1960197848,I031040,생화,SOS 긴급 구호세트 안전용품 캠핑용품 캠핑장비 캠핑,24730,22080,-2650
2018-06-01,1010255434,A017130,도라지,초L프라임)얼굴이보이는달콤담백고구마,5990,5990,0
2018-06-01,2027349497,C021010,아동화,[팁토이조이] 걸음마 신발 아기운동화 펑키,55250,46970,-8280
2018-06-01,253853000,E041070,밀폐용기,더치커피병/더치병/패트용기/선물박스/페트병/생수통,600,560,-40
2018-06-01,989051868,A021020,차,[동서식품]미떼 핫초코 오리지날 300g(10T),5200,5200,0
2018-06-01,786714058,E061050,청소용세제,미라클 곰팡이젤 120gX3개/욕실/실리콘/곰팡이제거제,11400,11400,0
2018-06-01,989051865,A015010,참기름,[정기배송]백설 고소한참기름 430ML*2캔,18980,9380,-9600
2018-06-01,1385859725,A011160,빵,안흥찐빵마을 수제 찐빵 500g(10입) 2봉 수제 초코블,41740,41740,0
2018-06-01,366525843,C013060,등산복,봄여름 등산바지/클라이밍/등산복 아웃도어 작업복,18800,14380,-4420
2018-06-01,657616936,A016020,배,[나주 APC농협/엄선선별] 신고배/추황배 5kg,9900,9900,0
2018-06-01,954040707,L012080,화장지,[유한킴벌리]유한킴벌리 크리넥스 여행용 70매*3,2000,2000,0
2018-06-01,1692502000,E031010,전기밥솥,쿠쿠 내솥 [K712] CRP-HPF0660SR 밥솥 교체용,42390,42390,0
2018-06-01,402983339,A012010,국산쇠고기,LA갈비세트 구이용 3kg 미국산 초이스등급,122550,122550,0
2018-06-01,958544109,A019040,소금,[청정원]청정원 신안보배 천일염 구운소금 500G,2500,2500,0
2018-06-01,240487597,I031040,생화,아웃팅]편의점테이블 편의점의자 파라솔 야외용테이블,37900,26960,-10940
2018-06-01,1176777680,C013020,티셔츠,[핫핑]내맘대로1+1+1티셔츠모음,19800,19800,0
2018-06-01,319446482,C012020,원피스,(해외직배송)리본 프릴 정장 원피스 여자원피스 프릴,72420,63730,-8690
2018-06-01,1161104881,I011030,사진기,캐논 정품 EOS M3 본체 + 15-45mm IS STM 명품마을,480870,442310,-38560
2018-06-01,1608283579,L021020,장신구,실버)진주 슬리밍 목걸이 폭스타일 악세사리 귀걸이,17760,17760,0
2018-06-01,1182213150,C013050,운동복,아디다스아동트레이닝복 트레이닝복 유소년트레이닝복,59800,59800,0
2018-06-01,1539727971,L012040,치약,죽염 히말라야핑크솔트 펌핑치약 285g x 2개+50g증정,10900,10900,0
2018-06-01,2001779416,A021020,차,코코넛크림파우더 (코만 160g) X24,116300,103510,-12790
2018-06-01,2139221147,A013130,오징어채,[가온애]국내가공 오징어실채/백진미채/홍진미채,4900,4900,0
2018-06-01,451112052,A011160,빵,딤섬 화권꽃빵1.5kg2개 빵 꽃빵 화권꽃빵 딤섬화권꽃,28190,25380,-2810
2018-06-01,1930394161,A017180,호박,(1)고추피클(레드칠리 수리 227g )X24개/고추피클 태,105750,100470,-5280
2018-06-01,192274701,E011060,의자,포켓스프링 좌식 의자 책상 학생 사무용 사무실,28000,28000,0
2018-06-01,20999758,A014010,우유,누룽지(성경 250g) X 20 누릉지 밥 가마솥 즉석 숭늉,48530,48530,0
2018-06-01,1920229614,E011050,책상,민트2 1200 1500 원목책상/컴퓨터책상,99000,99000,0
2018-06-01,816957880,C013020,티셔츠,캉골 여성 85 기본 라운드 면 긴팔 티 봄 가을 새제품,27630,27630,0
2018-06-01,196766193,A019110,드레싱,냉장고 속 유통기한 지난 소스들 버리세요! 오뚜기 소스,2280,2280,0
2018-06-01,1136689082,A011020,현미,삼원농산 2017년 찹쌀 5kg 100% 국내산,16100,16100,0
2018-06-01,436778585,C015030,넥타이,국산/조문용/검은색/넥타이/검정색/자동/수동/모음/문상용/장례식/행사용/검정넥타이/,4460,4460,0
2018-06-01,117762275,L021050,우산,[토마톰스]자동 장우산/2단 3단 우산,9900,9900,0
2018-06-01,1227271343,A021020,차,프리마 (가정용 동서 1K) X12,91040,81030,-10010
2018-06-01,2083172519,C013010,점퍼,스테판조셉 프린티드 레인코트 로봇A (택1) /(참고)아,86800,76390,-10410
2018-06-01,1010255493,A011180,파스타면,도나베라 삼색 푸실리 450G,2390,1790,-600
2018-06-01,1269403016,A013100,마른멸치,청정완도전복 (알뜰세트) 활전복 10ㅡ11미 500g(마,47680,47680,0
2018-06-01,2116219665,C012020,원피스,뉴이중지 재킷(EHJKHJ01)/ 케네스 레이디,329000,296100,-32900
2018-06-01,1010255494,A011180,파스타면,도나베라 스파게티 450G,1500,1390,-110
2018-06-01,1581696949,I053030,복사용지,한솔 A4 복사용지(A4용지) 복사지 75g 2박스/더블에이,36340,31260,-5080
2018-06-01,984396837,A022050,탄산음료,코카 씨그램 레몬 350ML,1000,600,-400
2018-06-01,989051890,A021020,차,[동서식품]미떼 핫초코 마일드 300g(10T),5200,5200,0
2018-06-01,1017620133,C021020,구두,[루플랫] 1288065 (해외) 18SS 아페쎄 구스타브 레더 더비 슈즈,374600,322950,-51650
2018-06-01,1309507318,C013050,운동복,dd98 슬림핏 트레이닝복 그레이 트레이닝자켓 운동복,19460,19460,0
2018-06-01,989051891,A021020,차,[동서식품]미떼 핫초코 모카 300g(10T),5200,5200,0
2018-06-01,989051892,A021020,차,[동서식품]미떼 핫초코 티라미수 300g(10T),5200,5200,0
2018-06-01,2096910445,C011030,남자학생복,FSSF18018 트라이앵글 패턴 셔츠 패턴셔츠 남성셔츠,38000,37620,-380
2018-06-01,636312005,E031010,전기밥솥,키친아트 전기 보온 밥솥 전기밥통 미니밥솥 밥통,28800,28800,0
2018-06-01,255471015,E011050,책상,헬프데스크/각도조절경사형/허리에도움주는학생책상,278000,202940,-75060
2018-06-01,1471979894,C011030,남자학생복,빈폴가디건/빈폴니트/집업가디건/후드가디건/닥스/헤지스/브이넥/카라티셔츠/라운드/정,77000,77000,0
2018-06-01,1296520135,C013020,티셔츠,고퀄유니크 반팔티 44~99 빅사이즈 여성맨투맨 후드,19900,19900,0
2018-06-01,1083600059,A011080,밀가루,온참 예산국수_잔치 국수 소면 10ea(13kg)/메밀/치자,39800,39800,0
2018-06-01,179804595,G011070,자전거,[옐로우콘] 상품평행사/20인치 접이식자전거 오즈,99000,84900,-14100
2018-06-01,265946296,A018050,비스킷,롯데 해태 크라운 오리온 농심 과자 간식 초코파이 마,2000,2000,0
2018-06-01,1954292908,I031040,생화,브로몰딩 접이식테이블 122CM/가정/사무실/야외/행사장/회의용테이블/초특가/도매,34900,31240,-3660
2018-06-01,376075668,C011030,남자학생복,슬림하고 깔끔한핏 배색차이나7부남방 차이나 7부셔츠,23900,21900,-2000
2018-06-01,263356432,A022050,탄산음료,펩시콜라 1.25L x 12펫/칠성사이다/코카콜라,9900,9900,0
2018-06-01,245886382,C011030,남자학생복,조거 후드 집업가디건 sj174-003 남성캐쥬얼.캐쥬얼가,39300,38520,-780
2018-06-01,1870866435,E011050,책상,와이드 우든베드트레이/좌식책상/독서대/노트북테이블,38200,38200,0
2018-06-01,958544143,A019040,소금,청정원 천일염 가는소금 280G,1290,1290,0
2018-06-01,2135169138,C013050,운동복,올뉴카니발 리무진 콘솔박스 팔걸이 쿠션 콘솔쿠션 팔,57440,51800,-5640
2018-06-01,958544142,A019040,소금,청정원 신안섬 보배 천일염 맛소금 250G,2090,2090,0
2018-06-01,990818725,A014010,우유,커피 믹스(맥심모카 자판기 동서 1K)X10 가루 믹스,148900,148900,0
2018-06-01,2022720952,L021030,가방,여성가방/숄더백/미니백/클러치/핸드백/토트백/쇼퍼백,15800,15800,0
2018-06-01,1308640589,C011020,남자상의,MJ_1137 보카시 더블트렌치 자켓 남성트렌치코트 코트,212590,212590,0
2018-06-01,1876498385,E031110,청소기,[샤오미] 샤오미 스마트 로봇청소기 2세대 한글지원 물걸레청소,590000,590000,0
2018-06-01,420597096,A019140,이유식,[엘빈즈]클래식 이유식  아기반찬  아기국,3180,3180,0
2018-06-01,1471953297,C011030,남자학생복,MCD-917 (가을신상) 빈티지 스타일 롱가디건 (FREE) 3,56920,50660,-6260
2018-06-01,1436969765,A022050,탄산음료,코카콜라185mlX30캔/칠성사이다/레쓰비/캔커피/음료수,13400,13400,0
2018-06-01,1935193884,A013090,전복,[마산어시장 이바다몰]남해안 통영 국산 바지락1kg/해물탕/국물용/조개구이/백합/가리,5000,4800,-200
2018-06-01,444652981,C012020,원피스,빅카라 루즈핏 숏 코트(Z174MSG003)/ 쥬크,219000,186150,-32850
2018-06-01,1142213648,D031010,주택수선재료,노루 순앤수 항균페인트 4L 곰팡이방지 친환경 벽지용,14900,13500,-1400
2018-06-01,1272046278,C015030,넥타이,5+1프리미엄 큐빅 실크넥타이 국내산최고급형 선물용,28000,28000,0
2018-06-01,84954010,A016040,포도,동원)황도 슬라이스 400g x 12개 사시사철 맛있는,41350,41350,0
2018-06-01,381451478,A013080,조개,국내산 새꼬막 1.5kg (대) 새벽조업후 발송 산지,36330,36330,0
2018-06-01,1320744756,A017180,호박,(참살이식품)중국산 고춧가루1kg 김장용 양념용 고추,16400,15910,-490
2018-06-01,1162669592,E061040,부엌용세제,그라인더세정제 퓨로그라인더클리너 커피머신세척제,44330,44330,0
2018-06-01,1973626569,A013170,생선통조림,살코기참치150 10캔/고추참치(100g)(150g)마일드,12900,12900,0
2018-06-01,950887051,C013020,티셔츠,[블루독베이비] (BL)로고포인트7부티셔츠 48319-331-02,30400,24320,-6080
2018-06-01,1067172047,E011070,식탁,하이그로시 접이식 식탁/접이식 테이블/스톨의자,97900,97900,0
2018-06-01,1601876027,C013020,티셔츠,[라코스테] 남성 히든 폴라켓 반팔 폴로 LCST PH552E-18B031,138000,131100,-6900
2018-06-01,796051908,E041010,식기,라면기/면기/스텐용기/스텐면기/이중라면기/식기,5800,5340,-460
2018-06-01,1410349515,L021060,유모차,예꼬맘 충전식 휴대용 유모차 클립 선풍기,16800,16800,0
2018-06-01,426168015,C013010,점퍼,루즈슬림절개시크자켓 IR1710 자켓 굴곡절개선자켓 여,104530,104530,0
2018-06-01,825973732,C011050,남자내의,삼성 마이크로여파자마 부드러운 면 여성 파자마,8980,8000,-980
2018-06-01,1073549894,E041030,솥,뉴 하이클래드 하이브압력밥솥 2 4 6 8 10인 풍년세원,84600,82070,-2530
2018-06-01,1138053005,E031020,가스레인지,GOR-B5B01S/동양매직 빌트인 가스오븐레인지+4구 가스렌지 일체형 제품/화재예방/안심,1050000,1050000,0
2018-06-01,653278718,A011160,빵,프랑스 프리미엄 크로아상 60gx10개 냉동빵 생지,11900,11900,0
2018-06-01,904270204,E041050,냄비,라면 편수냄비 18cm,9400,9400,0
2018-06-01,486831047,A017110,감자,충남 서산 나영길님의 자색당근 3kg/ 푸르젠,24900,24900,0
2018-06-01,797349794,F012010,종이기저귀,[+키재기 성장앨범] 보솜이 리얼코튼 기저귀 3팩,34900,34900,0
2018-06-01,986242864,A022010,주스,빙그레 따옴 (오렌지) 730ML,2800,2400,-400
2018-06-01,1885470680,C013020,티셔츠,여름 시원소재 루즈핏 칼라 맨투맨 티셔츠 (비치),20000,20000,0
2018-06-01,693817363,C011030,남자학생복,여름신상 체크 남방 7부 솔리드남방 반팔셔츠 남자 스,14700,14700,0
2018-06-01,451112016,A013150,어묵,풍조 신야채맛종합어묵3kg2개 어묵 종합어묵 야채맛종,37960,34170,-3790
2018-06-01,1586672501,C011050,남자내의,청반바지/5부7부오부칠부여름롤업바지커플룩남자옷숏,13800,13800,0
2018-06-01,528323276,C012030,여자상의,시원한 아이스 티셔츠/냉장고/원피스/쿨/빅사이즈,4900,4900,0
2018-06-01,1857548831,C013020,티셔츠,여성 야즈부키 콜라보 폴로 반팔 티셔츠 LCST PF5210-17BJDY/ 라코스테(의류),103600,98420,-5180
2018-06-01,378085128,L021010,손목시계,앤티크 바이시클/손목시계-색상임의배송 손목시계 패,9350,9070,-280
2018-06-01,178397761,F012020,생리대,에리에르 엘리스 크리닉스 슈퍼롱 10P / 생리대,4900,4900,0
2018-06-01,1055632586,E061040,부엌용세제,자연퐁 대용량 주방세제3000mllx2 트리오 참그린 퐁퐁,11900,11900,0
2018-06-01,570436603,E031120,믹서,클리나 프레쉬 블렌더 대용량 믹서기 KM001/KM002,32000,29900,-2100
2018-06-01,666272388,E011060,의자,식탁의자/홈바의자/벤치의자/피아노의자/원목의자,44900,44900,0
2018-06-01,1154603508,A021010,커피,동서맥스웰커피믹스 900g/오리지날/마일드/자판용,3300,3300,0
2018-06-01,480422309,A017200,토마토,토종원 국내산 건가지 70g 순수 자연그대로 나물,5100,5100,0
2018-06-01,418070729,E011060,의자,[이디고]마블게이밍 컴퓨터의자 풀세트,145000,145000,0
2018-06-01,1604435304,F012020,생리대,[시크릿데이] 러브 일반팬티라이너 20PX8팩,9500,9500,0
2018-06-01,1080423881,E031010,전기밥솥,CRP-FHR1010FG/쿠쿠/IH압력/10인용/음성/GH,531300,479100,-52200
2018-06-01,1954698722,A011120,두부,켈로그 씨리얼 1+1/허니첵스/콘푸로스트/대용량씨리얼,8600,8600,0
2018-06-01,1602856986,A019070,양념소스,(마마) 사골엑기스 1kgx6팩 사골 농축액 육수 분말,63000,63000,0
2018-06-01,1080181276,C013020,티셔츠,여름반팔티-린넨티/레이온/여성티셔츠/여성의류/나시,8000,7900,-100
2018-06-01,384823410,C013050,운동복,폴더 헤드레스트 미니 테이블 차량용수납포켓 자동차,23150,21090,-2060
2018-06-01,77698266,E011070,식탁,최고급 싱크대용 대리석 아일랜드 홈바/식탁,185000,166500,-18500
2018-06-01,350251535,C013020,티셔츠,T2234-여성 데일리 세틴 프릴 카라 맨투맨티셔츠 빅카,20830,20830,0
2018-06-01,454623860,I053040,기타문구,3M 플래그 오피스팩/팝업 플래그 인덱스/알뜰팩/683-5KP/683-9KP/683-9KN/FO4406/FO44,11800,11800,0
2018-06-01,338119351,C014010,아동복,플레이키즈 조던AJ NNM18QST77레거시 탱크탑 세트,50150,50150,0
2018-06-01,994149625,A011050,콩,서래푸드 볶음땅콩 500g x 2개 9종 커피/믹스/견과류,5900,5900,0
2018-06-01,1425709956,C015020,모자,군모/패션군모/캐주얼모자/남녀공용/빈티지/볼캡/패션,4300,4300,0
2018-06-01,1356072702,C013050,운동복,에어워크 스판츄리닝/츄리닝/운동복/체육복/단체복,49800,48800,-1000
2018-06-01,2105716517,A013140,북어채,황태채 300g 북어채/속풀이국이나 무침용으로 정말 좋,7800,7800,0
2018-06-01,2094598762,C011050,남자내의,[국내 배송]/ 디키즈바지/디키즈874오리지날,24500,24500,0
2018-06-01,475994076,C011020,남자상의,[무료배송]남자 자켓 마이 JK04 WS 남자정장 재킷 남,94450,94450,0
2018-06-01,1695888141,L012060,샴푸,헤어캅 헤어단비 내츄럴 샴푸/지루성두피.비듬.각질,30000,28000,-2000
2018-06-01,988097652,A017300,미역,두번 구운 김밥김 15매,2990,2990,0
2018-06-01,1269611793,C013050,운동복,dd98 슬림핏 트레이닝복 그레이 여성트레이닝복 트랙,20210,20210,0
2018-06-01,2131180230,L012040,치약,작트 치약 150gX6 Cj 라이온 작트라이온,14500,14500,0
2018-06-01,470620593,C013050,운동복,[스타일리쉬위즈] (색상선택 : 메탈릭실버) 3M 자동차 문콕,11810,10770,-1040
2018-06-01,1316765406,C012040,여자학생복,[올리비아로렌][올리비아로렌] 베이직 나시 블라우스 VOCNSSM4111,29100,27650,-1450
2018-06-01,1164540588,E061040,부엌용세제,크로바 1종 주방세제 최고급골드퐁 4L/퐁퐁/리필,7500,7500,0
2018-06-01,2061996297,C013020,티셔츠,[키즈레시피]여름신상/데님팬츠/면팬츠/엄청난특가,7900,7900,0
2018-06-01,1425590760,I053020,스케치북,흰도화지/마분지/색도화지/색상지/전지/코팅필름,7700,7700,0
2018-06-01,598427336,C011050,남자내의,봄 여름 남성 건빵 카고바지 청바지 면바지 작업복,15800,15800,0
2018-06-01,717188247,C012060,여자내의,[보슈아][보슈아]숙녀-Sw실과바늘 얇은면9부치마레깅스여름레깅스[9450],12800,12160,-640
2018-06-01,592944668,C014010,아동복,[래핑차일드] 슬림 7부 팬츠 (87326-400-01),19000,17100,-1900
2018-06-01,136320862,E011050,책상,LFM 리더스 아이탭하모니 1200와이드까지 공부상,26000,25740,-260
2018-06-01,482725834,E031130,보온매트,한솔참사랑매트/카페트매트/전기장판/전기매트/전기요,148000,148000,0
2018-06-01,631106386,C013010,점퍼,패딩점퍼 경량 PD14 WS 빅사이즈,66730,64730,-2000
2018-06-01,439634476,A013170,생선통조림,(무)유동 뚝배기번데기탕280gX24개유동 술안주 번데기,66200,56270,-9930
2018-06-01,377939209,A014010,우유,멸균우유 흰/초코/딸기 각 200ml x 24팩/ 서울우유,13900,13900,0
2018-06-01,774951998,A017170,풋고추,(맛나)알나라깐메추리알1kg/새한,10600,9540,-1060
2018-06-01,2039164367,I053030,복사용지,더블에이 A4 복사용지(A4용지) 80g 2500매 2BOX,53830,46300,-7530
2018-06-01,1454450097,C013050,운동복,매직콘 자동차 광택기 광택패드 차량용 휠 세차용품,9900,8930,-970
2018-06-01,150938093,I031040,생화,오난코리아 N9-LUMENA2 루메나2 캠핑용 LED 랜턴,79000,79000,0
2018-06-01,895394280,A018010,초콜릿,킨더 초콜릿 미니 T22 3+3봉 기획전,14780,14780,0
2018-06-01,1254263216,E061010,세탁세제,브라이트 가루세제 5.5x3개,14900,14900,0
2018-06-01,1206412174,C013020,티셔츠,엄마옷 마담4060 주름라운드반팔티셔츠-XTE804078-,27900,23160,-4740
2018-06-01,605932837,C012060,여자내의,빅사이즈/페이즐/시스루/스커트 페이즐시스루스커트,27700,27700,0
2018-06-01,170352087,A012060,햄및베이컨,콩으로만든 식물성 쏘시지 구프랑 200g 12입,55400,53740,-1660
2018-06-01,1090465995,C011030,남자학생복,[디바옴므]구스다운 울트라 라이트 경량 베스트,33800,29750,-4050
2018-06-01,1492366669,C013050,운동복,엣지/100%국내생산/여성트레이닝복/2장구매시무료배송,32500,32500,0
2018-06-01,549637774,C012060,여자내의,밴드골지니트스커트 MNW14012 여자스커트 여성니트치,45860,45860,0
2018-06-01,1903713875,C013010,점퍼,[PLAC]Uni V-neckline Blouson_WH(W)PWOG2JPL02U0C2,99000,69000,-30000
2018-06-01,1308639502,C013010,점퍼,소매 다운 집업점퍼 S-3XL SD-6629 집업 여성집업 점,62170,62170,0
2018-06-01,428868144,C011030,남자학생복,[지오다노]남 옥스포드 셔츠 048301S,19000,15200,-3800
2018-06-01,1716693813,L021020,장신구,원석sale/천연투어멀린/0.85ct/tourmaline,10000,10000,0
2018-06-01,668888797,A012040,닭고기,[허닭] 닭가슴살 큐브 볼 15+1 봄맞이 특가 진행중,28900,28900,0
2018-06-01,1174689519,I031040,생화,버팔로 와이드 릴렉스 산토리니체어 세트/캠핑의자,55000,48950,-6050
2018-06-01,50162232,A011080,밀가루,메밀국수 400g x3 +장국 360ml / 콩국수 냉면 비빔면,11900,11900,0
2018-06-01,1608283517,L021020,장신구,실버)오팔 쉐도우 목걸이 은 실버 오팔 원석 선물 기,21880,21880,0
2018-06-01,984372818,E061100,습기제거제,샤프란 꽃담초 섬유탈취제 자스민향 400ML,6900,3300,-3600
2018-06-01,984372819,E061100,습기제거제,샤프란 꽃담초 섬유탈취제 연꽃향 400ML,6900,3300,-3600
2018-06-01,1871207771,C013050,운동복,트레이닝복세트 츄리닝세트 7부 반팔 반바지세트 남성,17800,17800,0
2018-06-01,2025707437,C013020,티셔츠,티파니 주니어 T63KKT080G2 연두 앵무새 단가라티,11200,11200,0
2018-06-01,1946306799,A013070,굴,[랍스터테일] 랍스터테일 4~5oz (114~141g내외),9900,9230,-670
2018-06-01,1260966831,C013010,점퍼,걸크러쉬 슬림 가죽 자켓-m1071 (블랙) 가죽자켓 여성,54890,54890,0
2018-06-01,2001079252,A012060,햄및베이컨,동원 리챔 340g x10캔 /스팸/로스팜/런천미트/뚝심/햄,27900,27900,0
2018-06-01,1030256521,A019170,냉동식품,한성 속찬 손만두/속찬 김치손만두1.2kgx2,11900,11900,0
2018-06-01,634902744,L021030,가방,투카노 WORKOUT3 워크아웃3 15인치 노트북가방,89000,89000,0
2018-06-01,325065216,I053040,기타문구,3M 포스트잇 대용량 슈퍼노트 메모지 인덱스탭 플래그,700,700,0
2018-06-01,1484238152,E041070,밀폐용기,에코프레쉬 3/5/7종 세트 스텐 반찬통/밀폐용기/찬통,8000,7270,-730
2018-06-01,1387884625,A022010,주스,깔라만시 퓨레1kg/망고퓨레1kg/깔라만시원액100% 1kg,8500,8500,0
2018-06-01,1508320210,A017220,양파,(맛나)#흙쪽파(국산.단),10800,9720,-1080
2018-06-01,20877482,A012050,소시지,한성 매콤불고기맛후랑크 80gx50개 1박스/핫바,19900,19900,0
2018-06-01,1201735793,C012020,원피스,[미니멈][MINIMUM]캐주얼 면혼방 벨티드 롱코트 MRCAWY8260-BL,659000,626050,-32950
2018-06-01,911598130,E031130,보온매트,한일 레자황토 전기매트 1인용,99000,99000,0
2018-06-01,1298544066,L021060,유모차,마루스 안단테 유모차/휴대용/절충형유모차/기내반입,99000,99000,0
2018-06-01,841431806,C013020,티셔츠,사계절 나시 나시티 민소매 모음,1900,1900,0
2018-06-01,572666754,E041050,냄비,샤브샤브냄비 전골냄비 무쇠솥 샤브냄비 오뎅탕냄비,17000,16150,-850
2018-06-01,1465469439,E041070,밀폐용기,[국내산]와인병/코르크와인병/저장병/참기름병/유리병,2200,2030,-170
2018-06-01,570990869,C013010,점퍼,지퍼배색 초경량 점퍼 DK0222 빅사이즈 바람막이 큰옷,60900,60900,0
2018-06-01,1749195214,A013120,낙지,정화 통오징어 숯불다리 50gx5.,21560,19190,-2370
2018-06-01,1285813504,E031090,공기청정기,인증점 삼성 공기청정기 AX34M3020WWD 전국무료배송,234000,209000,-25000
2018-06-01,886048008,E031090,공기청정기,위닉스 공기청정기 제로 2.0 / AZBE380-HWK,219000,219000,0
2018-06-01,321555840,L021030,가방,30%쿠폰! 여행잇템 왕골가방/밀짚모자/버킷햇 外,9800,9800,0
2018-06-01,222427317,E041070,밀폐용기,스텐바트 PC 바트 밧드 밧트 뚜껑 물받이 드레인 뷔페,9600,8840,-760
2018-06-01,250336070,C011050,남자내의,레노마 18년 S S 네이비 허리밴드 스판 면바지RKAIBP92AGA,48970,48970,0
2018-06-01,1378950704,C012030,여자상의,정장원피스/여름/민소매/롱/린넨/쉬폰/레이스/랩,35700,35700,0
2018-06-01,321002562,C021010,아동화,리틀 스타 밸크로 유아신발(130-170mm) 900040 베이비,26510,26510,0
2018-06-01,301147854,A015010,참기름,일주일특가/추가금무/오뚜기 옛날 참기름 500mlx2개,9700,9700,0
2018-06-01,1010196748,A014030,치즈,Lactima)액티브카우라이트 120G,4900,4900,0
2018-06-01,394625240,E031010,전기밥솥,(추천)쿠첸 10인용 IH압력밥솥 WHQ-VE1081SD,147000,147000,0
2018-06-01,1895056913,C012040,여자학생복,[비키]쉬폰 믹스 백 스트라이프 드레이프 가디건 (TMCCE2917)_C5P7,34600,32870,-1730
2018-06-01,1209438387,C013040,청바지,[Blouson]쿨 썸머나염 리본 밴딩 와이드 팬츠_[B1806PT066B],29000,25780,-3220
2018-06-01,885663234,L021060,유모차,싸이벡스 악세사리_제로나 플러스 제로나 쿨시트,18000,18000,0
2018-06-01,1288264671,A012030,돼지고기,[코스트코 냉장냉동] 씨제이 통삼겹 수육 600G,18120,17400,-720
2018-06-01,1983414555,E061010,세탁세제,1+1 성분연구소 세탁세제 액체 액상 빨래 유아세제,14000,13800,-200
2018-06-01,918292749,A016160,과일가공품,[딜라잇가든]냉동 석류 1kg x 3/ 딜라잇가든,39900,39900,0
2018-06-01,896813126,F012020,생리대,[LG]바디피트 귀애랑 롱 (38P),5990,5990,0
2018-06-01,2064954959,C012060,여자내의,SK1663-시그널 플레어 스커트 FREE(44~66) 플레어치마,35450,35450,0
2018-06-01,573965481,L012060,샴푸,케라시스 대용량 퍼퓸샴푸 600mlX5 3KG /퍼퓸샴푸 1위,19900,19900,0
2018-06-01,1194872706,C013060,등산복,[디스커버리(discovery)]17 F/W 남성 스탠리(STANLEY) 다운자켓 (DMDJ73761)(영등포점,483000,410550,-72450
2018-06-01,694090854,A011100,라면,[백설] [CJ제일제당] 백설 국산 100% 자른당면 400g 잡채사리,5500,5500,0
2018-06-01,1202300077,C012040,여자학생복,[STUDIO B] 아이보리 넥셔링 민소매 블라우스 (BF8365S010_)/ 빈폴레이디스,279000,251100,-27900
2018-06-01,2064927371,C012060,여자내의,SK1652-포켓 체크 스커트 FREE(44~77) 체크치마 플레,48440,48440,0
2018-06-01,1089065355,A022010,주스,와일드망고분말/망고씨드/와이드망고/와일드망고가루,21900,21900,0
2018-06-01,457540694,L021050,우산,일회용우의 100%방수 성인용우의 아동용우의 비옷,400,400,0
2018-06-01,90502682,A017110,감자,품질A+ 국내산 건여주800g 돼지감자 여주차 여주,19000,19000,0
2018-06-01,964189605,A016160,과일가공품,푸드야 냉동 블루베리 1kg,5800,5800,0
2018-06-01,1121887884,I031010,장난감,PS Vita본체 PCH 2005(블랙)+ 16GB 메모리 증정,218000,218000,0
2018-06-01,1419329477,E011020,침대,[평상형 통깔판]SBS;우리 아이가 달라졌어요;방송협찬,150000,139000,-11000
2018-06-01,1717573657,A013160,맛살,건맛살(차오름 1K)X10/ 식자재 전문,257900,257900,0
2018-06-01,1036995545,C013010,점퍼,레터링 블루독점퍼 (48414-110-02)/ 블루독베이비,70400,59140,-11260
2018-06-01,552518367,I031040,생화,[카르닉] 캠핑테이블세트/야외용/휴대용/접이식테이블,30900,22290,-8610
2018-06-01,1010410121,A011100,라면,[면사랑] 함흥 냉면 20인분(동치미육수 10봉+비빔장 10봉),25900,19900,-6000
2018-06-01,1010410120,A011100,라면,[면사랑] 동치미 함흥 물냉면 10인분(동치미육수 10봉),17900,13000,-4900
2018-06-01,1253948339,I053010,공책,신학기 과목노트(음악)(10개입)-랜덤 학생공책 학생노,11370,11370,0
2018-06-01,510445405,E011050,책상,웨이커 스탠딩책상 서서일하는책상,278000,278000,0
2018-06-01,1327112709,F012030,안경,편안한 돋보기 안경테 휴대용 노안 돋보기안경 약70종,11500,11300,-200
2018-06-01,605736116,E031110,청소기,효리네청소기 스팀물걸레청소기 AM-7500BG/AM-5600,169000,169000,0
2018-06-01,896573129,A021010,커피,[네슬레]네스카페 수프리모(병)90G,7900,7900,0
2018-06-01,1717188921,A014020,분유,[아이배냇]순산양유아식 3단계 400g,16900,16900,0
2018-06-01,181479033,E021010,침구,순면워싱 차렵이불+패드+베개세트/이불세트,89900,89900,0
2018-06-01,1314981725,C011050,남자내의,GNN871 총알스판남자스키니청바지 스키니청바지 남성,48160,48160,0
2018-06-01,8763844,C011030,남자학생복,빅사이즈 베이직 가디건UN921-001라운드넥니트 빅사이즈 남성가디건 직장인패션 남자가,45440,40450,-4990
2018-06-01,1916275114,E041010,식기,숙씨네 이중스텐 우동기 냉면기 찬기 면기 탕기 그릇,1600,1480,-120
2018-06-01,1162468861,C013010,점퍼,투앤영 오버넥 바람막이 점퍼 스타디움 자켓 블루종,19800,18810,-990
2018-06-01,1282392075,E031090,공기청정기,[2018년 출시] 위닉스 공기청정기 제로S AZSH400-HWK,229000,229000,0
2018-06-01,5437535,E031130,보온매트,한일매트 전기매트 웰빙온돌마루 카페트매트 구들장,90000,49900,-40100
2018-06-01,1025806485,E011050,책상,위더스 컴퓨터책상 알파 1260,89900,89900,0
2018-06-01,895742731,E061070,가정용비닐용품,[3M]3M후레쉬백(중),2200,2200,0
2018-06-01,149508585,A018100,꿀,스페인 벌화분(비폴렌)500g / 꿀벌화분 벌꿀 비폴랜,17900,17900,0
2018-06-01,1288470783,C011030,남자학생복,신상 7부/반팔/긴팔/남방/셔츠/슬림/와이셔츠/루즈핏,17000,9800,-7200
2018-06-01,1010231501,A019150,김치,종가집 썰은포기김치(용기형) 450G,6480,6480,0
2018-06-01,2004432706,A019020,참깨,박피 들깨가루 (삼진 1k) X10,113140,100700,-12440
2018-06-01,989168078,E051020,건전지,에너자이저리튬CR2025 (4입),5990,5990,0
2018-06-01,515411666,L021010,손목시계,오토매틱시계/자동/기계시계/패션시계/남성/손목시계,27000,27000,0
2018-06-01,1428239369,C014020,유아복,아둘 패밀리룩 가족티 FLORIDA 56 유아반팔 티셔츠 12,9600,9500,-100
2018-06-01,488081717,E041010,식기,사무실/가게/상점/홈/풍수지리/인테리어/장식/엔틱/소,90700,88890,-1810
2018-06-01,1149719268,C014010,아동복,여름신상 아동복 주니어/긴팔/맨투맨/바지/의류,12700,12700,0
2018-06-01,1132553082,E011050,책상,타임 데스크 좌식 책상 컴퓨터 학생 철재 일자 테이블,21900,21900,0
2018-06-01,1302515313,A016100,수박,고당도 하우스 꿀수박 큰통 7~9kg내외/전용안전포장,16900,16900,0
2018-06-01,1308495290,C012040,여자학생복,MJ_1219 네이비 양털 조끼 퍼조끼 양털조끼 털조끼 남,29430,29430,0
2018-06-01,1666595264,I012010,컴퓨터,삼성LG컴퓨터/인강용/사무용/데스크탑본체PC/전시렌탈,199000,139000,-60000
2018-06-01,2058452092,C012040,여자학생복,단독가! 형지 본사 크로커다일레이디외 5천원~,10000,10000,0
2018-06-01,660750128,C013050,운동복,LED차량용 재떨이 휴지통 수납함 실내용품 자동차포켓,4500,4500,0
2018-06-01,86848964,E031080,선풍기,[TOUCH ME] USB 충전식 손난로 터치미 5200mA /스마트폰 보조배터리 + 충전,41000,41000,0
2018-06-01,1232178482,A022010,주스,오렌지주스(델몬트 1.5L)X6 경주스파 식자재 주스병,19730,19730,0
2018-06-01,86848965,E031080,선풍기,[TOUCH ME] USB 충전식 손난로 터치미 1800mA /스마트폰 보조배터리 + 충전,27900,27900,0
2018-06-01,86848966,E031080,선풍기,[TOUCH ME] USB 충전식 손난로 터치미 2600mA /스마트폰 보조배터리 + 충전,29950,29950,0
2018-06-01,1202137930,A019140,이유식,메디푸드-미니웰/멀티칼/하이칼/프로맥스/MCT오일,30600,30600,0
2018-06-01,896813166,A021010,커피,[동서]동서 맥심모카골드 (병/100G),6190,6190,0
2018-06-01,1873692923,E061010,세탁세제,구스다운워시(다운패딩침구세제)10회분+밀크코튼100ml,10900,10900,0
2018-06-01,483880440,C013030,스웨터,밀란시아 울기모 카브라폴라티 12-045-4 남성캐쥬얼,43950,43080,-870
2018-06-01,896813165,A021010,커피,[동서]동서 맥심 오리지날 (병/100G),6590,6590,0
2018-06-01,219294792,I031040,생화,헤드랜턴 USB 충전식 LED 해드랜턴 고광량 헤드램프,19500,17940,-1560
2018-06-01,1382410264,C011050,남자내의,[폴햄] 여성 브러쉬 3-L 숏팬츠(PHY2DH2042),39900,32320,-7580
2018-06-01,563697944,I031010,장난감,물놀이 오리보트 파스텔 장난감 파스텔오리보트 오리,7680,7680,0
2018-06-01,635760698,A013120,낙지,마른오징어(선택형)(20마리) 생산자직판,59150,59150,0
2018-06-01,718418430,C013050,운동복,야토 자동차 루프백 NW300L RV용 캠핑 가방 자동차캠,82220,73380,-8840
2018-06-01,366968787,C013010,점퍼,유아동 패딩_더플코트 스타일 유아 패딩점퍼_유아코트,26900,26100,-800
2018-06-01,1314930150,C013030,스웨터,밀란시아 양두 반폴라티 mar171-003 남성캐쥬얼 캐쥬,43950,43080,-870
2018-06-01,577367142,C013010,점퍼,[올리비아로렌] 베이직 포켓 가디건 VOBBCSM4261,26600,25010,-1590
2018-06-01,1549574240,E011050,책상,대나무원목 좌식책상 접이식테이블 밥상 독서대 멀티,16800,16800,0
2018-06-01,1122334968,I031040,생화,썬파인/해먹스탠드/풀세트/더블해먹포함/해먹거치대,138000,123430,-14570
2018-06-01,1435042585,C015030,넥타이,당일발송 나비넥타이 200종 보타이 유아아동 리본,2700,2700,0
2018-06-01,1667671850,A011170,떡,[신세계][9+1]궁중 두텁떡 2종 어버이날선물/스승의날,11800,11800,0
2018-06-01,1124442774,C013010,점퍼,남자자켓 포켓 라이더 레자자켓 자켓 라이더자켓 캐주,133000,131670,-1330
2018-06-01,1057416194,A022050,탄산음료,칠성사이다 355mlx24캔/콜라/맥콜/캔음료/음료수,14780,13900,-880
2018-06-01,586351437,A013050,오징어,오뚜기 꽁치 280g X 24EA 고등어 요리재료 식자재 가,78440,78440,0
2018-06-01,1471463628,A017170,풋고추,늘푸른 해마루 오이피클 슬라이스 3kg/대용량/피자/,5900,5900,0
2018-06-01,1228187018,I031040,생화,캡라이트 /헤드랜턴 /충전식/센서작동/usb충전,10900,9900,-1000
2018-06-01,1940145245,E031120,믹서,[엠엔] 엠엔 다용도 텀블러 미니 믹서기 6날 MMX-I50TPB,36900,34900,-2000
2018-06-01,2137485547,F012010,종이기저귀,[보솜이] 리얼코튼 밴드형 중형 남녀공용 46매 3팩,34900,34900,0
2018-06-01,1534147965,A018010,초콜릿,가나초코바 미니초콜릿 575g,7000,7000,0
2018-06-01,503670810,C013010,점퍼,여성 셔링 포켓 포인트 후드 롱 점퍼(TUMAD2142)/ 비키,329000,296100,-32900
2018-06-01,896813188,A021010,커피,[동서]동서 맥심 아라비카 (병/100G),7890,7890,0
2018-06-01,373239109,E061010,세탁세제,퍼실 대용량 액체세제 10L 유니버셜,32900,26400,-6500
2018-06-01,1888374491,C012020,원피스,[스테파넬]데님원피스 (SF7MOP910)(김해점),78000,63210,-14790
2018-06-01,1983105990,E031110,청소기,아이룸 AST-009 무선청소기 진공청소기 차이슨 청소기,149000,149000,0
2018-06-01,2131676983,E011030,거실장,[시니프][무료배송][마이너스옵션6만원]하이그로시-엑스큐브TV거실장/tv다이/장식장/t,164000,123300,-40700
2018-06-01,488081742,E041010,식기,사무실/가게/상점/홈/엔틱/풍수지리/인테리어/장식/소,90700,88890,-1810
2018-06-01,1176415741,C013020,티셔츠,[3+1][비비안]임부 30D고탄력 팬티스타킹/80D 임부레깅스/타이즈 (3개구매시 1개 더),8400,8300,-100
2018-06-01,989940915,L012060,샴푸,[LG]LG)닥터그루트샴푸(지성두피용)400ML,19000,19000,0
2018-06-01,1451545382,C013040,청바지,[메이드]일자청바지/데님/워싱/슬림/밴딩/남자/남성,12800,12800,0
2018-06-01,367669207,A022010,주스,키위농축액(삼아 835ml)/원탑몰 /식자재/식당/식자재,3380,3380,0
2018-06-01,265540372,C012040,여자학생복,화사한 꽃프린트 숏로브 (421890)/ 밸리걸,9900,8910,-990
2018-06-01,1895056981,C012040,여자학생복,[비키]미 버튼 프론트 가디건 (TMCCE2912),41600,39520,-2080
2018-06-01,568531599,L021050,우산,[MLB]16K두폭장우산 빅사이즈 자동 장우산,16500,16500,0
2018-06-01,609633775,C012060,여자내의,[나인(NAIN)]플로럴 풀 스커트(SK-2822)(대구신세계),69000,63590,-5410
2018-06-01,1003609510,C013050,운동복,[미르웨이 후사경] 차종별 선택가능 : 갤로퍼 싼타페 산타모 테라칸 투싼 트라제 카니,27000,24600,-2400
2018-06-01,682069970,E021010,침구,품질좋은 사계절 이불커버/순면/아사/알러지케어,21900,21900,0
2018-06-01,15619367,C011050,남자내의,밍크/여밑단 포근하고 따뜻한 밍크 시보리 파자마,13500,12020,-1480
2018-06-01,466677157,A013050,오징어,오뚜기 고등어 280g X 24EA 캔 가공통조림 고등어통조,61240,59410,-1830
2018-06-01,450161462,C015040,장갑,아놀드파마_APGW_BY1210(여성장갑) 장갑 아놀드파마,21010,18910,-2100
2018-06-01,722039930,L012040,치약,(CMIT/MIT 無) 덴티스테 칫솔/치실/혀클리너 모음,13200,12500,-700
2018-06-01,357226096,A021010,커피,[당일출고/무료배송]카누아이스 100T+텀블러/카누120T,18500,18500,0
2018-06-01,1209522113,C013050,운동복,세상 시원해!언제나 옳은 클릭앤미 트레이닝세트/린넨,5900,5900,0
2018-06-01,988034160,A018050,비스킷,롯데 빠다코코넛 오리지날 300G,3460,3460,0
2018-06-01,152377585,E061010,세탁세제,EM 세탁세제 1000ml / 친환경/섬유유연제/주방/이엠,14950,14950,0
2018-06-01,1464952934,A018070,파이,롯데 달콤한 초코파이/몽쉘/마가렛트/카스타드 모음,2400,2400,0
2018-06-01,1455822263,A013040,고등어,참바다 노르웨이 순살 고등어 14팩,11500,11500,0
2018-06-01,988034161,A018050,비스킷,롯데 제크 오리지날 300G,3360,1990,-1370
2018-06-01,230009127,I011030,사진기,소니 A7 III (+ FE 24-105mm 렌즈포함) 정품 주)클락,4700000,4511910,-188090
2018-06-01,415932501,C013040,청바지,EX 88 1 밴드 청반바지 청반바지 청5부 청 반바지 남,54190,53110,-1080
2018-06-01,224320523,A022050,탄산음료,칠성사이다210mlx30입 / 펩시콜라210mlx30입,10500,10500,0
2018-06-01,2051283380,C013010,점퍼,[푸마] (사이즈 : L(100)) 아스널 컵 롱 벤치 자,206530,206530,0
2018-06-01,463014851,A012010,국산쇠고기,[냉장] 남해한우 1등급 구이스페셜 3kg/등심3팩 채끝2팩 안심1팩/ 남해축협,359000,359000,0
2018-06-01,980250595,C011030,남자학생복,스판소재의 핀 깅엄체크 셔츠 ZAX1WC7106/ 올젠,35000,30450,-4550
2018-06-01,411329708,A011100,라면,감자전분(모아 20K),71520,71520,0
2018-06-01,597189634,E061020,섬유유연제,다우니 고농축 섬유유연제 1L 2개 당일 무료배송.,11700,11700,0
2018-06-01,826059401,E061030,전구,오스람 36W 55W 24W 45W 18W FPL 삼파장 FDL FDX FPX,1470,1470,0
2018-06-01,686995020,C013050,운동복,BMW 엠블럼 타이어 에어밸브캡 전차종 가능 패션 에어,16000,15520,-480
2018-06-01,1568215641,C013020,티셔츠,[게스][18SS] MI2K9415 남 NEW 로고 반팔 티셔츠/ 게스,16900,16900,0
2018-06-01,995556130,L021030,가방,수제공방 명품 EREDL/ITALY 프리미엄 카프가죽/에레들,348000,348000,0
2018-06-01,431595259,A018100,꿀,[마천농협]지리산 벌집꿀 3 kg / 꿀 벌꿀 명절선물,84000,84000,0
2018-06-01,2084591059,E061100,습기제거제,물먹는 제습제/옷장용/8개입4팩/3팩6개/중 선택,30800,30800,0
2018-06-01,1679458032,A011010,쌀,햅쌀 추청 경기미 20kg 국내산 쌀 백미 아끼바레,51900,51900,0
2018-06-01,1067399424,A011180,파스타면,오뚜기스파게티면500g/오뚜기마카로니500g/스파게티,790,790,0
2018-06-01,1629365242,L021020,장신구,[라라쥬얼리]Silver실버 남녀 팔찌/발찌 67종 모음전,21760,21760,0
2018-06-01,1891953547,L012060,샴푸,닥터포헤어 폴리젠 플러스 샴푸 500ml 1개 2개+사은품,18700,18700,0
2018-06-01,887185500,E031070,에어컨,20인치공업용벽걸이선풍기/18인치업소용벽걸이선풍기,58000,58000,0
2018-06-01,85787165,A013090,전복,국내산 새꼬막 1.5kg (상) 새벽조업후 발송 산지,32970,32970,0
2018-06-01,1764420360,C013010,점퍼,여자무스탕코트 롱무스탕 여성맞춤무스탕코트,2089500,2089500,0
2018-06-01,1541893095,C013040,청바지,아둘 패밀리룩 조던 민소매 메쉬 상하의 나시세트 39,15900,15900,0
2018-06-01,1536999455,E011060,의자,판매1위 무료반품 컴퓨터/책상/학생/사무용의자,33840,33840,0
2018-06-01,794360523,I012010,컴퓨터,Apple 공인판매점 2017 iMac [MNE92KH/A] 27형,2003000,1902850,-100150
2018-06-01,2008289259,C012020,원피스,니트배색 반코트 BACT85761/ 베네통,248960,224070,-24890
2018-06-01,216879603,C013020,티셔츠,[간쓰리] 30%쿠폰 3장추가할인 프리미엄 반팔티 M~XXL,9800,9800,0
2018-06-01,838383825,C011030,남자학생복,아메리칸웨스트 남성 가디건 Dike,19900,9950,-9950
2018-06-01,984551468,A011010,쌀,농사꾼 메뚜기쌀 (포)/10KG,31900,31900,0
2018-06-01,251495853,C013010,점퍼,여름/국내생산/95~110사이즈/정장자켓/콤비자켓,59000,59000,0
2018-06-01,1410266705,I011030,사진기,(주)아랑/정품/EOS 6D/바디,1200000,1104000,-96000
2018-06-01,1199453341,C013040,청바지,남자바지 클래식 체크 핀턱 와이드 팬츠 팬츠 와이드,60510,60510,0
2018-06-01,2048133052,L021020,장신구,비주트리 925실버 은반지 베스트상품 모음전,10500,10500,0
2018-06-01,911167231,A012050,소시지,사조 꼬마장사 왕소시지 대용량/치즈소시지/간식/햄,10900,10900,0
2018-06-01,1162070551,E061040,부엌용세제,퐁퐁 베이킹소다/아침보리/레몬식초1200mlx10(1BOX),23500,23500,0
2018-06-01,365726293,A018100,꿀,[청우팜] 벌침/벌침벌/봉침벌/프로폴리스/꿀벌,12000,11500,-500
2018-06-01,311560060,C013050,운동복,대형 차량커버 외장커버 차량용커버 세차 황사 차커버,67720,67720,0
2018-06-01,1449532510,C015030,넥타이,[찐링]수동넥타이 지퍼넥타이 나비넥타이 자동넥타이,2900,2900,0
2018-06-01,704940859,I031040,생화,덩컨/6000루멘/ L2/ 5발 /초강력서치/국내최강/,43900,38900,-5000
2018-06-01,339962120,L021020,장신구,10월탄생석 5mm 천연투어멀린 티아라 원터치귀걸이,265000,265000,0
2018-06-01,550677633,C014010,아동복,로하스 한지 키즈 캐미솔 NO1 닥나무 원료의 한지를,18020,18020,0
2018-06-01,427504174,A022050,탄산음료,라무네사이다 200mlx30병 구슬사이다 포도맛/딸기맛,42500,42500,0
2018-06-01,1369608873,A022050,탄산음료,[페트음료]탑시 1.5L 칠성사이다 펩시콜라 써니텐,10500,10500,0
2018-06-01,1088871148,E011030,거실장,[채우리] 모노 소나무 협탁 480,81000,81000,0
2018-06-01,2024602935,I031040,생화,야전삽 캠핑삽 멀티툴 삽 캠핑용품 파이어스틱 손도끼,69900,64310,-5590
2018-06-01,1088871147,E011030,거실장,[채우리] 샤론 소나무 협탁 480,81000,81000,0
2018-06-01,150400374,A013090,전복,제이에스 냉동백합조개 1kg2개,19510,19510,0
2018-06-01,659317841,C012040,여자학생복,무료배송/셔츠모음/스트라이프남방/베이직셔츠/헨리넥,8900,8900,0
2018-06-01,1319826324,C021020,구두,남성구두 M2191 키높이 5cm 끈타입 신사화 정장화 남,57610,57610,0
2018-06-01,1899671751,C013020,티셔츠,[필골드] SLKN503 노르웨이 겨울숲 오버핏라운드니트,39800,39800,0
2018-06-01,532113969,A019070,양념소스,맘스맘 불닭소스 2kg /냉장,9900,9900,0
2018-06-01,989168080,E051020,건전지,에너자이저리튬CR2016(4입),5990,5990,0
2018-06-01,1722275692,C021010,아동화,끈이없는 다이얼 아동화 아동운동화 다이나믹k,29900,29900,0
2018-06-01,1556878130,C011050,남자내의,봄 여름 링클프리 중년 남자 바지 남성 면바지 골프,19800,19800,0
2018-06-01,714308995,E041020,컵,일리 정품 로고 에스프레소컵(60ml)/잔/도자기/샷잔,18500,17210,-1290
2018-06-01,1011123366,L021050,우산,[로보카폴리] 하이드로겔밴드(18매입 원형)_10개,40000,16900,-23100
2018-06-01,855345776,L021020,장신구,원석sale/천연수정/quartz/7.83ct,45000,45000,0
2018-06-01,752262651,E061040,부엌용세제,(박스판매)LG 퐁퐁 주방세제 레몬식초 1200ml x 10개(,40100,35290,-4810
2018-06-01,631344030,F011150,건강기능식품,(알뜰/4개월분)파미스 트리플 마그네슘 120정(대용량),13700,13700,0
2018-06-01,700729319,E061060,살충제,쌀벌레퇴치제2gx3개 좀벌레 쌀벌레 제거제 겨자성분,4760,4760,0
2018-06-01,1409889512,C012040,여자학생복,봄신상 빅사이즈 66-110 블라우스 롱 남방 셔츠 모음,32200,28900,-3300
2018-06-01,694109016,C013050,운동복,봄신상 긴팔 트레이닝복 세트/ 빅사이즈/후드집업세트,29800,29800,0
2018-06-01,512408406,C011020,남자상의,남성 스판여름린넨정장 수트/블레이져자켓/린넨슬랙스,94000,94000,0
2018-06-01,989109705,A016150,아몬드,카카오닙스 200G,6990,5990,-1000
2018-06-01,1469423218,A012010,국산쇠고기,{TV홈쇼핑정품}명장 꼬리반골 한우 세트/사태/사골,98000,97020,-980
2018-06-01,947803443,A016020,배,2017 추석 미래로 프리미엄 고급배 선물세트 추석선물,66910,64910,-2000
2018-06-01,1156703629,C012060,여자내의,바르방 징 미니 스커트 (CD511Q287)/ 스튜디오화이트,36000,34200,-1800
2018-06-01,810806196,C013040,청바지,[컨셉원] 10117508 / 117508 히든 밴딩 슬랙스 여름 버전 (블랙),38000,31160,-6840
2018-06-01,537990050,C012040,여자학생복,빅사이즈 DEB1593 겹 브이넥 롱 조끼 803 빅사이즈 여,31890,31890,0
2018-06-01,1088871178,E011030,거실장,[채우리] 모카 800 서랍형 콘솔,159000,159000,0
2018-06-01,1088871177,E011030,거실장,[채우리] 모카 1000 서랍형 콘솔,171000,171000,0
2018-06-01,1108864945,C011050,남자내의,[게스]MI2D9953 [기획] 화이트 반바지 (본점),46400,40510,-5890
2018-06-01,1088871176,E011030,거실장,[채우리] 모카 1200 서랍형 콘솔,201000,201000,0
2018-06-01,1067039372,A017040,양배추,무배 스페인 냉동 밀푀유 밀포위 시금치 다이스 1kg,11480,11480,0
2018-06-01,1088871174,E011030,거실장,[채우리] 솔잎 소나무 거실장 1230,300000,300000,0
2018-06-01,1088871173,E011030,거실장,[채우리] 잎새 소나무 거실장+협탁 1800,396000,396000,0
2018-06-01,1088871172,E011030,거실장,[채우리] 잎새 소나무 거실장 1200,246000,246000,0
2018-06-01,913637301,A013170,생선통조림,동원참치 살코기 150g x 10 + 1000ml 반찬통 증정,19000,19000,0
2018-06-01,1088871171,E011030,거실장,[채우리] 잎새 소나무 협탁 600,167000,167000,0
2018-06-01,1777261292,A019110,드레싱,코리원/백설 오리엔탈 드레싱 소스 2kg/샐러드/연어,10200,10200,0
2018-06-01,1996399180,A016160,과일가공품,블루베리안주 (소울 350g) X6,130510,116160,-14350
2018-06-01,1385860655,A011160,빵,안흥찐빵마을 수제 찐빵 500g(10입) 수제 초코블랙 찐,25370,25370,0
2018-06-01,416680107,C013030,스웨터,아이보리 양면 양털 집업 남성의류 남자외투 니트집업,71130,71130,0
2018-06-01,539982402,C013050,운동복,차량 리얼 카본 도어가드 벤츠 아우디 랜드로버 TRD,13000,11610,-1390
2018-06-01,460411922,C015040,장갑,양가죽 무스탕 벙어리 여성장갑 킹스맨 벙어리장갑 여,25070,25070,0
2018-06-01,1853808475,A011040,보리쌀,무료배송 볶음 서리태 1Kg / 볶음검은콩 볶은검정콩,8900,8900,0
2018-06-01,2049125872,C013020,티셔츠,국산 반팔티/무지티/라운드티/면티/흰티/단체티/반티,3600,3600,0
2018-06-01,336362515,A018040,아이스크림,누텔라 바나나 아이스크림 만들기 홈베이킹 쿠킹박스,23000,20000,-3000
2018-06-01,762289193,F011150,건강기능식품,국산헛개차 CJ 헛개수 500ml x 20병 컨디션 헛개수,14200,13210,-990
2018-06-01,1859233382,A022010,주스,매일 피크닉 200ml x 24팩/사과/청포도/과즙음료,6900,6900,0
2018-06-01,814869708,E061060,살충제,방역용살충제 롱다운 벅클린유제 람다킬MC 분무/연막 겸용 바퀴벌레약 개미약 모기약,30000,30000,0
2018-06-01,1157534003,C012060,여자내의,미니 청 스커트 (CD311Q791)/ 스튜디오화이트,29000,27550,-1450
2018-06-01,720529606,A012030,돼지고기,[이베리코 최고등급  베요타100%] 꽃목살 -구이용,12000,12000,0
2018-06-01,767701455,I031070,애완동물관리비,4구 미니 당구대 탁구대 하키 접이식,190000,186170,-3830
2018-06-01,867760558,C014010,아동복,여름/아동/아동옷/아동의류/아동복/상하복/여아반팔,11200,11200,0
2018-06-01,1467832791,C013020,티셔츠,[케이투]CIRCUUL360 TECH THROUGH-LR W (KWP17280),47000,37600,-9400
2018-06-01,886734423,A016020,배,2017년 햇배 15kg 대용량 큰 크기/우체국택배,17900,17900,0
2018-06-01,541672919,C013050,운동복,뮤라스 밴딩 핫팬츠 트레이닝 면 반바지 FREE/L,6900,6900,0
2018-06-01,2047157455,C011030,남자학생복,피쉬본 패턴 파란색 블루 프린팅셔츠 긴팔남방 남성남,34270,34270,0
2018-06-01,482206859,C014010,아동복,번개맨옷 터닝메카드R 카봇 스파이더 아이언 쥬쥬 옷,11500,11500,0
2018-06-01,314320107,A017110,감자,송고버섯 중 20-35개1kg 진하고/향긋한/송이향/고기맛 같은 쫄깃한 식감/표고버섯/송,63860,60860,-3000
2018-06-01,777419445,C012040,여자학생복,레이스 리본 가디건 여름 니트 7부 얇은 노카라 비치,17500,17500,0
2018-06-01,911598129,E031130,보온매트,한일 단풍황토 전기매트 1인용,108000,108000,0
2018-06-01,1419317448,A017120,고구마,2018년 햇 감자 속노란 홍감자 자색감자 10kg,48000,48000,0
2018-06-01,1494092505,L021010,손목시계,보헤미안 스타일 시계팔찌 6개 -깡통악세사리 패션,55140,55140,0
2018-06-01,532150918,A011010,쌀,[참쌀닷컴] 대왕님표 여주쌀 추청 10kg,32800,32800,0
2018-06-01,1183230998,C014010,아동복,알로봇 남아 아동 155 오리털 다운 패딩 자켓 점퍼 짱,54950,54950,0
2018-06-01,450305661,C013030,스웨터,[톰앤래빗 니트/가디건모음] 민소매니트/롱가디건,10000,9900,-100
2018-06-01,208671916,C013060,등산복,[빈폴아웃도어]블랙 남성 에어홀릭 FLY 바람막이 (BO8439B035),111300,87930,-23370
2018-06-01,2046948112,C012060,여자내의,[모조에스핀]하이웨스트 스커트_S174MSD023(BK1),89000,84550,-4450
2018-06-01,988901051,E061070,가정용비닐용품,초L) 쿠킹호일 30CM*30M(18U),6500,6500,0
2018-06-01,1126018173,C013050,운동복,9월신상/제노바 썬글라스&카드 클립/올뉴카니발 qm6,5000,4510,-490
2018-06-01,737660904,A019110,드레싱,CJ 미니 유자 샐러드소스(115G),1380,1380,0
2018-06-01,603677885,A017110,감자,쥬스용 제주당근 햇당근 못난이(최상품),20900,20900,0
2018-06-01,1244377432,I031010,장난감,뽀로로 첨벙첨벙 수영하는 크롱 목욕 장난감 물,13860,12200,-1660
2018-06-01,1527898022,A011120,두부,켈로그 콘푸로스트 600g,3200,3200,0
2018-06-01,492258126,C012040,여자학생복,[플리츠미] 후드 숏 플리츠 자켓,143200,114560,-28640
2018-06-01,385054480,C013010,점퍼,여성 체크코트 후드코트 KK 셀린체크 후드CT 가을자켓,99350,99350,0
2018-06-01,1522316638,F012010,종이기저귀,리베로 기저귀 밴드형/팬티형 4팩 유럽제조,69900,69900,0
2018-06-01,450136543,C013010,점퍼,K2 S 무스탕 가죽점퍼 21 라이더점퍼,130570,130570,0
2018-06-01,1262014073,C021020,구두,VA-153 앵클부츠 천연가죽 남성구두 구두 정장화 남자,60430,60430,0
2018-06-01,1311628523,C011050,남자내의,스포츠바지/운동복/운동/5부/3부/수영복/헬스/반바지,7000,6900,-100
2018-06-01,2094547206,C021040,실내화,운동화 WX608V4W 뉴발란스 (흰남) NEWBALANCE 뉴발란,96000,96000,0
2018-06-01,329319210,C013010,점퍼,[무료배송]푸조 남녀공용 기모 양털 후드집업(FZ324-3,42700,42700,0
2018-06-01,1379661529,I012010,컴퓨터,정품 윈도우10 리퍼PC 대기업 렌탈 1년A/S 무료반품,128000,128000,0
2018-06-01,1575074358,E031010,전기밥솥,쿠첸 정품 원터치 커버 분리형 패킹 세트/SY,18400,18400,0
2018-06-01,225995281,E011040,소파,[우아미ON] 플라카 4인용 천연가죽소파/쇼파,547000,492300,-54700
2018-06-01,1621568636,A018050,비스킷,[그린너트] 에브리데이넛츠 블랙25g 30+30개입 +10봉 더,27900,25910,-1990
2018-06-01,1108781364,I011020,영상음향기기,CnK 빔프로젝터 GMK1 대실수5탄,299000,299000,0
2018-06-01,988213067,E061080,키친타월,[유한킴벌리]유한킴벌리) 크리넥스 뽑아쓰는 키친타올 140매*4,9900,8500,-1400
2018-06-01,2001263405,E031010,전기밥솥,쿠첸 WM-1083 //10인용 원터치 취사보온 전기밥솥,35900,35900,0
2018-06-01,1059504558,E011050,책상,가구뱅크/올뉴프리탑/중역의자/컴퓨터의자/,34000,34000,0
2018-06-01,581334805,I031040,생화,[몬스터파라솔][국산]카본파라솔/테이블/의자/받침대,49500,49500,0
2018-06-01,2139520299,C012030,여자상의,단배색플리츠원피스 MN1710 배색패턴원피스 예쁜원피,42110,42110,0
2018-06-01,1597090680,F011130,홍삼,정관장 화애락 본(70ML*30),130000,130000,0
2018-06-01,313973617,C013010,점퍼,인조이 롱 점퍼 (블랙) 가볍게 걸쳐입기 좋은 시보,38010,38010,0
2018-06-01,334687973,E061010,세탁세제,세제 아기사랑3p선물세트 유아세제 유아전용세제 액체,42110,42110,0
2018-06-01,387239867,C015030,넥타이,(색상 : 레드) BTIE_096 체크 보타이 정장리,13420,13420,0
2018-06-01,1353187383,F012020,생리대,화이트 입는 오버나이트 팬티형 중형 8P x 1팩,8800,8800,0
2018-06-01,1091730449,A012030,돼지고기,저지방 돼지목등심500g 다용도선택 구이/볶음/수육,3900,3900,0
2018-06-01,990759110,E031110,청소기,(공식)한경희강력살균 핸디스팀청소기HS-101Y/HS-101S,49000,49000,0
2018-06-01,1132746740,C015040,장갑,(2018)봄여름 등산장갑/반장갑/트레킹장갑,6800,6090,-710
2018-06-01,1409635453,A015020,식용유,살림터 미드미 고추맛기름1.8L 한식용 중식용,11300,11300,0
2018-06-01,492283119,C012020,원피스,[플리츠미] 밑단 자수레이스 팬츠,135200,108160,-27040
2018-06-01,1943017384,C012040,여자학생복,[패션플러스][시슬리]네추럴 라인 후드 베스트 가디건(SAKC48161다크그레이),75600,71820,-3780
2018-06-01,1966645218,L012090,기초화장품,미샤 미사 금설 기윤 아이크림 30ml,24870,24870,0
2018-06-01,616213075,E031090,공기청정기,LG 공식인증점 퓨리케어 공기청정기 AS122VDS 38.9㎡,319000,299000,-20000
2018-06-01,245740215,C012040,여자학생복,(예사랑)여성 인견 조끼 17YB10,59000,58410,-590
2018-06-01,749222060,A011140,부침가루,[삼립] 삼립 뉴욕치즈무스 조각케익 (75g 5입) 케이크,13000,12870,-130
2018-06-01,988901049,E061070,가정용비닐용품,초L) 지퍼백(특) 30*35*20매,3500,3500,0
2018-06-01,1263138999,C014010,아동복,코코비-여름신상오픈!아동상하복/레깅스/원피스,7900,7900,0
2018-06-01,451116795,C011030,남자학생복,BIGWM WN 602 (남) 빅사이즈 투톤케이블단추긴팔니트,53040,53040,0
2018-06-01,1156639288,C012040,여자학생복,오브제 여성 85 프릴 랩 7부소매 블라우스 블랙 가을,32970,32970,0
2018-06-01,988009397,A019150,김치,초L) 맛김치(용기형) 1.5KG,10800,10800,0
2018-06-01,1972357097,I031040,생화,바낙스 슈퍼 레이온2 0.8 1호 1.5호 2호 3호 바다릴대,160240,134610,-25630
2018-06-01,519550969,A019030,생강,하지카미 (생강순 605g) X10,282900,251790,-31110
2018-06-01,1467242013,E061050,청소용세제,유원말통18kg (대용량 유한락스 18kg) 업소용/가정용,7900,7900,0
2018-06-01,892400114,L012010,면도기,쉬크 하이드로5 면도날 총17입+기/프리미엄+사은품,35500,35500,0
2018-06-01,1743496842,E031020,가스레인지,무료배송설치/ SK매직 가스 오븐 레인지/GOR-S2200,607600,607600,0
2018-06-01,1108056389,A019050,간장,(샘표 진간장 금F3 1.8L x 2개) 진간장1.8Lx2개/양조,8500,8500,0
2018-06-01,2096936330,C011030,남자학생복,FSSF18007 블루 비행기 패턴 셔츠 패턴셔츠 남자남방,38000,37620,-380
2018-06-01,1489245347,C014020,유아복,아둘 쥬니어 커플 엄마랑 도날트덕 롱 원피스 티 12,14300,14300,0
2018-06-01,1486279241,F011150,건강기능식품,[광동] 옥수수수염차 340ml x 20병/헛개차/우엉/야왕,13950,13950,0
2018-06-01,562032467,C013050,운동복,강력 성에제거기500ml_9268 성에제거 강력성에제거제,11770,10730,-1040
2018-06-01,1965895346,C021040,실내화,여성 스니커즈 키높이 통굽 펀칭 운동화 슬립온 슈탐,28700,28700,0
2018-06-01,1451450418,A019180,즉석식품,즉석국 600g/볶음밥/갈비탕/육개장/곰탕/해장국/국,1390,1390,0
2018-06-01,1749450496,I031040,생화,[피티타임] JS-2868 LED 캠핑랜턴 등산용품 캠핑용품 생존용품,6440,6440,0
2018-06-01,598944307,A014030,치즈,크레프트 파마산치즈 치즈가루 227g 24개,205700,205700,0
2018-06-01,368202619,L021010,손목시계,JPM 남자시계 50종 가죽/메탈/스포츠/손목/패션/커플,24800,22800,-2000
2018-06-01,861070474,A013090,전복,(맛나)박스/백합1kg*5,25900,23310,-2590
2018-06-01,1037153164,F011130,홍삼,6년근 데이홍삼정 10gx30포/에브리데이활력홍삼정,27500,27500,0
2018-06-01,1362183861,C012060,여자내의,허리밴딩 끈조걸 큐롯팬츠 치마같은바지 치마바지,11500,10700,-800
2018-06-01,656264105,C012040,여자학생복,면아일렛자수셔링블라우스 HRBL321E/ 쥬시쥬디,69000,58650,-10350
2018-06-01,1240221458,A014030,치즈,덴마크 인포켓 스트링치즈 20gx40개 아이스박스 포장,28900,28900,0
2018-06-01,352348585,F011150,건강기능식품,전북정읍 귀리 미숫가루 500g,10500,10500,0
2018-06-01,697785560,I031040,생화,CREE L2 헤드랜턴 LC-2166/등산낚시 캠핑후레쉬 18650,15000,13430,-1570
2018-06-01,386426386,C021020,구두,로하 샌들 LKR272 여자샌들 여성샌들(YA02004),58200,54710,-3490
2018-06-01,1489245352,C014020,유아복,아둘 쥬니어 커플 엄마랑 도날트덕 롱 원피스 티 11,14300,14300,0
2018-06-01,441180662,C013010,점퍼,앙팡 래쉬가드 집엎 (네이비) 집업 어린이옷 물놀이용,24980,24980,0
2018-06-01,1624348074,A022050,탄산음료,스프라이트 185ml 30캔/ 음료수 탄산음료 사이다 / 커,10300,10300,0
2018-06-01,2046951739,C012020,원피스,[모조에스핀]포켓퍼포인트 오버핏코트_S174MSG430(BK1),399000,379050,-19950
2018-06-01,1842237471,C013010,점퍼,바람막이 패딩수선 패딩수선패치 옷수선테이프 테이프,9000,9000,0
2018-06-01,958573808,E061080,키친타월,[쌍용씨앤비]코디 키친타올 (150매*4+4),6550,6550,0
2018-06-01,1656250237,F011120,인삼,(장생농산장수산삼 7년근 3주(3뿌리) 부모님선물 선물,133200,133200,0
2018-06-01,572752799,C012040,여자학생복,오픈루즈털조끼 IR1712 털조끼 베스트 여자베스트 여,120830,120830,0
2018-06-01,1202686217,C013020,티셔츠,[락홀드] 마스터베어 남성 언더레이어 여름 이너웨어,10060,10060,0
2018-06-01,1362183856,C014010,아동복,[젤리스푼][젤리스푼] 멋지게입는워싱데님팬츠_MO,23900,21510,-2390
2018-06-01,621980563,C013020,티셔츠,브랜드특가/PK티셔츠/카라티/반팔티셔츠/골프웨어,26000,20300,-5700
2018-06-01,867060093,E031120,믹서,JB3010 브라운 믹서기 티리뷰트 컬렉션 블렌더 dk,64500,60350,-4150
2018-06-01,979212534,C013010,점퍼,(제스) 여름 셔츠/티셔츠/팬츠,10000,10000,0
2018-06-01,1263148354,A022020,두유,베지밀A/B/아몬드와호두/검은콩/애플망고(64팩)두유,33500,33500,0
2018-06-01,476372269,C012060,여자내의,스티아미아(STIAMIA) 쿨 썸머 팬츠 3종,39900,36710,-3190
2018-06-01,2007999250,A019110,드레싱,S&B 생와사비 소스(158G),5880,5880,0
2018-06-01,1422308029,C013040,청바지,남성 밑단 데미지 스키니 데님팬츠 (B175Z0262P)/ 버커루,59000,50150,-8850
2018-06-01,959497428,A011160,빵,[황금보리] 순수 국내산 보리로 만든 찰보리빵 30개입 (개당25g) / 무료배송,14900,13500,-1400
2018-06-01,269407681,G011070,자전거,삼천리자전거 나비드D MTB자전거 접이식자전거,280000,252000,-28000
2018-06-01,815162241,E031120,믹서,키친아트 다용도믹서기 신일 믹서기 미니믹서기 주서,21900,21900,0
2018-06-01,1756918220,A022010,주스,초록매실 180mlx15캔/180mlx12병/선물세트/음료세트,7900,7900,0
2018-06-01,959497425,A011160,빵,[황금보리] 순수 국내산 보리로 만든 찰보리빵 50개입 (개당25g) / 무료배송,23900,19900,-4000
2018-06-01,939775337,L021030,가방,LG 그램15 노트북가방/15형노트북가방/숄더백/LG정품,24800,24800,0
2018-06-01,1211373973,C014010,아동복,[게스키즈]ATH 7부팬츠G83KDP011-그레이/네이비2가지색상,46000,36800,-9200
2018-06-01,1578306402,C013060,등산복,작업복/봄등산바지/여름등산바지/낚시복/작업복바지/,8900,8100,-800
2018-06-01,644344374,A019080,고추장,(초특가) 해찬들 태양초 고추장 4.5kg / 6.5kg순창,14000,12900,-1100
2018-06-01,693807243,I011020,영상음향기기,LG미니빔TV 프로젝터 HF60FAG 스마트빔 빔프로젝터,1252630,1190000,-62630
2018-06-01,311138545,C015040,장갑,아디다스 퍼포먼스 니트글러브(BP5348) 겨울용장갑 방,32430,32430,0
2018-06-01,89621127,C012040,여자학생복,[MLB]엠엘비 2종택1 남성 실켓쭈리 MLB 후드집업(31TRC6811),79000,67150,-11850
2018-06-01,2046951710,C012020,원피스,[모조에스핀]밍크소매 롱코트_S174MSG428(ME1),499000,474050,-24950
2018-06-01,1216361125,E061060,살충제,바퀴벌레약/개미약/좀벌레약/진드기약/살충제,9400,8900,-500
2018-06-01,529673736,C012060,여자내의,허리조절 스판 네이비 교복치마 교복 예쁜교복 교복쇼,43580,42280,-1300
2018-06-01,468834159,C013020,티셔츠,T1432-베이직 슬라브 티셔츠 여성데일리셔츠 기본티셔,12620,12620,0
2018-06-01,552089465,C013010,점퍼,[플레이팝][플레이팝]보머퀼팅항공점퍼블루종 4종택1,32900,30270,-2630
2018-06-01,1180252718,A011120,두부,코리원/유기농 오트밀 1kg(1+1)/다이어트/압착/귀리,13900,13900,0
2018-06-01,1433436089,C013020,티셔츠,정품디즈니 미키마우스 맨투맨티/후드티셔츠/봄신상,9900,9900,0
2018-06-01,1621843221,E011050,책상,해머 원목식탁 6인용식탁세트 회의용테이블 2인용책상,219000,197100,-21900
2018-06-01,1647439475,F012020,생리대,위스퍼 피부애 보송보송 대형 슈퍼롱 오버나이트 모음전,15800,15800,0
2018-06-01,1686094631,C014010,아동복,[쁘띠뮤] 30%쿠폰/여름신상/상하복/래쉬가드/무료배송,8900,8900,0
2018-06-01,1778706887,L021020,장신구,[바보사랑]링게이지,11000,11000,0
2018-06-01,533336082,C012040,여자학생복,보풀방지 블랙 롱 교복조끼남자 교복 예쁜교복 교복쇼,25720,24950,-770
2018-06-01,821324965,A018060,스낵과자,[무료배송]브이콘40봉/난 나나콘1박스/오란다/안주,17400,17400,0
2018-06-01,1571170066,E011040,소파,[동서가구]LV 테라 라텍스탑 천연가죽 3인 4인 소파,349000,349000,0
2018-06-01,182746230,A011090,국수,컵누들 6종 (12입) 매콤/우동/쌀국수/팟타이/라면,11600,11600,0
2018-06-01,742386660,C012020,원피스,여성정장 투피스 자켓 치마 바지 유니폼 오피스2,85000,85000,0
2018-06-01,248193399,L021030,가방,가죽/서류가방/책가방/학생/남성/노트북/크로스/CM01,118800,118800,0
2018-06-01,1990794276,E061040,부엌용세제,1+1 프릴 2개구성 주방세제 베이킹소다 용기 리필,9000,8900,-100
2018-06-01,1889119367,C013010,점퍼,[위쉬몰][위쉬몰]MO 심플핏가죽자켓(Y710M),79200,67320,-11880
2018-06-01,2002586625,A018100,꿀,천연당진꿀 토종 벌꿀 아카시아 밤꿀 진꿀 1등급 꿀,80000,75000,-5000
2018-06-01,1815137944,C011050,남자내의,[프랭키뉴욕]쿨링스판 린넨 밴딩 빅사이즈 마바지_HE7SPA08,18720,16850,-1870
2018-06-01,1088726156,L021010,손목시계,CASIO 카시오 LTP-1095Q-1A 여성용 가죽시계,35000,35000,0
2018-06-01,1259796556,A013030,조기,여수 참 조기 1kg/22-30미내외/튀김용 조림용,12900,12900,0
2018-06-01,428246937,C012020,원피스,[대구백화점 I관] [올리비아하슬러]셔츠형코트(OH8MCT201),149800,127330,-22470
2018-06-01,367092652,C012040,여자학생복,하얀비WR2390 린넨 집업 베스트 /허리스트링 마롱조끼,27800,27800,0
2018-06-01,2138404932,C012060,여자내의,아둘 패밀리룩 반팔티 조던 엄마랑 커플룩 세트 24,15900,15900,0
2018-06-01,587446927,A018090,잼,코리원/가림/딸기잼/사과잼 3kg/잼/쨈/팥빙수/빙수,9000,8900,-100
2018-06-01,1414643751,C013020,티셔츠,골프웨어/기능성 언더레이어 쿨티셔츠 이너바지 의류,9900,7930,-1970
2018-06-01,1342377967,E061010,세탁세제,LG테크 한장빨래 화이트플러스9박스(총405회분)+아우라 주방세제,68800,68800,0
2018-06-01,795612806,E031010,전기밥솥,딤채쿡 3인용 전기보온밥솥 DCW-SA0301W,36000,36000,0
2018-06-01,1050081924,E061050,청소용세제,2018 청소혁명 탱크샷 나노야 20종 곰팡이제거제 후기,31000,29800,-1200
2018-06-01,900965810,A019080,고추장,청정원 태양초 고추장(2KG),12780,12780,0
2018-06-01,301505869,C013040,청바지,여름신상 청바지 남자 스키니 면바지 일자 스판 데님,13800,12800,-1000
2018-06-01,245646996,E061010,세탁세제,(PLM바르는테크 220ml 와이셔츠카라세제 바르는세제,8430,8430,0
2018-06-01,1421536718,A017020,상추,유기농/GAP 인증받은 당일수확 쌈채소/로메인/케일,8900,8900,0
2018-06-01,1388477430,C012040,여자학생복,DMS1403 렝가 자수 남방 803S 패션셔츠 여선패션남방,55820,55820,0
2018-06-01,1458777070,C013010,점퍼,[스튜디오럭스]윈디셔링스프링점퍼,19900,18910,-990
2018-06-01,261491507,C013010,점퍼,[바비앤펌킨][바비앤펌킨] 트렌드컬러 항공점퍼,80400,72360,-8040
2018-06-01,191477539,E041070,밀폐용기,팜스용기/밀폐용기/저장/플라스틱용기/유리병/페트병,990,920,-70
2018-06-01,901999023,C014020,유아복,베네통 여아동 52-100 패딩 점퍼 레이어드 좋음/200,17000,16830,-170
2018-06-01,467940395,I053010,공책,묶음상품 플라스틱링(45mm)흑색 50개입x3개 링 제본용,71460,71460,0
2018-06-01,1839724364,L012060,샴푸,아모스 퓨어스마트샴푸 녹차실감 샴푸액 당일무료배송,12900,12900,0
2018-06-01,1302796803,C011050,남자내의,(색상:사이즈 : 카키:L) DON 1846 린넨9부,28220,28220,0
2018-06-01,1813556736,C011030,남자학생복,2018 S/S 루이 베스트셔츠33종택1/ 루이까또즈(셔츠),35000,28700,-6300
2018-06-01,269169261,C013010,점퍼,겨울패딩 패딩점퍼 JK543W 빅사이즈패딩 패딩점퍼 패,89000,89000,0
2018-06-01,351478787,C012020,원피스,오버핏 체크 더블코트@브로치(C164MSG026)/ 씨씨콜렉트,119800,101830,-17970
2018-06-01,1361915286,F012010,종이기저귀,군기저귀 팬티형 특대형 XL(38p) x1팩/전사이즈,14680,14680,0
2018-06-01,1295409595,C013010,점퍼,[CC콜렉트]레터링포인트 후드점퍼 (C182MSJ036)(김해점),279000,248980,-30020
2018-06-01,1779515118,L021020,장신구,[바보사랑]925실버 드롭이어링-6mm 진주-RG,29900,29900,0
2018-06-01,1240003125,C011020,남자상의,레드 체크 밍크털 코트 캐쥬얼코트 퍼코트 남성용털코,105820,105820,0
2018-06-01,878415301,E041020,컵,에스프레소잔 커피 라떼,3500,3500,0
2018-06-01,572654270,E031020,가스레인지,[린나이] 스마트듀얼센서 화재/화상 예방 2구 가스레인지 RTR-D2010P(의정부점),248000,223730,-24270
2018-06-01,1779515119,L021020,장신구,[바보사랑]925실버 이어클립 진주귀걸이-Big A1168061,19900,19900,0
2018-06-01,1450771384,A017220,양파,깐쪽파1단(1kg내외),7200,7200,0
2018-06-01,1590268713,A018030,껌,롯데/오리온/자일리톨껌/후라보노/목캔디/커피껌/펌프껌/아이셔/풍선껌/젤리데이/왕꿈,370,370,0
2018-06-01,475470918,A019130,스프,보노스프 30봉 간식/유아 이유식/죽/치즈/크림/양파,23800,23800,0
2018-06-01,312033299,I011010,TV,[상품평5만] 인증점 삼성 UHD TV UN55NU7150FXKR,1440000,1029000,-411000
2018-06-01,862444961,A022010,주스,식자재 양념 음료 차 파인원액 화남 참존 836ML 1BOX,59210,59210,0
2018-06-01,985321450,L012080,화장지,미래생활 잘풀리는집 미용티슈 230매*8개,9900,7990,-1910
2018-06-01,603626235,C013040,청바지,[젤리스푼] New힙이멋진빈티지4부데님팬츠,21900,19710,-2190
2018-06-01,1301358694,E011050,책상,탑 데스크 책상 컴퓨터 학생 책장 다용도 h형 테이블,27900,27900,0
2018-06-01,1039814925,C013010,점퍼,바람막이 세제 크리너 고어텍스 자켓 다운 패딩 점퍼 바람막이 울 실크 자연섬유 세제,20000,20000,0
2018-06-01,988009305,A017150,버섯,풀무원 SOGA콩나물 500G,1990,1690,-300
2018-06-01,1779515120,L021020,장신구,[바보사랑]925실버 6mm 진주목걸이,29900,29900,0
2018-06-01,1779515121,L021020,장신구,[바보사랑]925실버 심플진주목걸이,19900,19900,0
2018-06-01,1252248073,A013100,마른멸치,봄맞이이벤트 활전복초특대사이즈(8~9미)1kg 특가판매,45000,45000,0
2018-06-01,394052741,C012040,여자학생복,[플라스틱아일랜드]골지 숏 가디건(PJ2KG561)(강남점),39000,34810,-4190
2018-06-01,1587659765,C011020,남자상의,[BON] S/S 네이비 슬림정장 EB6SJA014네이비,90000,72000,-18000
2018-06-01,1408999508,F012020,생리대,[중형20p+입오버2p+립밤] 라이너 유기농순면 롱 36x3/ 좋은느낌,10900,10900,0
2018-06-01,631948309,C012060,여자내의,빅사이즈/벨리/레이스/스커트 빅사이즈,31750,30800,-950
2018-06-01,1432208546,E011060,의자,[동서가구]LV 사무용 침대형의자 3종 DF908291,105000,94000,-11000
2018-06-01,989110458,A018080,설탕,CJ 알룰로스 350G,4900,4900,0
2018-06-01,408588099,F011150,건강기능식품,보리 곡물 검은콩 귀리미숫가루600g귀리볶음 현미간식,10900,10900,0
2018-06-01,1426974326,C014010,아동복,여름신상 아동 유아 상하복 세트 어린이집 등하원복,6900,6900,0
2018-06-01,2079878591,E031130,보온매트,“TV홈쇼핑정품” 일월 온돌마루 온수 보일러매트 초특대 거실용 2000x2700 분리난방,498000,493020,-4980
2018-06-01,1067737309,A017160,오이,(국내산) 건표고 버섯 원형 500g/표고/건조/건버섯,16000,16000,0
2018-06-01,1732222364,L021060,유모차,토이A 아이와 즐거운 외출을 즐기세요 코지 유모차 가,274120,243970,-30150
2018-06-01,2012476982,A017210,파,국내산 찰 토마토 10kg 정품,14900,14900,0
2018-06-01,238812837,E031050,냉장고,[삼성전자] 인증점 삼성 김치냉장고 김치 플러스 RQ57M9381M1,4514900,4514900,0
2018-06-01,295664159,A018010,초콜릿,[캔디마을]드림카카오6통 56%/72% 초콜릿 초콜렛 간식,8900,8900,0
2018-06-01,352718838,A012010,국산쇠고기,대관령한우 갈비세트 1호,261310,261310,0
2018-06-01,1690901713,A017110,감자,건표고버섯_150g x 3EA 버섯/나물/건나물/말린나물/말,62300,62300,0
2018-06-01,1902989351,I012010,컴퓨터,특가153만/삼성노트북 Pen NT930QAA-K58A MS오피스,1735780,1649000,-86780
2018-06-01,2084039440,C013040,청바지,(SR)MHA537 남자빅사이즈스판청바지 /(참고)남자청바,71600,60860,-10740
2018-06-01,1458777040,C012020,원피스,[씨]격자 무늬 더블블레이저 면 자켓 (SQJAD2152)_T6Y3,99000,94050,-4950
2018-06-01,867796024,C014010,아동복,여름/아동/아동옷/아동의류/아동복/상하복/아동상하복,11200,11200,0
2018-06-01,1613007935,C011050,남자내의,남자마바지 린넨팬츠 밴딩팬츠 9부10부 면바지 슬랙스,17800,14800,-3000
2018-06-01,1141837245,A013070,굴,바다사나이 캐나다 활 랍스타 1kg 랍스터 바닷가재,49000,49000,0
2018-06-01,1373357799,C013020,티셔츠,[필골드] SL3002 니트배색 폴라 티셔츠,25800,25800,0
2018-06-01,1204387398,C013020,티셔츠,[아가방앤컴퍼니]이야이야오 여름 의류 특가,5900,5900,0
2018-06-01,1702428528,A017050,미나리,유기농 양배추 3kg,11700,9360,-2340
2018-06-01,1942740752,A021010,커피,[파젠다커피]이종혁의 갓 볶은 4종 원두커피(500g),15800,15600,-200
2018-06-01,2084040434,C013040,청바지,(SR)MHA703남자빅사이즈스판청바지 /(참고)남자청바지,52900,44970,-7930
2018-06-01,1293003632,C013010,점퍼,푸조 남녀공용 방한복 자켓(FZ711-1) 겨울트레이닝점,90700,90700,0
2018-06-01,391887264,A019040,소금,아몬드(홀 볶은 비앤지 1K)X10 아몬드 아몬드씨 식자,236410,212770,-23640
2018-06-01,426288208,E031020,가스레인지,린나이 2구 가스레인지 1A20TF,149000,141500,-7500
2018-06-01,1385739541,A011160,빵,안흥찐빵마을 우리팥 수제 흑미찐빵 (500g 10입) 3봉,31910,31910,0
2018-06-01,2088786723,C012040,여자학생복,크로커다일레이디스 CL7M TS219 데님 프린팅 매쉬 조끼,39000,36270,-2730
2018-06-01,2101726103,G011070,자전거,[아펙스]상품평행사/26인치 접이식자전거 벨콘/자전거,87000,87000,0
2018-06-01,2070524626,E031110,청소기,POLTI 이태리 직수입 폴티 스팀청소기 다용도 PRO95,349000,349000,0
2018-06-01,745411621,A013020,명태,523 먹태 1kg이상10마리 속초아바이,60150,60150,0
2018-06-01,247127122,C012060,여자내의,톰스 연청 멜빵 청반바지(멜빵탈부착) SD-4085 멜빵바지 청바지 멜빵청바지 스키니진,18860,16790,-2070
2018-06-01,1060958121,A019080,고추장,[CJ직배송] 우리쌀태매운고추장2kg + 사계절쌈장500g,11100,11100,0
2018-06-01,603134373,A014020,분유,후디스 산양하이키드골드 700g,29000,29000,0
2018-06-01,684981416,I031010,장난감,로보카폴리 롤링카 / 엠버 / 로이 / 헬리 / 붕붕카,29900,29900,0
2018-06-01,1743014825,D031010,주택수선재료,숲으로 방균/듀제로 3.78L 결로곰팡이방지 항균페인트,16500,16500,0
2018-06-01,190749504,A013090,전복,깔끔하게손질된 조개살모음 홍합 바지락 가리비등,1700,1700,0
2018-06-01,215324407,A022040,기능성음료,롯데칠성몰 스포츠 게토레이 240ml/340ml/600ml/1.5L,14900,14900,0
2018-06-01,898073643,A021010,커피,[당일출고]맥심모카골드라이트 360T/320T+홀더머그,33800,33800,0
2018-06-01,451403314,C013010,점퍼,[페리미츠]여아베이직 선염ST 점퍼(P1865J551_10),25500,22950,-2550
2018-06-01,572715797,F012050,의료측정기,[코스트코] 오므론 자동전자 혈압계 HEM-7130,84780,84780,0
2018-06-01,1199416797,A016040,포도,동원)황도 슬라이스 400g x 12개 사시사철 맛있는,41360,41360,0
2018-06-01,96457865,A018090,잼,트라피스트 수녀원 유기 포도 잼 410g 식빵쨈 포도잼,18260,18260,0
2018-06-01,1811405228,G011070,자전거,[Strida] 스트라이다 5.1 QR+ 버젼 전국최대매장,740000,740000,0
2018-06-01,1247911720,E041060,수저,국산 티스푼 포크 과일포크 차스푼 수저세트 아동수저,1000,1000,0
2018-06-01,1766432090,A018010,초콜릿,마카다미아 쇼콜라 21g x 30개입 초콜릿 수입 초콜렛,14000,14000,0
2018-06-01,392133345,C011020,남자상의,MT-215 여름-초가을 신사스트라이프 싱글수트 (M-2XL),188960,188960,0
2018-06-01,657893977,F012010,종이기저귀,[리베로]리베로기저귀 밴드형5단계 56매 4팩,73900,70210,-3690
2018-06-01,1376229744,C013050,운동복,7부트레이닝바지/반바지/츄리닝/남성/5부팬츠/져지/면,12800,12800,0
2018-06-01,2137845771,A018080,설탕,비정제원당 3kg/100% 사탕수수 천연당 매실 원당 설탕,10000,9900,-100
2018-06-01,966902948,C021040,실내화,윌슨 러쉬 프로2.5 테니스화 ( WRS322630 ) 그레이,156870,156870,0
2018-06-01,1029221628,E021020,커튼,10%쿠폰! 쉬즈홈 아일렛 암막커튼1 2장/마이크로/거실,10900,10900,0
2018-06-01,1658829033,A013030,조기,[여수고기]국내산 참조기 50마리/조기/2.6kg 내외,19900,19900,0
2018-06-01,793862243,E041050,냄비,[네오플램] 네오플램 베리타 인덕션겸용 통3중 스텐 편수냄비16cm,32900,30900,-2000
2018-06-01,542919327,C013040,청바지,[모다아울렛][지컷]그레이 스판 스키니핏 팬츠(7226455001),39200,39200,0
2018-06-01,1916420944,A015020,식용유,오뚜기 프레스코 포도씨유 900ml X 20EA 포도씨유 식,262740,262740,0
2018-06-01,2056547424,C013010,점퍼,[네파키즈] (KD82003) 베스타 구스다운 점퍼 아동구스다운 여아패딩,159000,131970,-27030
2018-06-01,623979250,A017020,상추,반찬단지 간장깻잎 4kg 2개,61000,59170,-1830
2018-06-01,282656362,E031110,청소기,[오토비스]2018 NEW 오토비스 W 물걸레청소기 ASC-201,158000,142200,-15800
2018-06-01,1568502678,C013040,청바지,[정품]리바이스청바지/501/511/514/505/569/빅사이즈,60800,60800,0
2018-06-01,657063010,A011160,빵,프랑스 플레인 치아바타 140gx3개 냉동빵 생지,6000,5900,-100
2018-06-01,1833602820,L021060,유모차,토이A 아이와 즐거운 외출을 즐기세요 코지 유모차 가,258090,245190,-12900
2018-06-01,428128,A019040,소금,소나무로 구운 양치소금 (50g x 2),12000,12000,0
2018-06-01,1691009013,A017080,무,1+1 총60포 순수양파즙/빨간양파즙 무안군 자람푸드,17900,17900,0
2018-06-01,633035011,C013010,점퍼,격자무늬망사집업/바람막이/쉬폰가디건/시스루/스카시,8900,8900,0
2018-06-01,2096912335,C011020,남자상의,MJSF18001 블랙 코튼 베이직 코트 기본남자코트 남성,91960,91960,0
2018-06-01,516596882,E031080,선풍기,최신형 원적외선 전기온풍기 3.0kw (HV-3100) - 난로,428960,381780,-47180
2018-06-01,119980377,E011030,거실장,(아이잠)토토 책장 3단 400 [오픈형],27900,27900,0
2018-06-01,1655699867,L012090,기초화장품,2gy 모이스춰팩 구매시 화장품샘플 사은품증정,5500,5500,0
2018-06-01,739867624,C013020,티셔츠,[포스트릿]S~4XL 반팔티/티셔츠/커플티/남자/면티/티,9800,9800,0
2018-06-01,1958869488,F012020,생리대,화이트 슬림 날개 대형 생리대 32px10팩/화이트대형,89900,89900,0
2018-06-01,387360605,I031070,애완동물관리비,당구큐대세척제/당구재료/개인큐대/당구용품/당구장갑,8500,7530,-970
2018-06-01,1233516491,C013030,스웨터,폴라티 반팔 MJ7171 마르잔 빅사이즈 반팔티,24250,23770,-480
2018-06-01,826434667,A012050,소시지,진주 천하장사 800g/50g 16개입/프리미엄/오리지널/,9900,9900,0
2018-06-01,1900684062,I012060,저장장치,[장패드행사]앱코 K660 광축 게이밍 기계식키보드-,54900,54900,0
2018-06-01,1436416828,A018030,껌,롯데 자일리톨 아이스민트 리필 87gX3개+25gX3개,10700,10700,0
2018-06-01,1797012658,C013010,점퍼,남자봄자켓/면자켓/블레이져/트렌치코트/오버핏코트,33800,32800,-1000
2018-06-01,650722774,C012040,여자학생복,[핫핑] 빅사이즈 블라우스 셔츠 플라워 쉬폰 프릴,23800,23800,0
2018-06-01,2054968729,C013010,점퍼,남자자켓 포켓 라이더 레자자켓 레자자켓 남자자켓 라,121770,121770,0
2018-06-01,1237171306,C015040,장갑,양가죽 무스탕 벙어리 여성장갑 디자인장갑 장갑 워머,25010,25010,0
2018-06-01,971384076,C013050,운동복,불스원 레인OK 에탄올 그린 워셔액 1.8L /유리세정제,21000,19320,-1680
2018-06-01,2112166166,A018030,껌,롯데츄잉껌/후라보노/자일리톨/쥬시후레쉬,8300,8300,0
2018-06-01,1893029471,L012030,칫솔,2080 오리지날 칫솔 20개/미세모/부드러운모/치약,8900,8900,0
2018-06-01,1824287616,A012060,햄및베이컨,[퀸주트]정통독일식 수제햄/베이컨/소세지(캠핑/간식),6900,6770,-130
2018-06-01,259980774,C012030,여자상의,[핫핑]원피스모음/빅사이즈/티셔츠/니트,32800,21800,-11000
2018-06-01,29507330,C015040,장갑,남녀등산장갑/나일론돗트10켤레/미끌림방지/운전,6000,5520,-480
2018-06-01,1906519587,C012030,여자상의,[패션24시30%쿠폰]쉬폰 롱원피스 플라워 맥시프릴,5900,5900,0
2018-06-01,1521764528,D031010,주택수선재료,유리창 안개시트지1롤,3900,3800,-100
2018-06-01,501185286,C012040,여자학생복,8B-CA028 베이직포켓가디건/ 데드라,15900,11930,-3970
2018-06-01,8244458,C013010,점퍼,뱃살커버 팬티/보정속옷/비키니팬티/거들/힙업 옷이얇,1900,1900,0
2018-06-01,1282509595,C012060,여자내의,빅사이즈/페이즐/시스루/스커트 페이즐시스루스커트,25940,25170,-770
2018-06-01,1170339338,C012060,여자내의,[피그먼트] a햅번 롱 플레어 스커트,32000,27840,-4160
2018-06-01,1011941024,A011090,국수,인기컵라면 24개 1BOX[한박스]라면/신라면/불닭볶음면,14500,13900,-600
2018-06-01,460710342,A016040,포도,칠레 씨없는적포도/청포도/레드글러브 실중량 3kg,18000,18000,0
2018-06-01,1965738482,C013040,청바지,[젤리스푼]쁘띠레이스숏데님팬츠,21900,19710,-2190
2018-06-01,968397295,C014010,아동복,여름 유아 아동 모시 실내복 상하복 모시옷 원피스,19400,19400,0
2018-06-01,1361301712,E041070,밀폐용기,보르미올리/더치병/스윙병/유리병/와인병/쥬스병/밀폐,1000,920,-80
2018-06-01,2112457869,E011070,식탁,[상일리베가구] 럭셔리 대리석 식탁 4인 용 세트,269000,269000,0
2018-06-01,1157642793,C011030,남자학생복,신상/셔츠/남방/와이셔츠/긴팔/슬림/스판/체크/남자,17000,9800,-7200
2018-06-01,985815005,L021020,장신구,[까옥이]예쁜 은반지/실버반지모음/92.5반지/우정반지,17900,17900,0
2018-06-01,1029782133,A018070,파이,무배) 대용량 롯데 카스타드 138gx12갑 모닝밀 케이크,24800,24800,0
2018-06-01,417069369,C015040,장갑,아놀드파마_APGW-BY1219(가죽장갑_여성용) 손가락장갑,27420,27420,0
2018-06-01,1468435118,A012010,국산쇠고기,[무항생제] 불고기 500g 1+등급,30800,30800,0
2018-06-01,1770273867,C011020,남자상의,빅사이즈 패딩 점퍼 WC 남 헤비패딩 JK044M 오리털점,110700,110700,0
2018-06-01,394662790,C013010,점퍼,남자청자켓 와펜 패치 빈티지 데님자켓 C0216002a 남,50400,45360,-5040
2018-06-01,632128241,C013010,점퍼,[R.ROBOT](LG)에센셜바람막이점퍼(18329-110-04),55200,42510,-12690
2018-06-01,2078923788,E021020,커튼,/롤러블라인드 화이트 리셀로트 200x195 cm/ 블라인드,86310,76820,-9490
2018-06-01,956953051,C014020,유아복,[디플랜][디플랜] 아롱티셔츠(노랑 블루),5000,4750,-250
2018-06-01,2083160480,A011080,밀가루,칠갑국수/국수/우리쌀국수/떡국/물냉면/비빔냉면,22000,22000,0
2018-06-01,843359987,E011060,의자,DSP 체어렉스 의자/컴퓨터의자/책상의자/사무용의자,75000,67800,-7200
2018-06-01,1434280439,E011050,책상,[퍼닉 에스엠]실속형 책상세트 모음전 /H형책상세트/ 편수책상세트 / L형책상세트,82000,82000,0
2018-06-01,6746180,A022040,기능성음료,포카리스웨트 분말 20팩+물통1개/파워에이드/게토레이,25900,25900,0
2018-06-01,424646067,A019030,생강,적초생강 (참존 1.2k) X10,41770,37180,-4590
2018-06-01,947494768,A011030,찹쌀,두레생협 오가닉햇보리3곡 잡곡 가정용보리 국산영양,20160,20160,0
2018-06-01,1146538636,C013040,청바지,18SUMMER 까레라 스파클링 쿨데님 남자 2종,88000,88000,0
2018-06-01,1439874217,A019100,식초,오뚜기 토마토케찹 1kg / 업소용케찹 / 대용량,2650,2650,0
2018-06-01,2111555689,A011090,국수,진라면 40+8봉 증정기획,20900,20900,0
2018-06-01,2135257581,C013050,운동복,가정용소화기 색동소방차450,38290,34470,-3820
2018-06-01,1538701482,C014010,아동복,[WSB] 아동티/반바지/레깅스/7부/청바지/아동복,8100,8100,0
2018-06-01,170572453,L012060,샴푸,닥터시드 사차인치 자연유래 샴푸/트리트먼트 1000ml,14900,14900,0
2018-06-01,739442212,L021030,가방,[피에르가르뎅]교복 스타킹/80데니아 학생스타킹(검정) 5족/10족/KJC국제 고탄력 팬티,23160,21660,-1500
2018-06-01,1881139500,F012010,종이기저귀,국내산/ 닥터싸이언스 팬티 /밴드기저귀/사은품증정,25800,24800,-1000
2018-06-01,505576726,C013040,청바지,페인팅 빈티지 청반바지 남성청반바지 5부청반바지 편,15730,15730,0
2018-06-01,440324377,A015020,식용유,백설 카놀라유18L콩기름 올리브유 대두유 포도씨유 옥,94600,83250,-11350
2018-06-01,963539702,A019110,드레싱,코리원/오뚜기 갈릭치즈드레싱 1kg/참깨드레싱 1kg,6000,5900,-100
2018-06-01,78160654,C011030,남자학생복,고급 블루 파란색 반팔 와이셔츠 모시 여름 셔츠,35000,33950,-1050
2018-06-01,2124610399,C013050,운동복,(핑크돼지)뿅망치수납박스 콘솔박스 차량수납박스 다,24960,22750,-2210
2018-06-01,67762427,F012010,종이기저귀,공식) 백조기저귀 300매/신생아용/산모패드/혼합구성,29800,29800,0
2018-06-01,580312853,C011030,남자학생복,FS-172 화이트단추 데님셔츠 데님셔츠 청남방 데님 화,35910,35910,0
2018-06-01,1005807973,C013010,점퍼,[푸마]간절기 경량 패딩자켓 트레이닝자켓 패딩점퍼,39800,39800,0
2018-06-01,1300297336,A017040,양배추,박하분말(국산) 1kg/박하/민트/가루/분말/파우더/박하차/허브차/생식/선식/제과/제빵/,21000,21000,0
2018-06-01,2030162419,A015010,참기름,가마솥표 참향기름 1.8L 6개,166980,161980,-5000
2018-06-01,471654221,C012060,여자내의,포근 양털 반바지 겨울 핫팬츠 숏팬츠 여성 캐주얼,8840,8740,-100
2018-06-01,1062121953,L021010,손목시계,SEIKO 세이코5 SYMC18K1 여성시계 메탈밴드 패션시계,214000,214000,0
2018-06-01,1010377354,A012060,햄및베이컨,동원 리챔 340G*3+1기획,14800,12990,-1810
2018-06-01,1024772725,A018080,설탕,브라질 고이아사 유기농설탕 25kg,61000,61000,0
2018-06-01,465881028,C013010,점퍼,[카라]KARRA 7부메쉬니트점퍼_KBI6JP201A,48420,44550,-3870
2018-06-01,1820868163,C021040,실내화,[무료배송]여성 키높이운동화 슬립온 스니커즈,24900,24900,0
2018-06-01,483088290,C013010,점퍼,여자무스탕브랜드 양털무스탕 무스탕자켓(국내제작/44~88사이즈별맞춤제작),1269000,1269000,0
2018-06-01,442468700,C012040,여자학생복,와이드 플리츠 롱 팬츠 (J11PPT069)/ 매그제이(MAGJAY),36000,32400,-3600
2018-06-01,874067106,C012060,여자내의,[리리앤코]다양한슬랙스/25-36/빅사이즈/팬츠/밴딩,27800,20800,-7000
2018-06-01,646777956,C013050,운동복,그린텍 BMW 안전벨트 경고음 클립 (벨트레-2pcs),18000,17820,-180
2018-06-01,1973337230,A016090,참외,농민직접 성주꿀참외 10kg 한정특가,16900,16900,0
2018-06-01,1849046376,A013170,생선통조림,기장 추억의 벌크 번데기 특품4kg,25900,25900,0
2018-06-01,403792532,L012040,치약,(CMIT/MIT 無) 덴티스테 치약3개+오랄린스+칫솔증정,11700,5900,-5800
2018-06-01,1424250763,E061060,살충제,살충제 파비 옴진드기 모기 거미 바퀴벌레 거미,42000,42000,0
2018-06-01,1974010105,C014020,유아복,아둘 쥬니어 엄마랑 커플 도날트덕 롱 원피스 티 11,14300,14300,0
2018-06-01,258916473,A017230,마늘,필수요리재료! 2018년 햇 양파 3kg+햇 감자 2kg,6900,6900,0
2018-06-01,773481560,L012040,치약,깜짝특가/레드씰 베이킹소다치약 100gX5개/구취제거,18900,18900,0
2018-06-01,2022911734,F012010,종이기저귀,팸퍼스 크루저 기저귀 파우더향 3~6단계,49900,49900,0
2018-06-01,1224305223,A018070,파이,(공식샵)오리온 오뜨 쇼콜라 150gx4개/치즈/카스타드,10900,10900,0
2018-06-01,1603842642,C012060,여자내의,12컬러 밴딩 면스판 기본 5부스커트 DK-1583 치마 면치마 짧은치마 미니스커트 H라인스,5270,4700,-570
2018-06-01,806360863,C014010,아동복,알로봇 남아 아동 155 면 코트 패딩내피 가을 겨울 짱,41780,41780,0
2018-06-01,321748421,A015020,식용유,백설 콩기름 1.8L 튀김용기름 가정용기름 대두유 오일,9500,9400,-100
2018-06-01,11249923,E031120,믹서,한일 다용도 미니믹서기 핸드블랜더 모음 HMF-595,27200,27200,0
2018-06-01,1498649806,C015040,장갑,고급 양털 장갑(여성) 겨울용장갑 털장갑 패션소품 니,10230,10230,0
2018-06-01,1457273292,E041070,밀폐용기,락앤락 햇쌀밥용기 전자렌지용기 혼밥용기,7900,7270,-630
2018-06-01,651837029,L021060,유모차,[엔픽스]마블 기내반입형 휴대용유모차 (콤브그레이),263000,221500,-41500
2018-06-01,503608382,C013010,점퍼,경량소재에 기하학프린트로 스포티한 점퍼(CL8MJP206)/ 크로커다일 레이디,68000,63240,-4760
2018-06-01,776057272,A013120,낙지,정화 불고기 통.전기 오징어 50gx5.,25490,22690,-2800
2018-06-01,820118782,C011050,남자내의,(805/레이스자수호피)밑단레이스 스프사 8부파자마,11700,10420,-1280
2018-06-01,569974389,A017210,파,[산지직송] 도성우님의 키토산 토마토 5kg,22000,19900,-2100
2018-06-01,639451889,C011030,남자학생복,6온스 빅사이즈 카모플라쥬패딩밀리조끼,98670,95710,-2960
2018-06-01,1974010136,C014020,유아복,아둘 쥬니어 엄마랑 커플 도날트덕 롱 원피스 티 12,14300,14300,0
2018-06-01,325626032,C012060,여자내의,[루시다]D53 SL9284레베카 4부 린넨 큐롯팬츠,28080,25000,-3080
2018-06-01,1557775600,C021040,실내화,여성 키높이 스니커즈 슬립온 운동화 남성 신발 커플,22900,17900,-5000
2018-06-01,1140233373,C012040,여자학생복,[대구백화점 I관] [베스띠벨리]시스루 프린팅 롱 가디건(BQCBE2182),39000,33540,-5460
2018-06-01,980967439,E031090,공기청정기,ATQE400-HWK 위닉스 타워Q 공기청정기/2018년형/ ens,218900,218900,0
2018-06-01,1835437540,C013010,점퍼,[시보니] 스웨이드지퍼 박시무스탕,83700,83700,0
2018-06-01,1254214287,C012060,여자내의,[다바걸]포포버튼데님스컷,28000,26600,-1400
2018-06-01,2000800505,E061020,섬유유연제,라벤다 베이비전용 섬유유연제 bottle 유아세탁섬유유,21300,21300,0
2018-06-01,824212183,E041070,밀폐용기,사미자의마마집밥(30종)+사은품(2종),29800,26820,-2980
2018-06-01,1626749096,A022050,탄산음료,스프라이트 250ml/300ml,19900,19900,0
2018-06-01,820131749,F011150,건강기능식품,[삼성제약] 까스명수 골드 75ml 40병{황사마스크증정}소화제/정품,24000,24000,0
2018-06-01,984311401,A021020,차,[동서]동서 제티 초콕 딸기맛 36G,3300,3300,0
2018-06-01,168475872,C011050,남자내의,작업복/청건빵/청조끼/청남방/용접/건빵바지/카고바지,15800,15800,0
2018-06-01,1286298109,A015020,식용유,청정원 포도씨유 900ml 청정원 청정원포도씨유 청정원,18620,18620,0
2018-06-01,561730006,E011020,침대,#MD정품상품# 편안한잠자리/엘레강스 심플베드 더블(115cm)전동 접이식침대 2인용/침대,448000,443520,-4480
2018-06-01,82219893,C013020,티셔츠,[DUCLY] 신상 맨투맨/후드티/후드집업/기모/빅사이즈,19900,19900,0
2018-06-01,984311402,A021020,차,[동서]동서 제티 초콕 초코렛맛 36G,3300,3300,0
2018-06-01,1341050255,C012060,여자내의,jj41 니트 미디스커트_레드 여성미디스커트 니트치마,12560,12560,0
2018-06-01,1441031210,A015020,식용유,동원 카놀라유900mlx4개,11900,11900,0
2018-06-01,1308497368,C012060,여자내의,밴드골지니트스커트 MNW14012 니트치마 여성스커트 여,41600,41600,0
2018-06-01,632889307,A014020,분유,순산양분유 2단계 400g/ 아이배냇,16900,16900,0
2018-06-01,242737163,E061010,세탁세제,리큐 진한겔 세제 2.1L x6개 외~/스파크/트리오,26900,19900,-7000
2018-06-01,1117637055,C014010,아동복,[젤리스푼][젤리스푼] 잘나가는해지데님팬츠_MO,13900,12510,-1390
2018-06-01,1815757239,A022030,생수,산펠레그리노 330ml 24캔 자몽 스파클 생수 음료,27990,27990,0
2018-06-01,1067216070,I031010,장난감,야야 소프트지붕차 헬로키티(95969) 토이 여아 유치원,134260,134260,0
2018-06-01,1290549062,A018080,설탕,자일로스 하얀 설탕 5kg / 브라운 자일로스 설탕 5kg,9900,9900,0
2018-06-01,1384164937,L012090,기초화장품,엠도씨 화이트닝 톤업 크림,25000,25000,0
2018-06-01,989817847,A014040,발효유,[매일]매일 바이오드링킹블루베리 250ML,1000,1000,0
2018-06-01,1838692471,C021040,실내화,[푸마(PUMA)]푸마 액시스 V4 AXIS V4 (36217402),44000,36180,-7820
2018-06-01,324616074,C013040,청바지,PBMFJ700 샌드캣진청스판남성일자청바지 빅사이즈청바,43790,43790,0
2018-06-01,538125838,C012040,여자학생복,[CC콜렉트]플라워 프린트 오프숄더 블라우스(C172MSC063),84500,65910,-18590
2018-06-01,510014812,D031010,주택수선재료,소리담 층간소음방지매트 15M 방음 장판 DIY 바닥재,99500,99500,0
2018-06-01,1764420452,C013010,점퍼,핸드메이드 여성맞춤무스탕 여자무스탕브랜드,1089500,1089500,0
2018-06-01,881959508,A022020,두유,[일동후디스]검은콩/오메가3 두유 190mlx 48팩 초특가,17900,17900,0
2018-06-01,955860813,A019180,즉석식품,오뚜기 구수한 누룽지 (60G*5입),5990,5990,0
2018-06-01,1697256448,E041060,수저,숟가락 젓가락 10개세트 숫가락 업소용 식당용 수저,3800,3800,0
2018-06-01,2057419817,L021060,유모차,코지 유모차 / 풋커버 시트 증정 / 디럭스형유모차 초,138700,138700,0
2018-06-01,384103386,E011050,책상,마켓비 편리한 접이식 책상/테이블,29000,29000,0
2018-06-01,494686881,E031070,에어컨,홍진 천장형선풍기 HJ-16TP / 홍진(Hanworld),77300,68030,-9270
2018-06-01,1101477796,C011020,남자상의,SS갖고싶은남자의 스판 남자정장 GORGIO정장 남성정장,157700,157700,0
2018-06-01,1638478233,C013060,등산복,[K2 살레와] 역시즌 단독선오픈 다운/패딩 16종 특가,89000,89000,0
2018-06-01,1102402891,C012040,여자학생복,[쉬즈넘버나인]소매 포인트 니트 원피스,29800,28310,-1490
2018-06-01,1743146685,C013020,티셔츠,FREE 러블리넥반팔면티셔츠6장(묶음세일),58000,58000,0
2018-06-01,2069266135,C013020,티셔츠,베이직 후드티 LTT0035 여성티셔츠 여성후드티(YA0200,32100,28250,-3850
2018-06-01,1074812631,F012020,생리대,에리에르 엘리스 메가미/고쿠수이/초안심 슈퍼롱 모음,15900,15900,0
2018-06-01,476494697,C012060,여자내의,[악녀일기]버드슬랙스(S~L),44580,38800,-5780
2018-06-01,1040793262,C013010,점퍼,야상 세제 크리너 고어텍스 자켓 다운 패딩 점퍼 바람막이 울 실크 자연섬유 사파리 점,20000,20000,0
2018-06-01,342916073,A011140,부침가루,무료다운로드 쿠폰 두레생협 우리밀수제쵸코파이(3개,13450,13190,-260
2018-06-01,1890546779,C013020,티셔츠,[빈폴아웃도어]Unisex 화이트 베이직 헨리넥 티셔츠 (BO8342S041),69000,54510,-14490
2018-06-01,2041745463,A011050,콩,햇 볶음 땅콩 3.75kg/1관/땅콩/아몬드/호두,13900,13900,0
2018-06-01,1011184686,A018070,파이,해태 오예스 수박 360G,4800,4800,0
2018-06-01,1727481467,I031010,장난감,PS4 월드 오브 파이널 판타지 한글판,59800,51700,-8100
2018-06-01,1230516957,E031050,냉장고,[삼성전자] 인증점 삼성 스탠드 김치냉장고 RQ33M70A5S5 무료배송,1899900,1899900,0
2018-06-01,410472561,C011020,남자상의,(티티뱅크) JK540W 캐주얼 방한 자켓,56350,56350,0
2018-06-01,507682487,A011030,찹쌀,2017년 국내산 햇찰보리2kg/4.8kg,6900,6900,0
2018-06-01,1011184659,F011130,홍삼,대웅 비타민D 2000IU - 2병,40000,16900,-23100
2018-06-01,861867885,A013020,명태,(맛나)콩가루880g/대동,7300,6570,-730
2018-06-01,540283354,C012020,원피스,[쥬크(ZOOC)]오버핏 체크롱모직코트(Z174MSG001)(강남점),199000,177590,-21410
2018-06-01,1245448204,D031010,주택수선재료,엔씨 수성 세라믹 방수 페인트 무란새(백색) 4리터,26670,26670,0
2018-06-01,1328293938,I011010,TV,삼성패널 49인치TV 55인치TV UHDTV 50인치TV LEDTV,309000,309000,0
2018-06-01,1926464394,A019040,소금,신안군 국산천일염 짠도리 10kg/20kg 1등급 천일염,10000,9900,-100
2018-06-01,378325373,C012060,여자내의,[플레이팝][플레이팝]클로점프슈트세트,14900,13710,-1190
2018-06-01,1074800647,A019070,양념소스,(참소당 매운 갈비찜소스2kg) 소갈비 돼지갈비 찜소스,16900,16900,0
2018-06-01,416209610,C021040,실내화,[신슈]키높이운동화/운동화/스니커즈/통굽/캔버스화,10900,10900,0
2018-06-01,370599798,C013010,점퍼,행텐남아 매쉬후드집업14120-031-445-69,7470,7470,0
2018-06-01,473404114,C012020,원피스,[KEITH]월트셔트로피컬 K7MA370-99,171000,160740,-10260
2018-06-01,2127874498,A018090,잼,오뚜기)딸기쨈 500g x 6개 국산딸기 달콤 빵 과자,39690,39690,0
2018-06-01,1973340890,C021040,실내화,[아디다스 퍼포먼스]플루이드클라우드 CG3820 외4종,49000,39200,-9800
2018-06-01,231729064,C014010,아동복,[포래즈]넷중 하나 면바지_F17D7PT201,12000,11070,-930
2018-06-01,1163043057,A013120,낙지,정화식품 오징어 맥반석오징어 땅콩버터 전기구이,2890,2290,-600
2018-06-01,1457672961,A011160,빵,무배/모듬빵50개1박스/단체간식/단팥빵/삼립,19900,19900,0
2018-06-01,717156811,C013010,점퍼,[주크][AK수원점][ZOOC]캐주얼한 블루종 점퍼Z182MSJ009,227400,213760,-13640
2018-06-01,8425873,A012010,국산쇠고기,[무항생제 한우선물세트] 한우 갈비 1호 2.4kg,254600,254600,0
2018-06-01,802825967,C011020,남자상의,누빔패딩코트 안감패딩처리 남성의류 캐주얼의류 캐쥬,164810,164810,0
2018-06-01,2091450383,A012050,소시지,진주 알뜰주부 줄줄이 비엔나 소시지 1kg,10300,10300,0
2018-06-01,1211890938,C013040,청바지,다온샵 15%쿠폰 스키니/청바지/반바지/린넨/슬랙스/마,9900,9900,0
2018-06-01,1179704175,L021020,장신구,피지 미니 후프 귀걸이 SS-EA-FAHS-DIA/ 모니카비나더(주얼리),748000,673200,-74800
2018-06-01,2035487747,C013060,등산복,라포드S 남성 여름 등산티 셔츠 남자 등산복 작업복,12900,12900,0
2018-06-01,113341961,G011070,자전거,스타카토 접이식자전거 스튜어트20RS 20인치 7단 쇼바,118800,106920,-11880
2018-06-01,1421174153,L012010,면도기,질레트 특가/총30종/면도기 면도날 4입 8입 면도크림,15400,15400,0
2018-06-01,1549552187,A011130,시리얼,대상 바삭 튀김가루 1kgx10개 부침가루 1kgx10개,14900,14900,0
2018-06-01,378805231,C012040,여자학생복,[대구백화점 I관] [4CUS]젤라 프릴블라우스(FM8E9BL5043),29000,26970,-2030
2018-06-01,268454279,A013130,오징어채,중부시장도매 명엽채 밑반찬채 맛살채400g/진미채,5900,5800,-100
2018-06-01,1220193055,A013170,생선통조림,동원참치 150g x 10캔 마일드 참치캔 살코기 사조,8400,8400,0
2018-06-01,1395578512,C013020,티셔츠,옆망사 반목 폴라티셔츠 STLD-6462/폴라티 여성폴라티,19700,18720,-980
2018-06-01,818211118,C012040,여자학생복,흰색면티 여학생면티 여성속바지 여성면티 교복면티,3800,3800,0
2018-06-01,1398159633,A013080,조개,두레생협 냉동굴(400g) 해물파전용냉동굴 요리용굴 국,21570,21570,0
2018-06-01,995235760,A022050,탄산음료,스프라이트 355ml x24can,18300,18300,0
2018-06-01,1368303289,E041050,냄비,락앤락 스피드쿡 라면냄비 16cm 편수/양수 백종원,15800,15800,0
2018-06-01,1779515091,L021020,장신구,[바보사랑]925실버&천연진주 MAY팔찌 3종택1 JAM0124,35400,35400,0
2018-06-01,704097765,C021040,실내화,[나이키] 다운쉬프터 8 908984_001,53800,51650,-2150
2018-06-01,375832626,A019180,즉석식품,오쿡 영양밥 도시락 6종 혼합 12팩,39900,39900,0
2018-06-01,1779515094,L021020,장신구,[바보사랑][1+1행운세트] 925실버 행운의 위시본+진주귀걸이,39900,39900,0
2018-06-01,497745230,E041050,냄비,[키친아트] [키친아트] 통삼중 스텐 이유식냄비+통실리콘스패츌라,20900,20900,0
2018-06-01,1779515095,L021020,장신구,[바보사랑]진주세트 925실버 귀걸이/목걸이세트 A6012S005,45800,45800,0
2018-06-01,745616944,E051030,디지털도어록,밀레 디지털도어락 큐브/번호키/현관키/전자키/자동키,47900,43110,-4790
2018-06-01,1779515093,L021020,장신구,[바보사랑]진주세트 925실버 3box 귀걸이/목걸이세트 A6012S002,55800,55800,0
2018-06-01,1434872481,E041070,밀폐용기,락앤락 인터락 냉장고정리용기 혼합세트 / 밀폐용기 냉장고수납용기 냉장고보관용기 양,20000,18220,-1780
2018-06-01,466775692,C013050,운동복,고급 안전 LED삼각대(AA건전지 별매) 비상용삼각대 삼,19430,17710,-1720
2018-06-01,2019728820,C012040,여자학생복,kk34 헨리넥st 하프버튼 데님셔츠_진청 여성청셔츠 하,16090,16090,0
2018-06-01,1273191066,C013040,청바지,남자바지 썸머 베이직 밴딩 반바지 C0717011 남자바지,20430,18390,-2040
2018-06-01,1304121105,C014010,아동복,[젤리스푼]다이나믹매쉬트레이닝상하복,18900,17010,-1890
2018-06-01,1600742099,I053020,스케치북,삼원 NW07 뉴워터칼라패드 260X360 300g -41704,16020,16020,0
2018-06-01,321445361,A021010,커피,아이수 페루산 카카오닙스500g,16970,16970,0
2018-06-01,1361846944,I031040,생화,콩맨 4단 랜턴스탠드 랜턴걸이/캠핑/양방향/삼각대,27900,25670,-2230
2018-06-01,1316792444,C013010,점퍼,남자 가죽자켓/무스탕 레더자켓 레자 라이더자켓 남성,49800,47800,-2000
2018-06-01,313234082,C013050,운동복,툴마트6P폴리싱패드세트 광택 연마 청소 라이트복원,22900,16240,-6660
2018-06-01,1355157985,C012020,원피스,[다바걸][다바걸] 디엘내추럴코트,42000,39900,-2100
2018-06-01,838437188,A013070,굴,바다해 랍스타테일 3마리 랍스터 4-5oz 랍스터 꼬리살,28000,28000,0
2018-06-01,150399445,A013090,전복,인풍 (겉)홍합 1kg2개,20940,20940,0
2018-06-01,31848228,C013010,점퍼,랜더스 남여공용 노르딕 헤비 패딩자켓 ( JK850W ) 블,79470,70730,-8740
2018-06-01,413917680,G011070,자전거,알톤 로드마스터 R21 /시마노 원터치21단/DP 780소재/,236000,208160,-27840
2018-06-01,1386174959,A018060,스낵과자,삼립 디저트 누네띠네 2.5kg 벌크,11200,11200,0
2018-06-01,390072988,C015020,모자,(컬러:사이즈 : 카키:FREE) ACC-CAP103 빈티,19630,19630,0
2018-06-01,895776464,A019110,드레싱,풀무원 시골강된장 비빔양념 3-4인(150G),1880,1880,0
2018-06-01,1088163475,C013020,티셔츠,쿨링 남자나시티/박스나시/민소매/롱나시/오버핏/기본,12800,9800,-3000
2018-06-01,1391971083,C013010,점퍼,라보니 아동 리얼폭스퍼 다운점퍼 -블랙,106280,106280,0
2018-06-01,1820570468,L021020,장신구,이쁜 여자 피어싱은 믿고 사는 핑팝에서!,2500,2500,0
2018-06-01,1179704147,L021020,장신구,피지 라지 후프 귀걸이 SS-EA-FAHL-NON/ 모니카비나더(주얼리),258000,232200,-25800
2018-06-01,1780553044,A022050,탄산음료,[농심]웰치스355ml 24개입/청포도/포도/딸기/탄산음료,12800,12800,0
2018-06-01,896756620,A019010,고춧가루,[대상]대상 멸치액젓 750g,3450,3450,0
2018-06-01,298284967,C013050,운동복,트렁크 벨크로 그물네트 그물망 정리함 수납함 보관함,7900,6620,-1280
2018-06-01,428340031,C013020,티셔츠,시스터 여름신상 빅사이즈/루즈핏롱티/원피스/투피스,5900,5900,0
2018-06-01,1804573975,L021020,장신구,[바보사랑]지그재그 큐빅 귀걸이,8720,8720,0
2018-06-01,503283316,A013080,조개,국내산 새꼬막 1.5kg (상) 새벽조업후 발송 산지,31300,31300,0
2018-06-01,1378276575,C011030,남자학생복,[YEZAC]예작(신상품)반팔와이셔츠 25종 택1 (YJ8MBS217WH 외 24종)[갤러리아],21900,21900,0
2018-06-01,1090428310,L021030,가방,INTC-317X 발렌타인 더 뉴 백팩 노트북가방 15.6형,67500,64600,-2900
2018-06-01,1208201783,C013040,청바지,[데] 뱅뱅(BANGBANG) 남성용 레귤러 핫썸머 데님 팬츠 3종(남),69900,64310,-5590
2018-06-01,1656250300,C011050,남자내의,아디다스 맨유 카프리 팬츠 (AP6128 ),64740,57620,-7120
2018-06-01,492694014,C012060,여자내의,[핑크시슬리] SET/여름꽃 쿨링 밴딩팬츠세트/ 핑크시슬리,17200,13760,-3440
2018-06-01,989012067,A018100,꿀,스페인 비폴렌 먹는 화분 꽃화분 미네랄 비타민 200g/,14900,14900,0
2018-06-01,2092513261,E021010,침구,[아망떼] 솔리드침구/이불커버/패드/매트커버/호텔식,19900,17900,-2000
2018-06-01,2003767938,C012060,여자내의,3버튼 기모 가죽 바지 레깅스 팬츠 스키니 여성 여자,27240,27240,0
2018-06-01,1514191319,A021010,커피,맥심 모카골드 커피믹스 320T + 증정,33800,33800,0
2018-06-01,769703758,C013050,운동복,코텍 xrn.타이어 펑크 수리키트 K-472 빵구닥터,5550,5550,0
2018-06-01,91504627,L012090,기초화장품,최신정품/ 차앤박 CNP 클렌징 퍼펙타 150ML,11600,11600,0
2018-06-01,904992843,E041050,냄비,나눔냄비 반반라면냄비 샤브샤브냄비 반반냄비 전골냄비 편수냄비 양수냄비 국수냄비,6440,6440,0
2018-06-01,1546684431,F011150,건강기능식품,[술술 풀리고 5갑(25포)] 숙취해소제,71700,71700,0
2018-06-01,1625965984,C013020,티셔츠,여름신상 매일업뎃~! 스위트바니 티셔츠/롱티/반팔,5900,5900,0
2018-06-01,1804573973,L021020,장신구,[바보사랑]두산 베어스 최주환 팀컬러 팔찌,18000,18000,0
2018-06-01,1804573971,L021020,장신구,[바보사랑]피아플로스 피어싱홀 귀걸이 청소 클리너,9900,9900,0
2018-06-01,1010233454,F012020,생리대,[유한킴벌리]유한킴벌리)좋은느낌오가닉순면울날중36P,13000,9990,-3010
2018-06-01,1397052810,C012020,원피스,브로치장식 심플자켓 Z181MSF002/ 쥬크,174500,148330,-26170
2018-06-01,1010233453,F012020,생리대,[유한킴벌리]유한킴벌리)좋은느낌오가닉순면울날소32P,10700,10700,0
2018-06-01,340182310,C012020,원피스,루즈핏 핸드메이드 하프자켓(C181MSF503)/ 씨씨콜렉트,239400,203490,-35910
2018-06-01,441155561,A011170,떡,(냉장)두솔 초밥나라600g(초밥용유부)x10개,95710,95710,0
2018-06-01,449867251,C012030,여자상의,(메이룸)해쉬원피스 린넨원피스 나시원피스 뷔스티에,20900,20900,0
2018-06-01,325712482,C011020,남자상의,밀란시아 빅사이즈 와펜자켓 bigh8-4 빅사이즈 남성자,78450,78450,0
2018-06-01,1661121407,E021020,커튼,펀칭/별/암막커튼 찍찍이설치/북유럽/원룸/가리개커튼,34900,30270,-4630
2018-06-01,1160395694,I011030,사진기,소니 하이엔드 DSC-RX100M3 +액정필름/공식대리점,670000,616400,-53600
2018-06-01,1252936109,C012060,여자내의,빅사이즈/제이스타일 로드킨 스트라이프 프릴 스커트/ 제이스타일,38900,29960,-8940
2018-06-01,176190195,E031130,보온매트,한일생명과학_183×100 거실매트,72900,72900,0
2018-06-01,1010461112,E041070,밀폐용기,스텐이중국통10호~40호/스텐국통/보온국통/보온밥통/스텐밥통/스텐김치통/대형국통/국,68000,62560,-5440
2018-06-01,176190197,E031130,보온매트,한일생명과학_183×230 거실매트,114900,114900,0
2018-06-01,176190196,E031130,보온매트,한일생명과학_183×150 거실매트,84000,84000,0
2018-06-01,176190198,E031130,보온매트,한일생명과학_183×270 거실매트,133500,133500,0
2018-06-01,2084013524,C012030,여자상의,줄리엣 플라워나염 프릴 원피스- 플라워원피스 스트라,54700,46500,-8200
2018-06-01,390177109,G022020,자동차타이어,넥센타이어 고급형 CP672 215/45R17 정품 무료배송,64500,54400,-10100
2018-06-01,1145032263,C013020,티셔츠,미키티/원피스형롱티/루즈핏박스티/롱원피스티/반팔,7900,7900,0
2018-06-01,1232589633,C011020,남자상의,[찐링]28~46 빅사이즈 남성정장바지 골프정장신사,15800,15800,0
2018-06-01,1495320744,A017010,배추,적양배추즙/자색/양배추/브로콜리/즙/진액/위/건강/3,74900,74900,0
2018-06-01,955255017,C013050,운동복,모비스 크루저 루프백 캠핑가방 자동차캠핑용품 차량,268790,244830,-23960
2018-06-01,1090250802,C012040,여자학생복,[루시다][루시다]C97 JK4725애니원 린넨 썸머 가디건,47400,42190,-5210
2018-06-01,1319082790,C011050,남자내의,스판 밤색 교복바지 여자 학생티 고등학교교복 교복,51140,51140,0
2018-06-01,717406273,C013050,운동복,[스마토] 차량안전삼각대_450x400mm_비상시사용_(1EA) 자동차안,10560,10560,0
2018-06-01,1011157000,A018040,아이스크림,빠삐코 35개,35000,17360,-17640
2018-06-01,1011157001,A018040,아이스크림,거북알 30개,30000,16000,-14000
2018-06-01,67629577,C013020,티셔츠,후드티 티셔츠 커플티 후드집업 맨투맨 긴팔티 가디건,12900,12900,0
2018-06-01,1011157002,A018040,아이스크림,더위사냥 커피 30개,30000,16000,-14000
2018-06-01,475729851,E061100,습기제거제,[특가모음] 물먹는하마 525mlX16/ 525mlX32개/제습제,18600,18600,0
2018-06-01,2023986450,C021040,실내화,윌슨 엠플리필 amplifeel 테니스화 ( WRS322840 ) 차,188440,188440,0
2018-06-01,1011157003,A018040,아이스크림,설레임 밀크 24개,31200,16000,-15200
2018-06-01,1385740680,A011160,빵,안흥찐빵마을 우리팥 수제 안흥찐빵 (500g 10입) 3봉,30770,30770,0
2018-06-01,2096912429,C011020,남자상의,MJSF18003 차콜 코튼 베이직 코트 기본남자코트 베이,91960,91960,0
2018-06-01,200049039,A019070,양념소스,[토라니 소스 최저가 모음] 토라니소스 3종 각 1.89L,18500,18500,0
2018-06-01,585759482,I053030,복사용지,한솔 A4 복사용지(A4용지) 75g 2500매 2BOX(5000매),36340,31260,-5080
2018-06-01,1483497992,A018090,잼,트라피스트 수녀원 유기 포도 잼 410g 빵잼 포도잼 식,18850,18290,-560
2018-06-01,359980818,C013050,운동복,트레이닝바지 츄리닝바지 7부트레이닝 반바지 남자,8900,8900,0
2018-06-01,1344184358,L012010,면도기,카이 엑시아면도기+면도날총9입+음파진동눈썹면도기,15800,15800,0
2018-06-01,1372451046,C012040,여자학생복,[엽페][엽페] collar frill knit_skyblue,60800,57760,-3040
2018-06-01,1778706955,L021020,장신구,[바보사랑][925실버] 언발란스 미니 귀걸이 2pcs세트,15900,15900,0
2018-06-01,1060958098,A019080,고추장,[CJ직배송] 새콤달콤초고추장1050G X 3개 + 사계절쌈장500g,11900,11900,0
2018-06-01,1060958096,A019060,된장,[CJ직배송] 명품 집된장 900G X 3개 + 사계절쌈장500g,14580,14580,0
2018-06-01,245739348,C012040,여자학생복,(예사랑)여성 인견 조끼 17YB09,65000,64350,-650
2018-06-01,1448011495,A014040,발효유,액티비아 24개입 아이스박스무료 요플레 그릭요거트,12980,12980,0
2018-06-01,1312153940,C013010,점퍼,루즈슬림절개시크자켓 IR1710 자켓 슬림자켓 일자핏자,111130,111130,0
2018-06-01,1714150016,I012060,저장장치,VARMILO VA104M PBT 염료승화 한글 녹차바닐라/다크그레이,126590,119000,-7590
2018-06-01,1098168231,A011170,떡,제주도 오메기떡/오매기떡/선물세트/특산물/특산품,19000,19000,0
2018-06-01,895886790,A019120,혼합조미료,[CJ]CJ 다시다 산들애 쇠고기맛 (96g),4380,4380,0
2018-06-01,895862764,L021050,우산,녹말 요지 (사각),1800,1800,0
2018-06-01,386512908,E021020,커튼,암막포인트커튼 롱 아일렛형 70x230cm 커튼,10570,10570,0
2018-06-01,451141684,A019010,고춧가루,가을 상 고추가루 2.5kg2개 가루 고추가루 가을고추,84750,76280,-8470
2018-06-01,1466193688,C012060,여자내의,[코데즈컴바인]슬림 일자 린넨 팬츠(CDB-PT604W4)(하남점),59000,47850,-11150
2018-06-01,325758026,E011060,의자,5800부터~접이식의자/식탁의자/책상의자/스툴/사무용,8800,8800,0
2018-06-01,1061206912,C013050,운동복,여성트레이닝팬츠 FREE~3XL 츄리닝바지 요가 배기,10500,10500,0
2018-06-01,559070649,C013020,티셔츠,블랑티 속옷 NO 티셔츠/긴팔/반팔티 원피스 빅사이즈,15800,15800,0
2018-06-01,1268513073,L021020,장신구,14K 스페이드 피어싱,73080,73080,0
2018-06-01,1284093896,A019140,이유식,남양 맘스쿠킹 영양쌀죽 1팩 선택가능,1600,1600,0
2018-06-01,652134820,A022050,탄산음료,탄산 펩시 레트로 콜라 355mlx24캔 피크닉백 증정,14000,14000,0
2018-06-01,1878016488,A013130,오징어채,정화 진미오징어 전기 50gx5.,18700,18700,0
2018-06-01,633826256,E031110,청소기,신모델 S100 단후이 로봇청소기/카메라맵핑/음성안내,439000,439000,0
2018-06-01,1385135301,A021010,커피,맥스웰 마일드 900g/커피믹스/믹스커피/자판기커피,3720,3500,-220
2018-06-01,739035978,E061010,세탁세제,비트 실내건조 2.7kg x 4개 세탁 세제 빨래 냄새 장마,18900,18900,0
2018-06-01,1119013070,F012020,생리대,시크릿데이 100%순면커버 중형 6PX10팩/생리대,11900,11900,0
2018-06-01,324580271,C013050,운동복,카렉스 아이팝 접이식 멀티트렁크 박스 트렁크박스 트,19160,17460,-1700
2018-06-01,1992399360,C012040,여자학생복,[마르조[MARZO]][마르조] 미뉴에트모던블라우스5종,29800,24440,-5360
2018-06-01,631116354,A011010,쌀,브랜드미 4kg 모음/오대쌀.경기미.이천쌀,12700,12700,0
2018-06-01,895886726,A011130,시리얼,[오뚜기]오뚜기 바삭하고 고소한 부침가루 1kg,3150,3150,0
2018-06-01,398630311,G011070,자전거,스타카토 경량 알루미늄 여성용자전거 로제22인치 7단,126500,113850,-12650
2018-06-01,1010257446,F012010,종이기저귀,하기스보송팬티5여26P,15900,9900,-6000
2018-06-01,1941304384,E031010,전기밥솥,CRP-BHXB0660FD/쿠쿠/IH압력/6인용/GH,275300,252640,-22660
2018-06-01,1010257445,F012010,종이기저귀,하기스보송팬티5남26P,15900,9900,-6000
2018-06-01,1010257444,F012010,종이기저귀,하기스보송팬티4여31P,15900,9900,-6000
2018-06-01,1010257443,F012010,종이기저귀,하기스보송팬티4남31P,15900,9900,-6000
2018-06-01,1164792654,E011050,책상,무인도접이식테이블/수강용/사무용/컴퓨터/2인용/책상,65000,64000,-1000
2018-06-01,268395411,C012040,여자학생복,[엘프색][ELF SACK]아리엘쉬폰프릴셔츠,49800,44820,-4980
2018-06-01,1740467012,E061100,습기제거제,천연 야자활성탄 3kg/활성탄/야자숯/새집증후군제거제,22300,22300,0
2018-06-01,748822933,A022050,탄산음료,롯데칠성몰 트레비 1.2Lx12펫(플레인),18000,18000,0
2018-06-01,2071849576,C012040,여자학생복,린넨 노카라 자켓 LRT027 여성봄자켓 가디건(YA02004),105200,92580,-12620
2018-06-01,173765210,A017120,고구마,구기자300g(청양/진도농협)구기자차/구기자가루/분말,24000,24000,0
2018-06-01,650154786,I031010,장난감,3in1 배우는 기차붕붕카/사자붕붕카/포핑붕붕카 (3종),44900,44900,0
2018-06-01,516848952,C012040,여자학생복,[로엠] (특가) 카라 니트 RMKA823R21_NC아울렛,59900,42000,-17900
2018-06-01,1455440490,C012060,여자내의,린넨 A라인 미니 스커트 MIWWH8511B/ 미쏘,35900,34110,-1790
2018-06-01,1879161153,C013010,점퍼,[시슬리]포켓 캐주얼 점퍼(SAJP06641다크블루),107400,91290,-16110
2018-06-01,369706480,E061060,살충제,국내 처음으로 모기 기피제부분 로하스 인증을 획득한,14450,14450,0
2018-06-01,546889087,F012010,종이기저귀,(세일)폴맘 기저귀 팬티형 밴드형4팩 밤기저귀,22900,22900,0
2018-06-01,1010233482,A019170,냉동식품,발재반점 햄볶음밥 230G,1990,1990,0
2018-06-01,1956013940,E011050,책상,특대형 접이식 테이블 사각테이블 식탁 일자책상,13900,13900,0
2018-06-01,1983860876,E031070,에어컨,무배/블로워팬/블로워선풍기/블로어팬/타워팬/CM-100R,62000,62000,0
2018-06-01,1818990803,E031140,비데,이누스 스팀 방수비데 SS-365 (정품필터30개월분증정),349000,299000,-50000
2018-06-01,1905727864,A014020,분유,베비언스 (12입+니플1개) 6~24M 액상분유 240ml,22900,22900,0
2018-06-01,1180835274,C013050,운동복,2_고구마베이비 아기옷-진블루 악어코끼리 민소매 상,6580,6390,-190
2018-06-01,947803197,A016020,배,2017 추석 미래로 VIP 배 선물세트 추석선물 감사선물,97840,94910,-2930
2018-06-01,532351101,C013010,점퍼,STYLEENTER 무스탕추천 B3 메리노베이비 무스탕자켓 남자무스탕점퍼(주문제작),960000,960000,0
2018-06-01,586241663,E061010,세탁세제,알마윈 독일 유기농 세제세트C(액상세탁세제1.5Lx4개),83300,83300,0
2018-06-01,1998270376,E041050,냄비,그린팬 안도라 세라믹 편수냄비 18cm,51200,48880,-2320
2018-06-01,2056248774,F011120,인삼,名品자연애 우리땅 토종 새싹삼:100/200뿌리/산양산삼,39900,39900,0
2018-06-01,473225433,I031040,생화,애완동물 자동차시트패드 애견패드,47250,43040,-4210
2018-06-01,304782136,E031070,에어컨,[신일산업] 신일 블루투스 타워팬 타워형선풍기 SIF-DW120,99000,99000,0
2018-06-01,1010233455,F012020,생리대,[유한킴벌리]유한킴벌리)좋은느낌오가닉순면울날대32P,13000,9990,-3010
2018-06-01,1010343901,F011130,홍삼,한국삼 6년근 정성담은 순홍삼 70ml x 30포,38000,18900,-19100
2018-06-01,1830384683,C011050,남자내의,인터페이스 일자 면바지 다양한 사이즈 편안함 중독면,17700,17700,0
2018-06-01,1363258853,C011030,남자학생복,핏감나는훈남셔츠 46종면스판 면혼방 핸리넥 무료배송,22000,16800,-5200
2018-06-01,2100753767,C011050,남자내의,[클럽캠브리지]마이크로 체크패턴 면스판 팬츠 2종 택1 (CZPAM1725)(본점),39000,32160,-6840
2018-06-01,1509210081,C014020,유아복,[모노블랙][모노블랙] 밀리터리 맨투맨티 53MTS161,7000,6650,-350
2018-06-01,1203979500,A011030,찹쌀,쌀보리 (농협 1K) X10,65780,58550,-7230
2018-06-01,193137354,C012060,여자내의,시크폭스 크리디 밴딩배기팬츠/ 시크폭스,37800,29490,-8310
2018-06-01,1436945579,A013020,명태,속초바다를 품은 반건코다리 43~48cm내외(10미)/ 롯데식품관,21900,21900,0
2018-06-01,628992114,L021060,유모차,치코 휴대용 울랄라/절충형 미니모유모차/기내반입,99000,99000,0
2018-06-01,1651499065,A018100,꿀,타히 UMF10+ 마누카꿀x400g 뉴질랜드 벌꿀,155000,153450,-1550
2018-06-01,1134024308,C013010,점퍼,봄신상/캐주얼자켓/남자마이/남성봄자켓/남자블레이져,29900,29900,0
2018-06-01,447184941,C012040,여자학생복,[파프리카]에스닉패턴 로브 가디건_N82CDC03(경기점),29000,25880,-3120
2018-06-01,1530623174,C012020,원피스,MELODY F132 차콜/코트/여자코트/겨울코디/겨울코트/자켓/점퍼 미국 여성토탈브랜드 멜,84700,84700,0
2018-06-01,170354044,A017170,풋고추,싱싱한 백오이3kg/5kg 오이소박이 오이피클,7500,7500,0
2018-06-01,1525656156,A011130,시리얼,오뚜기 부침가루 1kg X 10EA 찹쌀부침가루 찹쌀부침가,33530,32530,-1000
2018-06-01,689025796,C013040,청바지,남자스키니청바지/남성팬츠/일자진/밴딩바지/28-40,15900,15900,0
2018-06-01,1813786972,E031110,청소기,[노벨로]초미니 휴대용 스팀다리미/여행용다리미,29900,29900,0
2018-06-01,1038961573,L021030,가방,스마일뱃지벳지 여자백팩가방 캐쥬얼백 초등학생 장식,6500,6500,0
2018-06-01,1775741823,E031110,청소기,단후이 로봇청소기 NR15 시즌2,298000,298000,0
2018-06-01,385683454,C013020,티셔츠,[루스코]MJST023 배색 랍빠 후드반팔티 오버핏,21300,18060,-3240
2018-06-01,352718995,A012010,국산쇠고기,대관령한우 알뜰세트 2호,119880,119880,0
2018-06-01,573040701,A018090,잼,오뚜기 디스펜팩 딸기쨈(12gx480개) 일회용 딸기쨈/쨈,32600,32600,0
2018-06-01,1333642172,A018020,사탕,무료배송10k모음과일종합카라멜대용량벌크 업소용사탕,30900,30900,0
2018-06-01,1462048607,A013060,게,갑오징어(60-80 베트남)220g,2580,2580,0
2018-06-01,1605521612,C013050,운동복,버버리 남아 여아 아동 100 밴딩 면 통 와이드 바지,34360,34360,0
2018-06-01,2109755055,L021050,우산,11//장마대비 여성레인코트 패션우비 성인여자비옷,20000,19500,-500
2018-06-01,1088014087,E061020,섬유유연제,[다우니]향기지속제 신제품 퍼퓸쥬얼 480g*2,22900,22900,0
2018-06-01,1107514382,C013010,점퍼,여름 가죽자켓 라이더 레더 남자 남성 점퍼 청자켓,49800,49800,0
2018-06-01,1405393427,C012030,여자상의,봄 여름 반팔 77 88 99 빅사이즈 밑단 프릴 롱 원피스,23900,23900,0
2018-06-01,530505843,C012060,여자내의,백합주름치마 베이지체크 전체 주름 교복치마 교복 예,55060,53410,-1650
2018-06-01,200247938,E041030,솥,대웅c 미니전기밥솥 DRC-0608 캠핑용 자취생 찜기,16900,16900,0
2018-06-01,2084039530,C013040,청바지,(SR)MHA533 남자빅사이즈스판청바지 /(참고)남자빅사,71600,60860,-10740
2018-06-01,1781689874,L021020,장신구,(실버) 니트 스틱 목걸이 (Gold Rose Gold) 심플금목,25050,25050,0
2018-06-01,515496821,A014020,분유,베비언스전용 니플/케이스포함/사이즈 S M L,6700,6700,0
2018-06-01,1248372629,E061060,살충제,홈케어 새집증후군제거 32평형 피톤치드 포름알데히드,67800,67800,0
2018-06-01,1441540437,C021040,실내화,스티유 18 S S 81307iv-81308kh 원 웨이 지 샌들,43870,43870,0
2018-06-01,98988023,A017250,고사리,국내산브로콜리8kg내외 두리반농산,33000,33000,0
2018-06-01,1840921578,F012020,생리대,릴리안순수한면 슈퍼롱오버나이트7px3팩,7900,7900,0
2018-06-01,1670104070,E041020,컵,클림트키스 커피잔 5인조세트/커피잔/찻잔/머그컵,88000,87120,-880
2018-06-01,887102922,A014050,달걀,아라리 계란 30gx50개/메추리알/에그맵/맵추리/무배,23200,23200,0
2018-06-01,1341767031,C021040,실내화,드라이버 2(18998103) 운동화 런닝화 운동신발 달리기,85200,85200,0
2018-06-01,956843201,A022030,생수,제주 삼다수 2L*6입,5820,5700,-120
2018-06-01,288937608,C013020,티셔츠,빅사이즈 카라 라운드 110 ~140(4XL)[더블온스],25900,25900,0
2018-06-01,956843200,A022030,생수,제주 삼다수 500ML*20입,9000,9000,0
2018-06-01,1147781095,C013020,티셔츠,브랜드특가 브이넥티/반팔티/라운드/반팔티셔츠/단체,24800,17500,-7300
2018-06-01,1297943636,C013030,스웨터,MNT-910 포인트 컬러배색 래글런 라운드 니트 캐주얼,21940,21940,0
2018-06-01,1272087897,C011020,남자상의,모던 보카시 그레이 싱글수트 리즈코 남자옷도매 도매,170630,153570,-17060
2018-06-01,1085148422,E011020,침대,아씨방 한정특가 저상형 패밀리침대 (매트리스포함),395610,395610,0
2018-06-01,1773946444,A018050,비스킷,초특가 몽쉘통통 384g 4개/초코파이 카스타드,12800,12800,0
2018-06-01,862442429,E011050,책상,샤이닝홈 무드 접이식테이블 좌식책상 밥상 다용도,17900,15210,-2690
2018-06-01,174899541,A017080,무,아스파라거스1kg 각종손질야채 구매가능,9800,9800,0
2018-06-01,1136474306,C012020,원피스,[나이스클랍]트리플 원피스 ( N182YSE001)(하남점),158000,128080,-29920
2018-06-01,1744795192,F012010,종이기저귀,[하기스] 네이처메이드 팬티 2팩/밴드 3팩/17년 썸머,43500,43500,0
2018-06-01,230250388,E041070,밀폐용기,전자렌지용 냉동밥 보관용기 찜기 쿡앤밥30세트,7900,7270,-630
2018-06-01,988925194,A013130,오징어채,키토산 진미오징어채 120G*2,14900,14900,0
2018-06-01,611597336,C012040,여자학생복,수지네 빈티지 아디다스오리지널 레드 베스트 여성 S,32580,32580,0
2018-06-01,1163625783,E031070,에어컨,[코멕스] 가정용 업소용 선풍기/16인치 벽걸이 선풍기 JP-1607W,25400,25400,0
2018-06-01,1154113587,C012040,여자학생복,W 오프리미츠 보더배색롱나시니트 G80KT2605/ 오프리미츠,34000,32640,-1360
2018-06-01,751046898,C012020,원피스,[2ME][2ME] 라운드넥 벨티드 코트 TMJH81101F27,139300,121200,-18100
2018-06-01,545983347,C013020,티셔츠,여성 JOURNEY 스판 반팔티셔츠 (힙커버),14900,14900,0
2018-06-01,1242737763,L012060,샴푸,[차밍 투인원겸용샴푸 바디워시 4.2Kg] 미장센,6800,6800,0
2018-06-01,1218853436,C013040,청바지,[게스]GUESS 여성 라이트톤 워싱 스키니 진 청바지(YF0D9068),39000,31980,-7020
2018-06-01,303757162,F011150,건강기능식품,봉동 생강 가루 150g 편강 즙 절편 국산 분말 스낵 칩,10900,10900,0
2018-06-01,1406409989,C013020,티셔츠,[케이투]EXM 로고 반팔 라운드티 W (KWM17224),29000,23200,-5800
2018-06-01,1093685919,E061040,부엌용세제,맑을청 친환경 주방세제/프릴/식물성/천연세제,7200,7200,0
2018-06-01,341137748,C013050,운동복,디즈니정품 미키마우스 여름 3부팬츠 트레이닝복세트,22900,22900,0
2018-06-01,2045833919,E031110,청소기,[BSW] 핸디형 싸이클론 파워 진공청소기 BS-1505-VC,55000,46400,-8600
2018-06-01,1318539368,D031010,주택수선재료,[던에드워드]친환경페인트/약1L 슈프리마/방문 벽면,22000,22000,0
2018-06-01,1926777715,I031040,생화,박치완원장 무릎보호대/관절보호대/무릎/파워렉/아대,24000,24000,0
2018-06-01,1623894362,E061010,세탁세제,화미 식소다1kg x 24,75390,67100,-8290
2018-06-01,350863234,E031120,믹서,[완특]일렉트로룩스 핸드블렌더 ESTM7804S,80000,74400,-5600
2018-06-01,483747836,E031050,냉장고,LG 디오스 냉장고 K412SS13 402L 스탠드형김치냉장고,1731000,1661300,-69700
2018-06-01,1486877148,C013020,티셔츠,지오다노 01028250 솔리드 크루넥 반팔 티 028250,7000,5810,-1190
2018-06-01,63534772,A011170,떡,백제푸드 즉석 쌀떡국 쌀국수 우동 스파게티,990,990,0
2018-06-01,1188636188,E061060,살충제,[바이엘 크롭사이언스]맥스포스 셀렉트겔 30g/마툴키/,13500,8910,-4590
2018-06-01,582790158,I031040,생화,윈닥스 아이스피아 6L 8L/아이스박스/아이스탱크/,10800,10800,0
2018-06-01,1488902211,E011040,소파,[에보니아] 뮤즈 2인 패브릭/가죽소파/천쇼파/2인쇼파,109000,78000,-31000
2018-06-01,528298107,A018010,초콜릿,유러피안 다크초콜릿55%/70% 300gX2개 총600g/무배,9800,9800,0
2018-06-01,547419739,A011120,두부,[씨알푸드]씨알로 대용량 지퍼백 시리얼 특가,10400,9400,-1000
2018-06-01,1460528888,C011030,남자학생복,30%쿠폰! 봄신상 셔츠/긴팔셔츠체크/루즈핏,9900,9900,0
2018-06-01,363080669,A019110,드레싱,[냉장] CJ 다담 마파두부양념 150g/ 씨제이제일제당,1090,1090,0
2018-06-01,1035682459,E061030,전구,오스람 LED전구 9.5W 13.5W 주광색 전구색/E26규격,2150,1940,-210
2018-06-01,1080132826,A021010,커피,맥심모카골드마일드/자판기용커피믹스/맥스웰마일드,3900,3900,0
2018-06-01,2027325713,C012060,여자내의,로사W 쿨썸머 와이드 팬츠 3종,59000,54280,-4720
2018-06-01,1829851388,C013040,청바지,루알라 청바지/아동바지/아동팬츠/하의/아동복/무배,20000,17900,-2100
2018-06-01,1905715810,C013010,점퍼,[르젠옴므]르젠 심플 와펜패치 배색안감 항공점퍼(LNJK803HS),32800,31160,-1640
2018-06-01,608452831,F012020,생리대,좋은느낌 오가닉순면커버 오버나이트10px6개 생리대,28500,28500,0
2018-06-01,1715054844,C012020,원피스,[모다아울렛][에이비에프지]허리밸트 핸드메이드 롱코트 (AFR4CC07) 블랙  그린,169000,158860,-10140
2018-06-01,1310488621,C012020,원피스,[블루종][블루종]린넨 스트라이프 롤업 벨트 코트_[B1805CT011B],39000,35100,-3900
2018-06-01,12823035,C012020,원피스,[리리앤코]남심저격원피스/44-110/빅사이즈/플라워,38800,27800,-11000
2018-06-01,1171349286,C013010,점퍼,[앤드지]메쉬조직 배색라그랑블루종BLX2JJ1002,55000,44000,-11000
2018-06-01,2051209190,C013010,점퍼,팬콧 얌얌 팝캐릭터 반팔티 PPOGURS72E-P2,12900,12900,0
2018-06-01,1216706517,A016060,감,달콤샤르르 자연그대로 만든 아이스 왕 홍시 18개(컵),34200,30780,-3420
2018-06-01,2108287127,A014050,달걀,청년농부의 무항생제 동물복지 유정란 30구_알찬농장,18900,17900,-1000
2018-06-01,2019043665,C013010,점퍼,cc58 사선지퍼 원버튼 슬림 자켓 블랙 여성의류 카라,30720,30720,0
2018-06-01,3325676,C012060,여자내의,[아덴] PT1518/비키 부츠컷슬랙스/ 아덴,19800,15050,-4750
2018-06-01,11500460,C012040,여자학생복,캘빈클라인 집업 니트 가디건/여성S/스웨터/중고/구제,23900,23900,0
2018-06-01,2123933873,C011030,남자학생복,MNTSF18001 체크 니트 베스트 / 조끼 봄 가을,14000,14000,0
2018-06-01,988925171,A013130,오징어채,DHA 진미오징어 120G*2,14900,14900,0
2018-06-01,393916992,C013010,점퍼,아디다스 니트 AK 3S 트랙탑(AJ3645) 츄리닝 트레이닝,69890,69890,0
2018-06-01,1086557981,C021040,실내화,나이키운동화 302519-001 에어 맥스 90 레더 (올검) A,158000,158000,0
2018-06-01,1825319791,C012040,여자학생복,[2ME][투미] 솔리드 심플 포켓 브이넥 가디건 TMCK54T04C_17,2800,2660,-140
2018-06-01,1670069251,L021030,가방,15/17인치 노트북백팩 노트북가방 학생 직장인 백팩,31000,30070,-930
2018-06-01,630790286,A017210,파,[네이버 재구매율 1위] 따옴농장 완숙토마토 5kg/3kg,11500,11500,0
2018-06-01,382355381,F012020,생리대,릴리안/순수한면/초흡수/숨쉬다/생리대/팬티라이너/,10900,10900,0
2018-06-01,1711691455,E061050,청소용세제,(초특가)유연락스 2L x 6개 / 유한 3L + 1L x 3개증정,10000,8900,-1100
2018-06-01,195467529,I031040,생화,클라우드 자립형 해먹 스탠드세트 그네해먹 캠핑용품,48000,41890,-6110
2018-06-01,555031507,A016020,배,[푸른자연-농부家] 나주배 실속선물세트 5kg (9-10과내) 나주배 배 배선물세트 명절과,64000,64000,0
2018-06-01,452572150,C013020,티셔츠,아이조아/여름최신상/디즈니/티셔츠/바지/상하세트,6900,6900,0
2018-06-01,387308257,C015030,넥타이,LTIE-185 네이비 스크레치 무지 넥타이 남자,15310,15310,0
2018-06-01,1010412102,A013070,굴,주꾸미(생물/태국) 100G,1490,1490,0
2018-06-01,2098104050,C013050,운동복,우먼스 ZNE 플러스 후드 2 여성짚업 여성집업자켓 여,135750,135750,0
2018-06-01,986215058,A016050,밤,[영동곶감]지함3호2kg(40~50개),84000,59000,-25000
2018-06-01,205396942,A019080,고추장,청정원 순창 진고추장 5kg / 태양초 고추장,9900,9900,0
2018-06-01,376472251,C013010,점퍼,스트랩후드퍼패딩/키즈롱패딩/아동롱패딩점퍼ed,33900,19900,-14000
2018-06-01,243480669,E061060,살충제,애경 홈즈 쌀벌레 퇴치제 2묶음(무료배송),10000,10000,0
2018-06-01,986215056,A016050,밤,[영동곶감]반건시4호2.6kg(40개),89000,72000,-17000
2018-06-01,1685466988,C013020,티셔츠,BEEN 남아 그레이 반팔 티셔츠 BS27TS10GY,10400,10400,0
2018-06-01,986215057,A016050,밤,[영동곶감]지함1호1kg(20~30개),59000,41000,-18000
2018-06-01,1058921295,E011050,책상,에이존 가구 사무용 중역 마스터 책상 중역용 사장님,62000,62000,0
2018-06-01,1961099279,A013070,굴,프리미엄 점보 활 랍스타 2.5kg 1마리 캠핑요리 랍스,114900,114900,0
2018-06-01,329285418,C012060,여자내의,[클라이드n]여성 워싱 데님 스커트(CIBSK702F)(김해점),49800,43480,-6320
2018-06-01,492733970,E041050,냄비,네오플램 스트레스 제로 멀티 냄비/후라이팬/코펠,9900,8900,-1000
2018-06-01,678436618,F012010,종이기저귀,[+썸머블랭킷] 보솜이 리얼코튼 썸머밴드/팬티 3팩,34900,34900,0
2018-06-01,69729670,A013170,생선통조림,롯데 런천미트 340g x1캔 /리챔/스팸/로스팜/훈제/햄,1840,1840,0
2018-06-01,9929652,C013030,스웨터,여름신상원피스/44-110/빅사이즈/쉬폰/플라워원피스,42800,28800,-14000
2018-06-01,924572802,C012030,여자상의,(일구삼구) 여성 캉캉 레이어드 뷔스티에 나시 원피스,9900,9900,0
2018-06-01,989073008,L012090,기초화장품,아토마일드) 모이스춰 로션,18500,9990,-8510
2018-06-01,218473897,I031010,장난감,줄라이카 미니바이크 Zoo 유아 무소음 붕붕카 푸쉬카,49800,49800,0
2018-06-01,1231120570,E011050,책상,[우드홀릭]원목책상/컴퓨터책상/원목테이블/,89000,89000,0
2018-06-01,1326937320,C011030,남자학생복,[후아유]유니 하와이안 플라워 문양 셔츠 / WHYA82430F,39900,35120,-4780
2018-06-01,577894017,D031010,주택수선재료,폼블럭 인테리어 파벽돌 벽돌무늬 시트지 포인트시트,10300,9170,-1130
2018-06-01,891754944,A018100,꿀,콤비타 마누카허니 로젠지(캔디) 쿨민트 180g,18900,18900,0
2018-06-01,1453592266,C013020,티셔츠,[수미수미(sumisumi)][이월] 밑단배색나시 SUIFTS21[갤러리아],39000,35100,-3900
2018-06-01,1499049899,E031120,믹서,리큅 프리미엄 홈 블렌더 CUBE BS5 A급리퍼 믹서기,169000,169000,0
2018-06-01,1340300994,L021020,장신구,블랙 썸 초커 목걸이 10대 겨울 레이스 선물 네크리스,11290,11290,0
2018-06-01,467939559,I053010,공책,묶음상품 플라스틱링(51mm)백색 50개입x3개 제본스프,78430,78430,0
2018-06-01,1331298716,E041030,솥,풍년 압력솥 고무 압력 패킹 가정용/영업용 추 밸브,5000,4000,-1000
2018-06-01,180374332,E031120,믹서,[필립스정품] HR-2870 쿠치나 미니믹서기 HR2870 2단속도조절 컵3개 거름망 믹서 분쇄,52300,52300,0
2018-06-01,576546794,A021010,커피,시원한~아이스 커피믹스 110T/락앤락물병세트/커피,18900,18900,0
2018-06-01,840959481,C011030,남자학생복,빅사이즈 캐쥬얼 롱가디건 atl172-001-빅사이즈 남성,57000,50730,-6270
2018-06-01,1631997810,E031050,냉장고,[LG전자] LG판매점 (JS) LG 김치냉장고 디오스 K337W11 327L,1114580,1070000,-44580
2018-06-01,155921336,F012010,종이기저귀,보솜이 소프트 슬림 중형42p/ 대형36p/ 특대형32p/4팩,30500,30500,0
2018-06-01,934252227,F011150,건강기능식품,중외제약 락토플러스 생 유산균 키즈 50포2개 비타민D,18900,18900,0
2018-06-01,773503462,E031070,에어컨,한일 벽걸이형 선풍기 모음 /한일선풍기/벽걸이선풍기,50000,46080,-3920
2018-06-01,212598071,E011020,침대,장인가구아이브 아르겐트 원목침대/SS Q 패밀리침대,281700,281700,0
2018-06-01,505540628,A011010,쌀,영양밥상 3.5kg(경기미70%기능성혼식30%),16500,16500,0
2018-06-01,1154052174,C012060,여자내의,선샤인코튼숏팬츠/ 립합(LIPHOP),23000,21850,-1150
2018-06-01,54960972,I031040,생화,[콜맨]침낭 / 2 IN 1 패밀리 c10 / 2000027256 / 2016년 신제품 신세계몰,67900,66550,-1350
2018-06-01,958656554,F012020,생리대,유한킴벌리 화이트 시크릿홀 울트라 날개 소형(18P),5340,5340,0
2018-06-01,1091500921,C013050,운동복,몽크로스 실리콘 도어가드 2컬러,9810,9810,0
2018-06-01,1310608929,F012020,생리대,좋은느낌생리대/좋은느낌 울트라 소/중/대형 생리대,44900,44900,0
2018-06-01,1784856055,C014020,유아복,아동바지 매화 미니쥬리 팬츠 KIDBOK-26 면바지 아동,10660,10660,0
2018-06-01,489164336,C012060,여자내의,패션풀 BPT17560홀릭 소프트 린넨 밴딩 팬츠/ 패션풀,15400,13090,-2310
2018-06-01,1609340443,A018100,꿀,독일 바이탈비토닉 30앰플 / 바이,271720,271720,0
2018-06-01,1502988184,C013050,운동복,나이키/아디다스/트레이닝복/세트/츄리닝/세트/45종,69000,69000,0
2018-06-01,415934521,C012040,여자학생복,[밸리걸] 플라워프린트 볼레로 가디건 973600,9900,8420,-1480
2018-06-01,1712872511,A017090,열무,[무료배송]무우!! 웰빙 황토 무우 / 천연비료 국산,11500,11500,0
2018-06-01,1897874455,A017210,파,(무배+사은품)맛있는 완숙토마토/ 크기선택/싱싱해요,10900,9900,-1000
2018-06-01,1271369134,C011030,남자학생복,레드라인 포켓 네이비 셔츠 남자남방 남자긴팔셔츠 남,25800,25800,0
2018-06-01,987227020,F011150,건강기능식품,GNM자연의품격 유기농 양배추브로콜리즙 1박스(30포),17400,17400,0
2018-06-01,975325108,C013010,점퍼,[모다아울렛][반에이크]스타디움점퍼 VA84JPQ304Z-BK,59800,54420,-5380
2018-06-01,1624666792,C012020,원피스,[티렌]에이라인 코트 T174MSG404,149000,119200,-29800
2018-06-01,1198431772,E061040,부엌용세제,참그린 석류식초 주방세제 900mlx4개 퐁퐁 트리오,8900,7900,-1000
2018-06-01,403228510,C013020,티셔츠,여성나시/여자나시/끈나시/롱나시/나시티/속바지/런닝,5800,5800,0
2018-06-01,1656034381,C014020,유아복,[대구백화점 II관] [카라멜플라츠]디어베이비 폴 지그재그면매쉬점퍼(2종택1 02L32500,35000,32550,-2450
2018-06-01,520436174,E041030,솥,순수국산 대성 누룽지 2중압력돌솥 특허상품 업소용,93800,93800,0
2018-06-01,865312598,E061030,전구,[단독1+1] 필립스 LED 전구 3W/7W/9W/11W 파격특가!!,2800,2800,0
2018-06-01,987301505,A011180,파스타면,롯데 까르보나라스파게티/볼로네이즈/뽀모도르스파게,2090,2090,0
2018-06-01,1057235175,A021020,차,테이크아웃컵/종이컵/8온스/10온스/핫컵/투명컵/뚜껑,5000,5000,0
2018-06-01,77794681,A017110,감자,장흥표고_백화고혼합세트건강식품 명절선물세트 특산품 추석선물세트 효도선물 표고세,93170,93170,0
2018-06-01,1572363141,C013020,티셔츠,[체스]러브 쿨 여성 골프 귀걸이 이너,27900,26510,-1390
2018-06-01,1356128433,C011020,남자상의,심플베이직 롱모직남자코트 / 참고 남자겨울신상 남자,134900,110620,-24280
2018-06-01,1521739480,D031010,주택수선재료,주방타일 기름때 오염방지필름,4500,4400,-100
2018-06-01,1340300968,C013010,점퍼,빅사이즈 DSM1044 빅 포인트 울 자켓 801 큰사이즈자,90590,90590,0
2018-06-01,782805113,E011070,식탁,이사벨B600 아일랜드 원목홈바 미싱테이블 식탁렌지대,95000,75900,-19100
2018-06-01,1759803908,L021030,가방,에블린 두근두근 기본 가터벨트(3color)-EBFC74956B,17430,16040,-1390
2018-06-01,1712581008,A018020,사탕,간식 모음)과자/초콜렛/껌/사탕/카라멜/골라담기,5950,5950,0
2018-06-01,882158635,A012050,소시지,롯데 키스틱 1200g 875g 빅팜 불닭 더블치즈 매콤문어,6700,6700,0
2018-06-01,79243509,A013070,굴,[요코몰] 업소용 게딱지장 400g/YD/영덕농수산/영덕대게/성게알통조림/대게살/게간장/,27550,26180,-1370
2018-06-01,416978078,E011050,책상,MT101-S 높이조절 워크스테이션 블랙 높이조절책상/,496940,496940,0
2018-06-01,389813474,C013050,운동복,붙이는납 테이프납 휠 바란스납 알루미늄납 접착 스틸납 타이어바란스 휠바란스 자동차,6900,6900,0
2018-06-01,987976633,E031070,에어컨,신일 써큘레이터 SIF-C50J,149000,109000,-40000
2018-06-01,494493686,C014020,유아복,까꿍맘/여름신상/아기옷/여아의류/유아원피스/아동복,12900,12900,0
2018-06-01,89846128,F012020,생리대,무료배송 템포 슈퍼 리뉴얼 20P X 2팩/ 템포,13800,13110,-690
2018-06-01,895776303,E061070,가정용비닐용품,[크린랩]크린백 미니(17*25*100),1990,1990,0
2018-06-01,895776304,E061070,가정용비닐용품,[크린랩]크린백(중/25cm x 35cm x 100매),2500,2500,0
2018-06-01,895776306,E061070,가정용비닐용품,[크린랩]크린랩)크린백(대) 30cm x 45cm x 100매,3690,3690,0
2018-06-01,456332546,C012020,원피스,쿠냥 린넨 자켓 투피스 (6 color),45000,45000,0
2018-06-01,1764420520,C013010,점퍼,여자무스탕 오버핏무스탕 천연양털무스탕점퍼,1089500,1089500,0
2018-06-01,1652227511,C012060,여자내의,쿨팬츠/나팔바지/몸빼바지/와이드팬츠/바지 냉장고,2500,2500,0
2018-06-01,34128792,C014020,유아복,갭 베이비 3-4세 가량 패딩 점퍼 후드탈부착 좋음/200,19000,18810,-190
2018-06-01,956784363,A011180,파스타면,[CJ]CJ 이탈리따 스파게티320G,1250,1250,0
2018-06-01,439636366,A013170,생선통조림,(무)유동 자연산골뱅이 400gX24개유동 자연산 골뱅이,339700,288750,-50950
2018-06-01,596082651,A016100,수박,고당도 하우스 꿀수박 (4~7kg),8800,8800,0
2018-06-01,1314653075,C012060,여자내의,SK1162-롱플레어 융기모 밴딩스커트 기모치마 밴딩치,20020,20020,0
2018-06-01,1477211420,A017080,무,[남도장터]담양 세아지매 새싹삼 30뿌리 선물세트,10000,10000,0
2018-06-01,605437678,C012060,여자내의,진청 A라인 에이라인 단추 롱 청 데님 치마 스커트,19900,19900,0
2018-06-01,1689285843,A018050,비스킷,로투스 50P x 6봉 1P 300개 씽글팩 비스킷 커피 과자,15900,15900,0
2018-06-01,523536785,C014010,아동복,솔리드 형태의 기본형 라운드 티셔츠 반바지 세트 [BK후크세트]/ 블랙야크(키즈),38000,31160,-6840
2018-06-01,775096093,F012010,종이기저귀,큐티기저귀/팬티기저귀 점보18Px5팩/돌선물/팬티형,29500,29500,0
2018-06-01,1289592945,C015040,장갑,LS_모장갑(손목누빔)W(여성용) 겨울용품 예쁜장갑 모,16030,16030,0
2018-06-01,1656819986,A013100,마른멸치,꼬마전복35-55미내외1kg,20900,20900,0
2018-06-01,327339254,I031040,생화,카나모 캠핑테이블/접이식/야외/좌식/책상/밥상/매대,38700,21700,-17000
2018-06-01,1288791499,A018080,설탕,백설 하얀설탕15kg/큐원/갈색/흑색,14500,14500,0
2018-06-01,1122618761,E041010,식기,루미낙 루미락 나뭇잎 타원접시21x13.36p,38000,36100,-1900
2018-06-01,2110768742,C013050,운동복,[kmmotors] 잡쓰 쓰레기통/차량용쓰레기통,9400,8280,-1120
2018-06-01,323834342,E041050,냄비,전골 냄비 스텐 샤브샤브 냄비 밀푀유나베 오뎅탕,22500,22500,0
2018-06-01,289398118,A017180,호박,늘푸른 특 고추가루 2.4kg,53200,51610,-1590
2018-06-01,1893739551,C013010,점퍼,주니어 래쉬가드 세트 수영복 레쉬가드 초등학생 래시,24900,24900,0
2018-06-01,422362390,C013040,청바지,30%쿠폰!1+1봄신상/남자청바지/스판/일자/카고/롤업,12800,12800,0
2018-06-01,351728323,I012010,컴퓨터,삼성 LG i5 i7 외 게임/사무/인강용 추천 중고노트북,279000,279000,0
2018-06-01,1904713138,C013060,등산복,빅사이즈 등산티 등산복 작업복 아웃도어 남성 반팔,18800,18800,0
2018-06-01,1992253062,A011130,시리얼,백설 부침가루 500gx20개,49150,43750,-5400
2018-06-01,1574649326,C012020,원피스,[ab.f.z][MD기획] 핸드메이드 코트 신상단독인하 (ARR4GC01L/ARR4GC02L)[갤러리아],119000,101150,-17850
2018-06-01,162958162,C013010,점퍼,여름 바람막이 항공 남자 남성 점퍼 자켓 아웃도어,25800,25800,0
2018-06-01,1152365586,A011040,보리쌀,작두콩차 100g 180g 삼각티백,9000,9000,0
2018-06-01,2076866881,C011050,남자내의,원턱 면바지/골프바지/남성바지/남자바지/작업복/여행,9900,9900,0
2018-06-01,1546782871,C013050,운동복,(미래안전) 다기능신호봉 미니신호봉 차량부착안전봉,12750,11620,-1130
2018-06-01,1221092906,C012040,여자학생복,소매 레이스 블라우스-IJ6U4WIB051,37700,37700,0
2018-06-01,488615282,I031040,생화,KC인증18650 파나소닉정품 충전배터리/3400mAh/1000회,4000,3360,-640
2018-06-01,1321940968,C013050,운동복,(하절기)서큘러 멜란지 트레이닝복세트 운동복 츄리닝,19800,19800,0
2018-06-01,1245412301,C021040,실내화,무료배송 국산 남성 빅사이즈 구두 웰트화 워커 250-300mm케주얼 로퍼 사이즈 고민끝,29900,29900,0
2018-06-01,1792587845,C013020,티셔츠,유아 아기 아동 키즈 남아 여아 어린이 후드티 맨투맨,9800,9800,0
2018-06-01,1565465602,C012020,원피스,[쥬크(ZOOC)]알파카코트(GR)Z174MSG026(강남점),219000,195440,-23560
2018-06-01,900302522,A011100,라면,[오뚜기]오뚜기 자른당면 (500G),5890,5890,0
2018-06-01,1395637256,C012030,여자상의,밑단프릴 후드 면원피스 DM-6641/후드원피스 이지웨어,19700,18720,-980
2018-06-01,235002794,C015030,넥타이,(색상 : 그린) BTIE_107 미로 패턴 보타이,13420,13420,0
2018-06-01,1243607730,I053010,공책,아이디얼 양장노트 유선 엘로우 박스24개입 양장노트,125470,125470,0
2018-06-01,900302526,A018060,스낵과자,[오뚜기]오뚜기 뿌셔뿌셔 바베큐 (90G),850,850,0
2018-06-01,960716589,A014020,분유,프리미엄 하이키드 밀크600gX3캔/초코650gX3캔,63500,63500,0
2018-06-01,1163309260,G011070,자전거,[알톤정품]17년 플로리아24/26 여성용 블랙잭 자전거,126580,116460,-10120
2018-06-01,666250398,A017090,열무,유기농 무말랭이 500g (친환경농산물),13000,11900,-1100
2018-06-01,70371330,E031090,공기청정기,넥스디지탈 HAIKE A800 공기청정기/ 4중필터,79000,69000,-10000
2018-06-01,2112482982,F012050,의료측정기,케어센스2+ 혈당측정기 풀세트/시험지110+침210+솜100,32000,32000,0
2018-06-01,458889320,A013070,굴,무료배송 주문진 홍게3kg 당일조업  선주직송  대게,18900,18900,0
2018-06-01,958656576,F012020,생리대,[유한킴벌리]유한킴벌리 화이트 시크릿홀 울트라 날개 소형(32P),8900,8900,0
2018-06-01,958656578,F012020,생리대,[유한킴벌리]유한킴벌리 화이트 시크릿홀 울트라 날개형 대형(16P),5490,5490,0
2018-06-01,958656579,F012020,생리대,[유한킴벌리]화이트 시크릿 울트라날개대형 32P,10900,6500,-4400
2018-06-01,414344619,F012010,종이기저귀,톨로 베이비드라이버 완구 장난감 어린이 아동 애기,28920,28920,0
2018-06-01,439636396,A019100,식초,(무)오뚜기 2분의1케찹475gX20개(1박스)마아가린 케찹,75200,63920,-11280
2018-06-01,92262421,C012040,여자학생복,[PL_홈쇼핑]심플 핑크 라인 포인트 폴라 니트,7900,7510,-390
2018-06-01,2042877013,A012060,햄및베이컨,정통 수제햄세트 (육함량95%/실속구성/햄선물세트),45900,44990,-910
2018-06-01,1142610504,E031120,믹서,[SK매직] Magic 다용도 미니믹서기 MCH-B606 (컵4개/칼날2종),29680,27900,-1780
2018-06-01,406458238,C014020,유아복,[트윈키즈]기본전판바지 (T7HT9P01),6600,4290,-2310
2018-06-01,180634294,A014010,우유,파스퇴르 무항생제 바른목장/내츄럴/딸기/쵸코/바나나,15900,15900,0
2018-06-01,1193943250,C012040,여자학생복,[보브(여성의류)] 2001중계아울렛] 시스루 지퍼가디건 (7128250511),155400,124320,-31080
2018-06-01,1213934499,C012040,여자학생복,[신상]기본셔츠/무지남방/화이트셔츠/스,23800,23800,0
2018-06-01,1742347750,F012020,생리대,시크릿데이 생리대 러브 입는 오버나이트2PX6팩,12900,12260,-640
2018-06-01,1727292367,C013020,티셔츠,블루빈 남자 오버핏 나시티 레이어드 박스 롱나시,9900,9900,0
2018-06-01,1743085149,A016040,포도,동원)황도 슬라이스 400g x 12개 사시사철 맛있는,41360,41360,0
2018-06-01,1298032885,C013030,스웨터,MNT-052 다이아 자가드 단가라 니트 블랙 품절 캐주얼,49700,49700,0
2018-06-01,1266606506,C013010,점퍼,제트 긴팔 야구 바람막이(BOVK-381) 블랙 바람막이 스,64830,64830,0
2018-06-01,968542532,C021040,실내화,아디다스 오리지널 ZX 플럭스 ADV 테크 런닝화 ( S763,117060,117060,0
2018-06-01,972239237,A017300,미역,삼각김밥김(50매x2봉)+(성형틀1개/후리가께 선택구매),14000,14000,0
2018-06-01,481143056,C011020,남자상의,남자코트 심플 하프 코트 BC0217003 오버핏코트 하프,81610,81610,0
2018-06-01,504557015,C012060,여자내의,세븐데이 멜빵청미니-스커트 SD-9101 롱청치마 청스커,26420,26420,0
2018-06-01,851859602,E031140,비데,{신제품} 노비타 방수비데 BD-N431 + 행사사은품,249000,229000,-20000
2018-06-01,1323651161,I031040,생화,스포츠 등산 물병 수통 물통 500㎖/700㎖/1000㎖,7000,6900,-100
2018-06-01,761723906,A014030,치즈,킹스코 모짜렐라 피자치즈 2.5kg/자연치즈100%/스틱,14900,14900,0
2018-06-01,895776396,A011090,국수,[팔도]팔도 도시락 용기 86G,800,800,0
2018-06-01,895776397,A011090,국수,[팔도]팔도 비빔면(130g*5입)*8봉지,30800,23920,-6880
2018-06-01,1373859189,C011030,남자학생복,MCD-917(가을신상)빈티지 스타일 롱가디건(FREE)3COLO,44740,44740,0
2018-06-01,323185253,I031040,생화,파라솔 모음전 캠핑/낚시/캠핑용품/낚시용품/레져용품,12800,12800,0
2018-06-01,895776398,A011090,국수,팔도 비빔면 130G*5+1입 증정입고,3850,2990,-860
2018-06-01,895776399,A011090,국수,팔도 왕뚜껑 (110g),950,950,0
2018-06-01,307772226,I031040,생화,[마운틴컴퍼니] SOS 긴급 구호세트 캠핑공구 캠핑용품 야외구호세트,24010,21870,-2140
2018-06-01,988120715,L012080,화장지,[유한킴벌리]유한킴벌리) 크리넥스 보습 에센스로션 150매*3,10400,8300,-2100
2018-06-01,836954348,C013020,티셔츠,여름신상 반팔 라운드티/남자옷커플기본프린트무지티,9900,9900,0
2018-06-01,988120717,L012080,화장지,[유한킴벌리]유한킴벌리) 크리넥스 디럭스 미니 230매*6,9300,9300,0
2018-06-01,884268527,C021010,아동화,노모 방패 털 아동 농구화 털 아동화(쥬니어)방패 운,49720,49720,0
2018-06-01,988120719,A015020,식용유,백설 바삭한 요리유 900ML,5950,5950,0
2018-06-01,230842317,I053030,복사용지,[더블에이] 더블에이 A4 80g 4000매 2BOX/A4용지/복사용지,45210,41600,-3610
2018-06-01,26253191,L021030,가방,[삼성전자] 삼성정품 노트북가방 AA-BC7AU5B 비즈니스용.15형,38900,38900,0
2018-06-01,1356889674,C013030,스웨터,인기신상 썸머니트 그물 여름 반팔티셔츠 특가모음전,12900,12400,-500
2018-06-01,1519016673,C011030,남자학생복,여름 가디건 남자 남성 집업 니트 브이넥 기본 롱,19800,19800,0
2018-06-01,1853593247,A011090,국수,팔도 왕뚜껑18개/한박스/김치/짬뽕/라면/컵라면,15500,15500,0
2018-06-01,374856715,C012040,여자학생복,44~99/국산 롱 셔츠 여자남방 체크남방 청남방 사은품,15800,15800,0
2018-06-01,689971207,C011030,남자학생복,봄신상 남자 셔츠/남방/스트라이프/체크/청/오버핏,15900,15900,0
2018-06-01,2010504083,C012040,여자학생복,빅사이즈 66~77 여름 블라우스 롱 민소매 남방 모음,25800,25800,0
2018-06-01,2027359130,A011110,당면,[농협] 안동 전통 국산콩 두부 현미연두부 80gx15팩,9900,8900,-1000
2018-06-01,1395613229,C013010,점퍼,왕끈 무지 후드집업 S~3XL STLD-6610/후드집업점퍼 후,25500,24230,-1270
2018-06-01,982610436,A012040,닭고기,초이스L 더드림 닭볶음탕 950G,6490,6490,0
2018-06-01,1220553291,A016030,복숭아,(대용량)아삭아삭 껍질째 먹는 적포도(크림슨) 8.2kg이내 XL,58900,56900,-2000
2018-06-01,1644687435,A021010,커피,맥심 모카골드 마일드 커피믹스 320T(160T x 2개),31900,31900,0
2018-06-01,747110350,A018020,사탕,대용량사탕x5봉/투시팝 말랑카우 롤리팝 사탕 마이쮸,8600,8600,0
2018-06-01,817568146,C012040,여자학생복,[바이퀸즈]여름 쉬폰블라우스 롱남방,14900,14900,0
2018-06-01,632961271,C011030,남자학생복,후드 빅사이즈 패딩점퍼 FZ823,234080,224720,-9360
2018-06-01,187606615,C011020,남자상의,여름 남자 스판 정장바지/슬랙스/빅사이즈/남성/체크,15800,14800,-1000
2018-06-01,201992227,E041020,컵,국산 도자기종이컵/머그잔/머그컵/종이컵 물컵 돌답례,1000,1000,0
2018-06-01,976102609,A019090,카레,청정원 카레여왕 구운마늘&양파(분말) 108g*8입,15800,15800,0
2018-06-01,1205259671,A017100,당근,(전남오픈마켓/풍년명가)무청시래기/배추우거지 1kg,2900,2900,0
2018-06-01,895776371,A014010,우유,파스퇴르 후레쉬우유 (1.8L),4990,4990,0
2018-06-01,1261329221,C012060,여자내의,아이스 쿨바지 9부 냉장고바지 남녀 커플바지,6900,6900,0
2018-06-01,1211623737,L012090,기초화장품,폰즈 모이스처 워셔블 클렌징크림 290mlX2개,14900,14900,0
2018-06-01,1879929013,L021030,가방,LG그램 삼성 맥북 노트북파우치 가방 11/13/14/15인치,14100,13500,-600
2018-06-01,1773440032,C012060,여자내의,[에이와비][에이와비]멜노우스커트,18590,16920,-1670
2018-06-01,1991277002,C015020,모자,메쉬캡 야구모자 볼캡 군모 골프 여름 여성 남자 모자,10000,10000,0
2018-06-01,1055360719,I011030,사진기,캐논중고카메라40d50d60d450d500d600d700중고dslr매입,235000,227000,-8000
2018-06-01,513305895,A018010,초콜릿,트윅스 미니스 1875g(약190개입) 대용량 코스트코,29900,29900,0
2018-06-01,680858563,A011090,국수,컵라면 100종 골라담기 신라면/왕뚜껑/진라면/진짬뽕,590,590,0
2018-06-01,1064629806,G011070,자전거,시애틀GS20+무료배송 18년 접이식자전거 7단20인치,115000,115000,0
2018-06-01,990060103,A013140,북어채,초L프레시)간절곶건오징어2미/봉,14900,11900,-3000
2018-06-01,959520423,A022030,생수,롯데 아이시스 8.0(300ML),270,270,0
2018-06-01,242510549,A014040,발효유,[데일리원] 데일리원 리얼 케피어스타터 10포 1통 요거트종균,10800,10800,0
2018-06-01,1233009581,C012060,여자내의,빅사이즈/로즈/레이스/스커트 로즈레이스스커트 빅사,41390,40150,-1240
2018-06-01,1943316874,I031040,생화,미니테이블 캠핑용 좌식테이블 캠핑용 접이식테이블,12800,12800,0
2018-06-01,1338406980,C015040,장갑,써클 포인트 피혁장갑(여성) 장갑 여성가죽장갑 여성,12320,12320,0
2018-06-01,667042014,C012060,여자내의,[크로커다일레이디]여름철 시원한 느낌을 더해주는 반바지 CL8M PT905,29900,27810,-2090
2018-06-01,1748974074,I031010,장난감,[해피store][와우토이즈 시드니 스쿨버스] 자동차장난감 장난감자동차 장난감 완구,28270,28270,0
2018-06-01,865770595,A011170,떡,[시루아네] 달지 않고 쫀득한 찹쌀떡 선물세트 60g x 25개,17500,17500,0
2018-06-01,423347614,A019090,카레,3분짜장(쇠고기 오뚜기 200gx24),41050,41050,0
2018-06-01,768658817,L021050,우산,[1+1] 24K사쿠라장우산/3단우산/자동장우산(무료배송),6990,6990,0
2018-06-01,1451474338,A019100,식초,하인즈 토마토케찹 397g /튜브,2300,2300,0
2018-06-01,1981534097,C014010,아동복,밀리터리끈장식티셔츠 52MTS111_KA/ 모노블랙,5000,5000,0
2018-06-01,573064689,A018070,파이,오리온 초코파이 1170g(30봉) x 2곽 골라담기,16500,16500,0
2018-06-01,627475611,L021030,가방,심플한 무지 백팩 여성 중학생 책가방 배낭 학생가방,24800,19800,-5000
2018-06-01,1345208725,C015020,모자,러브퀸 신상 남자 여자 연예인 빈티지 모자 군모 볼캡,7500,7500,0
2018-06-01,1413119177,C013010,점퍼,[R.ROBOT]에센셜바람막이점퍼(18329-110-04 05 06) 3종 중 택1,55200,42510,-12690
2018-06-01,218434316,A011080,밀가루,생칼국수 생수제비 생면 칼국수 수제비 국수,4000,4000,0
2018-06-01,575054892,E031040,전기레인지,도메틱 모비쿨 캠핑용품 차량용냉장고 T08 DC,99000,99000,0
2018-06-01,614278562,C013040,청바지,[게스키즈] G67KBP310게스키즈세라히트스키니데님,129000,64500,-64500
2018-06-01,1249541874,C014010,아동복,여름신상 엘사원피스 엘사드레스 여아원피스 사은품,25600,25600,0
2018-06-01,2050229209,C013010,점퍼,지프라브 남자 빅사이즈 무지 카키 블루종 항공점퍼,49900,48900,-1000
2018-06-01,322016578,I031010,장난감,물놀이 미니보트 파스텔 장난감 행동발달장난감 미니,6120,6120,0
2018-06-01,386490780,E021020,커튼,브라켓커튼봉 4단 25mm 길이조절450cm,30890,30890,0
2018-06-01,1242774664,C013010,점퍼,[무료배송]빅사이즈 DWW0018A 편한 쥬리 후드티 802,45500,45500,0
2018-06-01,1929838768,E041060,수저,윙크유아 수저세트 어린이 숟가락 젓가락 포크 티스푼,400,380,-20
2018-06-01,895859108,E061030,전구,와이즐렉환형30W삼파장,7100,7100,0
2018-06-01,1957540243,A014040,발효유,티마드 요거트 파우더/녹차/초코 라떼/블루베리,8600,8600,0
2018-06-01,467940516,I053010,공책,묶음상품 플라스틱링(38mm)백색 50개입x3개 제본스프,60480,60480,0
2018-06-01,875919050,A019060,된장,해찬들 재래식된장(6500g),21800,21800,0
2018-06-01,1965248417,L021060,유모차,마니또 유모차 레인커버 비닐커버 유모차커버,12900,12900,0
2018-06-01,2138164879,F012020,생리대,예지미인/생리대/건강한 순한/숲속이야기/텐셀/라이너,7900,7900,0
2018-06-01,451141624,A019020,참깨,은진 볶음들깨II(아주고은) 1kg2개 깨 들깨 볶음들깨,33670,30310,-3360
2018-06-01,890149150,E011060,의자,H 체어 카페 의자 식탁 업소 학생 책상 식당 인테리어,22900,22900,0
2018-06-01,1941235837,E031030,전자레인지,삼성 전자레인지 MS23K3535AK / 당일발송,100900,100900,0
2018-06-01,1542440182,I031040,생화,GDF 블레이즈 1-500/430 1호대/감성돔낚시대/인피니티,180000,180000,0
2018-06-01,1044396416,C012030,여자상의,[2018여름신상]홀복.청.데님.투피스.레이스.파티복,29900,29900,0
2018-06-01,1693844848,C012030,여자상의,리넨 린넨 나시 민소매 77 88 99 빅사이즈 롱 원피스,26900,26900,0
2018-06-01,1339203180,C013010,점퍼,bb99 숨김 원버튼 fur 도톰 자켓 크림 퍼자켓 여자자,47820,47820,0
2018-06-01,1005000424,A013140,북어채,백송식품 용대리황태포 황태채 황태찜포 황태머리,6900,6900,0
2018-06-01,266706943,A021010,커피,카누아이스라떼 60T/카누아이스블렌드/카누디카페인,22900,22900,0
2018-06-01,444654999,C012020,원피스,캐시미어혼방코트(Z174MSG507)/ 쥬크,229000,194650,-34350
2018-06-01,1058288516,C014010,아동복,한국생산 야구 상하복과 모자 레드(0-24개월)800023,69340,67960,-1380
2018-06-01,867218907,I031040,생화,12V전용/6단다이얼방식/캠핑온열매트 1P/캠핑전기장판/캠핑전기매트12V전용/오토캠핑매,95000,84130,-10870
2018-06-01,995247838,C011050,남자내의,탑텐 남여 면바지 슬랙스 MSX3PP1001외 14종/ 탑텐,9900,8910,-990
2018-06-01,480461740,G011070,자전거,시애틀모던F 18년 하이브리드자전거 21단 60mm하이림,118000,106200,-11800
2018-06-01,2002104848,L021020,장신구,(7차)피어싱 남녀피어싱 귀걸이 NO 알러지 써지컬스틸,3000,2970,-30
2018-06-01,412790710,C013020,티셔츠,여름신상 5900~ 데일리샵 여름신상 데이트룩 특가,5900,5900,0
2018-06-01,1486304791,E031070,에어컨,16인치18인치벽걸이선풍기 사은품커버증정,20800,19700,-1100
2018-06-01,1233359854,L012090,기초화장품,스킨미소 모공 퓨리파잉 토너 약산성스킨 각질개선,15000,14550,-450
2018-06-01,1392838855,A017050,미나리,[가족사랑] 유기농 양배추즙 100ml X 30포 HACCP인증,10000,9900,-100
2018-06-01,2084497259,C013020,티셔츠,슬림실켓스판티 남자반팔티셔츠 무지 라운드 브이넥,9600,9600,0
2018-06-01,1125635227,E031130,보온매트,아뜨 온돌 장판 (중형) 향균매트. 국내최초 나연 열선 사용!,48100,48100,0
2018-06-01,501726632,A016110,딸기,23311307/ 냉동가당딸기(1kgX15개)-청솔,92660,92660,0
2018-06-01,1125635225,E031130,보온매트,다온마루 무자계 전기장판. 전자파안심! /3인용 온열매트 분리난방 절전매트,241100,241100,0
2018-06-01,1989730369,I031010,장난감,플레이온 PX1 조이패드 PC/PS3/안드로이드 지원 GTA5,17900,17900,0
2018-06-01,1125635226,E031130,보온매트,아뜨 온돌 장판 (대형) 향균매트 인증!,57800,57800,0
2018-06-01,2084013430,C013040,청바지,(SR)MHA510 남자빅사이즈청바지 /(참고)남자빅사이즈,73100,62140,-10960
2018-06-01,988034383,A011040,보리쌀,적두(기획) 1.5KG,29900,29900,0
2018-06-01,1596212879,E061020,섬유유연제,FC 베이비전용 세탁세제 (refill) (#10046),18450,16430,-2020
2018-06-01,179987766,E021010,침구,[슈에뜨룸]플라밍고 리플 이불토퍼세트/여름이불세트,39900,39900,0
2018-06-01,1943068851,A011090,국수,신라면 안성탕면 팔도탄탄면 불닭볶음탕면 부대찌개면,3200,3200,0
2018-06-01,583613449,I012010,컴퓨터,LG총판 LG데스크탑 B70EV-AR7716 i7-7700 1TB Win10,1030850,969000,-61850
2018-06-01,1194691753,E021010,침구,곰돌이3 아동 아사 60수 리플 여름 홑이불 베개 세트(,34300,30620,-3680
2018-06-01,625497406,E011040,소파,[엠비언트라운지]영국본사 빈백 특가/인기 1인용쇼파,189000,189000,0
2018-06-01,21767252,E011040,소파,큐피트 빈백 소파 스툴/안락의자 보조의자/1인용소파/빈백 쇼파 빈백스툴/공의자,48000,48000,0
2018-06-01,1809453256,E061040,부엌용세제,뉴퐁퐁 12개(한박스)/980mlx12/주방세제/청원상사,35000,34650,-350
2018-06-01,397300152,L012090,기초화장품,이자녹스 녹스랩 모이스처 (스킨/에멀전),7400,7300,-100
2018-06-01,1118365164,E031080,선풍기,니코 히터/스탠드형/5방향/전도안전스위치 WH-2222,52000,52000,0
2018-06-01,37236092,C014010,아동복,(숲자람) 기능성 키즈 바람막이 유아용바람막이 유아,72000,72000,0
2018-06-01,1118365163,E031080,선풍기,신일산업 히터/컨벡션히터/온도조절기능 SEH-C200MH,106000,106000,0
2018-06-01,653154326,A013120,낙지,정화 불고기 통.전기 오징어 50gx5.,25210,25210,0
2018-06-01,1859164561,A022020,두유,매일유업 매일두유 99.89 무설탕 190ml 24팩,11500,11500,0
2018-06-01,1425805499,A018100,꿀,유기농 로얄젤리 로얄제리 생 천연 젤리 제리 앰플 /,46900,46900,0
2018-06-01,1466712937,I031040,생화,몬스터 차량용 냉장고 냉동고 20L(LG)/아이스박스,560000,445000,-115000
2018-06-01,1778566676,L021010,손목시계,[바보사랑]JA-1022 가죽시계,26280,26280,0
2018-06-01,432369664,A019130,스프,청정원 우리쌀 포테이토 컵수프 60g(20g x 3개입) X 2,101470,90310,-11160
2018-06-01,1778591630,L021010,손목시계,[바보사랑][공식  백화점AS] 딕시 여성시계(가죽)_W0854L2,258000,258000,0
2018-06-01,1778566673,L021010,손목시계,[바보사랑]JA-1021 가죽시계,26280,26280,0
2018-06-01,1778566679,L021020,장신구,[바보사랑]2컬러 foil circle drop earring,29000,29000,0
2018-06-01,1778566678,L021020,장신구,[바보사랑]pastel blue drop earring,27000,27000,0
2018-06-01,2142983971,L012090,기초화장품,설화수 퍼펙팅 쿠션/브라이트닝/인텐스/본품+리필,24000,24000,0
2018-06-01,1778566677,L021020,장신구,[바보사랑]pastel beige drop earring,28000,28000,0
2018-06-01,1888484270,F012020,생리대,[릴리안]대용량 생리대/순수한면/초흡수/숨쉬다/건강,21900,21900,0
2018-06-01,2036916006,A018010,초콜릿,[해태]미니자유시간 690g/140g 초코바 초콜릿 간식,6900,6900,0
2018-06-01,724448344,C011030,남자학생복,MJI2-5 남자빅사이즈밀리터리집업자켓 빅사이즈,58610,56860,-1750
2018-06-01,430872281,A017040,양배추,(면)(냉동)청학 부추1kg,7730,7730,0
2018-06-01,1270357072,A016020,배,찬바람N(앤) 도라지배즙 (100mg25포),54700,54700,0
2018-06-01,983357969,A011080,밀가루,오뚜기 옛날 국수 중면(2.5KG),6220,6220,0
2018-06-01,1248561915,C011020,남자상의,(색상 : 블랙 | 사이즈 : L) WMJ-009 지퍼,88300,88300,0
2018-06-01,1488759405,A012010,국산쇠고기,[무항생제] 사골 5kg 1+등급,103800,103800,0
2018-06-01,2139544011,F012010,종이기저귀,[보솜이] 디오가닉 팬티 대형 남아 32매 4팩,41900,41900,0
2018-06-01,1252936235,C012060,여자내의,빅사이즈/제이스타일리어셀 H라인 린넨 스커트/ 제이스타일,28800,22180,-6620
2018-06-01,1778591636,L021010,손목시계,[바보사랑][공식  백화점AS] 프리마 여성시계(메탈)_W1020L3,268000,268000,0
2018-06-01,323038017,C013010,점퍼,[로앤디누아][로앤디누아]자켓형 무스탕 NMT6O01,870400,826880,-43520
2018-06-01,1778591635,L021010,손목시계,[바보사랑][공식  백화점AS] 테일러 남녀공용시계(메탈)_W1018L1,218000,218000,0
2018-06-01,1778591633,L021010,손목시계,[바보사랑][공식  백화점AS] 첼시 여성시계(가죽)_W0993L2,118000,118000,0
2018-06-01,1778591637,L021010,손목시계,[바보사랑][공식  백화점AS] 마리나 여성시계(실리콘)_W1025L1,168000,168000,0
2018-06-01,1778566682,L021020,장신구,[바보사랑]2컬러 tube circle stud earring,22000,22000,0
2018-06-01,1778566681,L021020,장신구,[바보사랑]2컬러 foil retro line earring,22000,22000,0
2018-06-01,1778566680,L021020,장신구,[바보사랑]silver chain drop ball earring,33000,33000,0
2018-06-01,1975940962,C014010,아동복,[사은품][국산] 여름신상 여아원피스 아동복 여아옷,27900,25900,-2000
2018-06-01,1208507265,E011020,침대,비트 소나무원목 침대깔판 SS,152370,152370,0
2018-06-01,1319794830,C015040,장갑,남녀공용 스마트폰 터치 털장갑 M1716002 남자장갑 커,19600,19600,0
2018-06-01,1311352559,C013030,스웨터,양꽈배기니트(RMD_1712) 여성빅사이즈의류 롱니트 여,21960,21960,0
2018-06-01,80433539,L012040,치약,시스테마 숨결케어 치약 120gx5개 칫솔 구취 입냄새,7900,7900,0
2018-06-01,1297908915,C011030,남자학생복,MCD-901 유니크 잉카패턴 브이넥 가디건 남성가디건,20220,20220,0
2018-06-01,107736857,L012060,샴푸,아로마티카 로즈마리 스칼프 스케일링 샴푸900ml+50ml,27200,27200,0
2018-06-01,832303557,E041070,밀폐용기,[락앤락] 비스프리 모듈러세트 반찬통 밀폐용기,11900,11900,0
2018-06-01,1778591629,L021010,손목시계,[바보사랑][공식  백화점AS] 라임라이트 여성시계(가죽)_W0775L6,248000,248000,0
2018-06-01,1778591628,L021010,손목시계,[바보사랑][공식  백화점AS] 콘페티 여성시계(메탈)_W0774L4,348000,348000,0
2018-06-01,195805915,A017140,콩나물,도라지 250g (경북 영주 재배산) 말린것 도라지차재료,15460,15000,-460
2018-06-01,1645051138,F012010,종이기저귀,팸퍼스 프리미엄케어 기저귀 팬티/밴드,41800,39800,-2000
2018-06-01,1650646614,E011030,거실장,다올퍼니 북유럽풍 원목거실장 TV거실장 TV다이 TV장,129800,129800,0
2018-06-01,292471531,C012040,여자학생복,DYP1515 스티 체크 남방 803S 체크셔츠 패션용셔츠 여,55820,55820,0
2018-06-01,1900118490,C013010,점퍼,아디다스 여성 K 스트레치 덕 다운 패딩 ( B10322 ),159450,159450,0
2018-06-01,2009390580,L021030,가방,고급형 노트북 맥북 태블릿 PC 가방 파우치 13/14/15,15900,15900,0
2018-06-01,1361107247,A013160,맛살,올리브녹차 돌자반 70gx20개 입안에서 살살녹는 고,57600,57600,0
2018-06-01,339327390,C011050,남자내의,구김방지 슬랙스 S~3XL 빅사이즈 남성 바지 남자 팬츠,14800,14800,0
2018-06-01,1303165192,C013020,티셔츠,플라스틱아일랜드 (PJ2WB577) 수술장식오프숄더펀칭 블라우스,62100,50930,-11170
2018-06-01,2138438542,A017120,고구마,빛고을장터 햇감자 수미감자 5kg/3kg내외,4990,4990,0
2018-06-01,2008686520,L012090,기초화장품,프리메라 맨 워터리 크림 50ml 수분크림 보습크림 맨,38300,38300,0
2018-06-01,616952863,A022010,주스,아이스톡 아메리카노 190mlx50개/커피/탄산/음료수,22900,22900,0
2018-06-01,311560332,C013050,운동복,JP형 차량커버 외장커버 차량용커버 세차 황사 차커버,75740,75740,0
2018-06-01,126990752,I031010,장난감,Step2 이인용 밴 유아용완구 유아승용완구 장난감 유,255390,255390,0
2018-06-01,447424443,I053020,스케치북,켄트지 도화지 4절 130g 125매x4개 1박스 흰도화지 미,52870,52870,0
2018-06-01,407182575,C013040,청바지,[PLAC] 플랙 남성 데님/아우터 역시즌 파격 세일!,51000,51000,0
2018-06-01,1489306634,C014020,유아복,아둘 가족티 커플룩 엄마랑 도날트덕 롱 티셔츠 12,14300,14300,0
2018-06-01,1778591659,L021010,손목시계,[바보사랑][공식  백화점AS] 마리나 여성시계(실리콘)_W1025L4,188000,188000,0
2018-06-01,292228244,L012010,면도기,다스일회용두날면도기x10입 (10개 묶음)_1009 일회용,20820,20820,0
2018-06-01,421563850,L012060,샴푸,[일회용파우치 100개] 일회용샴푸 린스 바디워시,5000,5000,0
2018-06-01,960356563,A019060,된장,풀무원 국산콩 생청국장 190G,4900,4900,0
2018-06-01,580926907,E021010,침구,{베개솜무료증정}호텔식 침구세트/이불 풀세트,49000,37000,-12000
2018-06-01,1473886550,A013010,갈치,제주 은갈치(대) 4마리(1마리당350g내외 선물포장),138940,138940,0
2018-06-01,1439768888,I031070,애완동물관리비,2018윌슨 테니스라켓 울트라 100CV 블랙(100sq/300g),214870,179640,-35230
2018-06-01,1314187919,E061020,섬유유연제,고농축 버넬 10주 1L x 4개 (옵션 선택)/ 헨켈,11900,11900,0
2018-06-01,188569733,C013050,운동복,[TMall]레이스텍 에어밸브 모음전/휠너트 밸브캡 30종,8300,8200,-100
2018-06-01,441155429,C013010,점퍼,18 F/W 신상 롱기장의 벤치 파카 스타일의 덕 다운 자켓 [BK버드벤치다운자켓]/ 블랙야,169000,143650,-25350
2018-06-01,115825769,C011030,남자학생복,오마샤리프 플레이드 체크셔츠 블루 남자셔츠/30507BL,18800,18800,0
2018-06-01,1653140090,C015020,모자,뉴에라 2018 캐리어 백팩 블랙 11591736.,143200,133180,-10020
2018-06-01,1447870747,E011040,소파,1인/2인소파/암체어/인테리어의자/원목/철재/커피숍,152000,152000,0
2018-06-01,386402579,E021020,커튼,롤스크린 그림 일반_1444,39790,39790,0
2018-06-01,1368724003,A011010,쌀,경기미10kg / 쌀10kg,26200,26200,0
2018-06-01,627703501,E031110,청소기,가성비 짱!!! 단후이 로봇청소기 시즌2,298000,298000,0
2018-06-01,870266290,A017250,고사리,랜시 냉동 브로콜리 3kg(3kgx1ea)/냉동야채 냉동채소,23000,19550,-3450
2018-06-01,884146000,C021040,실내화,(특가)운동화 하이탑 신발 캔버스 스니커즈 남성신발,25800,25800,0
2018-06-01,1065723659,F011130,홍삼,GNM자연의품격 진일품 6년근 홍삼정스틱 패밀리 2박스 (60포),47800,47800,0
2018-06-01,670743682,E031020,가스레인지,(사은품증정) 무연무수 2구 가스렌지+그릴 GRA-C2101R,286500,286500,0
2018-06-01,1496861355,L021010,손목시계,큐빅 러블리 팔찌 겸용 손목시계 캐주얼시계 팔찌시계,14520,14520,0
2018-06-01,988925226,A012020,수입쇠고기,초이스엘 미국산 우 찜갈비 800G,19920,13561,-6359
2018-06-01,889014667,F012020,생리대,뉴 더 건강한 순수한면 중형16px10개 2018년 신제품,31200,31200,0
2018-06-01,1625747702,A011040,보리쌀,건강가득! 흰강낭콩 4kg (네이비빈/화이트키드니빈),8600,8600,0
2018-06-01,468508196,F012020,생리대,[위스퍼]생리대 순면감촉 피부애 오버나이트 14Px3팩,17300,16720,-580
2018-06-01,1065723660,F011130,홍삼,GNM자연의품격 진일품 6년근 홍삼정스틱 패밀리 1박스 (30포),26900,26900,0
2018-06-01,1065723661,F011130,홍삼,GNM자연의품격 진일품 6년근 홍삼정스틱골드 8박스 (240포),298000,298000,0
2018-06-01,344806245,C013020,티셔츠,신상UP 티33/44~110/빅사이즈/맨투맨/브이넥/니트,29800,15800,-14000
2018-06-01,1065723662,F011130,홍삼,GNM자연의품격 진일품 6년근 홍삼정스틱골드 6박스 (180포),228000,228000,0
2018-06-01,401660469,C011030,남자학생복,MJ-1156 패딩 조끼 / 겨울,25000,25000,0
2018-06-01,1065723663,F011130,홍삼,GNM자연의품격 진일품 6년근 홍삼정스틱골드 4박스 (120포),155000,155000,0
2018-06-01,1065723664,F011130,홍삼,GNM자연의품격 진일품 6년근 홍삼정스틱골드 2박스 (60포),81000,81000,0
2018-06-01,619457252,E021020,커튼,도로시 중형/대형/특대형(2+2-4장)이중 암막커튼,41800,41800,0
2018-06-01,1065723665,F011130,홍삼,GNM자연의품격 진일품 6년근 홍삼정스틱골드 1박스 (30포),41800,41800,0
2018-06-01,504586862,C012060,여자내의,다미엔 밴딩 후레아 청롱스커트청치마 SD-5038 롱청치,19860,19860,0
2018-06-01,1581053359,E041010,식기,leah 일본 칠기 그릇 / 우동그릇 냉면그릇 면기 라면,3170,3170,0
2018-06-01,618313164,E011050,책상,테이블 사이드테이블 이동식테이블 책상 노트북테이블,19900,19900,0
2018-06-01,796827549,F012050,의료측정기,옵티엄네오 혈당측정기+시험지110매+침100개+솜100장,57100,53100,-4000
2018-06-01,1778591661,L021010,손목시계,[바보사랑][공식  백화점AS] 리젠트 여성시계(가죽)_W1041G3,188000,188000,0
2018-06-01,1778591660,L021010,손목시계,[바보사랑][공식  백화점AS] 베니티 여성시계(메탈)_W1030L1,248000,248000,0
2018-06-01,1273964728,C012040,여자학생복,3단니트[RSC5NT001]/ 루코루코,39200,37240,-1960
2018-06-01,1778591664,L021010,손목시계,[바보사랑][공식  백화점AS] 레거시 남성시계(실리콘)_W1048G2,248000,248000,0
2018-06-01,1778591663,L021010,손목시계,[바보사랑][공식  백화점AS] 옥테인 남성시계(실리콘)_W1047G2,248000,248000,0
2018-06-01,967574529,E061010,세탁세제,미친찬스! 대용량 액체세제 프로페셔널 9L/ 퍼실,20500,20500,0
2018-06-01,1778591662,L021010,손목시계,[바보사랑][공식  백화점AS] 슬레이트 남녀공용시계(가죽)_W1044G1,168000,168000,0
2018-06-01,959409045,A011110,당면,강릉 초당콩국물 1KG,3890,3890,0
2018-06-01,2104413000,C011030,남자학생복,빅사이즈 바투스 청남방 BW청남방데님남방청카바청셔,70900,70900,0
2018-06-01,959409044,A011110,당면,우무묵 (340G),1990,1990,0
2018-06-01,534017994,A014020,분유,[LG생활건강]베비언스 액상분유 12-24개월(3단계)48개입 (니플미포함),73380,69700,-3680
2018-06-01,1053671539,E031010,전기밥솥,쿠첸 리홈 정품 패킹/ 밥솥패킹/ IH패킹/ 압력밥솥/SY,6000,6000,0
2018-06-01,784809378,C011030,남자학생복,[마인드브릿지]메리노울브이넥가디건(MSCD0101_BK),59900,47330,-12570
2018-06-01,1934360242,F011150,건강기능식품,01_베이비락 19종 생유산균 90포 / 120포,29890,29890,0
2018-06-01,745881496,C012020,원피스,새로본 830번여름정장/봄정장/면접/결혼식/유니폼,51800,49800,-2000
2018-06-01,1141609325,C013020,티셔츠,데일리앤 여름 기본 무지티 슬라브티 레터링티,9800,9800,0
2018-06-01,1488302897,E031020,가스레인지,SK매직 무연무수 그릴 가스오븐렌지 GOR-S7700 단독형,959000,959000,0
2018-06-01,1312952152,E031110,청소기,한경희 무선 물걸레청소기 아쿠아젯 AM-5600NB,189000,159000,-30000
2018-06-01,715274982,E011040,소파,보니타빈백 초대형 코쿤 C307 빈백/소파/1인용쇼파,103900,103900,0
2018-06-01,735155703,C012060,여자내의,리즘 주름 롱스커트 SD-9028 롱스커트 미디스커트 주,13770,13360,-410
2018-06-01,1778591668,L021010,손목시계,[바보사랑][공식  백화점AS] 브로커 여성시계(메탈)_W1072G1,148000,148000,0
2018-06-01,1778591666,L021010,손목시계,[바보사랑][공식  백화점AS] 블러쉬 여성시계(메탈)_W1062L1,168000,168000,0
2018-06-01,2124737063,C015040,장갑,고급 양털 장갑(여성) 손가락장갑 방한장갑 겨울용장,10340,10340,0
2018-06-01,1592927642,E011020,침대,뉴트 저상형 패밀리 침대 수납도어 헤드형(매트별도),505000,454500,-50500
2018-06-01,617587225,E031070,에어컨,듀플렉스 타워팬 선풍기 타워형 스탠드 DP-70TF,29800,29800,0
2018-06-01,57908134,C011020,남자상의,빅사이즈 오리털 점퍼 패딩 덕다운 남 WC 경량 JK013M,138500,138500,0
2018-06-01,2084039619,C013040,청바지,(SR)WHO2006 남성빅사이즈트레이닝긴바지 /(참고)국내,71200,60520,-10680
2018-06-01,982705356,A011090,국수,팔도 쫄비빔면 130G*5+1입 증정입고,3850,3750,-100
2018-06-01,603079685,F012010,종이기저귀,[토디앙] 핑크퐁 에어슬림 밴드기저귀 중형 48매X3팩,34600,34600,0
2018-06-01,1557219701,E041070,밀폐용기,락앤락 오븐글라스 유리밀폐용기 유리찬통 반찬통,5900,5430,-470
2018-06-01,985962753,F012010,종이기저귀,[Genki]프리미엄 소프트 겐키 기저귀 1팩,7900,7900,0
2018-06-01,1431723198,C021040,실내화,운동화-2018신상/신발 남성 여성 런닝화 커플화 등산,9900,9900,0
2018-06-01,989014388,F011150,건강기능식품,정관장 아이키커 오렌지/사과/포도 한정수량 특가,12500,9900,-2600
2018-06-01,911133454,E041010,식기,[예가샵][한국도자기][킴스아트] 국내생산 소면기/볼/면기 모음전 12종 - 냉면그릇/떡,12000,11040,-960
2018-06-01,1167039811,C012040,여자학생복,슈아 버튼 5부 골지 브이넥 니트/ 세인트마리,36200,32580,-3620
2018-06-01,520640009,C013020,티셔츠,[MRBOB] 두꺼운 헤비 기모 후드티 후드집업 빅사이즈,36800,33800,-3000
2018-06-01,60050602,C012040,여자학생복,#NAME?,57890,56740,-1150
2018-06-01,293247627,I031040,생화,이글루 바퀴형 아이스박스 26L/38L/58L 선택/캐리어,69300,63760,-5540
2018-06-01,1837403630,C012060,여자내의,레이스 머메이드 미디스커트(MIWWH8341M)/ 미쏘,49900,47410,-2490
2018-06-01,207428643,L012060,샴푸,1+1 보감비책 어성초샴푸 대용량 1000gx2개/탈모/한방,14900,14900,0
2018-06-01,2055163391,L012060,샴푸,아모스/녹차실감샴푸/컬링에센스/녹차실감/아모스샴푸,20000,20000,0
2018-06-01,2139546618,C012040,여자학생복,[로엠][로엠] 레이스 단가라 버튼 민소매 블라우스 RMBL4370G2_51,5500,5230,-270
2018-06-01,1078828576,A019160,밑반찬,돌핀 폴라레티 후르츠 아이스바 40ML 70개 / 트로피칼,11890,11890,0
2018-06-01,987360082,E041010,식기,아파트32 전자레인지 라면용기 무료배송,4900,4900,0
2018-06-01,519427705,C013050,운동복,대형 안전삼각대 특수반사판 낮100M 야간 200M인지,14500,13340,-1160
2018-06-01,1989573390,E021010,침구,순면 이불커버 매트리스커버침구세트 호텔식 매트커버,35500,35500,0
2018-06-01,246479470,C012060,여자내의,라이온스 블랙진 TK-5255 데님스키니 빅사이즈청바지 스키니진 빅사이즈 블랙스키니,31030,27620,-3410
2018-06-01,1489306671,C014020,유아복,아둘 가족티 커플룩 엄마랑 도날트덕 롱 티셔츠 11,14300,14300,0
2018-06-01,928348570,E031120,믹서,정품.2년무상AS 필립스 믹서기 Blender GO HR3556/00,132800,132800,0
2018-06-01,1174087057,C011050,남자내의,[폴햄 (POLHAM)](유니) 슬림핏 솔리드 5부 반바지(PHY2PH1012)[갤러리아],19900,15330,-4570
2018-06-01,1547330080,A016150,아몬드,[가온애]무료배송특가 아몬드 견과 45종 총모음,4900,4900,0
2018-06-01,723399861,C012020,원피스,[앤섬] 베이직 코튼 스키니 팬츠 MVBMPRM3481,18800,17680,-1120
2018-06-01,1086614080,A011010,쌀,햅쌀 경기추청 아끼바레쌀 10kg / 쌀 쌀10kg 추청쌀,27900,27900,0
2018-06-01,1790280012,A013070,굴,노르웨이 대게 스노우크랩 5kg (실속 3L SIZE),162000,162000,0
2018-06-01,246480462,C012060,여자내의,사하라 워싱 스키니 팬츠 TK-5258 데님스키니 블랙스키니 스키니진 빅사이즈 빅사이즈,33720,30020,-3700
2018-06-01,895620776,A016130,키위,하우스캠벨/팩,2990,2990,0
2018-06-01,622495307,C012060,여자내의,[행텐] 여성 모던 숏 팬츠 10120-151-406-50 NC아울렛,29800,10000,-19800
2018-06-01,886905800,C013020,티셔츠,[앙투] 파격가 데일리44~110빅사이즈 롱원피스 반팔티,11800,9900,-1900
2018-06-01,471957491,C012040,여자학생복,통일자오픈롱조끼 CM1711 무지롱조끼 롱베스트 니트조,51780,51780,0
2018-06-01,1065723657,F011130,홍삼,GNM자연의품격 진일품 6년근 홍삼정스틱 패밀리 6박스 (180포),139000,139000,0
2018-06-01,1856918177,L012090,기초화장품,하다라보 고쿠쥰 2종 세트 로션+밀크/로션+로션,22000,22000,0
2018-06-01,1065723658,F011130,홍삼,GNM자연의품격 진일품 6년근 홍삼정스틱 패밀리 4박스 (120포),94000,94000,0
2018-06-01,1214180712,I011030,사진기,-정품 니콘 D7200 +AF-P 18-55mm VR/DSLR 사은품증정,954150,906390,-47760
2018-06-01,1039439424,E031110,청소기,인증점P 신형 삼성 진공청소기 VC33M2110LP 당일출고,103000,82900,-20100
2018-06-01,579061984,A011030,찹쌀,2018햇보리 10kg (5kgx2봉) 찰보리 늘보리 쌀보리,20500,20500,0
2018-06-01,27904508,E031130,보온매트,(TV홈쇼핑정품)한일 모노륨매트 슈퍼킹특대형183x270cm 나노륨매트고급형/전기장판/웰,298000,295020,-2980
2018-06-01,1215900270,C013010,점퍼,[에꼴리에]패커블 후드 바람막이 점퍼_18B1101,38000,38000,0
2018-06-01,984431438,A011040,보리쌀,RF)서리태(봉)/450G,8990,8990,0
2018-06-01,982585391,A022050,탄산음료,롯데 칠성사이다(355ML),750,650,-100
2018-06-01,1476078217,A012050,소시지,(롯데) 빅팜불닭 소시지1200g(60gx20개) / 소시지,9600,9600,0
2018-06-01,1267649937,A013060,게,한치 마른화살오징어(L 20미)1kg,116000,116000,0
2018-06-01,21987934,I031040,생화,충전식 랜턴 LED 후레쉬 손전등 캠핑랜턴 경광봉 L2,33000,28530,-4470
2018-06-01,264706015,F012010,종이기저귀,[마미포코]에어핏 대형 특대형 4팩+물티슈2팩증정,46900,45900,-1000
2018-06-01,983813493,A011090,국수,오뚜기 스낵면 1박스(108gx40봉)/라면,15900,15900,0
2018-06-01,984431437,A011040,보리쌀,SF)적두(봉)/450G,8990,8990,0
2018-06-01,1132998248,E031120,믹서,필립스 블랜더 BLEND GO HR3565/00 / 당일발송,141550,141550,0
2018-06-01,176190228,E031130,보온매트,한일생명과학_100×200 편백매트,70400,70400,0
2018-06-01,587890093,C013010,점퍼,빅사이즈/제이스타일 노베아 레이스 후드집업/ 제이스타일,40300,31040,-9260
2018-06-01,2139389320,F012010,종이기저귀,[보솜이] 디오가닉 밴드 L 대형 공용 36매 4팩,41900,41900,0
2018-06-01,1000284244,A011170,떡,떡국떡 1kgx20봉1박스 한양식품 떡국 무료배송,42000,42000,0
2018-06-01,896781385,A019010,고춧가루,[대상]청정원 까나리액젓 750g,3690,3690,0
2018-06-01,479651796,C011030,남자학생복,DEB1580 오픈 루즈 가디건 803 가디건 여자가디건 긴,57690,57690,0
2018-06-01,396133256,A021020,차,일회용 프리마 (원두용 동서 50T) X20,61170,54450,-6720
2018-06-01,1071623929,C011020,남자상의,남성/남자/여름/린넨마/빅사이즈/콤비/마이/자켓/정장,59000,59000,0
2018-06-01,368462103,A017040,양배추,수입산 사상자70g 뱀도랏 사상자 뱀도랏 토사자 미나,3230,3170,-60
2018-06-01,421825037,E051020,건전지,소니충전기 소니충전지 AA AAA 건전지 충전용건전지,11800,11800,0
2018-06-01,1913865819,E011050,책상,[라이프타임] 라이프타임 직사각 4인용테이블 (122x61x73.6cm),43900,43900,0
2018-06-01,631914737,A016060,감,달콤샤르르 자연그대로 만든 아이스 홍시 50개(컵)/개,78200,68820,-9380
2018-06-01,937929643,A013170,생선통조림,(동원참치 10캔)마일드/살코기/고추/참치/캔/통조림,11100,9000,-2100
2018-06-01,1979751344,C013040,청바지,[디어제인][디어제인]SXL얇은여름소재스크래치일자데님팬츠M4522,9900,9410,-490
2018-06-01,1131761880,C013010,점퍼,투버튼롱베스트/롱조끼/베스트자켓/카라조끼...,29900,29900,0
2018-06-01,353179629,C014020,유아복,아동 유아 러블리 반팔티셔츠 브이 셔링티 5~13호,11900,11900,0
2018-06-01,565950408,I012010,컴퓨터,초특가 메이커컴퓨터 i3/ i5/ i7 고가성비 Win7/Win,359000,229000,-130000
2018-06-01,1229680506,A011140,부침가루,삼립/소프트케익 50gx10개 /고구마치즈케익 /냉동식품,6000,5900,-100
2018-06-01,1662483528,C013040,청바지,여자/여성 스키니팬츠/스키니진/일자/부츠컷/빅사이즈,9800,9800,0
2018-06-01,52597084,C013040,청바지,[게스][18SS] 남 카라 티셔츠 2종 택1,23900,23900,0
2018-06-01,1251987598,C012040,여자학생복,[모다아울렛][보니스팍스]옆여밈장식블라우스,39000,39000,0
2018-06-01,983536650,A019070,양념소스,청정원 돼지불고기 양념장 500G,3390,2590,-800
2018-06-01,1433076219,E061040,부엌용세제,크로바세제(24종)주방세제/퐁퐁/락스/락퐁/식초,7500,7500,0
2018-06-01,517339396,C012030,여자상의,퍼플스완 너의 품안에서 플레어 랩 리본원피스,39800,39800,0
2018-06-01,176190220,E031130,보온매트,한일생명과학_183×300 거실매트,142100,142100,0
2018-06-01,983536652,A019070,양념소스,청정원 돼지갈비 양념장 500G,3390,2590,-800
2018-06-01,983536651,A019070,양념소스,청정원 소갈비 양념장 500G,3390,3390,0
2018-06-01,176190225,E031130,보온매트,한일생명과학_140×200 황토매트,72900,72900,0
2018-06-01,451175382,C012060,여자내의,기본 진청 5부스커트 SD-9104,17160,17160,0
2018-06-01,1997316040,E011020,침대,[골든잼]원목 천연생황토 슈퍼싱글 돌침대(모리아),1783400,1729900,-53500
2018-06-01,983536649,A019070,양념소스,청정원 소불고기 양념장 500G,3390,3390,0
2018-06-01,75206856,A022010,주스,보해 매원 1.5L /매원 /매실음료,6500,6500,0
2018-06-01,205904050,C013010,점퍼,냉장고후드집업/바람막이/비치웨어/여름아우터/로브,5700,5700,0
2018-06-01,32413401,C013050,운동복,[카렉스] 프론트 리어 범퍼 가드 보호대 몰딩 블랙 몰딩 자동차,22120,20150,-1970
2018-06-01,52791339,C013010,점퍼,[티나쉐]티나쉐 시퀸 블루종 점퍼+반팔티 2종 SET,29000,27550,-1450
2018-06-01,1535133117,C013020,티셔츠,사계절 나시/롱나시 끈나시 나시티 민소매 레이어드,7900,7900,0
2018-06-01,1865948477,C011050,남자내의,아디다스 여성 우븐 슬릿 쇼트(BP9307),42000,39060,-2940
2018-06-01,385502960,E041060,수저,국산 스테인레스 수저세트 수저 숟가락 젓가락,980,980,0
2018-06-01,1298029193,C011030,남자학생복,MCD-906 베이직 하찌 가디건 남자가디건 캐주얼가디건,21940,21940,0
2018-06-01,1433451885,L012090,기초화장품,미프 미남크림 50ml/남성화장품/BB/남친선물/올인원,21000,21000,0
2018-06-01,1826143323,A014010,우유,일회용핫소스(태원 4gx1000),38010,38010,0
2018-06-01,373303891,C011050,남자내의,코모도스퀘어 쿨맥스 여름 슬랙스 팬츠 9317212152,47600,40940,-6660
2018-06-01,2072461248,D031010,주택수선재료,아리나데코 53cmx12.5m 소폭합지 포인트벽지 단색벽지,2500,2500,0
2018-06-01,1203522451,C013020,티셔츠,[마인드브릿지]스판넥변형세미오버티셔츠MSTS3127LP,29900,23630,-6270
2018-06-01,1443086728,C011050,남자내의,30%쿠폰! 면바지 26~40 스판/일자/슬랙스/팬츠,16800,16800,0
2018-06-01,1840316010,I011010,TV,공식파트너 삼성 138cm LED TV UN55M5550AFXKR,830000,769000,-61000
2018-06-01,477441002,C013050,운동복,모비스 크루저 루프백 캠핑용품 차량루프백 자동차캠,266580,242810,-23770
2018-06-01,359062825,E031070,에어컨,대우 벽걸이선풍기 RW516MA 박스팬 써큘레이터 리모콘,25900,25900,0
2018-06-01,1210361931,C013020,티셔츠,[트레몰로][TREMOLO] 남성 폴리스판 패치 터틀넥 티셔츠_TRSALUSC566,160000,152000,-8000
2018-06-01,1499934306,C013010,점퍼,아디다스 아디제로 트랙자켓 (S99687 ),153440,136570,-16870
2018-06-01,415185002,C013010,점퍼,헌팅자켓 사파리 BW 바람막이 야상 점퍼 남자야상 남,77310,75770,-1540
2018-06-01,2125695437,A019100,식초,오뚜기 케찹 마요네즈 가정용케찹 가정용마요네즈,1130,1130,0
2018-06-01,1360580105,C013020,티셔츠,[인디안][인디안(INDIAN)]스포티집업배색티셔츠_MIGASPM4251_23,17900,17010,-890
2018-06-01,403621382,C014010,아동복,어린이 방한 마스크 MA0672 모모앨리앵글,9810,9810,0
2018-06-01,657893762,F012010,종이기저귀,[리베로]리베로기저귀 팬티형7단계 36매 4팩,73900,70210,-3690
2018-06-01,635816490,C021040,실내화,[리복][REEBOK CLASSIC] 리복 클럽 C 85 칼라팝 (BS9600)[갤러리아],71200,56960,-14240
2018-06-01,1497167724,I012010,컴퓨터,삼성 등 브랜드PC 가격파괴,219000,199000,-20000
2018-06-01,647861893,A022040,기능성음료,천연 코코넛워터 지코 ZICO 330mlx12팩/이온음료,19500,19500,0
2018-06-01,62961063,A011090,국수,컵라면 한박스 진라면 신라면 왕뚜껑 진짬봉 큰사발면,9900,9900,0
2018-06-01,772777717,C012060,여자내의,[리스트][LIST] 프릴 스커트 TWWSKH60060 (3가지 색상),29000,24070,-4930
2018-06-01,281754724,C013020,티셔츠,[게스진] MI2K9416 남여공용 오리지날 삼각 PVC 반팔 티셔츠,22400,18150,-4250
2018-06-01,1634999895,E011060,의자,침대형의자/사무용/컴퓨터책상의자/안락의자/베드체,72000,72000,0
2018-06-01,1269731708,C012060,여자내의,jj41 니트 미디스커트_레드 치마 여성미디스커트 여성,13020,13020,0
2018-06-01,603883956,A014020,분유,일동 프리미엄 하이키드 600g,21000,21000,0
2018-06-01,258943765,A013100,마른멸치,(전남오픈마켓/다시마전복수산) 전복 1kg(22-25미),30000,30000,0
2018-06-01,269550083,A021010,커피,4박스 세트/무료배송+사은품/돌체구스토/캡슐커피,39520,39520,0
2018-06-01,1328602508,C013020,티셔츠,베이직 후드티 LLTT0032 여성티셔츠 후드티,23510,23040,-470
2018-06-01,1293841530,C013010,점퍼,푸조 큘팅 자켓(FZ715-4) 남성누빔자켓 남성겨울자켓,50730,50730,0
2018-06-01,347737438,A016160,과일가공품,미국산 프리미엄 A그레이드 블루베리 3kg 무료배송,19500,19500,0
2018-06-01,979838722,I012060,저장장치,[2900무료배송] 마우스 고감도 USB PS2 꼭맞는그립감,3600,2900,-700
2018-06-01,530420220,C012040,여자학생복,[하루메이비]M479 로즈자수 스트라이프 롱 셔츠,39900,39900,0
2018-06-01,1952855708,E021020,커튼,아이리스 실키쉬폰커튼 실크필 쉬폰속커튼,22800,20980,-1820
2018-06-01,48173788,A013100,마른멸치,[산지직송] 완도 명품 활전복 1kg (산소포장),19900,19900,0
2018-06-01,895654133,A017150,버섯,CJ 행복한콩 국산숙주(300G/봉),2290,1990,-300
2018-06-01,1810554383,L021060,유모차,진화된 미래형 쌍둥이 유모차 휴대용 티크듀오 유모차,220000,220000,0
2018-06-01,1326751653,C013010,점퍼,노딕 블랙라벨 (화이트 ) 집업잠바 집업점퍼 여성점퍼,17020,17020,0
2018-06-01,613490077,E011060,의자,베스트리빙 가죽의자(PU) 1+1/식탁의자/식탁벤치,64500,64500,0
2018-06-01,792563631,A016070,귤,감말랭이/반거시곳감/건과일/해울림 반건시세트 2호,67900,67900,0
2018-06-01,4986346,A011170,떡,떡보의하루 영양떡세트 5개입 10개입 골라담기 外,4500,4500,0
2018-06-01,129999046,A021010,커피,맥심 모카골드 마일드400T,41900,41900,0
2018-06-01,1406289432,A021010,커피,[당일출고/무료배송]맥심 아이스블랙 100T+아이스보틀,10900,10900,0
2018-06-01,1538835631,A019080,고추장,여행용 고추장 60g 3개 세트 찹쌀 궁중약 볶음 전주,6950,6950,0
2018-06-01,444532786,F012010,종이기저귀,군기저귀 밴드형 신생아(90p) x1팩/전사이즈,14450,14450,0
2018-06-01,602702922,C012020,원피스,[보니알렉스](보니알렉스) 노버튼 롱 오버 코트(BAHY103A),35500,31240,-4260
2018-06-01,1832687383,C014010,아동복,아동남방/흰남방/돌/옥스포드/블라우스/체크남방/유아,12800,12800,0
2018-06-01,938528020,A017250,고사리,[코스트코] 커클랜드 스터프라이 베지터블 2.49kg 볶음야채,26490,25990,-500
2018-06-01,1403202402,L021060,유모차,킨즈포켓 기내반입 기내주행 휴대용 유모차,179000,179000,0
2018-06-01,2083111228,A019110,드레싱,움트리 냉면장2kg/쫄면장2kg/진냉면육수(20인분)1kg,8500,8500,0
2018-06-01,1014316349,A011160,빵,삼다오메기 제주오메기떡 30개 팥/콩가루/흑임자/견과,21900,21900,0
2018-06-01,65764449,F012020,생리대,샘플증정8p 예지미인/생리대/오버나이트/텐셀,9900,9900,0
2018-06-01,542432600,C014020,유아복,[뿌야뿌][뿌야뿌] 솔리드저지팬츠 PC2TGPT29N,12500,5630,-6870
2018-06-01,542432603,C014020,유아복,[뿌야뿌][뿌야뿌] 라이크핑크팬츠 PC2TGPT47N,12500,5630,-6870
2018-06-01,1434847727,C012040,여자학생복,핏예뻐~반응좋은 롱/루즈핏 셔츠 여성 빅사이즈 남방,21800,21800,0
2018-06-01,418562,A013040,고등어,수산물 50종모음/생선/해산물/고등어/동태/오징어,10000,9900,-100
2018-06-01,925212025,A022050,탄산음료,나랑드사이다 180mlx30캔 음료수/콜라/사이다,7800,7800,0
2018-06-01,1534899008,A013170,생선통조림,유동 번데기캔 130g X 48EA_1BOX 번데기 맛있는번데기,58000,57420,-580
2018-06-01,981406599,E061080,키친타월,(70매증정)벨라지오 키친타올160매X16롤/휴지/화장지,11000,9700,-1300
2018-06-01,1210383232,C013020,티셔츠,[트레몰로][TREMOLO] 남성 그래픽 프린트 하프 집업_TRSALTSC476,52000,49400,-2600
2018-06-01,669903904,F012050,의료측정기,아크레이 트러스트체크 혈압측정기 혈압계 HL858BA,25710,23920,-1790
2018-06-01,777948412,E041050,냄비,당일출고 퀸센스 3종/4종 냄비세트 코팅 양수 편수,32900,32900,0
2018-06-01,1111326357,A019030,생강,하지카미 (생강순 605g),33920,30190,-3730
2018-06-01,503608562,L021010,손목시계,BELCARINO 손목시계 유로스타일 패션시계 MV2097027,75390,75390,0
2018-06-01,959558775,E041080,부엌용용구,마미스테이블)아이스 몰드(2개),11000,3000,-8000
2018-06-01,1863897485,C012060,여자내의,빅사이즈 헬로시스터 클레드[플레어미디스커트]/ 헬로시스터,34300,26760,-7540
2018-06-01,960273761,L012060,샴푸,트레제메 모이스처 리치 샴푸(900ML),16800,8400,-8400
2018-06-01,635456707,C013020,티셔츠,[오늘출발] 4900~ 실켓나시/나시티/롱나시/롱원피스,6900,4900,-2000
2018-06-01,1012833678,A021010,커피,쟈뎅 까페리얼 아이스커피 190mlx10팩/ 편의점커피,4200,4200,0
2018-06-01,900302612,A019070,양념소스,[백설]백설 돼지불고기양념 500G,3600,3600,0
2018-06-01,900302611,A019070,양념소스,[백설]백설 소갈비양념 500G,3600,3600,0
2018-06-01,900302610,A019070,양념소스,[CJ]백설 소불고기양념 500G,3600,3600,0
2018-06-01,900302614,A019070,양념소스,[백설]백설 닭볶음탕양념 490G,3890,3890,0
2018-06-01,900302613,A019070,양념소스,백설 돼지갈비양념 500G,3600,3600,0
2018-06-01,434221491,C021040,실내화,[푸마]푸마 키즈 샌들 190698 바오 3 Open PS [타임월드] 18SS[갤러리아],49000,39200,-9800
2018-06-01,899589648,E061040,부엌용세제,순샘구연산자몽리필1.4L,5990,5990,0
2018-06-01,178403440,F012020,생리대,에리에르 엘리스 메가미 슬림 팬티라이너(일반) 36P,3900,3900,0
2018-06-01,660727288,L021030,가방,[리틀파머스] law cut shoulder bag 1S8AHB0161,62300,56070,-6230
2018-06-01,1105414195,D031010,주택수선재료,바인더 아크릴 접착제 본드 수성프라이머 믹싱 시트지,3000,3000,0
2018-06-01,1053394835,C013050,운동복,남자 트레이닝세트/빅사이즈/남성트레이닝복/운동복,36000,31900,-4100
2018-06-01,1014485138,A019050,간장,타마고 계란간장 300ml/테라오카 일본간장 사시미간장,6190,6190,0
2018-06-01,987976533,E061050,청소용세제,먼로주의)베이킹소다10입+구연산10입+과탄산소다10입,15900,5000,-10900
2018-06-01,1011652073,C014020,유아복,[모다아울렛][리틀밥독]하울후리스JP,25800,25800,0
2018-06-01,1139978798,A018010,초콜릿,(무배)가나/크런키/아몬드초코볼/드림카카오/키세스,11800,11800,0
2018-06-01,2068305346,C013010,점퍼,(SR)MJI2-26 남자빅사이즈FR자수트레이닝셋트-상의단,73000,59860,-13140
2018-06-01,62040455,C011020,남자상의,(AGC패딩 코트 레이어드 PD05 WS패딩코트코트남자코트,155020,155020,0
2018-06-01,11573298,G022020,자동차타이어,[TIREPLUS]피렐리 스콜피온 베르디 올시즌 275/45R20,295000,238220,-56780
2018-06-01,1399387705,A019130,스프,보노스프 선물세트 5종(15봉) + 머그컵 증정 간식 죽,16900,16900,0
2018-06-01,393023386,C012060,여자내의,빅사이즈/제이스타일 벤트니 구제컷팅 코튼스판 스키니,35000,31500,-3500
2018-06-01,811458553,E011060,의자,체어클럽 최저가 학생 사무용 책상 컴퓨터의자,29900,22130,-7770
2018-06-01,126867649,C013020,티셔츠,[쏭스타일] 무심하게툭 신상롱티셔츠/후드/맨투맨,5900,5900,0
2018-06-01,1046349378,A019140,이유식,맘마밀 안심이유식(100g)x10팩/매일유업,18500,18500,0
2018-06-01,352397253,I031040,생화,구급함 소중대 구급상자 구급낭 구급가방 약품세트,10000,9900,-100
2018-06-01,1669827587,C013050,운동복,해골 헬스나시 민소매 운동복,8900,8900,0
2018-06-01,1241170175,A019130,스프,보노스프 10각/5각+머그컵 선물세트 골라담기,23800,23800,0
2018-06-01,240510076,C012030,여자상의,하운드투스체크OPS 원피스 플레어원피스 랩원피스 프,74600,66400,-8200
2018-06-01,377242168,E041010,식기,킴스아트 화이트 공기 밥공기 깔끔한밥공기 화이트공,8220,7490,-730
2018-06-01,1151282661,C013010,점퍼,내구성좋고 100퍼센트방수 여성 슬림 코트형 우의우비,25800,24510,-1290
2018-06-01,504655062,C012040,여자학생복,[코코애비뉴]쉬폰슬리브블라우스_80504,20900,20070,-830
2018-06-01,1316383797,C012030,여자상의,캐주얼원피스/원피스/박스원피스/롱원피스,12800,12800,0
2018-06-01,240597616,C021040,실내화,[푸마] (SIZE : 270) 플레어 2(18951703) 신발 러닝,85190,85190,0
2018-06-01,1064507770,A013170,생선통조림,동원 살코기참치100g×8개/150g×8개 2종 택1,13900,13900,0
2018-06-01,1316187203,A019030,생강,하지카미 (생강순 605g) X10,282880,251770,-31110
2018-06-01,1266572653,C011030,남자학생복,린넨 라이크 포켓 롤업 셔츠 남방 120size 남자셔츠,28940,28940,0
2018-06-01,2004995604,C013020,티셔츠,테이트 TATE (KA8U4-MKS220) 남성 메탈 버튼 블록 배색 피케 티셔츠,39920,33140,-6780
2018-06-01,873930111,C015020,모자,남자 여자 군모 무지 밀리터리캡 커플 모자 신상 추천,14000,12900,-1100
2018-06-01,1148939913,C013020,티셔츠,카렌 둥근카라 티/ 해피프린스,17000,14620,-2380
2018-06-01,539558480,C013050,운동복,오토코스 에어컴프레셔 모음전/12V/타이어 공기압,45000,38700,-6300
2018-06-01,657893787,F012010,종이기저귀,[리베로]리베로기저귀 밴드형5단계 56매 3팩,56500,52550,-3950
2018-06-01,1406535143,C012040,여자학생복,[대구백화점 II관] [보니스팍스]스트라이프 린넨셔츠(BW21BL130),55000,52250,-2750
2018-06-01,2131251447,C013030,스웨터,밀란시아 잔골 폴라티 is0116-002 남성티셔츠 폴라티,21310,21310,0
2018-06-01,450281532,A013150,어묵,가마보꼬 오뎅모듬전골 350g2개 전골 모듬전골 오뎅모,20640,18580,-2060
2018-06-01,530515109,C013020,티셔츠,2017년 PGR GOLF 여성 국내생산 긴팔티셔츠 25종 택1,64900,59900,-5000
2018-06-01,899589619,E061010,세탁세제,애경 스파크 리필 (6KG),14900,14900,0
2018-06-01,106205453,C011050,남자내의,[4계절면바지] 디키즈874 면바지 정품1억 디키즈873 슬림핏 오리지널 루즈핏 워크팬츠,24900,24900,0
2018-06-01,900243869,A018060,스낵과자,오리온 포카칩 소금맛 (137G),2450,2190,-260
2018-06-01,723277792,C013010,점퍼,[패션플러스][플레이팝][플레이팝]유니항공점퍼 1051,52900,48670,-4230
2018-06-01,1597173362,F011130,홍삼,정관장 황_진귀함을 드리다,100000,100000,0
2018-06-01,987976563,A013180,젓갈,[해음] 짠맛을 줄인 속초 명란젓 400g + 속초 오징어젓 400g,29500,27200,-2300
2018-06-01,1827782536,A011110,당면,차오름 파래김 (200G) x70,457960,457960,0
2018-06-01,652168207,A014010,우유,바른목장190ml외/멸균바나나초코두유우유/전상품특가,14950,14950,0
2018-06-01,1481855574,E011070,식탁,루니스 아일랜드식탁 홈바 일반형/전기렌지매립형,229500,229500,0
2018-06-01,1286891920,C013020,티셔츠,[아디다스골프] 여성 배색포인트 반집업 슬리브리스 티셔츠 BC5651_GA,78000,74100,-3900
2018-06-01,675157661,I053020,스케치북,삼원 AC03 아카데미아 A3 120g 패드 -45536 드로잉북,16640,16150,-490
2018-06-01,1010314051,A013180,젓갈,대림 김치꽁치조림 200G,3580,3580,0
2018-06-01,691406327,C012020,원피스,[NNF]NnF 쿠션 기모 퍼 코트,39000,37050,-1950
2018-06-01,1347639799,C011050,남자내의,반바지/5부/7부/비치/트레이닝/바지/남자/남성,8900,8900,0
2018-06-01,247247240,E011050,책상,심플한 컴퓨터용 조립형책상/이지심플컴퓨터책상100,34500,34500,0
2018-06-01,682887857,C013010,점퍼,주니어 초등학생 의류 여름 바람막이 점퍼 가디건,34500,34500,0
2018-06-01,353755031,C013020,티셔츠,[모다아울렛][모노블랙]세로나염롱티82MTS502,17000,15300,-1700
2018-06-01,64953577,A014030,치즈,뼈로가는칼슘치즈 본품30매 추가증정본품30매 총60매,15700,15700,0
2018-06-01,239437645,C011030,남자학생복,[리즈코] MCD-903 4단 배색 블로그 브이넥 가디건 와인,16000,16000,0
2018-06-01,199840547,E031120,믹서,[SK매직] Magic 다용도 미니믹서기 MCH-B601 (알찬구성),28290,26600,-1690
2018-06-01,1703406017,A019140,이유식,[신제품 특가]영양밥/육포/라면/햅쌀이유식 14종 50%,11890,11890,0
2018-06-01,434003186,A013040,고등어,제주 냉동고등어 10kg 무배까지,28900,28900,0
2018-06-01,658667667,A013070,굴,생새우살 대사이즈 1+1 약60마리 새우,9700,9400,-300
2018-06-01,1808719284,E011050,책상,스마일 H형책상+책장세트 10종 컴퓨터책상 공간활용,98000,92900,-5100
2018-06-01,1266569024,C013020,티셔츠,쿨론 라운드넥 긴팔(4XL/5XL)/냉감/단체티/티셔츠(쿨,12400,12400,0
2018-06-01,900243870,A018060,스낵과자,오리온 포카칩 양파 (137G),2450,2190,-260
2018-06-01,1630920614,C012040,여자학생복,[안지크]뒷주름포인트블라우스(CZ1BL1230),20000,18000,-2000
2018-06-01,1402863738,A022050,탄산음료,[웰치스] 웰치스 355ml x 24캔 포도/탄산음료,13900,13900,0
2018-06-01,1049580259,C014020,유아복,[신디키즈]왕관 나염 슬럽티 (CIRA7407),5000,5000,0
2018-06-01,1470500986,E031110,청소기,센스봇 스마트 물걸레 로봇청소기 + 핸디청소기 H7500,260810,250810,-10000
2018-06-01,984431345,A019140,이유식,[남양]남양 아이엠마더 4단계 800G,37800,37800,0
2018-06-01,1541220553,I011030,사진기,명품 니콘 D5600 + AF-P 18-55mm VR 정품+사은품,749890,749890,0
2018-06-01,907029063,A013140,북어채,100% 자연건조 먹태채1마리 손질먹태 명태 먹태 황태,4200,3990,-210
2018-06-01,352686416,A012010,국산쇠고기,대관령한우 프리미엄 1호,530780,530780,0
2018-06-01,294316526,C013040,청바지,[메이비베이비] Vespa (pt),30000,30000,0
2018-06-01,1730741971,C012060,여자내의,[대구백화점 I관] [베스띠벨리]밴딩 무릎 주름 팬츠(BQPAE2218),39000,33540,-5460
2018-06-01,388658386,L021010,손목시계,헨리코튼 메탈 손목시계 HC-701,150000,135000,-15000
2018-06-01,1210655483,E011050,책상,원목 책상 일자책상/책장/테이블/컴퓨터책상/책꽂이,75000,67500,-7500
2018-06-01,729147503,F012010,종이기저귀,[혜택가43 900원]하기스 매직팬티 3/4/5/6단계 4팩,48900,48900,0
2018-06-01,1020728667,I031040,생화,폴딩파라솔 사각파라솔 대형파라솔 천막 그늘막 텐트,83900,67590,-16310
2018-06-01,1298005169,C013030,스웨터,MNT-048 배색컬러 M자가드 패턴 라운드 니트 캐주얼니,46250,46250,0
2018-06-01,1099805028,A011140,부침가루,퍼지바 24개입/초코 모카/초코파이/초코바/케이크/빵,6000,6000,0
2018-06-01,707761347,I031040,생화,버팔로 와이드릴렉스 캠핑체어세트/캠핑의자 낚시의자,59000,49360,-9640
2018-06-01,896781415,A018090,잼,청정원 딸기쨈(470g),4770,4770,0
2018-06-01,1497755026,C013040,청바지,[게스진] 온라인 기획특가 남녀 오리지날 면바지 4종,10000,10000,0
2018-06-01,1308764990,F011150,건강기능식품,국내산 검은콩가루 200g x 2봉 총400g /선식/검정콩,10000,8900,-1100
2018-06-01,1385198771,C011050,남자내의,[앤드지바이지오지아]S/S 캐주얼 팬츠 7종 택1 [BLY1DP1001 외](대구신세계),31500,31500,0
2018-06-01,896827214,C015030,넥타이,자동 넥타이/나비 넥타이/단체/남자/정장/면접용/슬림,1350,1350,0
2018-06-01,1852698597,I031040,생화,홀러 마일드 화로대테이블/감성캠핑 용품,67000,59800,-7200
2018-06-01,1778456251,F011150,건강기능식품,[깬다큐Q] 밀크씨슬/간영양제/비타민B/숙취해소/회식,4000,4000,0
2018-06-01,429051907,E021020,커튼,40년 한길 달인의 인생 모기장 침대 사각 대형 야외,7000,6900,-100
2018-06-01,356157741,C013050,운동복,올뉴카니발 리무진 콘솔박스 팔걸이 쿠션 차량쿠션 팔,61430,55960,-5470
2018-06-01,288531207,A014030,치즈,코리원/썬리취 모짜렐라치즈 R슈레드 2.5kg/피자/치즈,13500,13500,0
2018-06-01,966358553,A018010,초콜릿,롯데 초콜릿 드림카카오 86g 6통/12통 56% 72%,9400,9400,0
2018-06-01,123674956,A018040,아이스크림,얼려먹는 쭈쭈바 7종/천연 아이스바 쮸쮸바 폴라레티,3000,2970,-30
2018-06-01,418767613,C012020,원피스,[BCBG]B8M5P354 라디오 PT,229000,206100,-22900
2018-06-01,687023649,C014010,아동복,여름신상 디즈니정품/유아동 반팔티/캐릭터티셔츠,5900,5900,0
2018-06-01,1205260570,A017100,당근,(전남오픈마켓/풍년명가)마른시래기 500g,8900,8900,0
2018-06-01,933555283,C011030,남자학생복,[후앙스][후앙스] 배색포인트 패딩조끼 SMPV6057,30800,26490,-4310
2018-06-01,1261525899,A016150,아몬드,[주식회사그로워앤패커] 햇아몬드 (400g+400g),9000,9000,0
2018-06-01,328930109,E021010,침구,시원한 유럽스타일 침구세트 요커버 이불 이불세트,59800,59800,0
2018-06-01,949435802,C021040,실내화,레이스 망사 하이탑 웨지힐 키높이운동화,33500,33500,0
2018-06-01,1406572143,L012040,치약,2080치약 14개 크린케어/페리오 후레쉬/진지발리스,11900,11900,0
2018-06-01,1355741663,E041010,식기,수복/진공/티타늄/ 반상기세트/금/도금/혼수/예단/기념일/출산/금/도금/선물/세트/외국,340000,306000,-34000
2018-06-01,1266011797,C012060,여자내의,[핑크시슬리]미니땡이 아이스쿨 점프수트/ 핑크시슬리,38900,31120,-7780
2018-06-01,2079073729,A017210,파,[동곡농협] 블랙체인지 흑토마토 3kg,13900,12900,-1000
2018-06-01,1519376226,C013020,티셔츠,꼬불꼬불세로줄티/골지티/반팔니트티/슬림티/셔링티.,7900,7900,0
2018-06-01,597863568,F012010,종이기저귀,[에코튜드]센서티브 기저귀 1팩/옥수수식물성 NGO안감,6900,6900,0
2018-06-01,1118389287,E011030,거실장,명품 심우 자작나무 원목 600 스피커 스탠드 2개 1세트,209000,209000,0
2018-06-01,1377675463,A014030,치즈,건국모짜렐라 피자치즈1kg /건국하모니 1kg,8900,8900,0
2018-06-01,2145887912,E031040,전기레인지,Coms)2캔용 USB 미니 냉온기(WH1202)USB냉장고 냉온기,56560,56560,0
2018-06-01,1118389284,E011030,거실장,심우 자작나무 원목 홈씨어터장식장 1200 누드거실장 550II,588000,588000,0
2018-06-01,1118389283,E011030,거실장,심우 자작나무 원목 1770 홈씨어터장식장 누드거실장 550III,800000,800000,0
2018-06-01,867992796,L021050,우산,제비표 우비 상하세트 작업용 등산용 오토바이 우의,29500,29500,0
2018-06-01,1118389286,E011030,거실장,명품 심우 자작나무 원목 800 스피커 스탠드 2개 1세트,220000,220000,0
2018-06-01,1118389285,E011030,거실장,심우 자작나무 원목 오디오장식장 누드거실장 863,463000,463000,0
2018-06-01,300951335,C013010,점퍼,가죽/패딩점퍼/패딩무스탕/무스탕/가죽자켓/가죽점퍼,127900,127900,0
2018-06-01,1875547652,F012010,종이기저귀,[[아이커머스몰][일본 정품 내수용] 군기저귀 3/4팩 밴드형 팬티형 리뉴얼 최신상품 입,48400,47400,-1000
2018-06-01,532351128,C013010,점퍼,MD추천 무스탕점퍼 라이더무스탕점퍼 프리미엄무스탕점퍼추천 주문제작,999000,999000,0
2018-06-01,1922854319,C013050,운동복,(1+1 EVENT) 16ss 첨이첨이 플라워래빗3부유아복 듀퐁 유아동의류 아동의류 공용 상하,28220,28220,0
2018-06-01,1225488783,E031110,청소기,[공식] (정품)한경희 스팀청소기 3중 초극세사패드4장,11180,10400,-780
2018-06-01,1991731456,E031020,가스레인지,[SK매직] 실속형 2구 안심센서 가스렌지 GRA-813SR (LPG),126590,119000,-7590
2018-06-01,22040979,A011120,두부,[당일출고]포스트골든그래놀라 360gx2개+틴케이스증정,11900,11900,0
2018-06-01,345548943,I031070,애완동물관리비,스타 /족구공/풋살공 기획전/공식판매점/공인구,29000,25670,-3330
2018-06-01,85905093,A022020,두유,매일뼈로가는칼슘두유세트 96팩/4Box,30900,29900,-1000
2018-06-01,1341133008,I031010,장난감,[지나월드][무료배송]뉴뽀로로붕붕카/완구/붕붕카,42700,42700,0
2018-06-01,1276158669,C013020,티셔츠,남자 긴팔티 7부티 헨리넥 오버핏 라운드 무지티,9900,9900,0
2018-06-01,799768285,A012030,돼지고기,헬로우흑돼지 왕목살/삼겹살/돼지갈비/대패삼겹 500g,3900,3900,0
2018-06-01,791360696,C014010,아동복,[젤리스푼] 러블리한 여아원피스모음,9900,9900,0
2018-06-01,1450700855,A014030,치즈,아담스 프리미엄파마산 1kg,9600,9600,0
2018-06-01,1066499721,A017230,마늘,햇양파 대용량 특가 10kg-5900원,5900,5900,0
2018-06-01,794301894,I012010,컴퓨터,Apple 공인판매점 2017 iMac [MNED2KH/A] 27형,2562000,2433900,-128100
2018-06-01,61627908,C013050,운동복,[안전지키미] 자동차삼각대/후레쉬/led점멸등/비상등/랜턴/led램프(,32340,32340,0
2018-06-01,1300948589,C013030,스웨터,[동대문] (색상 : 블랙 | 사이즈 : 3XL(115)) BIGWM,56200,56200,0
2018-06-01,596621023,C012020,원피스,김발(속대 에브리홈)X20,17170,17170,0
2018-06-01,193137411,C012060,여자내의,시크폭스 매직텐션 스키니팬츠/ 시크폭스,25900,20210,-5690
2018-06-01,827180297,A012010,국산쇠고기,[무항생제 한우선물세트]VVIP 지애 4호2.5kg(1++등급),390400,390400,0
2018-06-01,1044758888,A017110,감자,제주 햇 흙당근 10kg~20kg,23100,23100,0
2018-06-01,1131205886,L021020,장신구,(실버) 니트 스틱 목걸이 (Gold Rose Gold) 목걸이금,25470,24710,-760
2018-06-01,1985548535,D031010,주택수선재료,[프리미엄]붙이면끝나는!!풀바른실크벽지+무늬맞춤/벽,6700,6700,0
2018-06-01,1075344360,L021050,우산,제비표 우의 우비 바지 작업용 오토바이 낚시 우비,19800,19800,0
2018-06-01,438119675,L021030,가방,40년전통/장인정신/남성가방/서류가방/천연소가죽A/S,102800,102800,0
2018-06-01,327413523,C021010,아동화,텐우드 예브리 플라워 벤시 운동화 아동화 아동운동화,26980,26980,0
2018-06-01,297402494,C014010,아동복,아이러브파파n마마 티셔츠 4종 1택(6-24개월) 202213,17930,15960,-1970
2018-06-01,985384784,A013130,오징어채,홍진미(기획) 150G*2봉,15900,9900,-6000
2018-06-01,650563135,I031040,생화,정품 COGHLAN'S - 캐나다 명품 코글란 Poly Cord 나일론 코드 스트링 밧줄 로프,7950,7230,-720
2018-06-01,1428736701,F012020,생리대,[위스퍼] NEW 보송보송케어 울트라 날개소형 18P X 3팩,14700,14210,-490
2018-06-01,1778566613,L021010,손목시계,[바보사랑]JA-1012 가죽시계,26280,26280,0
2018-06-01,1409424999,C014010,아동복,어린이 방한 마스크 MA0668 로라앨리러브퐁퐁,9810,9810,0
2018-06-01,1778566611,L021010,손목시계,[바보사랑]JA-1010 메탈시계,39240,39240,0
2018-06-01,162409326,C013010,점퍼,랜더스 남여공용 노르딕 헤비 패딩자켓 ( JK850W ) 레,69780,69780,0
2018-06-01,1778566617,L021010,손목시계,[바보사랑]JA-1015 가죽시계,26280,26280,0
2018-06-01,1778566615,L021010,손목시계,[바보사랑]JA-1014 가죽시계,27720,27720,0
2018-06-01,1161440374,A017110,감자,장흥표고_분말세트2호건강식품 명절선물세트 특산품 추석선물세트 효도선물 표고세트,32080,32080,0
2018-06-01,1778566619,L021010,손목시계,[바보사랑]JA-1017 가죽시계,23400,23400,0
2018-06-01,470355330,C013010,점퍼,지오다노 05378502 여 오버사이즈 패딩 바머 자켓 [2018년 S/S],49800,41340,-8460
2018-06-01,989911211,A017070,부추,RealFresh부추/단,4000,2000,-2000
2018-06-01,321991583,C012020,원피스,컬러가 예쁜 오버핏 심플코트(C164MSG028)/ 씨씨콜렉트,95800,81430,-14370
2018-06-01,1843343171,F012020,생리대,바바파파 그날엔순면 롱라이너 20px4팩 +마스크팩증정/ 예지미인,9400,9400,0
2018-06-01,1190529140,A019100,식초,[본타몰]하이몬 칠리 샤브수끼 소스 300ml 샤브샤브 칠리소스,3900,3900,0
2018-06-01,1031317072,C012060,여자내의,꾸제꾸제/Calvin Klein 청치마/size 28/스커트/데님/진청/세일/브랜드/중고 구제/CK/캘,17900,17900,0
2018-06-01,288996324,L021020,장신구,925 실버 팔찌 발찌 인기 모음 은팔찌 은발찌,14000,14000,0
2018-06-01,123155706,C012030,여자상의,로로텐 롱/미니/쉬폰/레이스 원피스/빅사이즈,11800,11800,0
2018-06-01,1205698016,C014010,아동복,[버블트리]~23호/여아/의류/아동복/주니어/원피스,19800,19800,0
2018-06-01,410942858,C013010,점퍼,폴라이더 겨울점퍼 가죽점퍼 가죽점퍼 라이더자켓 라,139670,139670,0
2018-06-01,548652555,C013010,점퍼,[보니알렉스]썸머 스타일업 아노락점퍼(BBF590C),59000,59000,0
2018-06-01,559971187,C012040,여자학생복,[쉬즈미스] 2018 SSKPOI20120 라운드 소매단추 오버핏니트,138600,110880,-27720
2018-06-01,2118761589,L012040,치약,닥터데이즈 천연 홈케어 미백치약,12500,12500,0
2018-06-01,155908060,I031070,애완동물관리비,안전말랑말랑 피구공/스타/폼볼/학교/스포츠클럽공인,14900,13190,-1710
2018-06-01,989913852,F012020,생리대,[유한킴벌리]유한킴벌리)좋은느낌슬림날개대형32P,11900,11900,0
2018-06-01,578115720,A017230,마늘,2018 양파/햇양파 10kg - 마늘/깐마늘,11400,11400,0
2018-06-01,487172084,C013010,점퍼,바람막이/바람막이점퍼/야상/자켓/빅사이즈/골프웨어,48800,48800,0
2018-06-01,1692531639,E031010,전기밥솥,쿠쿠 내솥 [I922] CRP-HSB065FE 밥솥 교체용,44570,44570,0
2018-06-01,611620406,C013040,청바지,[게스키즈] G66KBP320게스키즈그레이 워싱 스키니진,133000,66500,-66500
2018-06-01,1220736996,C012040,여자학생복,[달콩시럽]루시아로브,11500,10930,-570
2018-06-01,1568323760,A011120,두부,(1+1)첵스초코 시리얼/씨리얼/간식/과자/요구르트,8990,8990,0
2018-06-01,1121885716,A013060,게,{재입고특가} 포항직송 총알오징어/라면오징어 1kg,16900,16900,0
2018-06-01,1249480792,E011060,의자,[샘글로벌] PURE 책상의자,128000,118000,-10000
2018-06-01,1263570249,E061060,살충제,홈케어 파워 방충제 옷장용 10개 + 서랍용 12개,13010,13010,0
2018-06-01,441155402,C013010,점퍼,18 F/W 신상! [BK투미다운자켓]여아전용 솔리드 형태의 롱기장 구스 다운 자켓/ 블랙야,199000,169150,-29850
2018-06-01,1778566643,L021010,손목시계,[바보사랑]JA-1016 가죽시계,23400,23400,0
2018-06-01,351116878,A011010,쌀,엄마밥줘 5kg/현미/쌀/잡곡/혼합곡/진공포장,21900,21900,0
2018-06-01,1778566646,L021010,손목시계,[바보사랑]JA-1013 메탈시계,38880,38880,0
2018-06-01,1195017616,C014010,아동복,유아 아동 반팔 상하복세트/남아 여아 상하복,14800,14800,0
2018-06-01,1246573368,A011170,떡,인절미 1.5kg/빙수용/떡/떡빙수/콩고물,14900,14900,0
2018-06-01,1778566648,L021010,손목시계,[바보사랑]JA-1019 메탈시계,38520,38520,0
2018-06-01,891906284,A017090,열무,자연미가 무청시래기1kg/냉장진공포장 고랭지농특산물,4400,3960,-440
2018-06-01,266488041,L021020,장신구,[폭스타일] 매티 트리플 스타 반지,11000,10010,-990
2018-06-01,1429350641,C012020,원피스,[나이스클랍]소프트 자켓 (N182XSF002)(김해점),172000,139420,-32580
2018-06-01,451440055,C014020,유아복,아동바지 플라워통바지 KIDBOK-200 바지 아동바지 통,17370,17370,0
2018-06-01,408194888,E021010,침구,10%쿠폰! 올리비아데코 미리 준비하는 여름 리플 이불/침구,9900,9900,0
2018-06-01,895620716,A016090,참외,사과(특대/300~350g 내외/개),4990,2490,-2500
2018-06-01,1206318749,F011150,건강기능식품,[나비골농협]국내산 콩국수용 콩가루500g/콩국가루,7700,7700,0
2018-06-01,1974421210,A011140,부침가루,라이프서포터/코스트코 치즈케익/1.269g,17990,17990,0
2018-06-01,1778566650,L021010,손목시계,[바보사랑]JA-1020 메탈시계,27720,27720,0
2018-06-01,366706767,C015040,장갑,실버D 통기성이 좋은 성인용 매쉬 손싸게 할머니 할머,54200,53120,-1080
2018-06-01,2045953996,L021050,우산,[국산]돌핀 판초우의/우의/우비/낚시우의/비옷/등산용우의/레인코트/비옷/등산우의/낚,12900,12900,0
2018-06-01,965493460,D031010,주택수선재료,16L 오일스테인 51stain DIY 방부목 가구 공구 목재페,116560,104910,-11650
2018-06-01,1849538015,C013010,점퍼,아디다스 유소년 콘디보16 스타디움자켓 ( AN9871 ),136950,123260,-13690
2018-06-01,1055120922,L012010,면도기,도루코 일회용 면도기 100개 휴대용 면도기,15700,15700,0
2018-06-01,901162650,E061100,습기제거제,P&G 페브리즈 섬유 탈취제 다우니향 리필,4900,4900,0
2018-06-01,473404307,C012020,원피스,[KEITH]카치온폴리 K7MA377-49,156000,146640,-9360
2018-06-01,1353358709,C013020,티셔츠,베이직 후드티 LTT0032 여성티셔츠 여성후드티,26120,25600,-520
2018-06-01,900300054,I031040,생화,파라솔 받침대 총망라  주물받침대 받침대무게추 대형,22500,20700,-1800
2018-06-01,519838924,A017090,열무,국내산 레드비트 1kg 내외,6900,6670,-230
2018-06-01,1706651379,A014010,우유,(특가+사은품증정)삼육 아기두유 빅스2~3단계 96팩,48000,28000,-20000
2018-06-01,1386499851,E031010,전기밥솥,쿠쿠공식몰/CRP-QS1010FG/풀스테인리스/10인용/베스트,182600,182600,0
2018-06-01,242507060,C013010,점퍼,UOD261_3202_CH 남성잠바 남성점퍼 남성아웃도어 바람,76820,76820,0
2018-06-01,1254857810,C013020,티셔츠,[타요][타요] 멜빵믹스티(TYC116MBTS17-WH),8970,8530,-440
2018-06-01,501702552,A016040,포도,동원)황도 슬라이스 400g x 12개 사시사철 맛있는,41360,41360,0
2018-06-01,1137051411,C013050,운동복,송풍구 핸드폰 거치대 차량용 휴대폰홀더 고급형 (핸,16500,14730,-1770
2018-06-01,989913848,E061060,살충제,홈매트리퀴드홈솔루션훈증기+45일*2,15900,15900,0
2018-06-01,759109309,A019160,밑반찬,일가집 쫄깃무말랭이무침 1kg 반찬용무말랭이 무우말,10250,10250,0
2018-06-01,199176132,L021030,가방,ssamzie 로고패턴 여성가방 숄더백외 백팩,14800,14800,0
2018-06-01,1347627707,A011100,라면,오뚜기 옛날당면/알뜰당면 1kg /잡채 국수 찜닭 라면,5900,5900,0
2018-06-01,2087485106,C015020,모자,스냅백 볼캡 빅사이즈 프리미어 모자 남여공용 패션모,26740,26740,0
2018-06-01,952879048,A019080,고추장,해찬들 태양초고추장 (봉/500G),5850,5850,0
2018-06-01,80433631,L012040,치약,시스테마 나이트 프로텍트 치약 120gx8개,11900,11900,0
2018-06-01,1778591603,L021010,손목시계,[바보사랑][공식  백화점AS] 서펜타인 여성시계(메탈)_W0624L3,328000,328000,0
2018-06-01,1039875636,F012020,생리대,생리대 중형 60매 기획전 / 팬티라이너 / 오버나이트,8900,8900,0
2018-06-01,2087546551,C013060,등산복,[밀레(MILLET)][남성용](이월상품)[간절기]라쉬날2 레트로 팬츠( MXLSP003 )(경기점),59000,47650,-11350
2018-06-01,1778591600,L021010,손목시계,[바보사랑][공식  백화점AS] 미니 에섹 여성시계(메탈)_W0403L2,258000,258000,0
2018-06-01,1022021615,E031120,믹서,독일강력모터분쇄/멀티믹서기/대용량믹서기/HDM-3000W,29500,27600,-1900
2018-06-01,151544836,A017280,김,차조기사쿠라하나(원효 1k)X10 식자재 업소용식자재,48290,45880,-2410
2018-06-01,1778591606,L021010,손목시계,[바보사랑][공식  백화점AS] ZOEY 여성시계(가죽)_W0736L6,148000,148000,0
2018-06-01,1778591605,L021010,손목시계,[바보사랑][공식  백화점AS] 포스 남성시계(가죽)_W0674G5,278000,278000,0
2018-06-01,1343338803,C021040,실내화,에어맥스 98 건담 640744-100,138000,138000,0
2018-06-01,1778591604,L021010,손목시계,[바보사랑][공식  백화점AS] 래티튜드 남녀공용시계(메탈)_W0639L1,278000,278000,0
2018-06-01,1269731803,C012040,여자학생복,ee43 자수레이스 뷔스티에 베이지 뷔스티에 캐주얼베,13680,13680,0
2018-06-01,1753629630,E011030,거실장,[채움가구] 리셈 3단 협탁,48900,48900,0
2018-06-01,1778591510,L021010,손목시계,[바보사랑]JA-1043 메탈시계,48000,48000,0
2018-06-01,1778566554,L021010,손목시계,[바보사랑]JA-994 가죽시계,34560,34560,0
2018-06-01,1137376167,C012030,여자상의,[리리앤코]하늘원피스/빅사이즈/루즈핏/쉬폰,37800,26800,-11000
2018-06-01,1351535689,A021010,커피,페루산/카카오닙스/100%/카카오립스/카카오콩/씨앗,18900,18900,0
2018-06-01,1778566558,L021010,손목시계,[바보사랑]JA-996 가죽시계,26640,26640,0
2018-06-01,1778566556,L021010,손목시계,[바보사랑]JA-995 가죽시계,24840,24840,0
2018-06-01,86320395,A016120,바나나,프리미엄 브랜드 바나나 13kg 6~9수,45800,44240,-1560
2018-06-01,2011016359,F012010,종이기저귀,톨로 베이비 드라이버 장난감 완구 어린이 아동 유,31530,31530,0
2018-06-01,1464612904,E011040,소파,동서가구 LV 노브 천연가죽 3인 4인소파 DF909529,349000,349000,0
2018-06-01,2081448827,E031130,보온매트,올크리니 무전자계열선 전기 카페트매트 미니 70x183c,82800,70380,-12420
2018-06-01,1703239362,A014040,발효유,산지직송 무가당 수제요거트 플레인 2000ml×2팩,20000,20000,0
2018-06-01,1605339531,A017160,오이,멸치볶음 (70gX4봉) 멸치볶음 멸치반찬 반찬거리 볶은,18000,17460,-540
2018-06-01,1778591512,L021020,장신구,[바보사랑]OVAL NEC,30000,30000,0
2018-06-01,732549138,C013020,티셔츠,롱원피스티셔츠 박스티/빅사이즈여성의류/빅파라,16800,12800,-4000
2018-06-01,1753629627,E011030,거실장,[채움가구] 리셈 1단 협탁,27900,27900,0
2018-06-01,1753629625,E011030,거실장,[채움가구] 리셈 1200 거실장,53900,53900,0
2018-06-01,1753629623,E011030,거실장,[채움가구] 모노 4자 1단 거실장,74900,74900,0
2018-06-01,1854747051,G011070,자전거,K2BIKE 클래식 여성용자전거 스와니24/26인치 7단,93700,84330,-9370
2018-06-01,895144921,A014050,달걀,우리가족 안심 계란 구쁘팜 옹알옹알 30  40구,17100,17100,0
2018-06-01,1895093514,C015020,모자,스냅백 신상 힙합 커플 모자 스냅백모자 아동 무지,7900,7900,0
2018-06-01,1972176019,C012040,여자학생복,마르니 85 민소매 끈 나시 블라우스 탑 이태리 명품,74160,74160,0
2018-06-01,1281534469,C012060,여자내의,코인코르셋팬츠/ 다바걸,48450,48450,0
2018-06-01,295279424,C013050,운동복,차량용 썬글라스클립 /선글라스케이스/안경클립,5200,4740,-460
2018-06-01,1778591509,L021010,손목시계,[바보사랑]JA-1039 가죽시계,36000,36000,0
2018-06-01,1803451213,I031040,생화,2in1 해충킬러 LED 캠핑랜턴 모기 해충 퇴치 캠핑용품,24900,20150,-4750
2018-06-01,422335023,L012060,샴푸,30%쿠폰+FCB발매트! 헤드앤숄더 850mlx2개+90mlX2,14900,14900,0
2018-06-01,326368816,L021010,손목시계,화이트엔젤 손목시계 패션시계 여성시계 팔찌시계 아,29430,29430,0
2018-06-01,1137679751,E031010,전기밥솥,[단독특가]쿠첸 6인용 압력밥솥 CJS-FA0610V,101000,101000,0
2018-06-01,116231366,A013120,낙지,명품 A+ 청정 동해바다 마른오징어 20마리 중량별 택1,53900,53900,0
2018-06-01,413449897,C012040,여자학생복,가디건 스타일 롱셔츠 캐주얼 롱셔츠 패션롱셔츠 여성,41070,41070,0
2018-06-01,1164550331,C013010,점퍼,남자청자켓 흑청 생지 데님자켓 데님자켓 생지데님자,26820,26820,0
2018-06-01,884756309,A015010,참기름,복방앗간 국산/참기름/들기름/생들기름/주문당일착유,12000,11400,-600
2018-06-01,1267672222,A013060,게,진미채 900g 오징어채 밑반찬 대용량 안주 건어물,35990,35990,0
2018-06-01,1152025272,C011050,남자내의,기모바지 622 남성긴바지 남자바지 겨울바지 남성등산,66830,64830,-2000
2018-06-01,2137639556,E011050,책상,뉴그린퍼니처 H형책상세트/투서랍 옷장 공장직판 특가,71000,69000,-2000
2018-06-01,1004063709,L021020,장신구,초커목걸이 체인초커 가죽초커 레이스초커 태슬초커 F,21260,21260,0
2018-06-01,1258277579,A018010,초콜릿,자유시간 36g x 20+4개 초코바/에너지바,12900,12900,0
2018-06-01,493790360,A015010,참기름,삼진 그린 들기름 300ml X 20EA / 삼진식품(Hanworld2,181400,154190,-27210
2018-06-01,1118389309,E011030,거실장,명품 심우 자작나무 원목 400 스피커 스탠드 2개 1세트,184000,184000,0
2018-06-01,534233334,C013040,청바지,[나나진]아동청바지특가모음/아동/아동청바지/키즈,9900,9800,-100
2018-06-01,1011121295,A016150,아몬드,다바오바나나칩 190G,3490,3490,0
2018-06-01,1778566584,L021010,손목시계,[바보사랑]JA-1001 메탈시계,60120,60120,0
2018-06-01,1778566582,L021010,손목시계,[바보사랑]JA-998 가죽시계,27000,27000,0
2018-06-01,643846385,C014020,유아복,아동후드집업 아동후드집업 바람막이 아동집업 후드집업 집업,18010,16030,-1980
2018-06-01,1778566588,L021010,손목시계,[바보사랑]JA-1003 가죽시계,26280,26280,0
2018-06-01,492910069,D031010,주택수선재료,간편시공 바닥 시트지 점착 바닥재 가구 상판 리폼,9000,8010,-990
2018-06-01,1778566586,L021010,손목시계,[바보사랑]JA-1002 가죽시계,28800,28800,0
2018-06-01,574343073,I012010,컴퓨터,#NAME?,735780,699000,-36780
2018-06-01,1121366636,A017200,토마토,가지 특 40개 / 국내산,64740,64740,0
2018-06-01,890149339,C013020,티셔츠,[아디다스 키즈][가격인하]UFB CC 저지 Y(AX7254)[갤러리아],17500,14880,-2620
2018-06-01,23711391,C013050,운동복,5기능 LED경광봉 안전삼각대 다기능경광봉 신호봉,5000,4600,-400
2018-06-01,1435485857,A015010,참기름,추가금무/오뚜기 옛날 참기름 320mlx2개/옛날참기름,10100,10100,0
2018-06-01,1025564337,C012040,여자학생복,ab f z 여름초특가 쉬폰블라우스 2종 택1,16600,16600,0
2018-06-01,175511856,E011030,거실장,[PookShuim] 푹쉼 리옹 인조가죽 2인용 컴팩트 소파,190000,190000,0
2018-06-01,175511853,E011030,거실장,[PookShuim] 푹쉼 릴 PU가죽 3인용 소파베드 (오리털내장),380000,380000,0
2018-06-01,175511854,E011030,거실장,[PookShuim] 푹쉼 툴루즈 FPL가죽 2인용 컴팩트 소파,270000,270000,0
2018-06-01,1127177740,E021020,커튼,벌집블라인드 화이트 호프발스 60x155 cm/ 롤스크린,41100,36580,-4520
2018-06-01,1118389310,E011030,거실장,명품 심우 카오스 골드 2100 TV 거실장 유광도장 고급제품,413000,413000,0
2018-06-01,175511851,E011030,거실장,[PookShuim] 푹쉼 우피치 FPL가죽 3인용 소파베드 (오리털내장),320000,320000,0
2018-06-01,1552482963,I011030,사진기,소니코리아정품 DSC-RX100M4 디카셀러,999000,957990,-41010
2018-06-01,175511852,E011030,거실장,[PookShuim] 푹쉼 릴 FPL가죽 3인용 소파베드 (오리털내장),400000,400000,0
2018-06-01,1895859884,L012010,면도기,쉬크 다리털 정리기 X 2개/레그 트리머/숱제거기,11800,11800,0
2018-06-01,1118389312,E011030,거실장,명품 심우 골드 카오스 1500 TV 거실장 유광도장 고급제품,282000,282000,0
2018-06-01,413653388,A019080,고추장,청정원 순창현미찰고추장 1kg+1kg+증정쌈장200g,13830,13830,0
2018-06-01,1118389311,E011030,거실장,명품 심우 카오스 골드 1800 TV 거실장 유광도장 고급제품,332000,332000,0
2018-06-01,1653201450,E011020,침대,[가구야]매트리스+큰서랍포함 싱글/슈퍼/더블/퀸침대,179000,179000,0
2018-06-01,1118389317,E011030,거실장,명품 심우 홈씨어터 AV 오디오 누드 거실장 663 우레탄 도장 고급제품,369000,369000,0
2018-06-01,784533282,I031010,장난감,[노는역] PS4 듀얼쇼크 확장 트리거 OB 주변기기,11880,11880,0
2018-06-01,1118389314,E011030,거실장,명품 심우 홈씨어터 TV AV 누드 거실장 장식장 600III 우레탄 도장 고급제품,838000,838000,0
2018-06-01,1118389313,E011030,거실장,명품 심우 골드 카오스 1500 TV 거실장 유광도장 고급제품,282000,282000,0
2018-06-01,1118389316,E011030,거실장,명품 심우 홈씨어터 AV 오디오 누드 거실장 963 장식장 우레탄 도장 고급제품,425000,425000,0
2018-06-01,1118389315,E011030,거실장,명품 심우 홈씨어터 TV AV 누드 거실장 500II 우레탄 도장 고급제품,550000,550000,0
2018-06-01,353938678,F012020,생리대,(5無안심커버) 순면커버 맞춤커버 생리대 4팩,9900,9900,0
2018-06-01,1257434233,C011020,남자상의,아이보리 체크 밍크털 코트 남자코트 털코트 퍼코트,102370,102370,0
2018-06-01,116943538,C013040,청바지,[루알라키즈] 여름신상 아동반바지/청바지/스판/무배,8900,8900,0
2018-06-01,1163021662,E011050,책상,ZEN 베이트 서재 원목책상 1200 1500 1800 엔틱내추럴,145000,143000,-2000
2018-06-01,1915539058,A015020,식용유,오뚜기 프레스코 해바라기유 900ml X 20EA(Hanworld),181500,154280,-27220
2018-06-01,441843571,A015020,식용유,백설(CJ) 카놀라유2P,11040,11040,0
2018-06-01,1573167044,C013020,티셔츠,v골지5부슬림티/무지티/오프숄더/여름니트/섹시티.,9900,9900,0
2018-06-01,1269706810,C012030,여자상의,oo01 7부소매 스트랩 단가라 ops - 오렌지 단가라원피,20210,20210,0
2018-06-01,532351323,C013010,점퍼,스타일엔터 메리노베이비 무스탕자켓 남자무스탕 핸드메이드 무스탕점퍼 천연양가죽,960000,960000,0
2018-06-01,1301755791,C013020,티셔츠,남자티셔츠 피스 배색라인 후드 티셔츠 / 참고 남자티,38300,32560,-5740
2018-06-01,206793877,C012030,여자상의,[오조이]입는순간 미모폭발 원피스/스커트/티셔츠,12500,12500,0
2018-06-01,1778591544,L021020,장신구,[바보사랑]스켈레톤 뱅글,180000,180000,0
2018-06-01,1778591543,L021020,장신구,[바보사랑]스마일 스컬 귀걸이(2개 한세트),40000,40000,0
2018-06-01,1079838279,A014020,분유,[아이배냇]순산양분유 2단계 800g,32900,32900,0
2018-06-01,609559709,E011050,책상,사이드테이블노트북책상이케아컴퓨터책상이동책상,20900,18810,-2090
2018-06-01,520823644,L021020,장신구,실버 은반지 모음/정품925실버반지 14900원부터,14900,14900,0
2018-06-01,2084003930,E061060,살충제,페스트세븐가드 마툴키 바퀴벌레약 살충제 개미약,14000,14000,0
2018-06-01,370597513,A022030,생수,트레비190mlX30캔/음료수/탄산수/초정탄산수,9900,9900,0
2018-06-01,1431035059,A012010,국산쇠고기,한우 명품사골 1등급이상 4kg(사골2kg+잡뼈2kg) 세트,29800,29800,0
2018-06-01,1674806634,A019030,생강,편강진저빈 (국산 250gX2통) 선물세트,32780,29180,-3600
2018-06-01,1414187993,E011070,식탁,모드니가구-아일랜드식탁 접이식식탁 광파오븐렌지대,69900,69900,0
2018-06-01,1463443361,C012020,원피스,부천) 몽고진간장13L,28070,28070,0
2018-06-01,1518004434,A016070,귤,제주감귤 한라봉 10kg 가정용 랜덤과/제주귤/제주도감,85470,80350,-5120
2018-06-01,311305377,C013050,운동복,카본 범퍼윙 가드 대 중 소 중 택1 도어가드 차량용범,20010,18230,-1780
2018-06-01,441155336,A011170,떡,(냉장)두솔 유부나라300g(전골용유부)x5개,32560,32560,0
2018-06-01,1778591573,L021010,손목시계,[바보사랑][공식  백화점AS] Rose Falken 여성시계(가죽)_FAST101-CL010614,288000,288000,0
2018-06-01,1778591572,L021010,손목시계,[바보사랑][공식  백화점AS] ROSE ELVA-ROSE MESH 여성시계(메탈)_ELST102-EM021414,248000,248000,0
2018-06-01,367368793,E061040,부엌용세제,세이프 천연소금580mlx6/ 발현미580mlx6 용기385mlx4,14900,14900,0
2018-06-01,1122895319,E031080,선풍기,대원가전 히터/할로겐/국산/타이머기능/회전기능 DW-803,54500,54500,0
2018-06-01,1778591571,L021010,손목시계,[바보사랑][공식  백화점AS] ROSE ELVA-BLACK CLASSIC 여성시계(가죽)_ELST102-EL010114,248000,248000,0
2018-06-01,1122895318,E031080,선풍기,니코 히터/스탠드형/5방향/전도안전스위치 WH-2020,39500,39500,0
2018-06-01,1804823314,F011130,홍삼,세척인삼,13600,13600,0
2018-06-01,2146564339,C013050,운동복,[트레이닝세트] F-4XL상/하 츄리닝세트 빅사이즈여성,24800,23800,-1000
2018-06-01,176189388,E031130,보온매트,특허온수보일러 매트 거실용 LH-308 대형(온돌마루),240000,240000,0
2018-06-01,1778591575,L021010,손목시계,[바보사랑][공식  백화점AS] 타임 투 기브 여성시계(가죽)_W0023L7,218000,218000,0
2018-06-01,176189387,E031130,보온매트,특허온수보일러 매트 거실용 LH-308 중형(온돌마루),220000,220000,0
2018-06-01,1778591574,L021010,손목시계,[바보사랑][공식  백화점AS] OCEAN NEVIL 2.0- BROWN SEWN CLASSIC 2 남녀공용시계(가죽)_NEST113:2-SC010215,418000,418000,0
2018-06-01,1107648570,L012110,색조화장품,닥터지 브라이트닝 업 선/선크림/썬크림/겟잇뷰티1위,19800,19800,0
2018-06-01,1232823091,G022020,자동차타이어,넥센타이어 N7000 플러스 215/55R17 정품 무료배송,66000,55680,-10320
2018-06-01,1125155685,I031040,생화,그물해먹 풀세트 - 그물침대해먹 그물해먹,7000,6350,-650
2018-06-01,1747386273,C011030,남자학생복,구제마켓 빈폴남방 폴로니트 라코스테 닥스 버버리,18900,18900,0
2018-06-01,513496188,C013020,티셔츠,[빈폴아웃도어]그린 여성 브이넥 실켓 티셔츠 (BO8342C04M),49000,38710,-10290
2018-06-01,910814128,F012010,종이기저귀,공식#백조기저귀150~300p#신생아기저귀#산모패드#혼합,12000,11600,-400
2018-06-01,1403361742,C012060,여자내의,[미센스]미센스_ 베이직 솔리드 부츠컷 팬츠_M74SLM206Z,21600,18360,-3240
2018-06-01,1170171088,A022010,주스,랭거스 망고 넥타 주스 3.78L 망고주스 과일주스,11290,11290,0
2018-06-01,784848837,C014010,아동복,[M.K] 한국 해피 마린 유아정장 3종 블랙 (3-24개월) 202048,74390,66210,-8180
2018-06-01,1601207906,L012110,색조화장품,이노랩 멀티 프로텍션 썬 크림 SPF 50+/PA+++ 60g,41000,41000,0
2018-06-01,1039059269,E061020,섬유유연제,[샤프란]샤프란 아로마시트 30매X3개 or 30매X2개/뽑아쓰는 섬유유연제/간편시트/고농,8700,8700,0
2018-06-01,176189386,E031130,보온매트,특허온수보일러 매트 침실용 LH-307 더블(레자),222500,222500,0
2018-06-01,1122895320,E031080,선풍기,신일산업 히터/세라믹/국산/타이머기능/회전기능 SEH-S800CR,54500,54500,0
2018-06-01,176189385,E031130,보온매트,특허온수보일러 매트 침실용 LH-307 싱글(레자),216300,216300,0
2018-06-01,176189384,E031130,보온매트,특허온수보일러 매트 침실용 LH-307 더블(양면패드형),216300,216300,0
2018-06-01,176189383,E031130,보온매트,특허온수보일러 매트 침실용 LH-307 싱글(양면패드형),203900,203900,0
2018-06-01,1233516712,I012010,컴퓨터,한정할인가 74만원+가방) 삼성 노트북5 NT500R5Y-GD5A,999000,799000,-200000
2018-06-01,322163799,A011120,두부,포스트 그래놀라크랜베리아몬드 570gx2개+사은품랜덤,11900,11900,0
2018-06-01,1201324180,L021030,가방,딱하루30%쿠폰!!라탄백/텀블러백/pvc백/여성가방,9900,9900,0
2018-06-01,1313728338,C012060,여자내의,[올리비아로렌][올리비아로렌] 지퍼 장식 큐롯 팬츠 4VOCDSQM5136,16400,15580,-820
2018-06-01,621365961,I031040,생화,2개이상무배/LED헤드랜턴/캡라이트/줌/등산/낚시,6000,5430,-570
2018-06-01,1663500975,E011050,책상,굿 데스크 책상 컴퓨터 학생 일자 다용도 멀티 테이블,19900,19900,0
2018-06-01,828503274,C011050,남자내의,아로미 601 늦가을부터 초겨울까지 따뜻한 치마레깅스,10950,9750,-1200
2018-06-01,723399983,C013010,점퍼,[앤섬] 원버튼 테일러드 카라 자켓 MVBFURM3221,28400,26700,-1700
2018-06-01,1385740469,A011160,빵,안흥찐빵마을 우리팥 수제 단호박찐빵(500g 10입) 3봉,31910,31910,0
2018-06-01,222342339,C012040,여자학생복,KD 은혜 앙고라 Y 원피스,102170,102170,0
2018-06-01,1654548251,A013070,굴,[골드크랩]활 스노우크랩/러시아대게/대게 1kg,64900,64900,0
2018-06-01,532351351,C013010,점퍼,남자무스탕자켓브랜드 메리노롱헤어무스탕점퍼 빅사이즈무스탕 천연양털(90~120사이즈,1290000,1290000,0
2018-06-01,1119749457,C012060,여자내의,[꼼빠니아][꼼빠니아] 5부 치마바지 CA7U5-WPL190_450 (P000335279),35500,31950,-3550
2018-06-01,1969444970,A011110,당면,차오름 파래김 (200G) x70,457950,457950,0
2018-06-01,788775504,E011040,소파,젤코바 쿠션 대형/1인용/빈백/사각/원형/소파/쇼파,46400,46400,0
2018-06-01,769402774,E011030,거실장,앳홈 네이처 TV거실장,40900,40900,0
2018-06-01,1778591569,L021010,손목시계,[바보사랑][공식  백화점AS] Ivory Aska 여성시계(가죽)_AKST101-SS010113,278000,278000,0
2018-06-01,1660245807,C012040,여자학생복,중년여성여름조끼 엄마등산조끼 할머니여름조끼엄마옷,34000,34000,0
2018-06-01,176189392,E031130,보온매트,한일생명과학_50×140 극세사 전기방석,31100,31100,0
2018-06-01,686295190,A018110,물엿,[두레촌] 식품 명인 도라지 조청 세트 (4병) 쌀 생강 물엿 꿀,59900,59900,0
2018-06-01,176189391,E031130,보온매트,한일생명과학_140×200 편백매트,72900,72900,0
2018-06-01,1217843331,A017300,미역,대천김 재래김/파래김/돌김 10봉+10봉(총 20봉),22900,22900,0
2018-06-01,1313753348,C011050,남자내의,HD-1828 (공용)쿨밴딩린넨팬츠 남자면바지 빅사이즈청,28000,27720,-280
2018-06-01,329285648,E061050,청소용세제,욕실의여왕 곰팡이젤 99%제거120g/실리콘곰팡이제거제,9900,8900,-1000
2018-06-01,1778591598,L021010,손목시계,[바보사랑][공식  백화점AS] 크로커 글램 여성시계(메탈)_W0236L2,258000,258000,0
2018-06-01,1778591597,L021010,손목시계,[바보사랑][공식  백화점AS] 오버드라이브 여성시계(실리콘)_W0149L6,218000,218000,0
2018-06-01,883193587,A015010,참기름,오뚜기 옛날참기름 1.8L/참기름,18400,18400,0
2018-06-01,988154291,F012020,생리대,[유한킴벌리]유한킴벌리) 좋은느낌 좋은순면 울날소 18P,6200,6200,0
2018-06-01,293402463,A018040,아이스크림,돌핀 폴라레티 아이스바 400mlx70개 후르츠 트로피칼,12990,12990,0
2018-06-01,984431311,A018010,초콜릿,롯데 가나 3번들 (98G),2400,2200,-200
2018-06-01,1854980733,I031010,장난감,예꼬맘 꼬마 바이크/쿠터/붕붕카/유아/씽씽카/킥보드,47800,47800,0
2018-06-01,1240257588,C012030,여자상의,[여름신상]XL까지/정장원피스/하객룩/빅사이즈/오피스,19800,19800,0
2018-06-01,193005762,L021020,장신구,저렴처분/1.75캐럿 천연에메랄드/광택칼라굳,275000,275000,0
2018-06-01,1619120953,C013010,점퍼,마크 남녀 빅사이즈 바람막이 MK1031_1033 단체복 스포츠의류 바람막이 후드점퍼 빅사,79340,70620,-8720
2018-06-01,176189361,E031130,보온매트,특허온수보일러 매트 침실용 LH-307 더블(단면패드형),203900,203900,0
2018-06-01,176189360,E031130,보온매트,특허온수보일러 매트 침실용 LH-307 싱글(단면패드형),191600,191600,0
2018-06-01,984431315,A021010,커피,[동서]동서 카누 다크미니 (스위트)100T*2.9G,22100,22100,0
2018-06-01,245898786,L021030,가방,노트북 맥북 케이스 가방 파우치 13 15 15.6인치,12900,12900,0
2018-06-01,1320658768,E061060,살충제,벅스존피프로겔 230g 바퀴벌레 바퀴약 해충제 바퀴트,30560,30560,0
2018-06-01,1846599245,C012030,여자상의,옵션가No 홀복/니트/섹시/클럽/롱/미니/하객원피스,79000,79000,0
2018-06-01,1029509472,F011150,건강기능식품,[동화약품] 동화약품 부채표 까스활 75ml x 10병 소화제/까스명수,6900,6900,0
2018-06-01,1320531657,E011020,침대,프리미엄 패밀리침대 SS+SS 오픈형 프레임,288500,279850,-8650
2018-06-01,926261595,I012010,컴퓨터,i3 i5 전제품SSD 렌탈회수삼성엘지컴퓨터 DDR3메모리,274000,274000,0
2018-06-01,1264820112,C012060,여자내의,빅사이즈 DSS0024R 밴딩 니트 미디 스커트 801 빅사이,19600,19600,0
2018-06-01,517364466,G011070,자전거,알톤 접이식자전거 엑스티드20RS 20인치 7단 뒷쇼바,118800,106920,-11880
2018-06-01,1451560539,A021010,커피,프렌치카페 카페믹스 아이스 부드러운 블랙 110T 2개,19800,19800,0
2018-06-01,75302640,E031140,비데,이누스 방수비데 IS-27 (파워방수IPX6) 정품필터증정,199000,199000,0
2018-06-01,625664244,E061060,살충제,(컴배트 바퀴벌레약 12개입X3통)/개미약,18900,18900,0
2018-06-01,1089219420,I031040,생화,굿모닝무릎보호대,20790,18950,-1840
2018-06-01,26749654,I053010,공책,유무선 무지 노트 모음 A5 양장 드로잉 스프링 일기장,3000,2400,-600
2018-06-01,1180656559,C012040,여자학생복,[앤아이]소매프릴 플라워 쉬폰 롱 로브가디건-NA,35100,33350,-1750
2018-06-01,1435446218,C013040,청바지,DDO1567 이너밴 일자 데님 803 청색바지 큰사이즈청바,56210,56210,0
2018-06-01,988239760,A019150,김치,[종가집]종가집 돌산갓김치 250G,4980,4980,0
2018-06-01,911910222,I012010,컴퓨터,[E]B70EV-AR77S2/7세대/i7/8G/256G+1TB/키보드+마우스,1135200,1078440,-56760
2018-06-01,1905001229,L021030,가방,세인트스코트 뉴욕 버킷백 NGY7701 그레이,71100,60440,-10660
2018-06-01,691171021,I031040,생화,MS 코지 퀵 에어베개/easy퀵에어밸브 여행용베개 캠핑,9300,8280,-1020
2018-06-01,1597089720,F011130,홍삼,정관장정 홍삼쿨(2G*10입),8500,8500,0
2018-06-01,1805443749,C013050,운동복,트렁크 우산 걸이 모음전 다용도 수납 정리 보관,5550,5000,-550
2018-06-01,646606587,E011040,소파,인텍스 1인용쇼파 에어쇼파 쇼파베드 캠핑용품 이케아,26900,26900,0
2018-06-01,542432511,C014020,유아복,[뿌야뿌][뿌야뿌] 립나시롱블라우스 PC2TGST40N,12500,5630,-6870
2018-06-01,994532976,C012060,여자내의,[나이스크랍] 허리밴딩 하이웨스트 마스커트 a182psd005 [nc중계점],149000,89400,-59600
2018-06-01,176189359,E031130,보온매트,특허온수보일러 매트 침실용 LH-307 더블(쟈가드),185000,185000,0
2018-06-01,176189358,E031130,보온매트,특허온수보일러 매트 침실용 LH-307 싱글(쟈가드),175000,175000,0
2018-06-01,150363409,E031130,보온매트,[프리미엄]독일기술력 물세탁 전기요 UB90(1인용),299000,299000,0
2018-06-01,596429615,A011030,찹쌀,보리쌀 (1K) X10,55750,49620,-6130
2018-06-01,1198017131,A021010,커피,돌체구스토 캡슐 싱글오리진(유기농) / 단독 선판매,11900,11900,0
2018-06-01,176189357,E031130,보온매트,거영테크 2017년형 순면트라이앵글(커버분리형) 온수매트 더블 (KY-M1 동력),162000,162000,0
2018-06-01,176189356,E031130,보온매트,거영테크 2017년형 순면트라이앵글(커버분리형) 온수매트 더블 (KY-B1 무동력),149900,149900,0
2018-06-01,1405126116,C015030,넥타이,남자 남성 패션의 완성 고급 자동 수동 넥타이 40여종,2900,2900,0
2018-06-01,1480204387,E041050,냄비,고급 아인스 3중바닥 냄비/편수/양수/전골/곰솥/찜기,14000,12500,-1500
2018-06-01,176189355,E031130,보온매트,거영테크 2017년형 순면트라이앵글(커버분리형) 온수매트 더블투난방 (KY-B2 투난방),163200,163200,0
2018-06-01,1328602410,C013020,티셔츠,베이직 후드티 LLTT0033 여성티셔츠 후드티,23510,23040,-470
2018-06-01,330178132,E061060,살충제,최강력소독셀프겔 바퀴벌레약맥스포스겔 살충제개미약,10000,2900,-7100
2018-06-01,150363407,E031130,보온매트,[프리미엄]독일기술력 물세탁 전기요 UB96(2인용),220000,220000,0
2018-06-01,404456396,A016110,딸기,청솔 냉동가당딸기 1kg /냉동,4500,4500,0
2018-06-01,148252185,A018110,물엿,왕비천하늘 생강조청 600g/국내산/전통방식/울진/명인,19900,19900,0
2018-06-01,176189353,E031130,보온매트,거영테크 2017년형 순면트라이앵글(일체형) 온수매트 더블 (KY-M1 동력),147500,147500,0
2018-06-01,458309644,A016160,과일가공품,블루베리안주 (소울 350g) X6,130520,116170,-14350
2018-06-01,176189352,E031130,보온매트,거영테크 2017년형 순면트라이앵글(일체형) 온수매트 더블 (KY-B1 무동력),135400,135400,0
2018-06-01,314765223,C013040,청바지,크림 주니어 라인수술 청바지 청/블랙,36000,35500,-500
2018-06-01,1250523268,C012040,여자학생복,MJ_1221 카키 양털 조끼 남여공용조끼 남성털조끼 양,31320,31320,0
2018-06-01,451116828,C013010,점퍼,빅사이즈 바람막이 7095-7102 바람막이 여자바람막이,103540,103540,0
2018-06-01,533336137,L012090,기초화장품,허브 마스크팩 구매시 여행용 미니 화장품 샘플 증정,5500,5500,0
2018-06-01,63532351,A021010,커피,원두커피 500gx2=1kg 당일로스팅 사은품 증정,8900,8900,0
2018-06-01,1900902611,C012030,여자상의,[앙투] 여름신상 원피스44~110빅사이즈 루즈핏 쉬폰,19800,19800,0
2018-06-01,1710253638,E041050,냄비,친환경 키친아트냄비 세라믹냄비 전골 국솥 곰솥 편수 양수 칼라냄비 국냄비-단골세상,17500,17500,0
2018-06-01,451116822,A019010,고춧가루,C한식 고추가루 1kg2개 가루 고추가루 한식고추가루,32780,29510,-3270
2018-06-01,193186581,C013010,점퍼,바람막이 점퍼 자켓 남자 남성 등산 윈드브레이커,19800,19800,0
2018-06-01,607371925,E011020,침대,플랫베드/침대/슈퍼싱글침대/저상형침대/프레임/베드,79900,79900,0
2018-06-01,176189329,E031130,보온매트,거영테크 2017년형 순면트라이앵글(일체형) 온수매트 싱글 (KY-B1 무동력),126900,126900,0
2018-06-01,2023949253,C012020,원피스,[조이너스(JOINUS)] 썸머 쉬폰 베스트 + 이지핏 팬츠 2종,89900,76420,-13480
2018-06-01,1603893941,E031070,에어컨,신일 벽걸이선풍기 SIF-16WAA 가정용 사무실 선풍기,47000,44460,-2540
2018-06-01,1016308954,C013060,등산복,여름 남성 긴팔 반팔 냉감 등산티셔츠 등산티 등산복,8920,8920,0
2018-06-01,1876462825,C011030,남자학생복,남성 여름셔츠/린넨셔츠/헨리넥/차이나/스트라이프,22000,22000,0
2018-06-01,985321350,F012020,생리대,LG 바디피트 내몸에순한면대형 32P,12900,9900,-3000
2018-06-01,1010377506,A013160,맛살,한성 몬스터크랩 142G*2,4490,4490,0
2018-06-01,83699468,A011170,떡,떡국떡 500g 1kg쌀떡볶이 가래떡 떡 쌀떡국떡,1650,1650,0
2018-06-01,1063027873,A022050,탄산음료,음료수모음 칠성사이다 탄산음료 코카콜라 레쓰비맥콜,5800,5800,0
2018-06-01,1739816755,E031040,전기레인지,음료수냉장고/냉장쇼케이스/업소용냉장고/전국배송,285000,285000,0
2018-06-01,253172364,I031040,생화,일제 호주머니 나침반 NO.135 등산 낚시 캠핑,12900,12900,0
2018-06-01,2000446,I031040,생화,LK-300H 피티타임 LED 헤드랜턴 헤드라이트 헤드램프,6440,6440,0
2018-06-01,2079580803,C012040,여자학생복,nn22 사이드 절개 리본 조끼_4color 여성리본조끼 여,30990,30990,0
2018-06-01,693819501,C011030,남자학생복,여름신상 프린트 셔츠 남방 7부 반팔셔츠 솔리드 체크,14700,14700,0
2018-06-01,1214395199,C021040,실내화,[정품] 나이키 레볼루션 4 4E (AA7402-002),63000,63000,0
2018-06-01,834903458,A018020,사탕,마이쮸 대용량 328g 무료배송/포도사과/딸기복숭아,7900,7900,0
2018-06-01,1946593000,A018030,껌,롯데 자일리톨껌 5000리필+통+보너스 대용량벌크알파,7900,7900,0
2018-06-01,1153869553,C012040,여자학생복,[에이인]slim line feminine knit,21000,19950,-1050
2018-06-01,2016836698,C011050,남자내의,S~5XL 빅사이즈 반바지/7부/5부/트레이닝바지/밴딩,13900,13900,0
2018-06-01,1736875503,C012060,여자내의,[대구백화점 II관] [록시]키즈해피래쉬바텀(T721RK154),31200,27150,-4050
2018-06-01,266767640,E011070,식탁,아리아퍼니쳐 6인용식탁/식탁세트/테이블+벤치+의자,299000,269100,-29900
2018-06-01,1200627243,G011070,자전거,[삼천리자전거]G-CT 21/시마노 21단/700C/하이브리드,139000,125100,-13900
2018-06-01,2123162539,C012020,원피스,트랜디한체크롱자켓(N181MSF007)/ 나이스클랍,189500,155390,-34110
2018-06-01,176189330,E031130,보온매트,거영테크 2017년형 순면트라이앵글(커버분리형) 온수매트 싱글 (KY-M1 동력),153500,153500,0
2018-06-01,87488475,C012040,여자학생복,[테이트][테이트] 여성 언밸런스 라운드 니트 KA4S1WSP700240_E7U9,7000,6300,-700
2018-06-01,457202312,E041010,식기,[정품] 냉면기 2개 세트+젓가락2쌍/냉면기/탕기/볼/대접/공기/밥공기/그릇/국대접/냉면,8000,7270,-730
2018-06-01,959583791,A013130,오징어채,청정원 사브작 쫄깃 육포 바이트 오리지널 30G,3290,1990,-1300
2018-06-01,959583792,A013130,오징어채,청정원 사브작 쫄깃육포바이트 달콤과일 30G,2900,1990,-910
2018-06-01,1580478812,E011010,장롱,젠장롱/옷장/이불장/투서랍장/쪽장/전국배송,49800,49800,0
2018-06-01,1558151369,C012060,여자내의,[리스트]벨트링 포인트 쉬폰스커트TWWSKH60040,30000,25500,-4500
2018-06-01,1268175032,D031010,주택수선재료,[마이독스] 3M정품 방수 코팅스프레이/코팅제/방수페인트/방수제/베란다/욕실/보수/시,9000,8900,-100
2018-06-01,681248410,C012060,여자내의,허리가 편한 밴딩바지,17700,17700,0
2018-06-01,1536843289,C021040,실내화,I 아디다스/나이키 운동화신발/런닝화/슈퍼스타/남녀,63000,54180,-8820
2018-06-01,50147088,C011030,남자학생복,인터페이스제작 양면가디건 BORN TO ROSE 후드집업,29700,29700,0
2018-06-01,57626468,F012020,생리대,화이트 수퍼롱오버나이트 20매/바디피트/생리대,8900,8900,0
2018-06-01,1760999706,E011050,책상,가구뱅크/올뉴프리탑/중역의자/컴퓨터의자/,34000,34000,0
2018-06-01,1545552563,F011150,건강기능식품,숙취해소제 술술풀리고 2갑(10포),31900,31900,0
2018-06-01,950300736,L021030,가방,러브캣 (베이직45)숄더백(LHF2S500/LHF2S542),250600,200480,-50120
2018-06-01,1004489375,A014030,치즈,서울체다슬라이스치즈1800g(100매)/모짜렐라치즈 피자,22900,22900,0
2018-06-01,707844182,A021010,커피,[판매1위]팻30다이어트커피/대용량300g/체지방감.소,8000,7900,-100
2018-06-01,1838631538,A013170,생선통조림,라이트스탠다드 85gx5캔+리챔 120gx5캔/ 동원,12900,10970,-1930
2018-06-01,1235675222,A011040,보리쌀,제주산 햇콩/발아율최고/소립종 풍산품종 콩나물콩1kg,12900,12900,0
2018-06-01,1094382601,E011030,거실장,삼나무 와이드 이동식 거실테이블 사이드테이블,99000,99000,0
2018-06-01,858019087,E061010,세탁세제,엘지생활건강 테크 수퍼타이 표백플러스 리필 10kg,12900,12900,0
2018-06-01,2046003557,A013060,게,진미채 900g 오징어채 밑반찬 대용량 안주 건어물 /(,43000,37840,-5160
2018-06-01,550498735,C012040,여자학생복,여성 니트 원피스 KKS 등리본 OPS,55840,55840,0
2018-06-01,412704999,A018100,꿀,한봉 토종꿀 병꿀2.4kg/지리산 뱀사골 전통 토종 벌꿀,42000,39800,-2200
2018-06-01,1740276375,C011030,남자학생복,꾸제꾸제/OLZEN 집업 니트 가디건/size XL/면혼방/골프/스웨터/자켓/세일/빈티지/중고,17900,17900,0
2018-06-01,1893987298,I031010,장난감,Step2 이인용 밴 장난감 운전놀이 지붕카 자동차완구,273010,273010,0
2018-06-01,1264820172,C012060,여자내의,빅사이즈 DSS0024R 밴딩 니트 미디 스커트 801 빅사이,19320,19320,0
2018-06-01,1098646576,F012030,안경,빅사이즈 안경테 남자 여자 동글이 메탈 금테 하금테,24900,24900,0
2018-06-01,468547692,C013010,점퍼,MJK001 마자켓 린넨 리넨 7부자켓 남 남성여름자켓,25800,24800,-1000
2018-06-01,1134327645,C021040,실내화,나이키 운동화 브랜드슈즈 모음 특가전,77700,77700,0
2018-06-01,439577778,A013170,생선통조림,유동뚝배기번데기탕구수한맛 280gX24개번데기탕 유동,68900,58570,-10330
2018-06-01,1544016497,C021040,실내화,나이키/아디다스 2018인기상품 모음전,29800,29800,0
2018-06-01,1840162276,E021020,커튼,[예쁜모기장 다모였다!] 커튼레이스 캐노피모기장,39800,37800,-2000
2018-06-01,2116207271,I031040,생화,제플린2루어대 쭈꾸미 오징어 문어 국민루어낚시대,39000,37050,-1950
2018-06-01,501124686,C012060,여자내의,빅사이즈/제이스타일 큐레티 레이스 밴딩 스커트/ 제이스타일,26300,20260,-6040
2018-06-01,467940302,I053010,공책,묶음상품 플라스틱링(45mm)백색 50개입x3개 책제본링,71460,71460,0
2018-06-01,927488430,A022010,주스,아메리카노 190mlx10개/커피/탄산/편의점/쥬스,5400,5400,0
2018-06-01,451234066,C013030,스웨터,ATS-024 (겨울-골프웨어) 반집업 목폴라 니트 (95-105,42830,42830,0
2018-06-01,1617211385,C013010,점퍼,빅사이즈 아웃도어 패딩점퍼 JK530 빅사이즈패딩 점퍼 남자패딩 패딩점퍼 패딩점퍼 패,78280,69670,-8610
2018-06-01,954879753,A019110,드레싱,풀무원 골드파인애플&키위 저지방 드레싱 235G,3980,3980,0
2018-06-01,1597016765,A018100,꿀,토종밤꿀/지리산/벌꿀/토종/천연/벌집/꿀벌/국내산꿀/,66000,66000,0
2018-06-01,954879754,A019110,드레싱,[풀무원]크리미 시저 드레싱 (220g),4480,4480,0
2018-06-01,1269523175,C012040,여자학생복,체크 패턴 술 장식 숄 가디건 (SD3KTF559)/ 시에로,137400,116790,-20610
2018-06-01,954879755,A019110,드레싱,풀무원 오리엔탈 드레싱 240G,3980,3980,0
2018-06-01,954879756,A019110,드레싱,풀무원 참깨흑임자 드레싱 220G,3680,3680,0
2018-06-01,1592771328,C021040,실내화,op0028 여성키높이운동화11~12cm/hill up sneakers,59000,59000,0
2018-06-01,2091449638,A011170,떡,금성 떡국 쌀떡 떡국떡 3kg,10500,10500,0
2018-06-01,1315539601,L021020,장신구,게르마늄 은팔찌 커플 남자 여자 건강 팔찌,108000,108000,0
2018-06-01,2091449639,A011170,떡,금성 떡국 쌀떡 떡국떡 1.4kg,6740,6740,0
2018-06-01,657709528,C012060,여자내의,[난닝구]페더 밴딩배기팬츠/ 난닝구,26900,26100,-800
2018-06-01,1021973003,C012040,여자학생복,[ab.f.z][17 S/S인하] 심플 미니 가디건AFR3GY05F[갤러리아],20000,16000,-4000
2018-06-01,953493018,A011010,쌀,엄마밥줘 하이아미 쌀눈쌀10kg(5kgx2)/당일도정,38900,38900,0
2018-06-01,542432573,C014020,유아복,[뿌야뿌][뿌야뿌] 스카시니트가디건 PC2TGCD21N,19500,8780,-10720
2018-06-01,542432575,C014020,유아복,[뿌야뿌][뿌야뿌] 와이드멜빵팬츠 PC2TUJK20N,19500,8780,-10720
2018-06-01,480328770,C013040,청바지,[지이크](PQ-PAD2300) 봄/여름 이태리 수입원단 다크네이비 블루 프리미엄 정장팬츠 2,50000,43500,-6500
2018-06-01,304747941,L021030,가방,파디오 남성가죽가방 서류가방 브리프케이스 무료배송,153400,153400,0
2018-06-01,1208081458,A012030,돼지고기,플라이미트 스페인 아비뇨 돼지고기 골라담기,4000,4000,0
2018-06-01,176189415,E031130,보온매트,거영테크 2017년형 순면트라이앵글(일체형) 온수매트 싱글 (KY-M1 동력),139000,139000,0
2018-06-01,323364059,C011050,남자내의,여성 네이비 레터링 밴드 트레이닝 팬츠 (158221WA1R)/ 에잇세컨즈,39900,35520,-4380
2018-06-01,1597907482,C012060,여자내의,푸조 여성 워테레깅스(S26-2),28540,26260,-2280
2018-06-01,425724406,E011050,책상,[유니크가구]40T특가 !!와이드 좌식책상 / 컴퓨터책상,18900,17050,-1850
2018-06-01,194032171,C012020,원피스,[로엠][로엠] 페미닌 버튼배색 트렌치 코트 RMJH423101,9900,9410,-490
2018-06-01,988154321,F012020,생리대,[유한킴벌리]좋은느낌좋은순면 슬림대형32P,13000,13000,0
2018-06-01,676341273,C013010,점퍼,무료배송/백화점용/봄 여름신상품/반안감망사/국내생,39800,39800,0
2018-06-01,200135143,I031070,애완동물관리비,프로케넥스 테니스라켓 KIQ30 119(260g)16x19-입고예,240000,208160,-31840
2018-06-01,297029679,C013040,청바지,[나나진]스키니/여자청바지/슬림/데님/헤짐/롤업,9900,9900,0
2018-06-01,1775011916,F011130,홍삼,정관장 홍삼젤리,15000,15000,0
2018-06-01,1692921257,C013020,티셔츠,긴팔티셔츠/티셔츠/남자티셔츠/오버핏/슬림핏/남자,16800,16800,0
2018-06-01,632838102,C011030,남자학생복,2온스 빅사이즈 후드패딩밀리조끼 빅사이즈,101660,98620,-3040
2018-06-01,228045747,L021020,장신구,우하나 너를사랑한시간 14K 정품 Gold 슬림큐빅스틱,193440,193440,0
2018-06-01,735659057,A011120,두부,포스트 콘푸라이트벌크백 1.1kgx2개+잡곡용기1200ml,15900,15900,0
2018-06-01,1314983921,E011050,책상,아망떼 독서실책상 학생 1인용 공부 책상/스탠드별매,79000,71100,-7900
2018-06-01,1313812145,C012060,여자내의,SK1662-레이첼 프릴 스커트 FREE(44~66) 프릴치마 롱,38690,38690,0
2018-06-01,988154318,F012020,생리대,[유한킴벌리]좋은느낌좋은순면 울날대32P,12600,7500,-5100
2018-06-01,2094714200,C014010,아동복,[휠라키즈]2018년반팔티FK2RSA2666X,29000,29000,0
2018-06-01,200620882,E031110,청소기,[[고객만족~판매1위]]신일/동일~업소/매장/사무실용~진공청소기/SVC-8787CM/TKVC-401A,127400,127400,0
2018-06-01,1495189960,C013010,점퍼,빅사이즈 DSM1044 빅 포인트 울 자켓 801 빅사이즈울,88340,88340,0
2018-06-01,1232801784,C012040,여자학생복,[KOOGI]소매리본디테일블라우스_KL1BL1249A,14800,13720,-1080
2018-06-01,1240811447,C014010,아동복,[래핑차일드] 스포티 윈드브레이커 (88329-110-03),19000,15580,-3420
2018-06-01,1192571369,E061060,살충제,고양이 스크래쳐 기피제/유해야생동물(두더지 청설모 멧토끼) 차단제 500ml,19900,19900,0
2018-06-01,1181504768,A021010,커피,수프리모 200T/신선한모카/맥심/네스카페/카누/원두,18900,18900,0
2018-06-01,612396395,L012090,기초화장품,[아이오페] 아이오페 스킨 모이스트젠 스킨소프너 150ml,15500,15500,0
2018-06-01,415222539,C015020,모자,스냅백 모자 볼캡 블로우B모자 볼캡 스냅백 패션모자,14450,14170,-280
2018-06-01,449644498,F012050,의료측정기,omk 카스 비접촉식 피부적외선 체온계 HB500,65000,55800,-9200
2018-06-01,624316508,E061060,살충제,레인보우에어 휘산기액 - 레인보우 솔루션 180ml (Han,56600,48110,-8490
2018-06-01,1476103451,C011030,남자학생복,[올젠] 시원시원 캐주얼 체크 셔츠 6종 택1,30000,24000,-6000
2018-06-01,1207776667,A017200,토마토,말린가지 1Kg,14090,14090,0
2018-06-01,155898361,F012010,종이기저귀,보솜이 소프트 슬림팬티 / 남녀 선택/ 입히는 기저귀,30500,30500,0
2018-06-01,717830722,I031040,생화,(여행/캠핑~히트상품)PAVONI~자동차/캠핑/레져~에어매트/차량/물놀이/사무실/야외~멀티,100000,99000,-1000
2018-06-01,811762916,E061050,청소용세제,유한락스 2Lx2개/500mlx7개 살균 소독 세정제 곰팡이,10000,9900,-100
2018-06-01,1977459538,C013020,티셔츠,레이스튜브탑/탱크탑나시/섹시나시/오프숄더티/나시티,7900,7900,0
2018-06-01,1681016350,C011050,남자내의,여름신상 카고바지 남자 남성 건빵 작업복 밀리터리,25800,25800,0
2018-06-01,953987109,L012010,면도기,도루코 휴대용 PACE 면도기 4입,5400,4390,-1010
2018-06-01,1547501768,C012060,여자내의,빅3XL 특가 점프수트 멜빵반바지,18900,18900,0
2018-06-01,450281653,C011030,남자학생복,비치웨어레쉬가드워터레깅스(남),26950,26950,0
2018-06-01,1151343919,C013010,점퍼,바람막이 야상 WS JM29 바람막이 남자점퍼 남자야상,80310,77910,-2400
2018-06-01,1790218211,E041060,수저,천연 고급 옻칠 대추나무 수저 세트 조리도구 스푼,1700,1700,0
2018-06-01,2007845784,E011050,책상,유로테이블/책상/탁자/식탁/작업대/포밍테이블/의자,62900,62900,0
2018-06-01,906237216,E011040,소파,레이디가구 천연 가죽 면피 바니 스팅 소파,589000,589000,0
2018-06-01,954880783,A019040,소금,[청정원]청정원 허브맛 솔트 50G(매운맛),2890,2890,0
2018-06-01,1875148401,E061020,섬유유연제,다우니아로마플로럴대용량섬유유연제8.5L/스너글 퍼퓸,17900,17900,0
2018-06-01,954880782,A019040,소금,[청정원]청정원 허브맛 솔트 50G (순한맛),2950,2950,0
2018-06-01,711370901,A013070,굴,[생물]랍스타(1.5kg~)(당일상품)(노량진수산시장)특송,28000,28000,0
2018-06-01,749200927,A011140,부침가루,[삼립] 삼립 고구마무스 조각케익 (90g 5입) 케이크,13000,12870,-130
2018-06-01,1010377473,A019180,즉석식품,[CJ직배송] 고메함박스테이크540G + 고메치즈함박465G X2개,23940,18900,-5040
2018-06-01,987976445,C015040,장갑,니트릴 다용도 장갑 (소) 40매,4990,4990,0
2018-06-01,987976444,C015040,장갑,초이스L) 니트릴 다용도 장갑 (중) 40매,4990,4990,0
2018-06-01,424161866,A011140,부침가루,삼립 / 조각케익 / 치즈케익 / 초코무스 /6가지중택,1750,1750,0
2018-06-01,1524729455,A018060,스낵과자,더한줌/옛날과자/주전부리/스낵/쿠키/어포/간식/안주,3000,2700,-300
2018-06-01,1621625274,E031130,보온매트,TV홈쇼핑정품!!전기매트/면매트(퀸사이즈)카페트매트/,168000,166320,-1680
2018-06-01,874031305,F012050,의료측정기,녹십자 CF155F 혈압계 가정용 혈압측정기 사은품증정,53970,45000,-8970
2018-06-01,1298184804,A018100,꿀,우성농산 잡화/아카시아 벌꿀 600g+600g/동서/국산,13900,13900,0
2018-06-01,1367689019,C011030,남자학생복,여름신상 체크남방셔츠/반팔/7부/오버핏/남자남성,6900,6900,0
2018-06-01,1300285229,E011010,장롱,가구스토리/고품격/10자~13자/최저가/옷장/장농/장롱,439000,439000,0
2018-06-01,2072159275,C013030,스웨터,민자 목폴라 니트 MRO 남성용목티 니트목폴라 남성용,49040,49040,0
2018-06-01,1963680163,C014020,유아복,지그재그 기모레깅스 겨울아동복 아동겨울옷 유아동복,7700,7470,-230
2018-06-01,232484559,A022050,탄산음료,나랑드사이다 245ml x 30캔 (대용량)/zero칼로리,10530,9900,-630
2018-06-01,553329571,C012020,원피스,새로본 820번봄정장/여름정장/면접/결혼식/유니폼,49800,49800,0
2018-06-01,443422008,E031070,에어컨,유니맥스 16형 벽걸이선풍기/3엽날개/UMF-N501W,18500,18500,0
2018-06-01,2052995509,C011030,남자학생복,2018 쿨맥스 여름탈출 반소매 일반핏&슬림핏 30종 모음전/ 예작(셔츠),30000,27000,-3000
2018-06-01,1972286385,C012030,여자상의,[공구우먼] 샤이 린넨 뷔스티에 원피스 29460 빅사이즈여성의류,29000,29000,0
2018-06-01,503608476,L021010,손목시계,BELCARINO 정장시계 트렌디한 손목시계MV202013MF 선,71950,71950,0
2018-06-01,1356128277,C013010,점퍼,(SR)TAL1984 남자빅사이즈후드롱야상점퍼 / 참고 빅사,129500,110080,-19420
2018-06-01,959558867,E061030,전구,오스람 LED7W 주광색 1입,15900,9900,-6000
2018-06-01,1557930397,E021020,커튼,[비드붐]비즈발 창문발 비즈커튼 비즈커텐 비즈장식,34000,34000,0
2018-06-01,820118656,C011050,남자내의,(805/레이스자수꽃)밑단레이스 스프사 8부파자마,11700,10420,-1280
2018-06-01,898229838,A019080,고추장,청정원 직화볶음고추장(60G*3),6980,6980,0
2018-06-01,2095889469,F012020,생리대,[위스퍼]생리대 보송보송 오버나이트 슈퍼롱10Px3,13500,13500,0
2018-06-01,451141809,A019100,식초,오뚜기 토마토케찹800g2개 케찹 케？R 토마토케찹 오뚜,14570,13120,-1450
2018-06-01,1522644871,F012050,의료측정기,오므론 프리미엄 안심커프 혈압계 HEM-7310+수첩,200000,186000,-14000
2018-06-01,724353420,C012060,여자내의,[에이비에프지]허리밴딩통바지[AFR3GP03E],27000,22950,-4050
2018-06-01,1626125795,A018050,비스킷,누네띠네 12gx100개 3종 19. 5. 6.까지 / 제리뽀 약,10900,10900,0
2018-06-01,1593327051,C012060,여자내의,리스트[LIST] TWWSKH10080 리본 디테일 슬릿 스커트,30000,24600,-5400
2018-06-01,300625522,C012060,여자내의,[모다아울렛][지컷]치마바지 7217330001,95400,90630,-4770
2018-06-01,1889120349,A022040,기능성음료,포카리스웨트 340mlx20펫 이온음료/게토레이/음료수,10900,10900,0
2018-06-01,1461188549,A021020,차,매일 휘핑크림 1L /동물성/냉장,8900,8900,0
2018-06-01,235460111,C013050,운동복,모비스 크루저 루프백 차량용루프백 자동차루프백 캠,266580,242810,-23770
2018-06-01,794010241,F011150,건강기능식품,[CJ제일제당] H.O.P.E 발효효소(90g)(3gx30포),15500,15500,0
2018-06-01,451210068,C013020,티셔츠,남자후드집업 무지 후드집업 AJ0217001,20330,20330,0
2018-06-01,503790194,C012040,여자학생복,[슈가펀]모아카라린넨블라우스,21480,20630,-850
2018-06-01,1828826243,A013170,생선통조림,유동 번데기캔 (구수한맛 280g) x24,47920,47920,0
2018-06-01,392936891,C013050,운동복,차량용 와인 멀티 콘솔박스 팔걸이정리박스 팔걸이수,33100,30150,-2950
2018-06-01,1010135307,L012070,바디워시,오가니스트유칼립투스월넛워시500G,6990,3490,-3500
2018-06-01,688226652,A021010,커피,캡슐홀더 고정(40) 회전형(28)/캡슐커피/치보 에카페,27000,27000,0
2018-06-01,1010135306,L012070,바디워시,오가니스트마카다미아베리워시500G,6990,3490,-3500
2018-06-01,1180656466,C012040,여자학생복,[앤아이]소매프릴 플라워 쉬폰 롱 로브가디건-BK,35100,33350,-1750
2018-06-01,1579377556,A013060,게,국내산 마른 오징어 1.1~1.3kg/20마리1축,48500,48500,0
2018-06-01,619435944,A017230,마늘,수확시작한 자색양파 3Kg/ 5Kg 특품 햇양파,6900,6900,0
2018-06-01,1269731893,C012060,여자내의,jj41 니트 미디스커트_네이비 니트치마 여성패션스커,13020,13020,0
2018-06-01,1010135305,E061040,부엌용세제,[애경]애경)트리오홍초용기3L,9900,3990,-5910
2018-06-01,588448472,E011070,식탁,4인용 식탁세트 / 다용도 카페 테이블세트,339000,309000,-30000
2018-06-01,1284849571,A019140,이유식,엘빈즈 클래식 이유식 진밥3단계(만 10~13개월)/ 엘빈즈,3380,3080,-300
2018-06-01,789802269,E011040,소파,[10%추가할인]비즈니스보루네오 3인소파,139500,139500,0
2018-06-01,1477984858,C014020,유아복,[키키제제]유아 상하복/여아/원피스/트레이닝 세트,10900,10900,0
2018-06-01,1683653363,C012060,여자내의,[피그먼트] a메이 플라워 주름스커트,26000,22620,-3380
2018-06-01,63446020,C013020,티셔츠,균일가 4 500원! TBJ/NBA 반팔티/팬츠외 썸머세일~95%,4500,4500,0
2018-06-01,1323923363,C013050,운동복,[아스토레] (SIZE : 085) 본딩 히트자켓(ABL) - 우븐+,110640,110640,0
2018-06-01,2030245320,F012010,종이기저귀,[VIP 5%쿠폰]팸퍼스 베이비드라이 소형팩 기저귀 1팩,21900,21900,0
2018-06-01,229025701,L012090,기초화장품,[뉴트로지나] 뉴트로지나 딥 클린 클렌징 크림 285ml,6100,6100,0
2018-06-01,1753629599,E011030,거실장,[채움가구] 모노 4자 2단 거실장,92900,92900,0
2018-06-01,2022972815,A019010,고춧가루,김치용 고춧가루 (진성 1k),41150,36630,-4520
2018-06-01,1090705453,A019170,냉동식품,[동원] 개성왕만두1.82kg 2봉 골라담기 /왕만두/김치/감자 (지퍼백),21400,21400,0
2018-06-01,1753629597,E011030,거실장,[채움가구] 모노 2단 협탁,64900,64900,0
2018-06-01,100237137,L012010,면도기,고급일회용면도기/두날면도기/1회용면도기 /대량700개,64900,64900,0
2018-06-01,618337106,C013060,등산복,[몽벨]역시즌한정]고기능성 japan직수입 구스다운 팬츠 EX [폴라다운빕][MB3MP16W021],144550,144550,0
2018-06-01,2021573103,L021010,손목시계,P0000HON_G504 가죽밴드(블루22mm) 시계줄 가죽 밴드,11900,11900,0
2018-06-01,1753629593,E011030,거실장,[채움가구] 모노 3단 협탁,82900,82900,0
2018-06-01,1248654264,C011020,남자상의,(색상 : 카키 | 사이즈 : L) WMJ-009 지퍼,88300,88300,0
2018-06-01,1805465072,L021020,장신구,[바보사랑]베르드레 큐빅 반지,14000,14000,0
2018-06-01,1303141038,C011030,남자학생복,빅사이즈 바투스 청남방 BW청남방데님남방청카바청셔,70900,70900,0
2018-06-01,1805465071,L021020,장신구,[바보사랑]유토르 목걸이,9000,9000,0
2018-06-01,2075729978,C013010,점퍼,AGC빅사이즈 야상 딜러자켓 BW 야상바람막이점퍼남자,113190,113190,0
2018-06-01,1805465070,L021020,장신구,[바보사랑]에스포 반지,8000,8000,0
2018-06-01,1165613154,C012020,원피스,[톰보이]트윌 오버사이즈 트렌치 코트 (9108111998),199000,155220,-43780
2018-06-01,1090573257,E031080,선풍기,홍진테크 히터/할로겐/3단 NSB-1200,24000,24000,0
2018-06-01,1853776800,D031010,주택수선재료,에나멜 3.78L 광택/유광/반광/무광/조색/센스멜골드,25000,24500,-500
2018-06-01,857970360,C013040,청바지,롤업청팬츠8032(DO_1609) 빅사이즈 빅사이즈롤업팬츠,49240,49240,0
2018-06-01,1090573259,E031080,선풍기,니코 팬히터/온풍기 WS-301FH,17500,17500,0
2018-06-01,1090573258,E031080,선풍기,홍진테크 벽걸이히터/할로겐 SF-1600H,33500,33500,0
2018-06-01,1509006330,A017040,양배추,(맛나)#시금치(국산.단),8100,7290,-810
2018-06-01,1600685559,A022010,주스,[황토농원]HACCP인증 데이앤깔라만시 1L 3팩,13900,13280,-620
2018-06-01,652374420,I031010,장난감,(Step2)이인용밴 (2016.4.1 소비자가인상) 지붕차 자,229380,229380,0
2018-06-01,1092181955,E061020,섬유유연제,F C 베이비전용 세탁세제 refill 세정제 유아세정제,23320,23320,0
2018-06-01,988927959,E061020,섬유유연제,샤프란꽃담초자스민꽃용기1.3L_2P,12900,11000,-1900
2018-06-01,266491758,L021020,장신구,[폭스타일] 세라핀 반지,16000,14560,-1440
2018-06-01,1337276749,C011020,남자상의,코트 스튜디오 더블롱코트 R2롱코트코트남자롱코트남,149680,149680,0
2018-06-01,2083174724,C013010,점퍼,스테판조셉 프린티드 레인코트 트럭B (택1) /(참고)어,86800,76390,-10410
2018-06-01,968532965,E011050,책상,리더스 자몽 U형 800/1200/1500/1800 책상/컴퓨터책상,64900,64900,0
2018-06-01,1805465064,L021020,장신구,[바보사랑]세라핀 반지,16000,16000,0
2018-06-01,1805465063,L021020,장신구,[바보사랑]워나유 롱 목걸이,15000,15000,0
2018-06-01,1314800635,E041050,냄비,[네오셰프] 내열 전골뚝배기(도자기뚜껑)중,21900,21900,0
2018-06-01,243646462,F012010,종이기저귀,유럽 친환경 리베로 기저귀 팬티형/밴드형 2팩,36600,36600,0
2018-06-01,1357621175,A021010,커피,동서식품 맥심 아이스블랙커피믹스 220T(110T+100T),22230,20900,-1330
2018-06-01,1805465067,L021020,장신구,[바보사랑][10K 골드] 미니 돌핀 귀걸이,26000,26000,0
2018-06-01,294076456,C012040,여자학생복,[로로텐]후드 빅로브 가디건,27600,26510,-1090
2018-06-01,1805465066,L021020,장신구,[바보사랑]네스트 태슬 목걸이,11000,11000,0
2018-06-01,1065723635,F011130,홍삼,GNM자연의품격 진일품 6년근 홍삼정스틱 패밀리 8박스 (240포),183000,183000,0
2018-06-01,1805465065,L021020,장신구,[바보사랑]레디플 초커 목걸이,11000,11000,0
2018-06-01,950033272,D031010,주택수선재료,[켈리무어 페인트]아크쉴드 외부용페인트1QT(약1리터),24000,23280,-720
2018-06-01,79351501,C012020,원피스,[드넬]세인드체크코트DJ81730A,36900,35060,-1840
2018-06-01,1533493405,C013010,점퍼,[헨어스]유니_네오플랜 후드탈부착 야구점퍼 HTC900,49000,43120,-5880
2018-06-01,955798376,F012020,생리대,바디피트유기농순면소형20P,8200,4990,-3210
2018-06-01,1692010089,F012020,생리대,릴리안 초흡수 무향 대형 14P x 10팩 (총140p),27500,27500,0
2018-06-01,1264141614,C012040,여자학생복,브이베이직니트조끼 RMW12012 브이넥조끼 캐쥬얼니트,37050,37050,0
2018-06-01,2000922826,C011050,남자내의,간절기 봄 남자/여자/남성/여성/바지/팬츠/밴딩팬츠,5800,5800,0
2018-06-01,1090573231,E031080,선풍기,신일산업 온풍기/팬히터 SEH-P580,161500,161500,0
2018-06-01,1343241585,A013010,갈치,제주 옥돔(대) 2kg(마리당250g내외 선물포장) 탐라,162930,162930,0
2018-06-01,1897681584,E031030,전자레인지,초특가/ 이노소닉 전자레인지 MW3100WH 20L/철저한 AS,48160,42900,-5260
2018-06-01,1769446085,C012060,여자내의,잇걸 멜빵청롱스커트 SD-9106 청치마 롱스커트 청스커,62790,47100,-15690
2018-06-01,1090573235,E031080,선풍기,홍진테크 온풍기/히터/2단온조조절/회전기능 SFR-201F,68500,68500,0
2018-06-01,274748830,C012020,원피스,원피스/롱스커트/여성정장/치마/캐주얼정장/오피스걸,12800,12800,0
2018-06-01,155908193,I031010,장난감,굿베이비 전동오토바이(21352),176000,176000,0
2018-06-01,2046948090,C012060,여자내의,[모조에스핀]하이웨스트 스커트_S174MSD023(DB1),89000,84550,-4450
2018-06-01,1996593720,A013170,생선통조림,동원참치85gx16캔+증정(리챔or양반김),19990,19990,0
2018-06-01,759327587,A016110,딸기,23311307/ 냉동가당딸기(1kgX15개)-청솔,92660,92660,0
2018-06-01,1890546688,C013060,등산복,[빈폴아웃도어]스카이 블루 여성 BREEZE 롱 MA-1 재킷 (BO8339C02Q),111300,87930,-23370
2018-06-01,1533530800,C014010,아동복,자수탑쉬폰벌룬ops/여아원피스/결혼/생일/파티/행사복,19500,19500,0
2018-06-01,688491107,C012020,원피스,[조이너스(JOINUS)] 뱀부 쿨스킨 스판팬츠 4종,49900,42420,-7480
2018-06-01,387360540,I031070,애완동물관리비,큐왁스/당구쵸크/당구재료/당구용품/당구장갑/당구공,9800,8680,-1120
2018-06-01,447001364,C012040,여자학생복,[레코브]카라자수 블라우스 (LU3186BL548X)(하남점),31800,26220,-5580
2018-06-01,86844145,A022010,주스,내사랑 드링크 오렌지/포도/사과 (185mlX24팩)/팩음료,7900,7900,0
2018-06-01,86844146,A022010,주스,내사랑 드링크 185mlX24팩 오렌지 사과 포도 팩주스,8900,8900,0
2018-06-01,907732779,L021030,가방,보정 거들 복부압박 겸용,19500,19500,0
2018-06-01,427940858,A019180,즉석식품,동그랑땡1+1/반찬/해물땡/산적/떡갈비/부침/전/돈까스,7600,7600,0
2018-06-01,833663016,A022010,주스,해태)포도봉봉(238mlX12캔)M805007 생활용품 문구 사,12970,12970,0
2018-06-01,386489966,E021020,커튼,베이직커튼봉 3단 25mm 길이조절300cm,25040,25040,0
2018-06-01,904369857,E011050,책상,*완제품* 900서랍좌식 /컴퓨터책상/입식/좌식/,28900,27900,-1000
2018-06-01,1247306574,C012040,여자학생복,베이직포켓베스트 EBW09311,39020,34730,-4290
2018-06-01,2046948082,C012060,여자내의,[모조에스핀]벨트포인트 하이웨스트 스커트_S174MSD019(BK5),89000,84550,-4450
2018-06-01,2046948081,C012060,여자내의,[모조에스핀]벨트포인트 하이웨스트 스커트_S174MSD019(BK1),89000,84550,-4450
2018-06-01,130572854,C013010,점퍼,[대구백화점 II관] [레코브](기존가:69 800원)클로징 파스텔점퍼(LU2177JK805X),34900,32110,-2790
2018-06-01,451439131,C013050,운동복,우먼스 ZNE 플러스 후드 2 집업자켓 여성집업자켓 후,156420,156420,0
2018-06-01,2126487080,C013010,점퍼,빅사이즈 카치온 자켓 MC 1500 빅자켓 빅사이즈등산자,86580,86580,0
2018-06-01,1029595459,C013020,티셔츠,단가라티 긴팔티/스트라이프/남자티셔츠/티셔츠/티,7900,7900,0
2018-06-01,533831156,C021040,실내화,신상 남녀 운동화/커플/스니커즈/키높이/어글리슈즈,14800,14800,0
2018-06-01,2037840915,C013040,청바지,[PLAC Jeans]플랙 Leo 69C 쿨링원단3종 반바지 [PJOE2EO69C1],23780,23780,0
2018-06-01,1619976929,C011050,남자내의,여름 M-5XL까지/7부바지/반바지/5부팬츠/밴딩팬,13900,13900,0
2018-06-01,1991540802,A011130,시리얼,백설 부침가루 1kgx10개,31470,28010,-3460
2018-06-01,1426083608,C013020,티셔츠,(4926상)랩스타일 산전산후 수유가능한 면스판 임부상,18570,18570,0
2018-06-01,1778566518,L021010,손목시계,[바보사랑]JA-981 메탈시계,42840,42840,0
2018-06-01,1987829741,A018090,잼,트라피스트 수녀원 유기 포도 잼 410g 식빵쨈 빵잼 과,18460,18460,0
2018-06-01,2112252651,A011040,보리쌀,수입산 완두콩1kg 강낭콩 작두콩 매화콩 렌틸콩 잡곡,1900,1900,0
2018-06-01,828517910,A019140,이유식,[바른맘]//특가/청정강원도 이유식8/10병세트 /유리병,23900,23900,0
2018-06-01,941321822,E021020,커튼,그레이스 나비주름 속커튼 이너커튼 속지,15000,13710,-1290
2018-06-01,1805465039,L021020,장신구,[바보사랑]탄생화 그리고 탄생석 목걸이,10500,10500,0
2018-06-01,57374451,E011020,침대,동서가구 피톤치드 원목 수납헤드 SS/Q 편백침대,224100,224100,0
2018-06-01,1805465038,L021020,장신구,[바보사랑]이즈 러브 반지,8000,8000,0
2018-06-01,1805465036,L021020,장신구,[바보사랑]블링 하트 반지,8000,8000,0
2018-06-01,1805465035,L021020,장신구,[바보사랑][10K] 헬레나 미니 귀걸이,30000,30000,0
2018-06-01,1805465034,L021020,장신구,[바보사랑][N+E] [실버] 레타 진주 세트,53000,53000,0
2018-06-01,532351289,C013010,점퍼,STYLEENTER 핸드메이드 메리노베이비 무스탕자켓 남성무스탕 남자무스탕점퍼(주문제작,960000,960000,0
2018-06-01,1466602638,C012040,여자학생복,엄마옷 마담4060 단추쉬폰카라조끼-XVE805003-,43900,36440,-7460
2018-06-01,2141173010,E061020,섬유유연제,무료증정 한정 이벤트! 컨센서스 섬유유연제/세탁세제,15900,15900,0
2018-06-01,895847369,A017090,열무,뻥튀기무말랭이 300gx4 무말랭이차 뻥튀기무말랭이차,37000,37000,0
2018-06-01,1689621775,E011020,침대,[동서가구/착불]LV 레몬 수퍼싱글 수납침대 프레임 외,129000,129000,0
2018-06-01,656991896,C011030,남자학생복,[지오다노]남 포플린 셔츠(50수) 048513,39800,31840,-7960
2018-06-01,1493258959,A012010,국산쇠고기,[무항생제] 안심 600g 2등급,58500,58500,0
2018-06-01,1778566526,L021010,손목시계,[바보사랑]JA-987 가죽시계,31320,31320,0
2018-06-01,955798323,A018060,스낵과자,[농심]농심 수미칩 오리지날 (85G),1950,1950,0
2018-06-01,1778566523,L021010,손목시계,[바보사랑]JA-987 가죽시계,31320,31320,0
2018-06-01,991414605,F012010,종이기저귀,LG 토디앙 자운보 본초 밴드/팬티기저귀 3팩,34900,34900,0
2018-06-01,606254016,A018090,잼,복음자리공식 딸기잼 500g+380g+배도라지한컵증정,8900,8900,0
2018-06-01,1778566527,L021010,손목시계,[바보사랑]JA-988 가죽시계,29520,29520,0
2018-06-01,1090573226,E031080,선풍기,니코 9핀/미니/라디에이터 WH-M09,44000,44000,0
2018-06-01,1090573228,E031080,선풍기,니코 5핀/미니/라디에이터 WH-M05,34500,34500,0
2018-06-01,1782288630,L021020,장신구,[바보사랑]두산베어스 멀티 실팔찌 블루,10000,10000,0
2018-06-01,1775310262,C013060,등산복,[블랙야크][이월상품]봄/여름 남성용 등산 기능성 신축성팬츠[B4XS7팬츠1](강남점),96200,79320,-16880
2018-06-01,1090573227,E031080,선풍기,니코 7핀/미니/라디에이터 WH-M07,39000,39000,0
2018-06-01,1056130800,C013010,점퍼,팬지로브자켓 BR1704 캐주얼자켓 자켓 롱자켓 로브자,87150,87150,0
2018-06-01,302495110,I053020,스케치북,삼원 아트스퀘어 크로키북 [A6~B4] 모음전/스케치북,2200,2200,0
2018-06-01,1090573229,E031080,선풍기,신일산업 히터/석영관/2단온열조절 SEH-JD1600,20500,20500,0
2018-06-01,1782288631,L021020,장신구,[바보사랑]두산베어스 엠블럼 실팔찌 레드,10000,10000,0
2018-06-01,2117411123,C013050,운동복,dd98 슬림핏 트레이닝복 그레이 트레이닝복 츄리닝상,18810,18810,0
2018-06-01,2046948052,C012060,여자내의,[모조에스핀]벨트포인트 하이웨스트 스커트_S174MSD019(GG1),89000,84550,-4450
2018-06-01,263572363,C013010,점퍼,USD461_3113_GR 등산자켓 남성점퍼 남성아웃도어 남성,50760,50760,0
2018-06-01,2046948055,C012060,여자내의,[모조에스핀]벨트포인트 하이웨스트 스커트_S174MSD019(OR1),89000,84550,-4450
2018-06-01,417008765,C012060,여자내의,SK1217-심플 H라인 데님 스커트 여자치마 여성치마 H,37280,37280,0
2018-06-01,2046948054,C012060,여자내의,[모조에스핀]벨트포인트 하이웨스트 스커트_S174MSD019(GG5),89000,84550,-4450
2018-06-01,286709577,A011010,쌀,7분도 흑백미 4kg/무료배송,11000,11000,0
2018-06-01,743474644,C021040,실내화,남여공용 클럽 씨 85 몬타나 CM9296/ 리복,59400,53460,-5940
2018-06-01,543540798,C021010,아동화,여름신상9900원~아동운동화 아동화 남아 여아 유아,17000,14900,-2100
2018-06-01,529947363,F012010,종이기저귀,러브스(LUVS)기저귀3-6단계 1박스,51900,51900,0
2018-06-01,1782288629,L021020,장신구,[바보사랑]두산베어스 멀티 실팔찌 레드,10000,10000,0
2018-06-01,1716485453,C011030,남자학생복,(배드민턴마켓) 푸마/남성베스트/패딩조끼/의류,79000,75050,-3950
2018-06-01,1343578401,E061020,섬유유연제,버넬 10주 섬유유연제 1L x3개+퍼실 300ml+프릴300ml,9900,9900,0
2018-06-01,1250802818,E021020,커튼,10%쿠폰! 쁘리엘르 아일렛 슬라브/레이스커튼,16900,16900,0
2018-06-01,818489100,E011070,식탁,직배/DIY아일랜드식탁/식탁/책상/화장대,27800,27800,0
2018-06-01,955798347,F012020,생리대,바디피트 유기농 순면 중형_20P,9000,4990,-4010
2018-06-01,950647073,I011010,TV,삼성49/55인치패널2년무상보증/특가UHDTV/당일출고,399000,339000,-60000
2018-06-01,395257960,C012040,여자학생복,[쎄쎄쎄]여성 셔츠남방 모음/무지/박스/체크/스트라이,13900,13900,0
2018-06-01,2048473999,G011070,자전거,시애틀모던F + 무료배송 하이브리드자전거 초3부터,126000,113400,-12600
2018-06-01,744844136,A022050,탄산음료,환타 250ml x30can (포도 오랜지 파인애플),20300,20300,0
2018-06-01,1271369395,C011050,남자내의,질스튜어트스포츠 입체패턴 하프팬츠 JMPA8B451_BK,73870,73870,0
2018-06-01,1805465041,L021020,장신구,[바보사랑]헤론드 큐빅 반지,8000,8000,0
2018-06-01,1805465040,L021020,장신구,[바보사랑]해리스 스타 목걸이,8000,8000,0
2018-06-01,737672895,E061030,전구,[두영]FPL 36W 형광등 전구 삼파장 초특가!!!,640,640,0
2018-06-01,612431113,C011020,남자상의,여름신상 남자 슬랙스/정장바지/스판/9부/남성 바지,15800,15800,0
2018-06-01,1685329251,A016030,복숭아,산초가루(산초 솔표 40g)X10개/산초 산초가루 산초분,25070,23570,-1500
2018-06-01,1566144498,A012040,닭고기,[맛있닭] 닭가슴살 전상품 맛보기세트 18팩 외 38종,28200,28200,0
2018-06-01,1653142749,A018010,초콜릿,한국마즈 초콜릿 대용량 모음전,9900,9900,0
2018-06-01,1555600094,L012110,색조화장품,라끄베르 UV스킨포스 3개 SPF50+ PA+++ 썬크림 선로션,10900,10900,0
2018-06-01,530938341,C012020,원피스,[톰보이]핸드메이드 아웃포켓 코트 9108111999,159000,124020,-34980
2018-06-01,1833276306,C013020,티셔츠,[컬쳐스타]드뢰 티셔츠 WSTSI427,29000,29000,0
2018-06-01,1977925620,E061030,전구,삼파장 전구 지니 에센셜 토네이도 dulux 11W 20w 30,2000,2000,0
2018-06-01,1720324449,L021020,장신구,원석sale/천연연수정/quartz/16ct,90000,90000,0
2018-06-01,117502656,C012040,여자학생복,(해외직배송)심플 가오리 브이넥 니트,54670,54670,0
2018-06-01,1171004148,A019080,고추장,해물볶음고추장120g x 4ea 프리미엄 비빔밥 무침 라면,7000,7000,0
2018-06-01,1397172394,C013010,점퍼,코콤 LED시스템 주방등 50W 주광색 전등 거실등 조명-,92000,91080,-920
2018-06-01,560935055,C013020,티셔츠,빅사이즈여성 롱티 민소매 원피스 반팔 박스티 임부복,12800,12800,0
2018-06-01,87718503,L021020,장신구,(실버) 4mm 큐빅 초커 목걸이 은목걸이 실버목걸이 초,16030,14430,-1600
2018-06-01,58109244,A012010,국산쇠고기,효도 견과세트 5호(고품격 웰빙 선물세트)사은품 답례,82830,82830,0
2018-06-01,150862824,F012010,종이기저귀,폴맘 기저귀 팬티형 새로워진 실속형4팩 / 하기스,25900,25900,0
2018-06-01,398182569,C013020,티셔츠,수유나시/나시티/끈나시/롱/캡/수유런닝수유복/임부복,9900,9900,0
2018-06-01,1234002533,C013020,티셔츠,(4926상)랩스타일 산전산후 수유가능한 면스판 임부상,17660,17660,0
2018-06-01,1198239598,L021030,가방,학생가방 여자백팩 초등학생중학생고등학생책가방소풍,16900,16900,0
2018-06-01,896573905,F012010,종이기저귀,[유한킴벌리]하기스 크린베베 중형 [78P-일자형기저귀],10900,10900,0
2018-06-01,813884397,L021050,우산,D아람 도롱이 AJ-2003 우비 비옷 오토바이 배달용우의,38900,38900,0
2018-06-01,2097711670,C013050,운동복,자동차 광택기/세차용품/광택융/광택패드/자동차용품,27400,27400,0
2018-06-01,1219328437,F011150,건강기능식품,귀리렌틸콩 미숫가루X2봉/당일제조/검은콩/無설탕,9900,8900,-1000
2018-06-01,127546989,F012020,생리대,[위스퍼]생리대 순면감촉 피부애 알찬구성,15300,15300,0
2018-06-01,420638649,C012020,원피스,[쉬즈미스][쉬즈미스] 코튼 스트라이프 러스틱 셔츠_SWWSTI20030_CO,89000,84550,-4450
2018-06-01,1125738343,E061080,키친타월,업소용 미트페이퍼/2롤/핑크 화이트/육즙지/흡수지,33800,33800,0
2018-06-01,1440180266,A011010,쌀,2017년 햅쌀 고창 황토 현미 쌀 4kg 당일도정/현미쌀,16900,16900,0
2018-06-01,952198796,A019080,고추장,㉭ 해표 순창궁 햅쌀고추장(1.8KG),7980,7980,0
2018-06-01,773236888,E041060,수저,수저세트 숟가락 젓가락 외국인선물 답례품 기념품,9900,9900,0
2018-06-01,1468557230,A012010,국산쇠고기,[무항생제] 불고기샤브샤브 400g 1등급,21500,21500,0
2018-06-01,959345585,A016160,과일가공품,카라바오 망고 3입/팩,9990,9990,0
2018-06-01,1742819691,A018110,물엿,큐원 이온물엿24kg 프락토 과당 저당 솔비톨,24700,24700,0
2018-06-01,895827202,E061080,키친타월,[유한킴벌리]유한킴벌리)크리넥스안심키친타올150매*4,4500,4500,0
2018-06-01,1983150940,A021010,커피,당일발송/네스프레소 영국차(Tea)캡슐추가/영국직수입,6800,6800,0
2018-06-01,2104841892,I031040,생화,툴리스 소프트플러스/무릎보호대/등산,28400,24920,-3480
2018-06-01,243431369,E031050,냉장고,[삼성전자] 인증점 삼성 김치냉장고 김치 플러스 RQ57M9291M2,5049900,5049900,0
2018-06-01,1268596555,C013030,스웨터,[업타운홀릭] 린넨 줄지 knit [단가라니트/라운드넥,32000,28800,-3200
2018-06-01,1121564812,F012020,생리대,엘리스 생리대 클리닉스 슈퍼롱 10P x 2팩/ 엘리스,12500,11880,-620
2018-06-01,986244968,G022010,자동차용품,불스원)레인OK발수와이퍼600MM,11300,11300,0
2018-06-01,986244969,G022010,자동차용품,불스원)레인OK발수와이퍼650MM,11700,11700,0
2018-06-01,728385030,A017050,미나리,양배추분말(국산) 70g(플라스틱통)/가루/선식/건강/차,5600,5600,0
2018-06-01,2061303659,C013040,청바지,[탑텐]여성 밴딩스키니팬츠(MSX2PP2012),14900,12670,-2230
2018-06-01,685330304,A017160,오이,[지리산 버섯농원]햇볕건조 표고버섯200g/버섯가루,20000,20000,0
2018-06-01,700597413,C012040,여자학생복,[PL_홈쇼핑]베이지 원피스형 니트,7900,7510,-390
2018-06-01,895827207,A014010,우유,[서울]목장우유 1000ML,3010,3010,0
2018-06-01,1296300379,C011020,남자상의,남자정장 네이비블루 심플 수트 D0116011 남성정장 남,194710,194710,0
2018-06-01,530292048,A014020,분유,[LG생활건강]베비언스 액상분유 12-24개월(3단계) 6개입 니플1개 포함,15040,14290,-750
2018-06-01,457285854,C011020,남자상의,체크 밍크털 코트 털코트 남성용털코트 남자코트 캐쥬,114550,114550,0
2018-06-01,439988839,C012060,여자내의,[앞머리]내츄럴 워싱 수술 데님 언발 롱 스커트n527,39900,37910,-1990
2018-06-01,977171405,C014020,유아복,아동바지 매화 미니쥬리 팬츠 KIDBOK-26 유아바지 면,11240,11240,0
2018-06-01,17756026,C012060,여자내의,빅사이즈민짱/품격있는정장바지모음/팬츠/밴딩/슬랙스,22900,22900,0
2018-06-01,585280264,E011060,의자,[시니프][무료배송]순수국산정품/플렉스의자12종/학생의자/책상/사무용의자/독서실의자,59800,39550,-20250
2018-06-01,612402225,L012090,기초화장품,[아이오페] 아이오페 모이스트젠 스킨150ml/에멀젼130ml 2종구성,32500,32500,0
2018-06-01,2116342376,A019180,즉석식품,부산맛집 사미헌 명품 갈비탕 꼬리곰탕 1인~ 10인세트,49500,49500,0
2018-06-01,1988120279,C013020,티셔츠,여성 라인포인트 라운드 티셔츠 DWRT5B731/ 디스커버리,34500,29330,-5170
2018-06-01,1158233901,E021010,침구,이불보 3종류 이불정리함 이불보관함 이불수납,3250,3250,0
2018-06-01,202609789,F012020,생리대,동아제약 템포10Px3개/슈퍼/레귤러/20Px2,10900,10900,0
2018-06-01,1599478341,L012110,색조화장품,30%+5%중복쿠폰! 랩노선밀크/선크림/이데베논세럼~50%,16000,16000,0
2018-06-01,484208091,A016070,귤,S일해/보석건귤 선물세트 8호 3박스-말린귤/제주의맛,37700,37700,0
2018-06-01,1866723519,F012010,종이기저귀,포인트 성인용 속기저귀/1박스(12팩)/포인트기저기,48000,48000,0
2018-06-01,1158206345,C013020,티셔츠,[인디안][인디안(INDIAN)]배색하프집업티셔츠_MIGCLPS1451_04,22000,20900,-1100
2018-06-01,699521980,A019110,드레싱,청정원 타르타르소스(300G),2000,2000,0
2018-06-01,321469877,C012020,원피스,[나이스클랍]포이 코트(N174XSG103)(광주신세계),139000,110400,-28600
2018-06-01,1476504934,A013170,생선통조림,동원 고추참치/매운 김치찌개용150gX8개/참치캔,14900,14900,0
2018-06-01,122439551,L012030,칫솔,오랄비 스테이지 어린이칫솔 2-4단계/코스트코,15490,15490,0
2018-06-01,440292607,A015020,식용유,프레스코 카놀라유900mlX20개(1박스)올리브유 식용유,141500,124520,-16980
2018-06-01,1955346537,L012090,기초화장품,아이오페 맨 하이드로 포스 크림 - 50ml,20900,20900,0
2018-06-01,1246595895,E031070,에어컨,레펠 3단독립 타워팬 선풍기 GG-TF6666/조용한 DC모터,147000,145000,-2000
2018-06-01,58110261,A012010,국산쇠고기,팔도 견과세트 2호(고품격 웰빙 선물세트)사은품 답례,77080,77080,0
2018-06-01,729039945,C013020,티셔츠,무지 패턴 기모 후드티 후드집업 빅사이즈 M~3XL,24800,24800,0
2018-06-01,1467232230,C012040,여자학생복,[대구백화점 I관] [레코브]얼룩배색가디건(L13183KC901X),47800,45410,-2390
2018-06-01,1701617254,L012010,면도기,[2천원할인!]*도루코 WIN3폼210mlx3+면도기+날 2입,13900,13900,0
2018-06-01,293017109,C011030,남자학생복,봄 여름! 남자 캐쥬얼 반팔 체크 카라 셔츠 남방,16900,16900,0
2018-06-01,566675091,C021020,구두,로하 샌들 LKR2722 여자샌들 여성샌들 YA02004,54850,54850,0
2018-06-01,50042917,C013040,청바지,[젤리스푼]시원한해지데님팬츠,14900,13410,-1490
2018-06-01,1250434681,C013030,스웨터,MJ_1226 양면 양털 집업,75040,66790,-8250
2018-06-01,857803447,C015020,모자,야구모자/베이스볼캡/MLB/매쉬/스판캡/남여공용,13300,13300,0
2018-06-01,985357813,A013130,오징어채,백진미 오징어 150G*2봉,15900,15900,0
2018-06-01,339201104,C014010,아동복,타미힐피거키즈칠드런 (TBMS1KOS92A0) 베이직브이넥반팔티셔츠 TOMMY HILFIGER (6∼16,48000,40800,-7200
2018-06-01,603415510,C011030,남자학생복,남성 7부 코튼린넨 차이나카라 셔츠 T172SH220P/ 티비제이,13000,13000,0
2018-06-01,1498708397,A016100,수박,5월한정판매 유기농 애플수박 3.5kg(3-5수)/품절임박,27900,27900,0
2018-06-01,630407156,C014020,유아복,데일리베베 파인애플로브/아동가운/비치룩/바캉스룩,28000,27160,-840
2018-06-01,135657205,A017040,양배추,수입산 사상자70g 뱀도랏,3130,3130,0
2018-06-01,1072099027,E021010,침구,COOL 시원한 여름이불 토퍼세트 요토퍼 이불세트,49800,45800,-4000
2018-06-01,1738106389,A018050,비스킷,인기과자(1+1)행사 사탕 초콜릿 스낵 젤리 간식 과자,2000,2000,0
2018-06-01,1927844394,A022030,생수,분다버그(레몬라임/진저비어)375미리x12병/무료배송,24700,24700,0
2018-06-01,566370386,I031040,생화,캠핑망치 팩해머 손망치 타프 텐트용품 스틸망치,14900,14900,0
2018-06-01,533987862,F012020,생리대,[좋은느낌] 좋은느낌 입는오버나이트 대형8Px2개 팬티형 무료배송,20900,20900,0
2018-06-01,895827242,E061040,부엌용세제,[LG]LG 자연퐁 솔잎 1.2KG(리필),6300,2990,-3310
2018-06-01,1270982406,A021010,커피,화이트골드 320T/모카골드 320T+플라워텀블러,32900,32900,0
2018-06-01,1019198439,C013010,점퍼,푸마 아스널 캐주얼 자켓 (74978405 ),134220,119460,-14760
2018-06-01,1405649463,E041060,수저,디즈니 유아수저세트/숟가락/수저통/젓가락/포크세트,3800,3600,-200
2018-06-01,1226070421,C013010,점퍼,기모캐주얼라이더자켓 MS1711 집업자켓 여성용겨울자,98300,98300,0
2018-06-01,326956070,A017180,호박,건고추(호식이네 1k)X10 식자재 업소용식자재 대량구,151720,144140,-7580
2018-06-01,1250170442,C012040,여자학생복,[나이스클랍]유니크한브이넥니트(N182KSK017),161000,136850,-24150
2018-06-01,16278974,C013040,청바지,봄신상 청바지/슬림일자/남자옷/빅사이즈바지블랙,15900,15900,0
2018-06-01,378083018,L021010,손목시계,데이지 팔찌 /손목시계 손목시계 패션시계 여자시계,12840,12460,-380
2018-06-01,984463248,L012090,기초화장품,[유한킴벌리]그린핑거 힘센 보습 울트라로션 (260ML),15900,15900,0
2018-06-01,172356025,A015010,참기름,백설 진한 참기름 1500ml / 1.5L,14900,14900,0
2018-06-01,984463245,E061090,방향제,페브리즈 비치형 다우니 리필(5.5ML),5400,5400,0
2018-06-01,245675981,C013020,티셔츠,(AGC이너웨어 긴팔 주니어 상의 아동긴팔티 어린이티,63700,63700,0
2018-06-01,280335484,I011010,TV,삼성正品TV 기사설치 32인치/28/24인치 소형TV 티비,172160,167000,-5160
2018-06-01,1228552698,C012040,여자학생복,[부루앤쥬디]썸머 나시 가디건 세트(WOKE2ST001),39900,39430,-470
2018-06-01,1229863038,G022020,자동차타이어,한국타이어 벤투스 V2컨셉2 H457 무료배송 특가모음전,85000,72250,-12750
2018-06-01,440292602,A013170,생선통조림,삼포큰구슬골뱅이 400gX24개골뱅이캔 식자재 골뱅이,221100,187940,-33160
2018-06-01,759327425,A016110,딸기,(냉동)국내산 딸기1kg,12730,12730,0
2018-06-01,1739672063,E021010,침구,[쁘리엘르]뽀송뽀송~순면100% 차렵이불패드세트,39900,36710,-3190
2018-06-01,195681832,C021010,아동화,특가할인 휠리스 바퀴달린 운동화 LED 충전식,29900,29900,0
2018-06-01,384609382,C011050,남자내의,[뱅뱅][뱅뱅] 여성 선염스트라이프 마린프린트 트레이닝 바지-NPBT33,13800,13110,-690
2018-06-01,944878953,C013050,운동복,DDK00218 트레이닝 져지 803 여성트레이닝집업 여성트,51600,51600,0
2018-06-01,1316131371,E061060,살충제,컴뱃파워 작은 바퀴막멸 전문베이트 12입 바퀴 컴배트,15610,15610,0
2018-06-01,525776478,C021010,아동화,주니어운동화 아동운동화 어린이운동화 초등운동화,24900,24900,0
2018-06-01,1234935928,A011090,국수,진라면 순한맛 매운맛 120g x 20봉/스낵면 열라면,10600,10600,0
2018-06-01,1410142313,A022030,생수,불가리수 탄산수/탄산음료 7종 12pet x 2 파격가!,11900,11900,0
2018-06-01,499248008,C013020,티셔츠,[30%쿠폰][로리앤콜린]신상 상하복 국내생산 아동의류,4900,4900,0
2018-06-01,1070611965,E031070,에어컨,한일 천장용선풍기 FC-62LB-S/FC-62LB/FCR-65,62000,57140,-4860
2018-06-01,104553173,C013040,청바지,[갖고파]아우라진 일자핏 봄/여름신상 여성/청바지,13800,13800,0
2018-06-01,236765938,C011020,남자상의,더블트랜치 빅사이즈 4XL 남성코트 겨울남성남 하프트,237270,237270,0
2018-06-01,897561745,A013110,마른오징어,국물용 멸치기획 700G/박스,13900,13900,0
2018-06-01,554964786,L012110,색조화장품,애터미 선크림/비비크림/이브닝케어폼/마스크/필링젤,7790,7790,0
2018-06-01,2038793326,C013020,티셔츠,아디다스키즈 주니어 반팔티 5종-BK3475외,21240,21240,0
2018-06-01,2058973068,C013020,티셔츠,게스 [기획] 미니 와펜 카라티셔츠 MI2K9470,29000,21000,-8000
2018-06-01,504680797,C012040,여자학생복,[모다아울렛][반에이크]반에이크 뒷목셔링블라우스 VA86BLM204Z,39800,36220,-3580
2018-06-01,992961135,G011070,자전거,무료조립 알로이 하이브리드 자전거 리버스 어반H,290000,265880,-24120
2018-06-01,2009461242,C013020,티셔츠,지오다노 018501 반팔 피케 폴로,15000,12450,-2550
2018-06-01,577357000,E031130,보온매트,(주)한일의료기/자연마루/전기매트/온돌마루/전기장판,72000,72000,0
2018-06-01,416680970,C011020,남자상의,블랙 체크 밍크털 코트 남자코트 코트 남성털코트 남,99980,99980,0
2018-06-01,654237261,C011020,남자상의,정장아울렛 S/S 봄여름신상품 슬림핏/빅사이즈정장,79000,79000,0
2018-06-01,362873391,E021010,침구,[한샘] 알러리스 어반체크 누비이불세트 Q/ 한샘,97900,94970,-2930
2018-06-01,687444007,C011020,남자상의,[제스]XESS S/S 봄 여름 프리미엄 데일리 정장 수트 X7BSU5267 X7ASU1264 X7BSU1272,129000,110940,-18060
2018-06-01,823079432,L012090,기초화장품,첫물녹차 클렌징크림 300g X2개 / 발효녹차추출물,11800,11800,0
2018-06-01,390941920,C013020,티셔츠,클라이머홀릭 PGD01 레고라운드티 mhb257tr,10000,10000,0
2018-06-01,737932335,C015040,장갑,쿨엑스 여름 쿨토시 팔토시 토시 남자등산복 작업복,2900,2670,-230
2018-06-01,1209436488,C013040,청바지,[Blouson]쿨 삼각패턴 와이드 밴딩팬츠_[B1806PT064B],29000,25780,-3220
2018-06-01,1724861107,A017250,고사리,동결건조 건강한 유기농 브로콜리 분말 가루 60g 녹즙,10800,10800,0
2018-06-01,502506050,A011160,빵,삼립 크림빵 10봉/1000빵/슈크림빵/단팥빵/크림빵,6900,6900,0
2018-06-01,442845643,E031070,에어컨,윈드피아 타워팬 선풍기 타워형 리모콘 모음전,24510,24510,0
2018-06-01,1127092337,E021020,커튼,캐노피 침대 가리개 커튼 침대커튼 침대캐노피 공주풍,40790,40790,0
2018-06-01,1206142914,C011020,남자상의,체스트맨 언컨 수트 스판 남성정장 여름 양복세트,85000,85000,0
2018-06-01,705858539,C013010,점퍼,[빈폴골프] [THE OPEN] 여성 옐로이시 브라운 원포인트 큐롯 (BJ8326E16B),258000,206400,-51600
2018-06-01,955963828,E061040,부엌용세제,뽑아쓰는자연퐁 100매 천연시트세제/주방세제/간편시트/친환경세제/여행용세제/일회용,11900,11900,0
2018-06-01,312572845,C012060,여자내의,빅사이즈/제이스타일 폴리튼 체크 프릴 스커트/ 제이스타일,38900,29960,-8940
2018-06-01,1311875818,C012040,여자학생복,[이프네(IFNE)]쉬폰롱가디건 (DI5WCD02)(센텀시티점),26000,23210,-2790
2018-06-01,1691193029,F012050,의료측정기,뉴 아큐첵 퍼포마 NC 혈당측정기 온라인공식업체,30700,28560,-2140
2018-06-01,1491346805,C012030,여자상의,뷔스티에원피스/롱원피스/레이스원피스/프릴원피스,22900,22900,0
2018-06-01,1695089720,I031040,생화,新 김병만의 정글코트/야전/간이/접이식침대/캠핑텐트,160000,142310,-17690
2018-06-01,1154115660,C012040,여자학생복,W 오프리미츠 그물포켓니트티 G80KT2603/ 오프리미츠,34000,32640,-1360
2018-06-01,416021136,C015040,장갑,란체티 손목퍼시보리 여성 순모장갑 TL-5404 여자겨울,46030,46030,0
2018-06-01,140122936,A011030,찹쌀,신화 업소용식자재 엿기름 15K 1포대 대용량엿기름 식,91150,81130,-10020
2018-06-01,1980019545,C013050,운동복,카엑스512 일반승용차용 차량트렁크 네트 그물망 차량,15920,14370,-1550
2018-06-01,2096505507,C013010,점퍼,지프 JEEP 남여공용 넓은 스트라이프 피케 반팔티 JH2TSU703,33970,33970,0
2018-06-01,1943662159,C013010,점퍼,빅사이즈 여성 패딩조끼 WC 여 웰론조끼 VT 059W - 빅,104030,92590,-11440
2018-06-01,451026366,A013060,게,상록 백족(오다리) 1kg2개 백족 오다리 오징어다리,98230,88410,-9820
2018-06-01,758201618,C013050,운동복,이지립 범퍼가드 몰딩 고무립 에어댐 카본 프론트립,24000,20490,-3510
2018-06-01,1557596441,L012010,면도기,(무료배송) 질레트 쉐이빙폼1+1/바바솔/면도크림/거품,10490,10490,0
2018-06-01,986183404,A017130,도라지,감자(특/100G),699,699,0
2018-06-01,460178602,A011090,국수,농심 둥지 비빔냉면 32입/냉면/비빔면/둥지냉면,26900,26900,0
2018-06-01,986183403,A017070,부추,파채(팩),1990,1990,0
2018-06-01,1332707805,C012060,여자내의,30%쿠폰![깜짝특가]투투 ~3XL 슬랙스/청바지/반바지,6900,6900,0
2018-06-01,1216190488,C013050,운동복,차량용컵홀더/관광버스용컵홀더/수납/동전/재털이/재떨이/드링크/캔/핸드폰/거치대/음,4600,4600,0
2018-06-01,1862437227,C013020,티셔츠,폴햄외 본사 역대최강 어벤져스 콜라보& 역시즌~80%,9000,9000,0
2018-06-01,448259552,C011030,남자학생복,기능성 패션 조끼 등산조끼 MC 46,40520,40520,0
2018-06-01,52421848,C013010,점퍼,[JR주니어] 데일리후드점퍼(핑크_라이트블루_민트_블,14900,10430,-4470
2018-06-01,40988012,C021040,실내화,아디다스 남녀공용 이큅먼트16 런닝화 (AF4969 ),112390,100030,-12360
2018-06-01,1965371444,C011050,남자내의,남자 와이드팬츠 9부 밴딩바지 슬랙스 남녀공용 팬츠,20500,18500,-2000
2018-06-01,1340990576,C012060,여자내의,jj42 꽈배기니트 미디스커트_블랙 여성미디스커트 미,14280,14280,0
2018-06-01,1505807412,I011010,TV,더함 코스모 C651UHD 4K UHD TV 삼성 SVA /LG IPS,619000,619000,0
2018-06-01,2118501981,C013010,점퍼,[모다아울렛][에이비에프지]양털 배색 점퍼,39000,35880,-3120
2018-06-01,1157619042,E061010,세탁세제,란제리드라이 1000mlX2개 - 속옷세제 홈드라이 울샴푸,13000,13000,0
2018-06-01,1077525961,E011020,침대,장인가구아이브 멀티 트윈 침대,187770,187770,0
2018-06-01,985382861,A019030,생강,고흥·창녕 햇마늘(장아찌용/반접) 50입내외,15900,12900,-3000
2018-06-01,1639916469,A017150,버섯,계양]알루미늄용팁쏘 255-405mm/비철금속용,44750,44750,0
2018-06-01,1417454729,A012060,햄및베이컨,통그릴비엔나360gx2+통그릴후랑크300gx2/ 동원,15600,13260,-2340
2018-06-01,1391047283,C012040,여자학생복,8900원~/루즈핏셔츠/데님셔츠/롱남방/스트라이프,17800,17800,0
2018-06-01,2147265084,A011110,당면,차오름 파래김 (200G) x70,457950,457950,0
2018-06-01,607574252,C013010,점퍼,소매밴딩 썸머간절기 바람막이점퍼(BBUB590C)/ 보니알렉스,49000,44100,-4900
2018-06-01,1034716074,E011060,의자,[다와사] - 학생/사무용의자,27800,27800,0
2018-06-01,1452120104,C012040,여자학생복,[엠폴햄]W 엠폴햄 남성 넥라인 배색 롱 가디건 EPY1EC1501,39900,37910,-1990
2018-06-01,1083219107,C013020,티셔츠,BTR 비티알 캐쥬얼/골프웨어 여름 MD추천의류 특가전,12900,11490,-1410
2018-06-01,1042286636,C011030,남자학생복,초특가 여름신상 긴팔 셔츠 솔리드 남방 남자 데님 청,24000,15800,-8200
2018-06-01,780538092,F011120,인삼,(장생농산장수산삼 8년근 10주(10뿌리) 선물용 8년근,417480,417480,0
2018-06-01,2133390225,E061050,청소용세제,맥스크린 살균소독제 식품첨가물허가 콜레라 예방,17900,17900,0
2018-06-01,1291922323,E021010,침구,와! 싸다! 극세사 차렵이불+베개커버 세트SS/Q,19900,18310,-1590
2018-06-01,986244966,G022010,자동차용품,불스원)레인OK발수 와이퍼_500MM,10200,10200,0
2018-06-01,337376440,L021020,장신구,웅장한 최신상 19종 고급 실버반지 (open-svr9) 실버커플링 남성반지 골드조아,78000,78000,0
2018-06-01,1011150056,L012110,색조화장품,해피바스 마일드 선스틱20g,8900,8900,0
2018-06-01,986244967,G022010,자동차용품,불스원)레인OK발수와이퍼550MM,10600,10600,0
2018-06-01,986244964,G022010,자동차용품,불스원)레인OK발수 와이퍼_400MM,8100,8100,0
2018-06-01,986244965,G022010,자동차용품,불스원)레인OK발수와이퍼450MM,9100,9100,0
2018-06-01,617166426,C013020,티셔츠,타미힐피거 카라티 반팔티/긴팔티셔츠 맨투맨 단체티,23800,23800,0
2018-06-01,1155813775,C012040,여자학생복,[타미힐피거여성]여성 스트라이프 그래픽 니트(TFMS1WOE30A0),178500,160650,-17850
2018-06-01,897585739,A019130,스프,[오뚜기]오뚜기 3분 데리야끼치킨 150G,1840,1840,0
2018-06-01,1260909951,C013020,티셔츠,[에잇세컨즈] 네이비 솔리드 헨리넥 반소매 셔츠 (228465WY2R),35900,34110,-1790
2018-06-01,1398131602,A013070,굴,두레생협 손질꽃게(500g) 손질꽃게 요리용꽃게 튀김용,52070,52070,0
2018-06-01,2123389383,C011030,남자학생복,[해리슨] 3번체크 오픈 남방 MT1119,29700,21490,-8210
2018-06-01,1480043304,A017080,무,안동참마/마가루/맛이 좋은둥근마/발효효소현미/발아현미/울금,11000,11000,0
2018-06-01,1205963309,C012020,원피스,(해외직배송)여성 꽃프린트 트렌치 코트 프린팅코트,77220,67960,-9260
2018-06-01,1828289176,C012020,원피스,[쉬즈미스] 블루라벨 뒷 절개 슬림핏 팬츠_SWWSLH22010,49000,40670,-8330
2018-06-01,575003678,A016060,감,반건시세트2호 반건시10과x2 감말랭이250gX2,78000,75000,-3000
2018-06-01,855142512,E031080,선풍기,[기본배송무료][신일금속] 노출형 주물 벽난로 SL-005 /펜션/별장/,783500,783500,0
2018-06-01,987232842,L012010,면도기,쉬크하이드로5 면도날 6입 기획,25900,25900,0
2018-06-01,988089845,F011150,건강기능식품,[올즙] 올바른 석류즙 50포(실속포장),45000,23900,-21100
2018-06-01,1655235280,A016100,수박,달콤한수박 1+1=2통 11kg이상/안전배송/우체국택배,18900,18900,0
2018-06-01,2063754139,E021010,침구,겨울왕국 면기모 패드 - 뷰티선샤인 (064187) 패드 까,64090,58380,-5710
2018-06-01,439964843,C012040,여자학생복,[오빵스타일]린네가디건브이넥가디건프린 린넨 브이넥가디건,28000,26600,-1400
2018-06-01,1994493611,C012060,여자내의,쉬즈미스 베이직 스판 일자핏 팬츠 SWWSLH21120,39000,33930,-5070
2018-06-01,988089840,L012090,기초화장품,그린핑거 네이처 메이드 베이비 크림 95G,29000,29000,0
2018-06-01,986158445,L012040,치약,[애경]애경2080키즈딸기(2~5세)70G*2입,3800,3800,0
2018-06-01,2020113251,C011050,남자내의,아디다스 여성 에센셜 리니어 타이츠 (BR2523 ),52960,47140,-5820
2018-06-01,986244941,G022010,자동차용품,불스원)레인OK유리발수코팅300ML,5090,5090,0
2018-06-01,855142516,E031080,선풍기,[기본배송무료][신일금속] 노출형 철제 벽난로 SL-078/펜션/별장/,1745000,1745000,0
2018-06-01,1054624880,A012060,햄및베이컨,청정원 런천미트 115gx10개,16500,16500,0
2018-06-01,855142513,E031080,선풍기,[기본배송무료][신일금속] 노출형 주물 벽난로 SL-029A /펜션/별장/,808000,808000,0
2018-06-01,855142514,E031080,선풍기,[기본배송무료][신일금속] 노출형 철제 벽난로 SL-06 /펜션/별장/,906000,906000,0
2018-06-01,1293865710,C013010,점퍼,푸조 큘팅 자켓(FZ715-1) 깔깔이 남성퀄팅자켓 다운점,50730,50730,0
2018-06-01,986244937,A014050,달걀,CJ 더안심건강란 15입/대란,4990,4990,0
2018-06-01,1464242135,E041020,컵,필수아이템/드링크자/유리컵/밀폐/유리병/커피/머그,500,500,0
2018-06-01,74218879,C013050,운동복,카본 범퍼윙 가드 대 중 소 중 택1 도어가드 차량용가,20230,18430,-1800
2018-06-01,1088415242,C011030,남자학생복,그남자의 스타일멘토 체크셔츠/남방 헨리넥 데님 남성,18800,16800,-2000
2018-06-01,1010316037,A019180,즉석식품,[씨티푸드] 돼지불곱창 280g x 3봉,30900,21900,-9000
2018-06-01,1010316035,A019180,즉석식품,[씨티푸드] 미니직화불족발 350g x 2봉,24900,18600,-6300
2018-06-01,385980759,E021010,침구,나르는 양탄자40수 누비면 매트 커버(황토색-퀸) 매트,81290,81290,0
2018-06-01,1772623685,A011010,쌀,농협 한토래 쌀눈쌀 5kg/ 국산 쌀 잡곡,16300,16300,0
2018-06-01,1011150028,A016100,수박,[청년농장]블루베리 100G/팩,4990,4990,0
2018-06-01,477085192,E061010,세탁세제,(21kg특가)세탁세제 10.5kgx2개 스파크/비트/가루세제,7000,6900,-100
2018-06-01,15756317,I031040,생화,아이어 사운드 블루투스 캠핑랜턴 보조배터리 휴대용,68000,60720,-7280
2018-06-01,250694146,C011050,남자내의,여름슬랙스 남자 남성 바지 정장 일자 밴딩 9부,9900,9900,0
2018-06-01,1010316039,A019180,즉석식품,[씨티푸드] 맥반석데리야끼 닭날개 300g x 3봉,29900,21800,-8100
2018-06-01,2022075707,L021030,가방,[헤지스 ACC][헤지스ACC] [ HIBA8E528W2 ] 폴린 브라운 로고레터링 스몰 숄더백 크로스,160200,128160,-32040
2018-06-01,1669713428,E051030,디지털도어록,내맘대로 번호설정 자물쇠 3종 사물함 열쇠 다이얼자물쇠 번호열쇠 도어락 잠금장치,1490,1490,0
2018-06-01,22774543,A017140,콩나물,[종근당건강] 도라지 배즙 청 즙 엑기스 도라지차 목청관리 농축액/,24900,24900,0
2018-06-01,1337063942,C014010,아동복,아동 슈프림 베기 7부 스판 아동복,13500,13500,0
2018-06-01,2070039835,C012040,여자학생복,빅사이즈/반오픈/셔링/블라우스 / 참고 반오픈셔링-BL,52600,44710,-7890
2018-06-01,1614967553,C021040,실내화,뉴발란스 운동화 런닝화 스니커즈 신발 574 580 모음,50000,50000,0
2018-06-01,255179015,L021030,가방,숄더백/미니백/크로스백/토드백/클러치백/여성가방,14600,14600,0
2018-06-01,545598863,A011010,쌀,추청경기미 안성쌀20kg 밥선생,52900,52900,0
2018-06-01,998461457,A012010,국산쇠고기,돼지갈비양념장(대상 10K)/갈비전문점용 갈비양념장 유명맛집 LA갈비 갈비찜 식당용 업,37740,36610,-1130
2018-06-01,1942409557,A017040,양배추,(맛나)아욱(국내산)300g,3700,3330,-370
2018-06-01,506578663,C015030,넥타이,3+1 사은품넥타이 500종류 수동 자동 니트 넥타이 1st,3900,1900,-2000
2018-06-01,440049287,C013050,운동복,아스토레 쉘 4 우븐자켓(AB)-레인자켓 트레이닝운동복,61140,61140,0
2018-06-01,546971704,A011140,부침가루,필라델피아 치즈케익 794g (28oz 10조각  클래식플레인),19900,19900,0
2018-06-01,867826003,C012020,원피스,프레임직사각쟁반 중,30700,27330,-3370
2018-06-01,196534275,A011010,쌀,국내산 우렁이농법 벼고을쌀 현미쌀 흑미 백미 햅쌀,23000,23000,0
2018-06-01,1345629265,C013050,운동복,3부5부팬츠/미니반바지/핫팬츠/숏팬츠/여름바지,7900,7900,0
2018-06-01,1595714008,C011030,남자학생복,핫딜 9900 반팔 셔츠 헨리넥 린넨 체크 남방 빅사이즈,9900,9900,0
2018-06-01,1222822072,E041070,밀폐용기,와인 페트병 PET/더치 커피 공병 플라스틱병 수축필름,350,330,-20
2018-06-01,1630385920,C013010,점퍼,[제시뉴욕]J815NSEJ1070점퍼,206400,196080,-10320
2018-06-01,1715473759,C013010,점퍼,봄여름/결혼식하객패션정장/면접정장/수트/정장바지,68900,68900,0
2018-06-01,464215436,L012090,기초화장품,[화이트래빗]제스티아 항균 엠보 화장솜 500~1200매,8000,7600,-400
2018-06-01,285447782,C014020,유아복,소프트 면스판레깅스 유아레깅스 유아레깅스 유아바지,5390,5230,-160
2018-06-01,520532421,C013020,티셔츠,남자나시/span/헬스복/나시티/런닝/타투/민소매/골지,7700,7700,0
2018-06-01,357150756,E031120,믹서,신일 티타늄 미니 믹서기 블렌더 거품기 SFM-7700JJH,28500,28500,0
2018-06-01,1194996793,C012060,여자내의,[피핀] 카리 뒷트임 데님 스커트 5905,18600,16740,-1860
2018-06-01,876131360,A011070,혼식곡,백설 유기농 밀가루(400G),2900,2900,0
2018-06-01,1259265578,E041050,냄비,(인덕션가능)로얄 단조 냄비/전골 양수 테팔 키친아트,44900,39900,-5000
2018-06-01,995357643,A012010,국산쇠고기,농협하나로 마트 암소한우 300g/500g 소고기 모음,21800,21800,0
2018-06-01,502922257,L021010,손목시계,손목 시계 안틱 캐주얼2 블랙 BC6155BM 캐주얼손목시,90310,90310,0
2018-06-01,1144152726,C015040,장갑,애니멀 변신 벙어리 장갑 방한장갑 장갑 예쁜장갑 겨,12640,12640,0
2018-06-01,985380101,A018010,초콜릿,롯데 초코쿠키 빼빼로_32G,960,960,0
2018-06-01,2052165451,E011070,식탁,차밍 아일랜드식탁 홈바 렌지대 주방수납장 2인용식탁,190000,170100,-19900
2018-06-01,957674341,A013170,생선통조림,샘표 우리엄마 멸치볶음 (50G),2600,2600,0
2018-06-01,1424980118,C013040,청바지,[젤리스푼]프리티프릴숏데님팬츠,21900,19710,-2190
2018-06-01,1586999346,I031040,생화,크롬단조팩 단조팩 텐트팩 스틸팩 강철팩 캠핑팩,800,740,-60
2018-06-01,1783207192,L021010,손목시계,Classy Glasgow 여성시계(나토밴드)_DW00100066,151300,151300,0
2018-06-01,756580591,I031040,생화,[37구 써치라이트]써치랜턴 LED랜턴 후레쉬 캠핑 낚시 자전거전조등 바나낚시 조명등,16900,15410,-1490
2018-06-01,1164121417,C012040,여자학생복,[McGINN]V넥 백 리본 스프링 니트 (MJ1KH008),19900,18910,-990
2018-06-01,928493100,C012060,여자내의,[아메리칸스토리]라인 데님 스커트/스커트/청치마/데님/치마/미디스커트_JPAS-014,16800,15800,-1000
2018-06-01,659006448,L012060,샴푸,더블모 어성초 샴푸+모발팩 4.6kg 대용량,69000,69000,0
2018-06-01,542432484,C014020,유아복,[뿌야뿌][뿌야뿌] 스모킹블라우스 PC2TGST22N,17500,7880,-9620
2018-06-01,525475222,C012040,여자학생복,기본 골지 반팔 니트 (TSKPOH60010)/ 리스트,19000,16150,-2850
2018-06-01,1544407845,E061060,살충제,잡스 모기 개미 바퀴벌레 진드기 해충 퇴치제 살충제,6800,6800,0
2018-06-01,448318330,A013150,어묵,(냉장)부산 등대어묵(범벅)3kgx3개,41880,41880,0
2018-06-01,38006225,A012030,돼지고기,[무항생제] 국내산 한돈(韓豚) 목살(구이용) 500g,19400,19400,0
2018-06-01,529700517,C012060,여자내의,허리조절 블랙 교복치마 교복 예쁜교복 교복쇼핑몰 중,43580,42280,-1300
2018-06-01,638341221,E061050,청소용세제,뉴 청소박사 매직크린 버블 찌든때 곰팡이제거제 킬러,31000,27800,-3200
2018-06-01,330788802,E061010,세탁세제,미국산 암앤해머 베이킹소다 6.12kg/파우더 코스트코,13880,13880,0
2018-06-01,516758620,C012060,여자내의,SK1782-델로스 플레어 미디스커트 3월 말 입고 예정,20830,20830,0
2018-06-01,631204371,A016060,감,경북청도 껍질없는 아이스 왕 홍시 15개(컵)/개당100,63200,53720,-9480
2018-06-01,322016293,I031010,장난감,물놀이 보트 장난감 아동장난감 유아장난감 보트 물놀,7580,7580,0
2018-06-01,1725111577,A014050,달걀,자연방사유정란/부화용10알/토종닭계란/하늘농장,10000,10000,0
2018-06-01,440920017,C012040,여자학생복,[LAP] AF2WB674. 트러블러 블라우스,26910,25240,-1670
2018-06-01,730425976,C013040,청바지,워싱헤짐팬츠/주니어/청바지/아동공용바지/면바지,9900,9900,0
2018-06-01,402163108,I053020,스케치북,무료배송 매수많은 캐릭터 스케치북 종합장 10권/5권,4900,4900,0
2018-06-01,548424690,C013010,점퍼,[메이드]바람막이/점퍼/아웃도어/자켓/야상/남성/남자,19800,19800,0
2018-06-01,1865759699,E011030,거실장,공장직판 원목 2칸거실장 협탁 tv다이,69000,68000,-1000
2018-06-01,1057558257,A022030,생수,트레비 레몬 500ml/라임/플레인/자몽/음료수,14500,14500,0
2018-06-01,517423951,A019110,드레싱,미담채드레싱소스/과일드레싱/탕수육/돈까스/타르타르,10900,10900,0
2018-06-01,1144998488,A017250,고사리,[코스트코] 파인 프렌치 그린 빈스 2.27kg 초록깍지 강낭콩,21990,21990,0
2018-06-01,481045146,C013020,티셔츠,반폴라 스튜디오 티셔츠 긴팔폴라티 어린이겨울폴라티,11110,11110,0
2018-06-01,2087548583,C012060,여자내의,라인업팬츠 /팬츠/반바지/핫팬츠/바지/ 톰앤래빗,12000,11280,-720
2018-06-01,1010380510,A013020,명태,[기획전][산지직송] 민물장어 1kg (1~3미),58500,48500,-10000
2018-06-01,299612751,C013020,티셔츠,유니_여름 팬츠&티셔츠 9종택1(H162H403 H162U013 H162M047)/ 흄,6900,6010,-890
2018-06-01,440944078,C012040,여자학생복,[LAP] AF2WB570. 매쉬 사틴배색 블라우스,31860,29890,-1970
2018-06-01,1630966632,E011060,의자,[위드퍼니처]식탁의자모음19 900원~/원목의자/목재의자/식당의자/업소용의자/카페의자,19900,17910,-1990
2018-06-01,1048663809,C011050,남자내의,DON1886 밴드옥스포드카고스판남자면바지,38000,38000,0
2018-06-01,268263952,F012050,의료측정기,휴비딕비접촉식체온계/써모파인더에스/FS-300/HFS-900,35700,35700,0
2018-06-01,1217645153,C015040,장갑,스포츠장갑 스마트폰장갑 스마트폰터치장갑 레저장갑,4800,4420,-380
2018-06-01,1298044510,C013020,티셔츠,신상 빅사이즈/맨투맨/루즈핏/티셔츠/여성의류/롱티,10800,9800,-1000
2018-06-01,698496641,C014020,유아복,북유럽스타일 롬퍼 우주복 바디수트 신생아옷 실내복,13900,13900,0
2018-06-01,341446876,A019100,식초,OTTO 오토 후추 영흥식품 1Kg / 오토미 흑후추 가루 9,9000,9000,0
2018-06-01,1011211660,A017020,상추,간편샐러드_양배추&적채 100G,1000,1000,0
2018-06-01,1972825370,C013010,점퍼,여자비취가디건/여름쉬폰집업/망사베스트/청남방자켓,25000,24000,-1000
2018-06-01,1241784780,C011030,남자학생복,(남자옷도매)MCD-909 안배색 가디건 (FREE) 3COLOR 패,27230,27230,0
2018-06-01,710987289,A022050,탄산음료,초특가 인기 캔음료 모음전 사이다 콜라 커피 음료수,7900,7900,0
2018-06-01,1011125041,A011100,라면,[CJ직배송] 쉐프솔루션 면비빔용소스890G+제일제면소소면 900g X2개,12980,8900,-4080
2018-06-01,48472489,E041050,냄비,바이오 뚝배기 전골냄비 모음 내열냄비 업소용 식당,14000,13860,-140
2018-06-01,1346162199,A014010,우유,엿기름(화미 15K)/엿질금 고추장재료 시골엿기름 엿기름가루 식혜재료 보리가루 엿질금,51790,49210,-2580
2018-06-01,347198871,E031040,전기레인지,RT9 (Coms) 2캔용 USB 미니 냉온기 (WH1202),65710,64400,-1310
2018-06-01,896691209,A011100,라면,[샘표]바지락 칼국수 (111g),990,990,0
2018-06-01,1308739795,C014010,아동복,기능성 7부 바지 K2FPY697F/ 휠라 키즈,10000,9500,-500
2018-06-01,61174560,A016040,포도,(전남오픈마켓/애플파이)거봉&청포도&적포도900g택1,9900,9900,0
2018-06-01,2119435831,A012010,국산쇠고기,[무항생제] 우족 1.5kg 1등급,40500,40500,0
2018-06-01,395137652,C012040,여자학생복,[쎄쎄쎄]여성 셔츠남방 모음/스트라이프/롱/박스/체크,14900,14900,0
2018-06-01,416702948,C011020,남자상의,아이보리 체크 밍크털 코트 남성코트 캐주얼코트 털코,99980,99980,0
2018-06-01,651489531,C013010,점퍼,장가네몰/남성점퍼/남자점퍼/봄신상점퍼/잠바/,77000,77000,0
2018-06-01,927944677,A011170,떡,특[떡장인 황대규옹]NEW 영양찰떡 45Gx20개 30개 40개,22500,22500,0
2018-06-01,312092939,C012040,여자학생복,[리안뉴욕] 기본핏 브이넥 반팔 블라우스 (RMFWBL980),19000,15580,-3420
2018-06-01,1093341008,E031080,선풍기,대성하이원_원적외선 전기히터 DSHE-70 (33~49.5㎡),857000,857000,0
2018-06-01,769502515,C013020,티셔츠,[키키제제] 유아 티셔츠/남아/반팔티/맨투맨/가디건,10900,10900,0
2018-06-01,1093341007,E031080,선풍기,대성하이원_원적외선 전기히터 DSPE-120 (49.5㎡~89.1㎡),1250000,1250000,0
2018-06-01,2145062717,F011150,건강기능식품,상쾌환 3g x 20개/숙취해소/헛개/컨디션/굿모닝,32500,32500,0
2018-06-01,352714070,A012010,국산쇠고기,대관령한우 골드2호,151760,151760,0
2018-06-01,870998162,A013150,어묵,범표부산어묵 생선살70%이상 고급수제어묵 생선살88%,7000,7000,0
2018-06-01,708878559,F012020,생리대,[위스퍼]보송보송 오버나이트 슈퍼롱 10Px4,17100,17100,0
2018-06-01,1225352619,C015040,장갑,리본 모직 장갑 방한장갑 리본장갑 패션장갑 손가락장,21540,21540,0
2018-06-01,855142486,E031080,선풍기,[기본배송무료][신일금속] 소각난로(이중연소식)/송풍모터 1/2마력 210W SL-800,1715000,1715000,0
2018-06-01,1652774047,G011070,자전거,베리벨로 프라임GS 20 18년형 20인치 접이식자전거,66900,66900,0
2018-06-01,329684555,C013010,점퍼,아이올리스 윈드 자켓 - KDD0608/ 네파키즈,39000,31980,-7020
2018-06-01,855142487,E031080,선풍기,[기본배송무료][신일금속] 소각난로 중(거꾸로 완전연소식)/ SL-850S,2359900,2359900,0
2018-06-01,1238130110,E061010,세탁세제,와이셔츠 약 셔츠깃때제거 와이셔츠약 와이셔츠세제,6770,6770,0
2018-06-01,1138665886,A013020,명태,두레생협 바다마을대구전(500g) 부침용냉동대구 대구,33390,33390,0
2018-06-01,457897504,E041050,냄비,나리히라 대리석 IH 인덕션냄비 (가스렌지겸용),19000,17800,-1200
2018-06-01,1986715714,C013020,티셔츠,국내산 남자나시티/민소매/골지/망고/롱/사각/남성,5900,5900,0
2018-06-01,899553065,A011080,밀가루,초이스L 금실면 (500G),3490,3490,0
2018-06-01,64841019,A017160,오이,무료배송 표고버섯 1Kg/ 목이버섯 표고채 통표고 버섯,17900,16900,-1000
2018-06-01,899553066,A011080,밀가루,초이스L 국수 소면 (900G),2290,2290,0
2018-06-01,1853880917,A013150,어묵,부산어묵 어육 70%이상 튀김어묵 20종 골라담기,2200,2200,0
2018-06-01,620289606,A014030,치즈,파마산치즈 227g 그리이티트치즈 가루치즈 파마산분말,15500,15500,0
2018-06-01,1292177130,I011010,TV,48인치49인치55인치 LEDTV UHD 삼성패널 티비 TV,299010,299010,0
2018-06-01,984487116,A011170,떡,칠갑 신당동 떡볶이 400G,1800,1800,0
2018-06-01,1052370254,F011150,건강기능식품,큐원 상쾌환 숙취해소 /최신제조상품,16900,16900,0
2018-06-01,1093341006,E031080,선풍기,대성하이원_원적외선 전기히터 DSPE-150 (49.5㎡~108.9㎡),1380000,1380000,0
2018-06-01,1093341005,E031080,선풍기,대성하이원_원적외선 전기히터 DSPE-200 (66~161.7㎡),2200000,2200000,0
2018-06-01,1093341004,E031080,선풍기,대성하이원_원적외선 전기히터 DSPE-250 (82.5~188.1㎡),2365000,2365000,0
2018-06-01,1093341003,E031080,선풍기,대성하이원_원적외선 전기히터 DSPE-300 (99~217.8㎡),2530000,2530000,0
2018-06-01,1093341002,E031080,선풍기,대성하이원_전기 라디에이터 DST-07R (14.4㎡),56000,56000,0
2018-06-01,1093341001,E031080,선풍기,대성하이원_전기 라디에이터 DST-09R (19.2㎡),65000,65000,0
2018-06-01,1493493914,A013170,생선통조림,유동 번데기탕 캔 구수한맛 280g X 24EA_1BOX 번데기,49950,48460,-1490
2018-06-01,1093341000,E031080,선풍기,대성하이원_전기 라디에이터 DST-13R (24.0㎡),89000,89000,0
2018-06-01,1784102723,L021020,장신구,[바보사랑]4005 하트 체크 이어링 (3colors),8000,8000,0
2018-06-01,688520898,C012040,여자학생복,수지네 빈티지 아디다스오리지널 블랙 베스트 여성 S,32580,32580,0
2018-06-01,1010137227,E041040,프라이팬,라체나계란치즈구이팬36cm,19900,19900,0
2018-06-01,1228263506,C012040,여자학생복,DBN1147 줄 배색 청남방 802S 블라우스 여성남방 여성,60720,60720,0
2018-06-01,1291562241,A013020,명태,절단코다리1kg-2kg 코다리찜 조림 찌개 손질 명태,5150,5150,0
2018-06-01,1010137230,L012030,칫솔,메디안)딥스케일링칫솔(미세모)4입,4990,4990,0
2018-06-01,306601218,C012030,여자상의,[제이엘프]예쁨보장 청순코디/원피스/블라우스/스커트,9900,9900,0
2018-06-01,884359665,A022030,생수,롯데칠성음료 아이시스 8.0 300ml x 40개입,8900,8900,0
2018-06-01,1264444884,E021010,침구,겨울왕국 면기모 패드 - 뷰티선샤인 (064187) 캐릭터,57680,52550,-5130
2018-06-01,269875596,E041020,컵,도자기 카페머그컵-머그잔/커피잔/물컵/답례품,3000,2970,-30
2018-06-01,2123316489,E061040,부엌용세제,대용량주방세제 1종주방세제18k/트리오14L/애경트리오,8800,8800,0
2018-06-01,1546041172,I011010,TV,POL32H 32인치LEDTV / IPS 무결점패널 / 2년방문AS,125000,125000,0
2018-06-01,398013750,C013020,티셔츠,[나이키골프]AA1063-010 나이키 골프 에센셜 GRFX 폴로반팔티(영등포점B),39000,31500,-7500
2018-06-01,988158199,E061070,가정용비닐용품,초L) 롤팩(중) 25*35*200매,2240,2240,0
2018-06-01,1340627351,A011010,쌀,2017년 햅쌀 단일품종 농협쌀 10kg 모음전/당일도정,28800,28800,0
2018-06-01,988158198,E061070,가정용비닐용품,초L 지퍼백(대) 25*30*20매,2500,2500,0
2018-06-01,672096927,L021020,장신구,[걸핀스]고객만족 재구매100%써지컬,50,50,0
2018-06-01,1320536338,E011020,침대,프리미엄 패밀리침대 Q+SS 밸런스 본넬 매트리스,659800,640010,-19790
2018-06-01,1602665437,L021050,우산,고급 우산 자동 골프 장우산 의전용 대형 블랙 2인용,22500,21400,-1100
2018-06-01,457104977,E021010,침구,시원한 여름이불 린넨이불 리플이불SS/Q,11900,11900,0
2018-06-01,1050375502,I031040,생화,캠핑 샤워기 설겆이통 다용도물통 샤워기 캠핑용품,3900,3590,-310
2018-06-01,625837209,C021040,실내화,리복 매장정품 휘트니스 크로스핏나노7 BS8345,99000,85140,-13860
2018-06-01,263557089,A014020,분유,[1+1] 베비언스 산양액상분유 6입 180/240ml + 니플,25900,25900,0
2018-06-01,119720589,A022050,탄산음료,닥터페퍼 355ml x24can,17900,17900,0
2018-06-01,2130094491,L012060,샴푸,정문희 천연샴푸 비듬 지성 두피 약산성 지루성 각질,22500,22500,0
2018-06-01,545759756,F012050,의료측정기,블루투스 바나나 체온계/체온 실시간 모니터링,29000,29000,0
2018-06-01,1857599950,C012020,원피스,여성정장/면접/빅사이즈/정장세트/유니폼,52000,49800,-2200
2018-06-01,989881143,A016150,아몬드,초L프레시)아몬드 125G,4990,4990,0
2018-06-01,989881144,A016150,아몬드,초L프레시)알땅콩 135G,2990,2990,0
2018-06-01,1913631460,C013010,점퍼,봄자켓 여름자켓 정장 빅사이즈 여성의류 55~110,29900,29900,0
2018-06-01,1972321513,C011050,남자내의,남자 빈티지워싱 스판 카고팬츠 면바지 빅사이즈가능,29900,29900,0
2018-06-01,1931107462,A011070,혼식곡,초이스엘 도토리묵가루(300G),7350,7350,0
2018-06-01,1734190435,L012040,치약,암앤해머 컴플리트케어치약 178gX5개입,18800,17900,-900
2018-06-01,1261920143,C012060,여자내의,매킷 헤지 청반바지 여성반바지 패션파지 반바지 데님,17870,17870,0
2018-06-01,1920553634,C014010,아동복,(숲자람) 기능성 키즈 바람막이 여아바람막이 유아용,69650,69650,0
2018-06-01,369741913,C013010,점퍼,WWS2160G 커플여자웰론후드롱패딩점퍼 여성패딩점퍼,61270,61270,0
2018-06-01,1575784983,F012030,안경,블루라이트 차단 안경 시력보호 청광 안경 PC안경,14900,14900,0
2018-06-01,677098687,C012060,여자내의,BYC여성 기모 유발 레깅스타이즈(T1103) 타이즈 스타킹 팬티스타킹 BYC 레깅스,12690,11300,-1390
2018-06-01,1743671506,A017220,양파,대파분말(중국산) 1kg/대파/파/가루/선식/제빵/육수,15000,15000,0
2018-06-01,214990290,C021040,실내화,나이키운동화 22종택1 다운쉬프터 레볼루션 외 런닝화,48000,42240,-5760
2018-06-01,451924993,E031130,보온매트,한일의료기웰빙 리얼생황토악어투톤 전기매트싱글 한,172340,172340,0
2018-06-01,1690531831,E041070,밀폐용기,유럽풍 전자렌지용 냉동밥보관용기 심플 쿡앤밥 12개,6900,6350,-550
2018-06-01,1917808758,C015030,넥타이,넥타이 지퍼넥타이 자동넥타이 기본 수동 교복 명품 정장,3900,3900,0
2018-06-01,896548913,L012090,기초화장품,[유한킴벌리]그린핑거 마이키즈 바스 320ML,18800,9990,-8810
2018-06-01,630001838,A016090,참외,달고 싱싱한 성주 꿀 참외 8kg/안전포장,14900,14900,0
2018-06-01,959431924,A017130,도라지,[고구마루] 한끼 호박고구마 말랭이 70g x 3봉 + 고구마 스틱 65g x 3봉,21900,17500,-4400
2018-06-01,119120954,F012020,생리대,NEW 엘리스 생리대 크리닉스 오버나이트 10매 2팩,12900,12900,0
2018-06-01,1014050291,A019170,냉동식품,오양 교자만두2.8kg,12900,12900,0
2018-06-01,896548914,L012090,기초화장품,[유한킴벌리]그린핑거 마이키즈 샴푸 320ML,18800,9990,-8810
2018-06-01,27688922,C011050,남자내의,지오다노 코튼 스판 페이크 삭스 158153,2940,2940,0
2018-06-01,749100877,C011050,남자내의,아디다스 여성 우븐 슬릿 쇼트 ( BP9307 ),42050,37430,-4620
2018-06-01,982467129,C013020,티셔츠,[대구백화점 II관] [게스키즈] 스트라이프티(G83KCT030),36000,28800,-7200
2018-06-01,1418899508,A022050,탄산음료,롯데칠성몰 탄산 칠성사이다 280mlx12병,13900,13900,0
2018-06-01,1829403279,C013010,점퍼,국내산 신상품 봄/여름 캐주얼/정장 자켓/콤비/마이,59500,59500,0
2018-06-01,766928918,E031120,믹서,[한일] 한일 미니유리믹서 GMFC-670 저소음/다기능/3유리보틀,98000,89100,-8900
2018-06-01,1387701866,E061040,부엌용세제,닥터큐 우유분해 세정제 우유분해세정제 우유분해살균,46340,46340,0
2018-06-01,260336949,I011030,사진기,명품마을 캐논 정품 EOS 800D + 18-55mm IS STM,829900,829900,0
2018-06-01,899553035,A018090,잼,프라임L 유기농 딸기잼 (300G),4900,4900,0
2018-06-01,15144739,L012040,치약,[본사직영] 플레시아 치약 100g x3,8900,8900,0
2018-06-01,1419552861,E061020,섬유유연제,(특가)피죤 리치퍼퓸 2000mlX 4개 / 섬유유연제,13800,13800,0
2018-06-01,829684336,L021020,장신구,무료배송 14K 정품 Gold 슬림큐빅스틱 반지 오하나 스,227700,220870,-6830
2018-06-01,489880090,C012040,여자학생복,엄마옷 빅페이즐나염앙상블-XEN804009-/ 마담4060,54900,46120,-8780
2018-06-01,1403312679,A019060,된장,강릉 촌막장 된장 고추장 1kg 시골틱 나게 맛있어요,15000,15000,0
2018-06-01,2031874678,C013020,티셔츠,RUDDER 프리미엄 반팔티 M~XXXL 빅사이즈 반팔티셔츠,9900,9900,0
2018-06-01,145947590,I031040,생화,콩맨 데저트 침낭 캠핑침낭/동계침낭/사계절/군용,17900,16030,-1870
2018-06-01,1197553805,E031120,믹서,[LG전자] LG WHISEN 제습기 실버 DQ198PSE (19L)(강남점),665200,632030,-33170
2018-06-01,173256523,L021020,장신구,은 볼팔찌 4.0mm ~6.0mm 전체순은,20000,20000,0
2018-06-01,1303052752,C013010,점퍼,가죽자켓 라이더자켓 가죽점퍼 P171가죽가죽점퍼가죽,95390,95390,0
2018-06-01,579030541,A017230,마늘,18년산 햇양파 정품대과 8400원 오늘만이가격 햇 양파,8400,8400,0
2018-06-01,1036060664,E061060,살충제,일양약품 초파리용품(1+1)/트랩/스프레이/모기살충제,11900,11900,0
2018-06-01,1120057520,F011130,홍삼,[농협홍삼/한삼인] 홍삼애 아로니아진 70ml*10포*3박스,30100,30100,0
2018-06-01,397475531,C013010,점퍼,(냉동)양념숙성소막창1kg2개,132370,132370,0
2018-06-01,895648492,A012040,닭고기,초이스L 생닭 9호(800G),4490,4490,0
2018-06-01,984306443,E061090,방향제,[P&G]페브리즈 화장실용 비치형 산뜻한 정원향 5.5ML,6500,6500,0
2018-06-01,1393439448,I031040,생화,빅사이즈 오로라 해먹모음 침대해먹 그물 야외침대,19800,18220,-1580
2018-06-01,1445910615,C011050,남자내의,남자면바지/슬랙스/밴드/일자/조거/슬림핏/바지,14900,14900,0
2018-06-01,222226865,C012040,여자학생복,FREE 폴라넥골지여자긴팔니트티,16140,16140,0
2018-06-01,625683450,C013040,청바지,신상 28~42 일자 청바지 남자 빅사이즈 밴딩 9부,16800,16800,0
2018-06-01,401153945,E011030,거실장,[아트랙] 펠리스 익스텐션거실장/tv다이/tv장/tv선반,66000,66000,0
2018-06-01,632098354,C011030,남자학생복,골프 바람막이 7094 더블립 7082 빅사이즈,87580,84960,-2620
2018-06-01,60027238,A011090,국수,컵라면 98종 골라담기/ 신라면 진라면 육개장 왕뚜껑,590,490,-100
2018-06-01,1120057518,F011130,홍삼,[농협홍삼/한삼인] 홍삼애 천진 70ml*10포*3박스,30100,30100,0
2018-06-01,984306445,E061090,방향제,[P&G]페브리즈 화장실용 에어 상쾌한 하늘향 275G,6500,6500,0
2018-06-01,214412427,L012030,칫솔,[오랄-비]크로스액션 컴플리트7 3입x2개+그린티 2입,11900,11900,0
2018-06-01,2115480230,F011150,건강기능식품,[세노비스] Advanced 트리플러스 90캡슐x2/선물세트+쇼핑백,69000,61620,-7380
2018-06-01,1832321078,A014040,발효유,[신앙촌]신앙촌 런 요구르트 12P[갤러리아],17000,16150,-850
2018-06-01,333817347,C013060,등산복,여름 남성 등산 티셔츠 남자 작업복티 상의,7900,7080,-820
2018-06-01,1931107406,A011070,혼식곡,초이스엘 녹두빈대떡 가루(500G),6180,6180,0
2018-06-01,1120057517,F011130,홍삼,[농협홍삼/한삼인] 기운담은 선물세트(홍기천50ml*15포 + 홍삼기력100ml*6병),59900,59900,0
2018-06-01,990003226,L012040,치약,[LG]LG)페리오클링스(상쾌한민트)100G*3,9900,4990,-4910
2018-06-01,1120057516,F011130,홍삼,[농협홍삼/한삼인] 건강담은 선물세트(홍기천50ml*20포 + 홍삼기력100ml*8병),79900,79900,0
2018-06-01,1262807682,F012050,의료측정기,VT 휴비딕 손목형 혈압계 비피첵 HBP-700+사은품,34000,30940,-3060
2018-06-01,862006108,C011030,남자학생복,데일리 스타일링 데님 셔츠/스트라이프/오버핏/캐주얼,19900,16900,-3000
2018-06-01,944866902,E041020,컵,카페리/커피잔/머그컵/카푸치노잔/카페영업용커피잔,26500,26500,0
2018-06-01,895803209,A012060,햄및베이컨,롯데 의성마늘햄 480G,9480,6290,-3190
2018-06-01,1892326825,C013050,운동복,차량용컵홀더 차아네 차량용5단멀티컵홀더,5900,5900,0
2018-06-01,676180029,A019040,소금,백설 허브맛솔트 55g / 3종 / 천일염 허브솔트 소금,1900,1900,0
2018-06-01,1781418770,L021020,장신구,[바보사랑]P6295 블루 스퀘어 큐빅 귀걸이(케이스포함),17800,17800,0
2018-06-01,895648488,A012040,닭고기,초이스L 영계6호 (500G/마리)(점포마다 브랜드 및 포장지가 상이할수 있습니다),2990,2990,0
2018-06-01,342772910,A022010,주스,웅진)자연은 포도100 180ml12개입 포도음료 주스 음료,14070,12530,-1540
2018-06-01,1320536371,E011020,침대,프리미엄 패밀리침대 Q+Q 밸런스 본넬 매트리스,698900,677940,-20960
2018-06-01,1302772352,C012060,여자내의,스타일 멜빵 데님팬츠-M1054 와이드 힙합청바지 데님팬츠 데님스커트 멜빵청바지,35730,31800,-3930
2018-06-01,1144642013,E021010,침구,동물원 매트커버세트 아동침구 아동이불 아동매트 매,94500,84340,-10160
2018-06-01,463785027,L021030,가방,노트북가방,16800,16800,0
2018-06-01,346166723,F012020,생리대,시크릿데이 생리대 센스 중형12PX8팩,12900,12260,-640
2018-06-01,985357902,A014010,우유,남양 초코에몽 250ML,1000,1000,0
2018-06-01,1581674980,F012050,의료측정기,케어센스2 혈당측정기 시험지60장+침210+솜100+사은품,23700,23700,0
2018-06-01,156648850,A018090,잼,오뚜기)딸기쨈 500g x 6개 국산딸기 달콤 빵 과자,36780,36780,0
2018-06-01,1408080150,C011020,남자상의,단골15%쿠폰! 제제 슬림핏 캐주얼 정장/양복/슬림,78800,78800,0
2018-06-01,897620525,A012020,수입쇠고기,E-호주산 냉동 우갈비(꽃갈비_LA식갈비)구이용 100G-뼈있음,3190,2488,-702
2018-06-01,1442889248,C014010,아동복,아동남방/남아정장/청남방/돌복/아기옷/아동복/흰남방,17900,17900,0
2018-06-01,685775252,C012040,여자학생복,쉬즈미스 블루라벨 히든버튼 블라우스_SWWBLH22020_BL/ 쉬즈미스,29000,24070,-4930
2018-06-01,1320536281,E011020,침대,프리미엄 패밀리침대 SS+SS 밸런스 본넬 매트리스,580200,562800,-17400
2018-06-01,625658617,C012040,여자학생복,[로엠(ROEM)]R넥 루즈핏 블라우스 (2colors) RMBL813R11,41900,41900,0
2018-06-01,1035820081,E061060,살충제,해피홈/컴배트/좀벌레아웃/좀벌레싹/옷장/서랍장/콤보,3100,3100,0
2018-06-01,952522706,E061010,세탁세제,순수크린 세탁세제 2.5Lx 4개 10無 세제 자연유래성분,6900,6900,0
2018-06-01,560984114,C013030,스웨터,롱 긴팔니트 45-174-004 남성캐쥬얼 캐쥬얼티셔츠 남,39370,39370,0
2018-06-01,1714862699,C012040,여자학생복,[이사베이]라인 배색 집업 가디건 (VQCBD5170)_W3R6,31000,29450,-1550
2018-06-01,1337156336,A018020,사탕,푸른농장 아이밀크 27gx12/우유캔디/초유사탕/뽀로로,20900,20900,0
2018-06-01,1328555757,E051030,디지털도어록,밀레 MI-350K 위너 디지털도어락 현관문 도어락 번호,41000,36900,-4100
2018-06-01,503846740,C013010,점퍼,[마담4060]엄마옷 마담4060 펀칭소매카라점퍼-XJP805014-,68900,65460,-3440
2018-06-01,988930999,F012020,생리대,[엘지생활건강] 천연코튼 롱 무향 66p(그린) x2,8200,8200,0
2018-06-01,988930996,F012020,생리대,[엘지생활건강] 천연코튼 라벤더 일반 84P x2,9400,9400,0
2018-06-01,1136158614,I031040,생화,식약청인증 모기퇴치제 물파스 밴드 3종세트 무료배송,6900,6350,-550
2018-06-01,988930998,F012020,생리대,[엘지생활건강] 천연코튼 롱 무향 66p x3,21000,16800,-4200
2018-06-01,988930997,F012020,생리대,[엘지생활건강] 천연코튼 라벤더 롱 66P x3,15600,15600,0
2018-06-01,1263942748,F012050,의료측정기,브라운 정품 귀체온계 IRT-6520/필터21개포함/as가능,89810,82500,-7310
2018-06-01,40883704,E021020,커튼,[난또 은사 실커튼]반짝반짝 은사 실커튼 실커텐 비즈발 블라인드 로만쉐이드 스핑클,6000,6000,0
2018-06-01,1312242228,C012030,여자상의,nn66 스트랩 베이직 린넨원피스 - 네이비 린넨원피스,34970,34970,0
2018-06-01,845176122,A018080,설탕,CJ 롱슈가 (5gⅩ100개) / 각설탕 / 스틱설탕,1650,1650,0
2018-06-01,2089497740,A011050,콩,산과들에 17년 국내산 햇 생 땅콩 1kg 볶음땅콩 800g,12500,12500,0
2018-06-01,1078887815,A011010,쌀,2017년 햅쌀 온누리 쌀 20kg/당일도정,50900,50900,0
2018-06-01,442409146,C011020,남자상의,아이보리 체크 밍크털 코트 캐쥬얼코트 남성용코트 코,111770,111770,0
2018-06-01,529641840,C012060,여자내의,스판 차콜 교복치마 교복 예쁜교복 교복쇼핑몰 중학교,37070,35960,-1110
2018-06-01,1433536804,F011150,건강기능식품,미인활 75ml x 20병_여성 소화제_부채표 동화약품,19770,19770,0
2018-06-01,1172342225,L021020,장신구,2월탄생석 4mm 천연자수정 티아라 원터치귀걸이,182000,182000,0
2018-06-01,152902316,L021010,손목시계,[간지나는 신상]남성시계/메탈시계/패션시계/손목시계,16900,16900,0
2018-06-01,1390072379,D031010,주택수선재료,탑스테인 오일스테인 4리터 방부목페인트 우드케어,20000,20000,0
2018-06-01,512565820,A013160,맛살,(냉동)한성 꽃맛살F 2kg 식품 꽃맛살 식자재 한성 맛,28630,28630,0
2018-06-01,1857260208,A014020,분유,일동후디스 프리미엄산양분유 1 2 3 4단계 (800gX3캔),120000,120000,0
2018-06-01,1750730982,A022010,주스,[포시즌홈]자라섬 뱅쇼 베이스 3000ml,49000,49000,0
2018-06-01,1903318764,A019060,된장,천년의유산 전통 된장(900G),25000,25000,0
2018-06-01,572695971,C014020,유아복,[대구백화점 I관] [로엠걸즈]여름QR뷔스티에티셔츠(RGRA18S3Q),25900,24090,-1810
2018-06-01,55982742,C013040,청바지,[바지킹] 밴딩팬츠/신상/슬림/일자/빅사이즈/스판,11900,11900,0
2018-06-01,419564066,E011070,식탁,캔버라 기획 4인식탁세트/원목식탁/4인용식탁,99000,99000,0
2018-06-01,595014205,A022030,생수,(무료배송)씨그램 450ml x20pet레몬 라임 플레인,12990,12990,0
2018-06-01,1895982292,C012030,여자상의,oo01 7부소매 스트랩 단가라 ops - 오렌지 오렌지원피,18550,16510,-2040
2018-06-01,1532851585,A014030,치즈,코리원/프로마제 모짜렐라치즈 1kg/치즈/피자치즈,7600,7500,-100
2018-06-01,336266096,C012060,여자내의,협력업체 PBM8060 쎄무롱플레어스커트,19870,19870,0
2018-06-01,625837100,I031040,생화,국산파라솔세트/파라솔+테이블+의자4개/야외용/음식점,89000,89000,0
2018-06-01,175462578,C013050,운동복,디지니정품 루즈핏 미키나염 7부팬츠 트레이닝복세트,37900,37900,0
2018-06-01,1379840593,E041010,식기,안성/방짜/유기/손조각/학/김수영/놋그릇/반상기/세트/무형문화재/혼수/예단/선물/외국,598000,598000,0
2018-06-01,798954544,E031130,보온매트,[한일의료기] 우레탄 전기매트 HL-M105D 더블 /매트/선물/,108800,108800,0
2018-06-01,1965503669,G011070,자전거,삼천리 클래식 여성용자전거 베네치아22인치 7단,126500,113850,-12650
2018-06-01,1183658875,G011070,자전거,알톤 콤파스/알로이차체/ 하이브리드/ 시마노 원터치21단/R6021,229000,201980,-27020
2018-06-01,798954547,E031130,보온매트,[한일의료기] 거실 매트(소) HM-101DW (1000x1830) /매트/선물/,90200,90200,0
2018-06-01,1100284299,A011110,당면,국내산 도토리전분 도토리 묵말랭이250g 2개,62810,62810,0
2018-06-01,1242759542,A015020,식용유,라온 현미유 (500ml) 국내산미강유 유기농산수몰,5100,5100,0
2018-06-01,1239854960,C011030,남자학생복,(색상 : 핑크) FSS18046 스트라이프 걸러,26500,26500,0
2018-06-01,757007363,C012020,원피스,[마르조] 여성릴렉스팬츠4종,29800,24740,-5060
2018-06-01,531033104,A019080,고추장,태양초골드고추장1.8kg+450g 재래식된장2kg+300g 쌈장,6600,6600,0
2018-06-01,1883705803,C013010,점퍼,엑스톤즈 N2B 항공점퍼,187000,185130,-1870
2018-06-01,493733541,C013050,운동복,한국소방 분말소화기 자동차용 1.5Kg / 한국소방(HanC,47400,37070,-10330
2018-06-01,70545388,E021010,침구,시원한 여름이불/여름이불세트/매트리스커버 이불세트,8900,8190,-710
2018-06-01,84014531,F012020,생리대,깨끗한나라 생리대 모음전 (릴리안 순수한면),1800,1800,0
2018-06-01,1020527154,E011070,식탁,추가할인/삼익가구 스테이 원목 4인/6인 식탁 풀세트,134100,134100,0
2018-06-01,1162883086,A019080,고추장,황교익미식가이드-전통의 발효명가옹고집프리미엄장,60900,59900,-1000
2018-06-01,600972207,A014030,치즈,파마산 블렌드 치즈가루 227g,8000,7900,-100
2018-06-01,985357934,A015010,참기름,백설 고소한 들기름_300ML,6580,6580,0
2018-06-01,2060362267,I031010,장난감,[아가플러스] 목욕놀이/물놀이/버블게/고래/해마/오리/돌고래,18000,14900,-3100
2018-06-01,1830785456,I012010,컴퓨터,LG전자 B50 중고 컴퓨터 PC,321000,321000,0
2018-06-01,287087405,I011030,사진기,올림푸스PEN E-PL8 14-42mm셀카 OM-D E-M10 II 6%쿠폰,550000,464850,-85150
2018-06-01,620290475,A014030,치즈,프리미엄 파마산 1kg 파마산치즈 치즈가루 파마산분말,21400,21400,0
2018-06-01,956662323,A019060,된장,[대상]청정원 순창 재래식生된장 2KG,12500,12500,0
2018-06-01,1385410327,E061050,청소용세제,메디아쿠아 500ml + 4리터 살균소독제 살균 방역 위생,25000,22750,-2250
2018-06-01,1238215730,C011020,남자상의,아이보리 체크 밍크털 코트 남성용코트 털코트 코트,105820,105820,0
2018-06-01,1431253808,C011050,남자내의,밴딩 우유바지/푸딩바지/빅사이즈/봄바지/간절기옷,7900,7900,0
2018-06-01,892022747,C012030,여자상의,원피스/롱원피스/나시원피스/미니원피스 플레어원피스,9900,9900,0
2018-06-01,798954520,E031130,보온매트,[한일의료기] 항균압축 전기매트 HL-M106S 싱글 /매트/선물/,148300,148300,0
2018-06-01,982433642,A013110,마른오징어,초이스L)신선한 하루 국물용 멸치(100G/봉),2990,2990,0
2018-06-01,1301145156,E011040,소파,크로바의자 보조 쇼파 공의자/1인용 안락의자 수유,41900,41900,0
2018-06-01,1177059820,C012040,여자학생복,[르오트] (TV홈쇼핑방송/무료배송) 포레스트 데일리 SUMMER 가디건 4종세트,19800,17820,-1980
2018-06-01,900361360,A019080,고추장,해찬들 태양초골드고추장 200G,3550,3550,0
2018-06-01,461099063,C013010,점퍼,라보니 아동 리얼폭스퍼 다운점퍼 -블랙 /(관련) 아동,120200,102170,-18030
2018-06-01,904282813,A017300,미역,대천참다온김/10봉+10봉/박스배송/가정용/김/대천김,14900,14900,0
2018-06-01,1124653170,E031080,선풍기,대웅모닝컴 히터/스탠드형/5방향/전도안전스위치 DWH-5055WS,33500,33500,0
2018-06-01,1034065763,A017020,상추,온새미로 적상추 제철상추(4kg/2kg) 내외 최상품!!,25000,25000,0
2018-06-01,896548890,L012090,기초화장품,[유한킴벌리]그린핑거 마이키즈 로션 260ML,20500,10900,-9600
2018-06-01,335284052,C013050,운동복,아디다스 여성 아디제로 트랙자켓(CE0330) 여성스포츠,145630,145630,0
2018-06-01,255529514,C013020,티셔츠,[에뜨와]제이포인트 JP-07L355082(대구신세계),39000,32160,-6840
2018-06-01,2070123592,C012040,여자학생복,마리 긴팔니트티 LDZ013 여성의류 여성니트티 / 참고,83500,70980,-12520
2018-06-01,878900038,A019080,고추장,해찬들우리쌀태양초고추장(200G),1950,1950,0
2018-06-01,798954518,E031130,보온매트,[한일의료기] 황토참숯 전기매트 HI-105S 싱글 /매트/선물/,81600,81600,0
2018-06-01,798954516,E031130,보온매트,[한일의료기] 황토참숯 전기매트 HI-105D 더블 /매트/선물/,87800,87800,0
2018-06-01,458572173,A011010,쌀,햅쌀 씻어나온 오뚜기쌀 가바백미 1kg (가바함량10배),4500,4500,0
2018-06-01,1409314394,L012090,기초화장품,김정문알로에 큐어 알로에 수딩 젤 150ml X 2개,19900,19900,0
2018-06-01,298977195,E061010,세탁세제,슈퍼매직 세탁세제13kg 세제/ 가루세제/ 통,10900,10900,0
2018-06-01,846166367,C012030,여자상의,(도도한걸)레이스원피스/롱/데님/플라워/쉬폰/세트,9900,9900,0
2018-06-01,1425592775,A011010,쌀,신동진쌀 10kg / 충남예산,26200,26200,0
2018-06-01,1058740556,E011020,침대,인쏘노 저상형 패밀리침대 마리아쥬 + 매트리스 포함,203670,203670,0
2018-06-01,299526380,C013050,운동복,소낙스 더뷰워셔액 2L-6개 1박스/에탄올워셔액,33000,33000,0
2018-06-01,2070062022,C012060,여자내의,빅사이즈/망사/주름/롱/스커트 / 참고 망사주름롱스커,58700,49900,-8800
2018-06-01,1286120365,C013020,티셔츠,[지프] 온라인특가 지프 남녀공용 기본로고 반팔티6종,29000,21750,-7250
2018-06-01,194888306,A019060,된장,된장 쌈장 식용류,3880,3880,0
2018-06-01,1194446044,A012050,소시지,CJ 맥스봉 치즈 35g X 23개 805g/소세지/햄/키스틱,9180,9180,0
2018-06-01,1544395136,E061040,부엌용세제,특가!! 제로퐁1종 주방세제2500ml x 4개/6개 참그린,9000,8900,-100
2018-06-01,494714016,A012030,돼지고기,(두메촌) 국내산 한돈 생고기 돼지 뒷다리살 500g,2500,2500,0
2018-06-01,1331975089,A011160,빵,삼립냉동빵15종/베이글/와플/치아바타/바게뜨/머핀,3900,3900,0
2018-06-01,379006544,C013020,티셔츠,[무료배송][18SS] 남녀 로고 반팔티셔츠 10종 택1/ 게스,18500,18500,0
2018-06-01,1316023661,E041060,수저,수저 세트/숟가락/젓가락/양식기/나이프/스푼/포크,4000,4000,0
2018-06-01,1733381329,C011050,남자내의,최저가 작업복바지 카고 건빵바지 봄여름용 면바지,16500,16500,0
2018-06-01,165769831,A014020,분유,[아이배냇] 순산양유아식 4단계 800g,34800,33090,-1710
2018-06-01,504679860,C012040,여자학생복,[모다아울렛][크로커다일레이디스]쉬폰소재에 레이스 패치한 민소매 블라우스(CL8MBL1,89600,85120,-4480
2018-06-01,1528675894,C014010,아동복,[섀르반][섀르반] 부엉이 ST 라운지 세트 (K14B1OM801),9800,9310,-490
2018-06-01,2046823743,F012030,안경,디마크안경/안경테/당일발송/정품케이스/디마크/뿔테,15000,13800,-1200
2018-06-01,764691020,A017220,양파,싱싱한 흙쪽파/깐쪽파 김치용 나물 양념 싱싱지오,6000,6000,0
2018-06-01,198700861,D031010,주택수선재료,본크리트 방수재 4kg (옥상방수 방수페인트),26000,26000,0
2018-06-01,895827149,A014010,우유,[남양]남양 맛있는 우유 GT 200ML,750,750,0
2018-06-01,476577032,C013010,점퍼,YAN2166 양털집업자켓 양털잠바 집업자켓 양털집업 겨,14830,14830,0
2018-06-01,895827143,A011120,두부,[농심]농심 켈로그 첵스초코오곡(340G),4990,4990,0
2018-06-01,895827142,A013170,생선통조림,[동원]동원 꽁치 (400g*2),5990,5990,0
2018-06-01,598143157,L021020,장신구,14k정품 귀걸이 14k피어싱 골드 TR118_한쪽,27900,27900,0
2018-06-01,2010067698,F011120,인삼,산삼그대로 20ml X 30vial 비트로시스,96470,85860,-10610
2018-06-01,1976575043,E031010,전기밥솥,쿠첸 6인용 전기압력밥솥 CJS-FC0604F,112000,105280,-6720
2018-06-01,1360852798,C012030,여자상의,에찌 여름신상 특가할인 무료배송/원피스/투피스/정,34900,24900,-10000
2018-06-01,192345193,C012030,여자상의,떳다그녀 복수구매+무료배송! 여름원피스/린넨 특가,7800,7800,0
2018-06-01,976085293,E061030,전구,삼파장전구/삼파장램프/볼전구/형광램프/미니전구/LED,1500,1500,0
2018-06-01,1310454896,C012060,여자내의,s.a.d.e 샤데이 아이스쿨 스트레치 슬랙스 3종,39900,38900,-1000
2018-06-01,643976218,E031140,비데,{본사직영점} 노비타 비데 BD-N330T (생활방수 IPX4),179000,159000,-20000
2018-06-01,106260032,A017210,파,[정품특가]영양만점 토마토 3kg/5kg 웰빙식품,8000,6900,-1100
2018-06-01,152157046,A013090,전복,천우물산 자숙갯고동10kg(1kgx10),49060,49060,0
2018-06-01,1215747475,C011030,남자학생복,쿨링프리미엄 얼음조끼 머플러세트형,54330,48900,-5430
2018-06-01,554868734,C013010,점퍼,빅사이즈 DDK00221 스포티 폴리 집업 803 패션용집업,66790,66790,0
2018-06-01,1121057485,A014020,분유,[LG생활건강]베비언스 액상분유 6-12개월(2단계) 60개입 (니플미포함),92500,87850,-4650
2018-06-01,46134816,F012050,의료측정기,카스 팔뚝형 자동혈압계 LS-808 혈압측정기 혈압기,58800,54400,-4400
2018-06-01,450779915,C013010,점퍼,ZNE 트랙 탑 LS 블랙 트레이닝복 운동용자켓 져지자켓,123510,123510,0
2018-06-01,106939643,A016110,딸기,(냉동)국내산 딸기1kg,9820,9820,0
2018-06-01,1915723773,C013020,티셔츠,AST-3524 나시 후드 집업/ 앨빈클로,24900,21670,-3230
2018-06-01,397062722,A019060,된장,조선토종/콩된장/3kg/재래식/집/재래/강/시골/전통/구수한집/된장통/찌개/업소용/된장,32900,32900,0
2018-06-01,665249041,C012060,여자내의,엄마옷 데드라 8B-PT903 페릴와이드팬츠,50400,39870,-10530
2018-06-01,1530591245,C012020,원피스,MELODY F106 아이보리/코트/여자코트/겨울코디/겨울코트/자켓/점퍼 미국 여성토탈브랜,84700,84700,0
2018-06-01,1154029336,A019020,참깨,(면)논두렁 볶음참깨1kg 참깨 볶음참깨 잡곡류 깨 논,22660,22660,0
2018-06-01,978555203,C011030,남자학생복,압구정클럽 남녀공용 프리사이즈 하찌후드니트숄가디,72460,72460,0
2018-06-01,1269439636,D031010,주택수선재료,[네모마루]틈없는조립식마루(원판16p마감재8p)/베란다,35000,35000,0
2018-06-01,1355769435,C014020,유아복,[모노블랙][모노블랙] 체크배색 M자수티 53MTS181,7000,7000,0
2018-06-01,313246328,A016040,포도,동원)황도 슬라이스 400g x 12개 사시사철 맛있는,41360,41360,0
2018-06-01,1157619141,C013020,티셔츠,가족티/커플티/후드티/맨투맨/반티/단체티,9900,9900,0
2018-06-01,67416400,E041010,식기,수운학 반상기세트 / 그릇세트 선물세트,34900,34900,0
2018-06-01,103933919,C012020,원피스,[스테파넬]루프디테일 포인트 반팔 티셔츠(SF7MTS205)(광주신세계),38000,33920,-4080
2018-06-01,1910116031,F011150,건강기능식품,[함소아]NEW 바이오락토 플러스 A 100일(2gx100포)/어린이유산균 아기유산균 아연함유,59900,59900,0
2018-06-01,1270029030,E011020,침대,보스코 4구서랍침대/삼나무원목/수납침대/슈퍼/퀸침대,449000,438000,-11000
2018-06-01,489941686,C013040,청바지,큐니걸스 155cm 컷팅스키니진/ 큐니걸스,30700,25180,-5520
2018-06-01,1437774938,E031010,전기밥솥,쿠첸 6인용 전기압력밥솥/전기밥솥/밥솥 CJS-FA0601V,111000,111000,0
2018-06-01,410183900,A019160,밑반찬,무료배송/동서 리치스 통단팥 3kg x 6개/빙수팥 1박스,44100,44100,0
2018-06-01,1133830921,C013050,운동복,여자 여름 반팔 드레이닝복 세트 운동복 츄리닝-95706,35800,35800,0
2018-06-01,985382919,E031070,에어컨,신일 16인치 스탠드 선풍기 (SIF-167FSJ),139900,79900,-60000
2018-06-01,1254405545,A013010,갈치,낚시갈치 왕특대450g 순중량손질갈치 머리꼬리제거,6900,6900,0
2018-06-01,718964974,C012020,원피스,빅사이즈/이지/카라/롱/조끼 빅사이즈,43520,42220,-1300
2018-06-01,9344204,A013120,낙지,동해안 마른오징어 1.3Kg 20마리,48900,48900,0
2018-06-01,1439502264,A022020,두유,베지밀A/B/아몬드와호두/검은콩칼슘/애플망고/두유,19200,19200,0
2018-06-01,345191645,E011010,장롱,지센장롱시리즈/옷장 이불장 양복장 투서랍장 선반장,59000,59000,0
2018-06-01,2110026620,A014010,우유,콜드브루 바이 바빈스키 아메리카노 270ml X 5개/ 한국야쿠르트,10000,10000,0
2018-06-01,465347020,L012090,기초화장품,프리메라 와일드 씨드 퍼밍 아이크림 25ml 1개 아이케,74660,72430,-2230
2018-06-01,873346532,C021040,실내화,[아디다스]MENS RUNNING 알파바운스 6종 [DB1090][DB0206][AC8633][AC8634][CG4762][C,71400,60960,-10440
2018-06-01,504873912,C013040,청바지,[지오다노] 118522 펜슬핏 치노 팬츠,20000,16000,-4000
2018-06-01,1612400438,L012010,면도기,편리한 안경거치대 보비노 글라스클립,4900,4130,-770
2018-06-01,1265708839,C012020,원피스,헤리스 코트(EWHCHK10)/ 케네스 레이디,299000,269100,-29900
2018-06-01,1265708837,C012020,원피스,파스테르 코트(EWHCHK15)/ 케네스 레이디,399000,359100,-39900
2018-06-01,1265708835,C012020,원피스,비기체크 코트(EWHCHK01)/ 케네스 레이디,429000,386100,-42900
2018-06-01,263462168,A014020,분유,베비언스 산양 액상분유 0~24개월 20입,47900,47900,0
2018-06-01,798954550,E031130,보온매트,[한일의료기] 거실 매트(중) HM-101DW (1500x1830) /매트/선물/,116200,116200,0
2018-06-01,1354145909,E011060,의자,타이탄의자/사무용/중역/컴퓨터의자/피씨방의자/pc방,109000,109000,0
2018-06-01,1310981093,C021040,실내화,컨버스 로우/하이/기본 코어/척테일러 21종 모음전,41900,41900,0
2018-06-01,1368670249,A011040,보리쌀,국산 서리태속청 2kg /4kg구매시 찰흑미,30200,30200,0
2018-06-01,451089850,C013010,점퍼,무스탕 라이더 가죽자켓 WS_PU_08 무스탕 라이더,187160,187160,0
2018-06-01,1288758572,A018080,설탕,CJ / 백설 자일로스 설탕 2kg / 하얀설탕 / 갈색설탕,5100,5100,0
2018-06-01,549519416,A012060,햄및베이컨,특가세일/사조오양 베이컨 파지 1kg/베이콘/돼지고기/,13400,10900,-2500
2018-06-01,897644586,A019030,생강,양파 (1KG/망),2990,2990,0
2018-06-01,1597207988,F011130,홍삼,정관장 천녹삼(180G),240000,240000,0
2018-06-01,316649264,A022010,주스,웰치스캔 포도맛 355ml 24ea,27800,27800,0
2018-06-01,448198169,C013020,티셔츠,[무료배송]롱베이직폴라1 롱폴라티셔츠 롱목폴라티 슬,9990,9990,0
2018-06-01,1014241074,I011030,사진기,소니 사이버샷 DSC-RX100M5 정품 명품마을,1283000,1283000,0
2018-06-01,751198741,C013040,청바지,린넨드레스/아동/주니어/청반바지/데님/3부/구제롤업,22000,17600,-4400
2018-06-01,1114468474,A011170,떡,[신궁전통한과]명인김규흔 꿀약과 500g x 2봉,29900,29900,0
2018-06-01,691810858,A022010,주스,롯데칠성몰 델몬트 드링크팩 190mlx32팩/48팩,8900,8900,0
2018-06-01,1966429214,G011070,자전거,삼천리자전거 베네치아22 22인치 여성용자전거,126500,113850,-12650
2018-06-01,1234886552,A011130,시리얼,버터양파맛 감자튀김 시즈닝(500g)X10 업소 분 분말 c,76620,76620,0
2018-06-01,1876518548,E041070,밀폐용기,스텐락 27종스텐레스/스텐반찬통/스텐밀폐용기/스텐도시락 찬합/스텐김치통/김치통/ 반,3800,3500,-300
2018-06-01,382850505,C012040,여자학생복,[갤럭시] 와인 리넨 Y넥 카디건 (GA715AU05Z),191400,162690,-28710
2018-06-01,140122870,A011030,찹쌀,성진 업소용식자재 엿기름 1K 10봉 보리엿기름 식당용,88150,78460,-9690
2018-06-01,794235210,D031010,주택수선재료,듀럭스 곰팡이 방지 제거 방수 습기 프라이머 패키지,34000,33000,-1000
2018-06-01,1806323209,L021010,손목시계,[GUESS] 게스 W0993L2 여성용 가죽밴드 패션시계,119000,119000,0
2018-06-01,1082616202,C011030,남자학생복,남자 남성 빅사이즈 남방 셔츠 차이나 체크 정장,33900,33900,0
2018-06-01,1806323208,L021010,손목시계,[GUESS] 게스 W0885L13 여성용 가죽밴드 패션시계,129000,129000,0
2018-06-01,1806323207,L021010,손목시계,[GUESS] 게스 W0623L2 여성용 메탈밴드 패션시계,229000,229000,0
2018-06-01,1806323206,L021010,손목시계,[GUESS] 게스 W0836L3 여성용 메쉬밴드 패션시계,209000,209000,0
2018-06-01,313944793,C012030,여자상의,퓨리티 데님 롱원피스-M1062,31360,31360,0
2018-06-01,1806323205,L021010,손목시계,[GUESS] 게스 W0767L2 여성용 메탈밴드 패션시계,199000,199000,0
2018-06-01,1441458788,C013010,점퍼,[퍼스트레인] 1st Lane Scape 후드자켓/숏점퍼/스카프/숏자켓/통자켓/여성캐주얼/캐주,29800,14900,-14900
2018-06-01,2068311024,C011020,남자상의,남자아우터 데일리 모직 하프 코트 / 참고 남자아우터,113300,99710,-13590
2018-06-01,895355632,C012020,원피스,[로엠][로엠] 클래식 자수 코트 RMJH523R11,22300,21190,-1110
2018-06-01,921663223,C015020,모자,골드캡프리미엄 스냅백모자 균일가모음전/힙합모자,9900,9900,0
2018-06-01,1550388783,E011040,소파,보니타빈백 LF501 북유럽스타일/명품빈백,112900,112900,0
2018-06-01,2086019966,E041070,밀폐용기,[정품]보르미올리/스윙병/와인병/더치병/유리병,490,460,-30
2018-06-01,829857412,I011030,사진기,[사은품증정][파나소닉]루믹스 디카 DC-GH5 바디킷,2241000,2151360,-89640
2018-06-01,2077270078,I031040,생화,[맥스파이더] 정품 3D 이지웨빙 (루프랙없는 차량의 루프백 장착용),37000,34040,-2960
2018-06-01,1150208760,A022050,탄산음료,칠성사이다355ml 24캔 음료수 코카콜라 밀키스 뚱캔,11800,11800,0
2018-06-01,352714127,A012010,국산쇠고기,대관령한우 프리미엄 5호,235220,235220,0
2018-06-01,397062759,C012060,여자내의,[모라도](M.MORADO) 솔리드 H라인 니트 스커트 [M5S1SK510핑크],50000,47500,-2500
2018-06-01,1291899502,C015040,장갑,아디다스 COND 니트장갑(BR9919) 남성니트장갑 방한용,32900,32900,0
2018-06-01,1460211569,C021040,실내화,[락포트] 18S/S 토탈모션 로퍼 CG9091,180000,156600,-23400
2018-06-01,823591646,F012020,생리대,에리에르 엘리스 생리대 전체 골라담기,2900,2900,0
2018-06-01,532299225,C012060,여자내의,스판 밤색 교복치마 교복 예쁜교복 교복쇼핑몰 중학교,36090,35010,-1080
2018-06-01,722657100,C012020,원피스,빅사이즈/폼폼/온리/롱/베스트 빅사이즈,58760,57000,-1760
2018-06-01,72366361,I053030,복사용지,더블에이 A4 복사용지(A4용지) 80g 2500매 1박스,25430,23400,-2030
2018-06-01,1782239941,A013070,굴,바다해 국산 붉은대게살 700g 파지게살 홍게살 다리살,19000,19000,0
2018-06-01,345166692,A011140,부침가루,베이킹 아크릴 스텐실도안 어린이날 케익데코용스텐실,9910,9910,0
2018-06-01,1349255421,A013050,오징어,펭귄 꽁치캔 (1.8K) x6,79080,79080,0
2018-06-01,657053343,C013020,티셔츠,남 프린트 반팔 티 098501/ 지오다노,9800,8040,-1760
2018-06-01,1597026388,F011130,홍삼,정관장 홍이장군 3단계(20ML*30),120000,120000,0
2018-06-01,1810501771,L021060,유모차,진화하는 미래형 세쌍둥이 유모차 휴대용 티크듀오,220000,220000,0
2018-06-01,1158389860,L012060,샴푸,미용실전용/아론스캘프 쿨샴푸 비듬두피샴푸,15000,15000,0
2018-06-01,786110310,A017160,오이,후코웰알파 10병/코셔인증 후코이단/푸코이단/액상,1200000,1200000,0
2018-06-01,1608261502,L021020,장신구,실버)밀리언 목걸이(Short-White)스틱 슬림 목걸이 롱,17760,17760,0
2018-06-01,1806323212,L021010,손목시계,[GUESS] 게스 W0954L1 여성용 메쉬밴드 패션시계,169000,169000,0
2018-06-01,905750740,C013010,점퍼,빅사이즈민짱/시크한아우터모음/사파리/야상점퍼,49900,49900,0
2018-06-01,1806323211,L021010,손목시계,[GUESS] 게스 W0959L6 여성용 가죽밴드 패션시계,139000,139000,0
2018-06-01,1806323210,L021010,손목시계,[GUESS] 게스 W0647L2 여성용 메쉬밴드 패션시계,229000,229000,0
2018-06-01,509618065,C013050,운동복,모비스 크루저 루프백 캠핑루프백 캠핑용품 자동차루,254620,231920,-22700
2018-06-01,988929998,E061080,키친타월,초L프라임) 3겹 키친타올 160매*4롤,5990,5990,0
2018-06-01,219512711,I012060,저장장치,스카이디지탈 NKEY 메카닉 RGB 기계식키보드 1,168720,158600,-10120
2018-06-01,981599275,A019080,고추장,해찬들 수라상 약고추장 (200G),3990,3990,0
2018-06-01,509618061,C012060,여자내의,시크폭스 아드레닌 밴딩배기팬츠/ 시크폭스,30900,24110,-6790
2018-06-01,981658058,A013110,마른오징어,안심국물용멸치 200G,5990,5990,0
2018-06-01,953509705,L012010,면도기,[공식!] 도루코 페이스5 면도기획세트(면도기+날11입),21900,21900,0
2018-06-01,826160739,A012010,국산쇠고기,[무항생제 한우선물세트]한우 보신3호약 3.1kg,114000,114000,0
2018-06-01,1541927589,F012020,생리대,[예지미인] 예지미인플러스 순면 중형 16p x 10펙 A13867 생리대/,74900,74900,0
2018-06-01,549267181,C021020,구두,황토제화 황토발 천연소가죽 망사신사화,39800,39800,0
2018-06-01,1310307544,A011090,국수,(특가) 오뚜기진짜쫄면 x 10봉/팔도비빔면 열무 라면,11500,11500,0
2018-06-01,896632650,A019100,식초,[청정원]청정원 고소한 마요네즈 300g,2600,2600,0
2018-06-01,1973533777,C011030,남자학생복,여름남방.마남방.긴팔남방.와이셔츠.모시남방.아빠옷,16900,16900,0
2018-06-01,2083955739,C011030,남자학생복,(SR)SEL1973 양기모면집업후드자켓 /(참고)남성빅사이,58100,51130,-6970
2018-06-01,458968125,C013050,운동복,55~88 루즈핏 빅사이즈 티셔츠 3부 트레이닝복 세트,24900,24900,0
2018-06-01,949388692,A019060,된장,자연향 국내산콩 전통 메주 5덩이(개당 1.6kg 내외)/붉은 고추+숯 증정,89900,89900,0
2018-06-01,949388691,A019060,된장,자연향 국내산콩 전통 메주 2덩이(개당 1.6kg 내외)/붉은 고추+숯 증정,39900,39900,0
2018-06-01,1723899910,A013120,낙지,오징어실채(300g)국산 오채 오칼 실채 무조미,16250,16250,0
2018-06-01,127943950,A022030,생수,나비수 함평나비수 함평수 함평천지나비수 천지영천수,26000,26000,0
2018-06-01,1597026322,F011130,홍삼,정관장 홍이장군1단계,80000,80000,0
2018-06-01,389093665,C015030,넥타이,(색상 : 네이비) BTIE_116 작은점 와이드 보,15140,15140,0
2018-06-01,1246172391,A011090,국수,컵라면 모음 육개장 사발면 짜파게티 범벅 신라면,15500,15500,0
2018-06-01,599375925,C013020,티셔츠,[TOMBOY]레터링프린트티셔츠(9108222998)(본점),39000,31650,-7350
2018-06-01,2032139504,C012060,여자내의,[체리코코]attention  skirt(C706PWSK21)/롱스커트/H라인/밴딩/옆트임(G1-8-1),37000,37000,0
2018-06-01,141240004,F011150,건강기능식품,영양가득 20곡 미숫가루1kg /식사대용,2900,2900,0
2018-06-01,538243280,A016090,참외,달콤한 성주 꿀참외9kg,10900,10900,0
2018-06-01,13691767,L021030,가방,30%쿠폰! 신상특가 예쁜 숄더백 여성가방 크로스백,12900,12900,0
2018-06-01,758683454,I031040,생화,파워렉 스프링 아이언 무릎보호대,59000,54280,-4720
2018-06-01,1687527521,L012040,치약,부광 안티프라그 치약 130g x 10개/2080/크리오/칫솔,8900,8900,0
2018-06-01,1377888957,C013020,티셔츠,여성용 아쿠아 냉감티셔츠/여름철 골프웨어/래쉬가드,19800,19800,0
2018-06-01,1241556906,C015020,모자,모자/캡모자/볼캡/야구모자/남성/남자/여성/여자/무지,9900,9900,0
2018-06-01,987232849,L012010,면도기,도루고 PACE7 파워 면도기 1입,16800,16800,0
2018-06-01,643339610,C013020,티셔츠,고퀄 맨투맨 후드티 반팔티 44~99빅사이즈 여성티셔츠,19800,19800,0
2018-06-01,987232846,L012010,면도기,도루코 PACE7 면도기 1입,15800,7990,-7810
2018-06-01,427643624,E061010,세탁세제,올바르게 8無 액체세제 3.2L 4개/섬유유연제 세탁세제,11900,11900,0
2018-06-01,1356126291,C011030,남자학생복,남성 버튼다운 리넨 셔츠(MSX2WC1901)/ 탑텐,12000,10800,-1200
2018-06-01,956074773,C014010,아동복,[아디다스키즈/adidaskid] BG9590 YB 엑티브 트랙수트 YB ACT TS,64500,64500,0
2018-06-01,705557202,C013040,청바지,봄신상 프리미엄 청바지 면바지 슬랙스 남자청바지,18800,17800,-1000
2018-06-01,990091695,F011120,인삼,초L프라임)얼굴평창표고버섯 (150G/팩),2990,2990,0
2018-06-01,306625367,F012020,생리대,NEW 라이너 일반 20PX15팩,10900,10900,0
2018-06-01,1612876585,C013010,점퍼,[TATE]테이트 남녀공용 여름 바람막이 항공점퍼(KA7U4-UGJ800)(인천점),19000,16590,-2410
2018-06-01,938525978,C013020,티셔츠,단독 ~94%! 후아유 반팔티/팬츠외 인기 여름 1 900원~,1900,1900,0
2018-06-01,989020147,A013050,오징어,노르웨이 간고등어 450G/팩,5500,5500,0
2018-06-01,269198993,C013010,점퍼,빅사이즈 무지블랙가죽자켓 MO1710 빅사이즈 여성의류,87540,87540,0
2018-06-01,1998708349,A013040,고등어,제주직송 영앤푸드1호세트/갈치/굴비/고등어/선물세트,60000,54900,-5100
2018-06-01,2366567,A013090,전복,통영 왕바지락3kg/조개살500g/당일조업/무료배송,14500,14500,0
2018-06-01,1088704437,E031120,믹서,WSH-429 핸드믹서/거품기/반죽기/휘핑기/홈베이킹,44900,44900,0
2018-06-01,318975019,A018050,비스킷,대용량 21종 쿠키 모음전 2Kg/옛날과자/뻥튀기/버터링,5900,5900,0
2018-06-01,2053008468,C013020,티셔츠,[공구우먼] 포에 레이스 티셔츠 29808 빅사이즈 여성의류,32000,32000,0
2018-06-01,2140082453,D031010,주택수선재료,마이티실러 USA 욕실방수제 방수스프레이 고무 페인트,25000,25000,0
2018-06-01,1008521639,E061100,습기제거제,써보고 참숯 제습제 525mlx12개 습기제거제 염화칼슘,10900,10900,0
2018-06-01,1896208902,L021020,장신구,시크 롱 목걸이 (W) 20대 주얼리 스틱 이니셜 목걸이,15940,15940,0
2018-06-01,1811731893,C015020,모자,빅사이즈 큰모자 스냅백 군모 대두볼캡 XL등산모자,9900,9900,0
2018-06-01,705317747,C021020,구두,락스터드 리본 쪼리 MW2S0552 PVS P45/ 발렌티노,245000,205800,-39200
2018-06-01,788570593,E011040,소파,젤코바 쿠션 소형/쇼파/소파/빈백/공의자/1인용/안락,28400,28400,0
2018-06-01,1884404587,A011050,콩,산과들에 2017년산 대용량 햇 수입 볶음 땅콩 3.75kg,13900,13900,0
2018-06-01,825995803,A022030,생수,[해태음료] 올림픽공식 강원평창수 2Lx12PET,9450,8890,-560
2018-06-01,631204438,A016020,배,2017 추석 미래로 프리미엄 고급배 선물세트 추석선물,87300,76830,-10470
2018-06-01,625886094,L012060,샴푸,풀라무 EM샴푸/치약 비누 비듬 두피 친환경 천연 이엠,12950,12950,0
2018-06-01,1145221038,I012010,컴퓨터,최종114만원+선착순사은품 삼성노트북9 NT900X5Y-XD5S,1262100,1199000,-63100
2018-06-01,972553587,E061010,세탁세제,파워퐁(특상 한샘 13k) 세탁세제 세제통 액체세제 액,13370,13370,0
2018-06-01,1409436698,C015030,넥타이,[나쁜남자] 넥타이 균일가 솔리드 스트라이프 체크,3900,3900,0
2018-06-01,1028515508,C013020,티셔츠,RT6 V트임 티셔츠 BTT026 남자티셔츠 남자긴팔티,31730,31100,-630
2018-06-01,2139154607,C014020,유아복,아둘 패밀리룩 가족티 유아 반팔 조던 상하세트 11,15900,15900,0
2018-06-01,894085975,C012040,여자학생복,[롱루즈핏셔츠모음] F-3XL 롱블라우스/남방 빅사이즈,30800,29800,-1000
2018-06-01,1064877821,C013010,점퍼,[CAMBRIDGE] [S-Britain] 체크 트위드 테일러드 자켓 MRJBM17251NAV,356000,302600,-53400
2018-06-01,1417320435,A019050,간장,[샘표] 양조간장 1.8L 701/501/진간장F3 1.8L,9700,9700,0
2018-06-01,296874410,E041010,식기,코렐 공기/대접/찬기/접시/면기/단품 모음전,7900,7900,0
2018-06-01,1113786635,C012040,여자학생복,수술 포인트 롱 가디건 (TQCCF2973)/ 비키,39000,35100,-3900
2018-06-01,859737210,A016070,귤,화남-밀감대(3kgX6개),151340,119560,-31780
2018-06-01,1597026360,F011130,홍삼,정관장 홍이장군2단계(20ML*30),100000,100000,0
2018-06-01,685692550,E011040,소파,메이플 M103 빈백/ 키즈빈백/어린이빈백 쿠션/소파,52900,52900,0
2018-06-01,2018844060,L021020,장신구,은침귀걸이 이어링 귀고리 유색비즈 스와로브스키스톤 색깔귀걸이 악세사리귀걸이 실버,11700,11350,-350
2018-06-01,437270160,E031020,가스레인지,사은품증정) 2구 가스렌지 GRA-806SR /전면배터리교체,157000,157000,0
2018-06-01,545094867,C013020,티셔츠,2014봄 라운드넥/브이넥/라운드니트/국내생산/단가라티/스타일리쉬 티셔츠/무료배송,22800,10800,-12000
2018-06-01,732395376,C013060,등산복,여름등산복바지 남자아웃도어 작업복 트레이닝 기능성,16200,16200,0
2018-06-01,499422003,A012060,햄및베이컨,(냉동)SFOOD후레쉬베이컨 1kg후레쉬 베이컨 안주 식자,34500,29330,-5170
2018-06-01,504775550,C013050,운동복,프론트 리어 범퍼 가드 보호대 몰딩 블랙 차량범퍼가,22930,20470,-2460
2018-06-01,433514483,A017200,토마토,말린가지 10Kg /건가지/경북봉화,161000,161000,0
2018-06-01,619168527,C013050,운동복,아디다스 여성 아디제로 트랙자켓(CE0330) 트랙자켓,142090,142090,0
2018-06-01,1391542890,F011150,건강기능식품,17곡 미숫가루1kg x 2봉/당일생산/검은콩,11900,10900,-1000
2018-06-01,98105308,C015030,넥타이,[나쁜남자] 리본타이 여성타이 나비넥타이 교복넥타이,3900,3900,0
2018-06-01,1673618083,A019160,밑반찬,자연웰/도토리묵가루/메밀묵/청포묵가루/올방개묵가루,4900,4900,0
2018-06-01,899350417,A013060,게,생가자미(대/마리),5290,5290,0
2018-06-01,1665855462,L021030,가방,독일 리바케이스 8262 15.6인치 노트북 가방/백팩/,49000,48020,-980
2018-06-01,631204494,A016060,감,경북청도 껍질없는 아이스 왕 홍시 10개(컵)/개당100,47700,40550,-7150
2018-06-01,597559757,E021010,침구,2018신상봄차렵이불/마이크로/알러지방지/진드기방지,57900,44070,-13830
2018-06-01,279838516,I012010,컴퓨터,애플정품 16년형 New iMac MK462KH/A 5K 레티나/아이맥신형/SG,2481390,2481390,0
2018-06-01,895648551,A012040,닭고기,초이스L 닭다리살 300G,4990,3990,-1000
2018-06-01,442938087,C013020,티셔츠,T1401-엔젤 라운드 셔링 티셔츠 반팔티셔츠 여성라운,21110,21110,0
2018-06-01,376201184,C021020,구두,[발렌티노(VALENTINO)]매니아온발렌티노 락스터드 무광 슬링백 JW2S0393 VOD P30,715000,643500,-71500
2018-06-01,895648554,A012040,닭고기,초이스L 닭안심 (300G/팩),3990,3990,0
2018-06-01,1279057909,E041010,식기,일본그릇 오리엔탈 사각종지(5종),7200,6630,-570
2018-06-01,171417552,C011030,남자학생복,남여공용 울트라 덕 다운 베스트 _ PHX4VP1030,69900,37400,-32500
2018-06-01,279537246,C013020,티셔츠,카네브로스 CB 스페이스 브로 반팔티 PU,38000,38000,0
2018-06-01,1295678298,C012040,여자학생복,인기신상 조끼 린넨 베스트 자켓 로브 특가모음전,22900,22400,-500
2018-06-01,1982730396,I031040,생화,빈슨메시프 프리미엄 2.45M 초대형 2층 꺾임 파라솔,23900,23900,0
2018-06-01,1883272336,C011030,남자학생복,봄신상 맨투맨/가디건/반팔/빅사이즈 S-4XL 특가!,15900,12900,-3000
2018-06-01,1265838050,L021010,손목시계,로제타 여성 손목시계 FW-22 손목시계 팔찌 팔찌시계,14490,14490,0
2018-06-01,2068335050,C013010,점퍼,PBM1072M 루즈남자롱모직코트 / 참고 모직코트 코트,82800,72870,-9930
2018-06-01,117750958,C012060,여자내의,[SIWY]CAMILLA CHARM(W750SCY CHA),99000,79200,-19800
2018-06-01,1686508499,A017210,파,새콤달콤 맛나는 正品토마토 5kg판매,9900,9900,0
2018-06-01,195436051,C012060,여자내의,SK1030-데일리 20대 30대 예쁜스커트 사각 체크 모직,20680,19650,-1030
2018-06-01,1468437232,A012010,국산쇠고기,[무항생제] 불고기 500g 1등급,25900,25900,0
2018-06-01,983624224,A019050,간장,샘표) 국산 콩간장 930ml,9900,9900,0
2018-06-01,257068719,C021040,실내화,[슈퍼콤마비]진유니)]남녀공용 시그니쳐레터링샌들 P62AM18103BLK(강남점),109500,95600,-13900
2018-06-01,1190529646,E041060,수저,수저받침 모음전 받침대 젓가락 숟가락 저분,500,480,-20
2018-06-01,1121214603,I011030,사진기,[정품]a5100/16-50mm렌즈 필수악세사리패키지,588000,536360,-51640
2018-06-01,390999302,C013050,운동복,푸조 남녀공용 니트 트레이닝 세트(FZ131-4) 남여츄리,67040,67040,0
2018-06-01,231313097,C012020,원피스,무지대형 숄목도리 겨울 목도리 머플러 남성자목도리,30580,30580,0
2018-06-01,895709995,A013050,오징어,초L)친환경990치커리 (80G/봉),1490,1490,0
2018-06-01,942928233,E051030,디지털도어록,J20-IH 메탈후크 카드키4+번호키 현관문 디지털도어락,89000,79950,-9050
2018-06-01,427834224,E031080,선풍기,한빛 공기청정슬림형 전기온풍기hv-5800F(5.5kw) - 전,743570,661780,-81790
2018-06-01,1154625496,C013010,점퍼,바람막이/윈드자켓/골프웨어/골프자켓/등산자켓,40800,32800,-8000
2018-06-01,50147243,C011030,남자학생복,인터페이스제작 양면가디건 해적포인트 후드집업자,29700,29700,0
2018-06-01,999953052,I031040,생화,SOS 긴급 구호세트 안전용품 캠핑장비 캠핑공구 캠핑,24540,22360,-2180
2018-06-01,1704433399,C012060,여자내의,PT1341-데일리 베이직 롤업 숏 팬츠 여성핫팬츠 롤업,21810,19630,-2180
2018-06-01,630121706,A022010,주스,[자연은] 제주감귤 외 500mlx20 6종택 알로에/토마토,18600,18600,0
2018-06-01,835863572,C013010,점퍼,[보브(여성의류)] 2001중계아울렛] 슬림 항공점퍼 (7117220301),499000,299400,-199600
2018-06-01,1492995477,I031010,장난감,타요버스 지붕차 / 무소음 발포 바퀴,101500,101500,0
2018-06-01,2068335045,C011030,남자학생복,(티티뱅크) AT5455 보안 조끼 / 참고 조끼 지퍼 보안(,54300,47790,-6510
2018-06-01,1092443429,F011130,홍삼,[종근당건강] 홍삼녹용프리미엄 30포 3+1세트 (총4세트),65700,65700,0
2018-06-01,897561842,A019080,고추장,해찬들 새콤달콤초고추장 1.05KG,6100,6100,0
2018-06-01,953475808,C012060,여자내의,SK0811/다피노 체크 프릴스커트/ 아덴,10900,10250,-650
2018-06-01,1833105227,C014010,아동복,[블루독] 핀턱데님숏팬츠 (27315-414-50),46000,37720,-8280
2018-06-01,411006352,C012030,여자상의,KD 목폴라 앙고라 POPS 원피스 겨울원피스 롱니트 세,95200,95200,0
2018-06-01,1530255918,C013040,청바지,골드아이/봄신상/아동청바지/여아청바지/기모바지,8900,8900,0
2018-06-01,1286541310,A019020,참깨,검정볶음깨 200g X 40EA_1BOX 볶음검은깨 검은깨 볶음,176430,176430,0
2018-06-01,2068311086,C011020,남자상의,(티티뱅크) JK530 어반 아웃도어 자켓 / 참고 아웃도,65100,55340,-9760
2018-06-01,60821154,A012010,국산쇠고기,팔도 견과세트 4호(고품격 웰빙 선물세트)사은품 답례,66740,66740,0
2018-06-01,1112461324,C013050,운동복,자동차 성에제거기 차량용 성애제거기 겨울용품,8500,7400,-1100
2018-06-01,126314147,A015020,식용유,커클랜드 엑스트라버진 올리브오일 2L/올리브유,22780,22780,0
2018-06-01,1586975482,C013050,운동복,차량용 컵홀더 사이드포켓 핸드폰거치대 자동차용품,3500,3400,-100
2018-06-01,1427820687,L021020,장신구,925 실버반지 실반지 은반지 은팔찌 발찌 핑크골드,7100,7000,-100
2018-06-01,638788896,F012050,의료측정기,시티즌 자동전자 혈압계/혈압측정기(부정맥감지),39800,35800,-4000
2018-06-01,895648521,A012040,닭고기,초이스L 닭가슴살 300g,3990,3990,0
2018-06-01,50174839,C011030,남자학생복,인터페이스제작 특양면가디건 달러포인트 후드집업,29700,29700,0
2018-06-01,424146003,G022020,자동차타이어,[타이어플러스]피렐리 Cinturato P7 245/45R18,195000,157470,-37530
2018-06-01,362097062,C013050,운동복,DDK00218 트레이닝 져지 803 여자트레이닝자켓 여자트,51010,51010,0
2018-06-01,1293343993,C012040,여자학생복,sy01 자수 금장 셔츠 블라우스 여성 남방 베이직,29900,29900,0
2018-06-01,2038612345,C013010,점퍼,크림 주니어 위너롱패딩/초등학생 롱패딩 모자점퍼,116000,110200,-5800
2018-06-01,968092007,C013010,점퍼,[모다아울렛][반에이크]반에이크 후드 양가죽숏자켓(VA83LEM501D),199000,189050,-9950
2018-06-01,46608929,A018010,초콜릿,골든버그 츄엣 초콜릿 1.36kg(110개입)/초코바/대용량,16900,16900,0
2018-06-01,907998684,F012020,생리대,(사은품증정)화이트 탐폰 레귤러/슈퍼 80p특가/템포,25900,25900,0
2018-06-01,384172447,I053040,기타문구,포스트잇 리필 3팩 묶음 KR330 76x76mm 사무용메모지,11730,11730,0
2018-06-01,9430694,A017300,미역,[무배] 햇파래김 100장/곱창김/생김/마른김,9900,9900,0
2018-06-01,488652651,E021010,침구,[러그쏭] 시어서커 침구 모음전 홑이불/누빔이불,69900,54230,-15670
2018-06-01,1377840925,E011070,식탁,퍼스웰 홈바 아일랜드식탁 렌지대(OPT_003),85000,85000,0
2018-06-01,1943708104,C011020,남자상의,(AGC패딩 코트 PD23 WS패딩코트코트남자코트트랜치코,169240,150630,-18610
2018-06-01,1238840276,C015040,장갑,[무료배송]남녀공용 패션 프리미엄 털장갑 AG1716019,17500,17500,0
2018-06-01,1301755980,C013020,티셔츠,베이직 후드티 BTT0034 남성티셔츠 무지후드티 (YA020,35100,29840,-5260
2018-06-01,987053947,A017300,미역,광천 해저들기름김 16봉,6990,6990,0
2018-06-01,1997314890,E011020,침대,[골든잼]원목 천연생황토 더블 돌침대(물망초)/흙침대,1683600,1633100,-50500
2018-06-01,1327699946,C013020,티셔츠,면스판 기본 박스 라운드티 DM-5639 무지반팔티 루즈,6660,6660,0
2018-06-01,378009156,E011050,책상,유로테이블/작업테이블/진열대/식탁/포밍/미니탁자,62900,62900,0
2018-06-01,1355853258,E011040,소파,코쿤쇼파/2용인쇼파/3인용쇼파/패브릭쇼파/싱글쇼파,152900,137610,-15290
2018-06-01,580133577,I011010,TV,시네아이 48인치 LED TV 삼성정품패널 패널2년보증,269000,269000,0
2018-06-01,410278740,A014030,치즈,아담스 프리미엄 파마산 1kg,18000,18000,0
2018-06-01,1190867965,F012050,의료측정기,케어센스2 혈당측정기+시험지110매+솜100매+침210,32000,32000,0
2018-06-01,1394716495,C013010,점퍼,모나코 모베이직 자켓 여성쟈켓 DM-4616,71020,67470,-3550
2018-06-01,1714862726,C012040,여자학생복,[이사베이]배색 포인트 니트 가디건 (VQCCD9933)_C9B1,27000,25650,-1350
2018-06-01,1057860666,C012020,원피스,IW6WH466체크더블라인 코트/ 코인코즈,47000,38540,-8460
2018-06-01,915485300,F011150,건강기능식품,[JW중외제약] 키즈비타민 앤 미네랄 6개월분/ 12개월,11900,11900,0
2018-06-01,1923560239,C012040,여자학생복,신상추가 5900~ 아이템 티셔츠/셔츠,5900,5900,0
2018-06-01,25361314,I011030,사진기,#NAME?,1841640,1739060,-102580
2018-06-01,1727419616,L012090,기초화장품,프로랑스 녹두 클렌징크림 2개/크린싱크림.클린싱크림,12500,12500,0
2018-06-01,1629705515,C012020,원피스,[ab.f.z]심플 모던 핸드메이드 코트,199000,189050,-9950
2018-06-01,1296300450,C011030,남자학생복,FS-116 투톤 단가라 7부 셔츠 - 블루 캐쥬얼셔츠 스트,18670,18670,0
2018-06-01,529555407,C012060,여자내의,라인이 예뻐보이는 그레이체크주름치마 주름 교복치마,49840,48350,-1490
2018-06-01,1057860669,C012020,원피스,컬러배색 코트IZ6WH450/ 코인코즈,47000,38540,-8460
2018-06-01,530534860,C012040,여자학생복,보풀방지 다크브라운화이트라인 교복조끼(여자) 교복,23160,22470,-690
2018-06-01,1192490572,E031050,냉장고,LG공식인증(주)대명 K332SW13M LG 디오스 김치냉장고,1150000,1090000,-60000
2018-06-01,2028090363,E041070,밀폐용기,조은락 밀폐용기 반찬통 김치통 보관 밀폐 양념통 통,1300,1300,0
2018-06-01,1712644641,L012040,치약,페리오 46cm 펌핑치약 285g 3+1 총4개/송중기 치약,14900,14900,0
2018-06-01,1059638484,A017180,호박,청양고추-2kg.5kg.10kg,27900,27900,0
2018-06-01,1147592677,C014010,아동복,[에어워크주니어]공용_Air-Cool베이직트레이닝팬츠_A172B3522B,23900,23430,-470
2018-06-01,1010137348,A014030,치즈,서울 테이스티치즈 180G,3500,1750,-1750
2018-06-01,29154700,C013050,운동복,프론트 리어 범퍼 가드 보호대 몰딩 블랙 자동차범퍼,22500,20500,-2000
2018-06-01,515885835,C013020,티셔츠,[모다아울렛][트윈키즈]스팽글장식티셔츠1,14500,13780,-720
2018-06-01,1191020916,A014020,분유,하이키드 프리미엄 밀크 초코 산양골드 x 3캔,60000,60000,0
2018-06-01,522262140,C011030,남자학생복,[하프클럽/VONIN]보닌 헨리넥 포켓 시어서커 셔츠 TODN033NV,35600,35600,0
2018-06-01,886559625,E041010,식기,금수저 은수저 티타늄 티스푼 전통수저 답례품 선물,35800,32850,-2950
2018-06-01,1456985773,A014030,치즈,파마산 블렌드 치즈가루 227g 12개,56900,56900,0
2018-06-01,1010137352,A019130,스프,CJ 고메크림베이컨포테이토 200G,4990,3490,-1500
2018-06-01,932976052,C013050,운동복,로카 성에제거기 겨울성애제거기 겨울철차량성애제거,2750,2650,-100
2018-06-01,1105815336,D031010,주택수선재료,숲으로 에이스 내부용 3.78L 수성/벽지용/베란다/조색,14000,13000,-1000
2018-06-01,1199360160,A019020,참깨,들깨가루 (산들샘 1k),38720,34470,-4250
2018-06-01,531094119,A019130,스프,[샘표] 폰타나 피에몬테 양송이크림 즉석수프 60g (20g x3개입)/ 샘표,2480,2360,-120
2018-06-01,559773156,I011020,영상음향기기,인기제품 비비텍 DW282ST 단초점 와이드 빔프로젝터,829000,697900,-131100
2018-06-01,1386603597,C012040,여자학생복,빅사이즈 DBN1387 플레아 뷔스티에 803S 여성용뷔스티,45630,45630,0
2018-06-01,1485316360,C012040,여자학생복,[포에버21]후드 니트/FOREVER21/니트/스웨터/후드니트,37900,15160,-22740
2018-06-01,1478913405,C021040,실내화,월드컵 런닝화 워킹화 조깅화 운동화 남성운동화,22700,22700,0
2018-06-01,443725745,C012040,여자학생복,BL212-체크 롱 벨트 블라우스 블라우스 여성블라우스,46100,46100,0
2018-06-01,381987040,C013050,운동복,ECO 에탄올 워셔액 소낙스 THE VIEW 워셔액,1700,1570,-130
2018-06-01,1010379431,A014010,우유,매일)저지방(2%)우유900ML,2500,2350,-150
2018-06-01,793528038,L021060,유모차,라이트원 4.5kg초경량 핸들링대박유모차-최대32%할인,147000,99960,-47040
2018-06-01,1010379430,A014010,우유,매일)우유(오리지널)900ML,2500,2500,0
2018-06-01,1194933025,C014010,아동복,유아 아동 반팔 상하복세트/남아 여아 반팔세트,14800,14800,0
2018-06-01,1010379432,A014010,우유,매일)저지방(1%)우유900ML,2500,2350,-150
2018-06-01,1989296216,A019060,된장,진배기 된장1.1kg 간장 1.8L 고추장 /청도 우수농산물,17900,17900,0
2018-06-01,509728388,D031010,주택수선재료,코올탄 골탕 콜타르 콜탈 핏치 우레탄 에폭시 대체,60000,60000,0
2018-06-01,2136745399,A022040,기능성음료,파워오투500ml /오렌지레몬/애플키위/스포츠레몬/아이,29900,29900,0
2018-06-01,1010379429,A018020,사탕,롯데곤약애빠지다복숭아맛130G,1600,1600,0
2018-06-01,1147364717,C012040,여자학생복,섹시홀터넥BL /블라우스/나시/홀터넥블라우스/홀터넥나시/ 톰앤래빗,19000,17860,-1140
2018-06-01,255432048,C013050,운동복,플렉시패드 M14 어뎁터 1.5x1.5x4cm (13400),4800,4380,-420
2018-06-01,1669389303,C012030,여자상의,신상 정장 캐쥬얼 원피스모음 루즈핏 롱티 빅사이즈,26800,24800,-2000
2018-06-01,147340103,C013050,운동복,Bores TUP 케이블 홀더/배선정리/선정리/클립/타이,9900,9030,-870
2018-06-01,1668720617,C014010,아동복,[구매할인10%]꼰띠키즈 여름신상 원피스/상하복/가디,9900,9900,0
2018-06-01,1474977498,C013010,점퍼,MRBOB 신상 기모 후드티 후드집업 빅사이즈 M~3XL,24800,24800,0
2018-06-01,122757455,E041050,냄비,▶키친아트 정품냄비◀믿을 수 있는 신비냄비/편수/양수/전골/후라이팬/주전자/곰솥/냄,20000,19000,-1000
2018-06-01,988158069,A019110,드레싱,[CJ직배송] 상큼드레싱 3종 (오리엔탈+요거트+키위샐러드),11940,11940,0
2018-06-01,838604437,E061020,섬유유연제,라벤다 베이비전용 섬유유연제 bottle 아동세탁세제,22640,22640,0
2018-06-01,1195857729,A011170,떡,[신세계몰]명미당 밥알떡세트 55g*20개 아침식사 답례떡,17900,17900,0
2018-06-01,657830580,C013010,점퍼,[블루독](NY)메쉬스타디움점퍼(27315-111-01),53000,40810,-12190
2018-06-01,1320536214,E011020,침대,프리미엄 패밀리침대 SS+SS 밸런스 프레임,329100,319230,-9870
2018-06-01,1010137378,A019180,즉석식품,Onlyprice)두번구워 더 구수한누룽지 500G,3000,3000,0
2018-06-01,1942231886,C012040,여자학생복,NT241-양 V넥 니트 슬리브리스,24910,22420,-2490
2018-06-01,700597381,C012040,여자학생복,[PL_홈쇼핑]그레이 원피스형 니트,7900,7510,-390
2018-06-01,608682035,E011070,식탁,런칭특가/이지-대리석 홈바형 아일랜드식탁 / 조리대 홈빠 씽크대 주방수납장 식탁 테,215000,215000,0
2018-06-01,1738907845,C015020,모자,빅사이즈모자 큰모자 군모 프로 야구모자 캡 등산모자,11900,11900,0
2018-06-01,11326261,I031040,생화,270cm 목꺽임 대형파라솔 낚시파라솔 파라솔세트 사각,36900,36900,0
2018-06-01,988041933,C021040,실내화,[아디다스] 인기 운동화 모음전,39800,39800,0
2018-06-01,1159593423,C012060,여자내의,[트위] 클로에 랩 스커트 (TGEBFSK020),25900,25900,0
2018-06-01,1658472355,A011010,쌀,2017년 햅쌀 대나무향미 쌀 20kg 국산 현미 찹쌀,47900,47900,0
2018-06-01,1509858513,E021010,침구,Gift! 마이하우스 HEPA 키즈/성인 먼지없는 이불 베개,49000,49000,0
2018-06-01,1427594868,C013020,티셔츠,[앤드지바이지오지아]S/S 배색 절개 라운드 티셔츠 4종 택1(광주신세계),29000,23920,-5080
2018-06-01,1865804196,E021010,침구,굿몽 국산 알러지 자극없는 부드러운 아사면 차렵이불,32900,30270,-2630
2018-06-01,707768288,F012020,생리대,시크릿데이 슈퍼롱 오버나이트 6팩/생리대,9900,9900,0
2018-06-01,1293040002,A014020,분유,헤모틴틴베이비 60포1캔/어린이비타민/철분제/초유밀,11900,11900,0
2018-06-01,1270477326,L021020,장신구,14K 크로스 블루큐빅 이어커프,94910,94910,0
2018-06-01,1283487881,D031010,주택수선재료,캐노픽스 규격:650 X 1000 눈 비가림 렉산 PC 차양 밴딩 장마 폭설 어닝 폴리카보네이,110000,110000,0
2018-06-01,972142285,A012060,햄및베이컨,[청정원] 청정원 고소한베이컨1kg,10900,10900,0
2018-06-01,1170984036,C012060,여자내의,레자 레깅스 여성 패션 인조 가죽 쫄 바지 지퍼 라인 무광 유광 칼라 뱀피 무늬 여자,10900,10900,0
2018-06-01,1342660658,C014020,유아복,[대백아울렛] [포인포]여아별3부팬츠(PPTC72505Q50100),7900,7900,0
2018-06-01,1956322535,E011040,소파,국산 1인용쇼파 모음전/정품자재소파싱글수유사무실용,110000,108900,-1100
2018-06-01,495523078,C012040,여자학생복,(더틸버리) 배색 하프넥 스카프 니트 TI2N1KT53/ 더틸버리,25000,22500,-2500
2018-06-01,631196813,C012060,여자내의,빅사이즈/엔젤/쉬폰/스커트 빅사이즈,40950,39730,-1220
2018-06-01,14107689,C012040,여자학생복,쿨젠.쉬폰나시블라우스 오프숄더.민소매.시스루린넨,27800,25800,-2000
2018-06-01,186846128,C011030,남자학생복,남자 브이넥 가디건/니트 롱 기본 남성 티셔츠 집업,20800,19800,-1000
2018-06-01,306625335,F012020,생리대,NEW 코튼라이너 롱 20PX8팩,10900,10900,0
2018-06-01,2076211693,C013020,티셔츠,타미힐피거 반팔티 클래식 커스텀 카라티 남성 여성,37800,37800,0
2018-06-01,1173229454,C014010,아동복,[꼰띠키즈]여름신상!상하복/원피스/아우터,9900,9900,0
2018-06-01,989044143,E061050,청소용세제,Mr.홈스타 눈에 보이는 거품 락스 1L,3000,3000,0
2018-06-01,989044142,E061050,청소용세제,Mr.홈스타 튀지 않는 겔락스 1L,3000,3000,0
2018-06-01,97213059,A013070,굴,국산 꽃게 10kg 숫꽃게 냉동꽃게,160000,160000,0
2018-06-01,2100565066,E011070,식탁,모드니가구- 아일랜드식탁 접이식탁 오븐수납장 가구,104900,104900,0
2018-06-01,1406527029,F012010,종이기저귀,(공식) 18년 군기저귀 오리지널 밴드 S (84매)X3팩,43900,43900,0
2018-06-01,674870373,C011030,남자학생복,여름 반팔 와이셔츠/반팔 신상 입고/무료배송/,13500,13500,0
2018-06-01,921604936,A016160,과일가공품,(전남오픈마켓/애플파이)국내산 유기농 블루베리 1kg,17900,17900,0
2018-06-01,1951777400,I011010,TV,삼성55인치커브드패널2년무상보증/특가UHDTV/당일출고,569000,529000,-40000
2018-06-01,494177955,A017020,상추,제이제이몰 오향적치마 상추 종자 씨앗 8g 채소 재배,5250,5250,0
2018-06-01,349546831,C013040,청바지,[모드나인] Back in the Day - MOD6,67200,57120,-10080
2018-06-01,1010380485,A013100,마른멸치,[기획전][산지직송]자연산 백골뱅이(백고동) 1kg (20~40미),26000,20100,-5900
2018-06-01,464278936,A019170,냉동식품,180장 현재식품 납작만두 /비빔만두/ 비빔장,13800,13800,0
2018-06-01,1866165734,A014030,치즈,서울체다슬라이스치즈1800g(100매)/모짜렐라치즈 피자,20900,20900,0
2018-06-01,508464407,C012040,여자학생복,[앤드스타일]포셀 린 쉬폰 V 블라우스 세트_236143,23900,22710,-1190
2018-06-01,2116949401,E011030,거실장,[elle 익스텐션거실장] tv다이/tv장식장/티비다이,79000,76000,-3000
2018-06-01,440292672,A013170,생선통조림,유동뚝배기번데기탕얼큰한맛 280gX24개번데기 유동 식,66200,56270,-9930
2018-06-01,1751957483,A019080,고추장,청정원 직화맛쇠고기볶음고추장 60gx3개,4700,4700,0
2018-06-01,1667321373,C013010,점퍼,[모다아울렛][레코브]기본레자점퍼,79000,72680,-6320
2018-06-01,664642537,A013030,조기,영광굴비/굴비/선물세트/굴비세트/법성포/참조기/명절,219900,219900,0
2018-06-01,688914240,L012040,치약,죽염치약 12개 / 잇몸고 시린고 5days / 잇몸치약,19800,19800,0
2018-06-01,1406625415,E061040,부엌용세제,뽑아쓰는 자연퐁시트 10매/주방세제/일회용세제/세제,1200,1200,0
2018-06-01,168188804,I031040,생화,CTM 야전침대/캠핑침대/간이침대/접이식침대/캠핑용품,36000,33030,-2970
2018-06-01,1092911359,A019040,소금,뉴오리진 칼라하리 사막소금 90g 호수염,8000,8000,0
2018-06-01,645706413,C013010,점퍼,봄바람막이/여름바람막이/신사점퍼/캐주얼점퍼/작업복,57500,57500,0
2018-06-01,270252807,C013040,청바지,[게스] G76KCP911게스키즈데미지스키니진[nc아울렛],79000,55300,-23700
2018-06-01,1481934695,C011030,남자학생복,[대백아울렛] [지오송지오]스트라이프 셔츠 (ZTS31244),68000,68000,0
2018-06-01,896548829,A018010,초콜릿,해태 미니자유시간 140G,2900,2900,0
2018-06-01,985475050,A018030,껌,롯데 자일리톨 쿨러쉬 용기 70G,4000,3290,-710
2018-06-01,1491991968,A017300,미역,보령대천김/현대수산맛김/10봉/도시락/식탁/다량할인,13400,13400,0
2018-06-01,1294847852,A021010,커피,이태리 킴보 하드포드커피 ESE 파드 3종류 18개입,12000,11000,-1000
2018-06-01,1714862759,C012040,여자학생복,[이사베이]심플 시스루 오픈 가디건 (VQCCD2981)_K9O7,23000,21850,-1150
2018-06-01,1204505429,C012060,여자내의,빅사이즈/제이스타일 코리트 7부 밴딩 배기 팬츠/ 제이스타일,18400,14170,-4230
2018-06-01,79162510,A013070,굴,[요코몰] 영덕매운게장 90g*1캔 /YD/영덕농수산/영덕대게/성게알통조림/대게살/게간장,8000,7600,-400
2018-06-01,1318816340,C021020,구두,0709 4.0cm 가죽남성옥스포드 0709 옥스포드 4.0cm 남,131150,131150,0
2018-06-01,1320536250,E011020,침대,프리미엄 패밀리침대 Q+SS 밸런스 프레임,368200,357160,-11040
2018-06-01,326956221,A017180,호박,건고추(호식이네 1k) 식자재 업소용식자재 대량구매,17040,16190,-850
2018-06-01,975738203,C013040,청바지,[잠뱅이]남) AH2DL732 ( 쿨맥스 파이핑 코드봉제 캣시와 얼룩이 워싱 7부 롤업-DB)(,29000,25320,-3680
2018-06-01,1130797563,C013010,점퍼,[모다아울렛][반에이크][반에이크 남양주모다] 지도리 스테디움 누빔 점퍼 VA83JPM201,99800,94810,-4990
2018-06-01,796087309,C021040,실내화,나이키 에어맥스 2017 블랙/화이트,106000,106000,0
2018-06-01,1003134483,C013040,청바지,JMM9973 기획기본블랙남자스판청바지-빅사이즈까지 남,26400,26400,0
2018-06-01,1649183175,D031010,주택수선재료,30평형 옥상방수(전제품1액형가능) 세트 우레탄 방수,514000,514000,0
2018-06-01,1979403384,A012060,햄및베이컨,(냉동)진주햄 베이컨골드1kg / 진주햄(Oneworld2),39700,34940,-4760
2018-06-01,1915039865,C021040,실내화,[리복] 2018 신상 남여공용 로얄 컴플리트 2LCS 운동화/스니커즈 2종택1-CN7426외,47000,40890,-6110
2018-06-01,278047886,C012060,여자내의,[대구백화점 I관] [유지아이지]린넨 스트링 3부 팬츠(UBPB572),23840,20510,-3330
2018-06-01,706384570,E061060,살충제,[훈연 바퀴킬라]바퀴벌레연막탄/바퀴벌레퇴치제/바퀴벌레약/바퀴약/바퀴벌레박멸/살충,4300,4200,-100
2018-06-01,1257353465,E011040,소파,한화 L&C 정품 EPP충전재 50L~200L 선택 빈백 DIY,12000,10000,-2000
2018-06-01,307613364,A022040,기능성음료,스퀴즈보틀증정/포카리스웨트 분말 1L용X20팩/물병,21300,21300,0
2018-06-01,378083238,L021010,손목시계,큐빅나비/손목시계-색상임의배송 손목시계 패션시계,11240,10910,-330
2018-06-01,452354730,C012040,여자학생복,[클라비스]강연 진주 스웨터 CVKR82402Q,29000,26680,-2320
2018-06-01,264639971,C012060,여자내의,[제쉬나인][제쉬나인]컬러패턴 플리츠 스커트,44300,39870,-4430
2018-06-01,264639973,C013010,점퍼,[제쉬나인][제쉬나인]블링펄 쉬폰 자수 집업점퍼,25400,22860,-2540
2018-06-01,1954060935,I031040,생화,sfc 해향기(바다향기) 바다릴대 1-430 부터 3-530까지,43500,41330,-2170
2018-06-01,283510374,C014020,유아복,싱글 면스판 레깅스 유아레깅스 유아레깅스 유아바지,5390,5230,-160
2018-06-01,1116745241,C021040,실내화,나이키 코르테즈 72 팬텀베이지  화이트  오트밀,109000,107900,-1100
2018-06-01,990027343,A022030,생수,[농심]농심 백산수 330ML,440,440,0
2018-06-01,1930384041,C012030,여자상의,민소매심플원피스/나시원피스/캐주얼원피스/슬림롱,9900,9900,0
2018-06-01,990027340,F011120,인삼,머쉬마루버섯/팩,2490,2490,0
2018-06-01,770145816,E031080,선풍기,[파티오히터 전기종 호환용] 야외용 가스 파티오히터 특수 방수 보관 커버,36500,36500,0
2018-06-01,1281404069,C013010,점퍼,[모다아울렛][반에이크][반에이크 남양주모다] 후드 양면 무스탕 VA82HCQ309Z,89800,85310,-4490
2018-06-01,19428810,E021010,침구,10%쿠폰!쁘리엘르 여름홑이불&패드세트/인견/시어서커,9900,9900,0
2018-06-01,1809548429,C011030,남자학생복,[I.M.Z PREMIUM]레귤러 카라 슬림 면스판 드레스 셔츠 67SS101 99(블랙),59000,53100,-5900
2018-06-01,589613902,E011070,식탁,디럭스 네이비 홈바 아일랜드식탁 조리대 주방수납장,130000,130000,0
2018-06-01,539510888,C015040,장갑,나스카 발토시 여름 자외선차단 레깅스 다리 쿨토시 등산 자전거 조깅 인라인 낚시 용,14500,14500,0
2018-06-01,1164456160,C013020,티셔츠,남여공용 반팔 티셔츠 6종 택1(GJ0TSU091외5종)/ 지프,19900,16920,-2980
2018-06-01,121796815,F011130,홍삼,[농협홍삼/한삼인] 심의환 3.8g*20환,200500,200500,0
2018-06-01,121796817,F011130,홍삼,[농협홍삼/한삼인] 6년근 봉밀절편홍삼 20g*10개입,78200,78200,0
2018-06-01,121796818,F011130,홍삼,[농협홍삼/한삼인] 6년근 봉밀절편홍삼 20g*5개입,43100,43100,0
2018-06-01,196233233,E041050,냄비,스텐샤브샤브냄비 인덕션냄비 오뎅탕냄비,18000,18000,0
2018-06-01,1608261438,L021020,장신구,실버)미니 더블 서클 목걸이 실버목걸이 은목걸이 서,21880,21880,0
2018-06-01,1839689643,C013050,운동복,2000원쿠폰발급/남자/레깅스 반바지/쿨레깅스/변필남,10800,10800,0
2018-06-01,415930928,I012010,컴퓨터,DB-P150 인텔 쿼드코어Q9400/DDR3-4G/SSD-120G/WIN10,208000,208000,0
2018-06-01,889181296,E031080,선풍기,신일 석영관 2단 전기히터 SEH-Q800HS [국산 / 미니히터 / 소형히터 / 전도안전장치],26000,26000,0
2018-06-01,889181292,E031080,선풍기,신일 NEW 탁상용 전기 온풍기 SEH-2000DCAS [2단조절 / 미니히터],31000,31000,0
2018-06-01,1315118775,C011030,남자학생복,봄신상 데님셔츠/청남방/연청/진청/워싱/캐주얼남방,19800,16800,-3000
2018-06-01,889181293,E031080,선풍기,신일 석영관 2단 전기스토브 히터 SEH-900AN [2단조절 / 무취 무연 무소음],33000,33000,0
2018-06-01,1776637884,C013020,티셔츠,남자나시/박스나시/루즈핏/민소매/비치웨어/여름나시,8900,8900,0
2018-06-01,722417540,E031120,믹서,[쇼특] 일렉트로룩스 마스터피스 블렌더 EBR9804S,339000,315270,-23730
2018-06-01,2047106564,E061040,부엌용세제,1+1 프릴 2개구성 주방세제 베이킹소다 용기 리필,9000,8900,-100
2018-06-01,889181298,E031130,보온매트,신일 온돌마루 카페트매트 SMM-M330HM [전자파차단 온도조절 7단계],149000,149000,0
2018-06-01,938026786,C013010,점퍼,아디다스 유소년 콘디보16 스타디움자켓 ( AN9871 ),136960,121900,-15060
2018-06-01,889181299,E031130,보온매트,보이로 순면 전기요 UB58 [더블 / 물세탁가능 / 면100% 순면소재 / 좌우분리난방],129000,129000,0
2018-06-01,26324155,L021030,가방,실리콘나염 복부 보정팬티,39500,39500,0
2018-06-01,1166838965,C012060,여자내의,(해외직배송) 쉬폰재질 수술 미디스커트 미디움기장,38400,38400,0
2018-06-01,1289778546,C013040,청바지,[모드나인(mod9)]Khaki Jean - MOD1s(강남점),71200,62160,-9040
2018-06-01,977940725,A011140,부침가루,베이킹 아크릴 스텐실도안 어린이날 케익데코용스텐실,10680,10680,0
2018-06-01,1895123383,C014020,유아복,아디다스 저지 집업 점퍼 48신장-78,19000,19000,0
2018-06-01,890977528,E011050,책상,주문제작/스틸책상테이블/학생책상/컴퓨터책상/철재,34900,31410,-3490
2018-06-01,1306554904,A013010,갈치,[haccp인증]뼈없는 국내산 순살갈치 200g×5팩/10팩,13900,13900,0
2018-06-01,1862256109,D031010,주택수선재료,스포탄 모노탄 우레탄 옥상방수 4L 하도 중도 코팅제,19000,19000,0
2018-06-01,1760429666,C014010,아동복,[패션쿠폰30%]꼰띠키즈 아동의류 여름신상3500원,6900,6900,0
2018-06-01,1658148835,E061020,섬유유연제,드라이시트 250매 빨래 의류 건조기 유연제 코스트코,6720,6720,0
2018-06-01,685368732,C013040,청바지,일자핏 스키니 부츠컷 슬림핏 F-3XL 빅사이즈여성의류,26800,25800,-1000
2018-06-01,50196399,A013070,굴,다인 소프트 쉘 크랩 (10미이상) 900g/꽃게튀김,22900,22900,0
2018-06-01,1308642420,C012040,여자학생복,[로프나인]지지미차이나카라셔츠(M18202078)(영등포점A),39000,34810,-4190
2018-06-01,1337335182,C012030,여자상의,여성 바네사 양V넥 뒷트임 원피스V넥 니트니트골지니,48320,48320,0
2018-06-01,1195387368,F012050,의료측정기,녹십자 혈압계 BPM-642 + 사은품 3종 몽땅 증정,45000,45000,0
2018-06-01,1041954915,A017300,미역,매일 새제품 성경김 20봉 1BOX 식탁김 72봉 재래김,23900,22900,-1000
2018-06-01,895744593,A019120,혼합조미료,[대상]대상 맛소금 250g,990,990,0
2018-06-01,1011091441,A022010,주스,[롯데]롯데)콜드(오렌지) 250ML*2,2300,1800,-500
2018-06-01,591590298,F011150,건강기능식품,상쾌환 3g x 10포/숙취해소/헛개/컨디션/굿모닝,16300,16300,0
2018-06-01,895744595,A019120,혼합조미료,[대상]대상 맛소금 500g,1890,1890,0
2018-06-01,895744590,A019010,고춧가루,[대상]청정원 까나리액젓 500g,2690,2690,0
2018-06-01,895744591,A019060,된장,[대상]청정원 순창 재래식生된장 1KG,6700,6700,0
2018-06-01,346166814,F012020,생리대,시크릿데이 생리대 센스 대형10PX8팩,13500,12830,-670
2018-06-01,264615978,C012040,여자학생복,[에이인]shine croquis shirts,43000,40850,-2150
2018-06-01,454385568,L021030,가방,남자 남성 서류 가방 직장인 노트북 브리프 케이스 백,39200,38420,-780
2018-06-01,1348637365,C013010,점퍼,KD 양면 여자 무스탕 - 여성무스탕 무스탕 여자무스탕,167360,148960,-18400
2018-06-01,121796822,F011130,홍삼,[농협홍삼/한삼인] 홍삼정 프라임 240g,178500,178500,0
2018-06-01,1960910817,A016100,수박,함안대산 하우스 정품수박 [5~6kg],17000,14900,-2100
2018-06-01,1212053299,L012010,면도기,도루코 6중날 페이스6 고급 휴대용면도기 10P 박스,34980,31140,-3840
2018-06-01,1068223601,C013010,점퍼,[모다아울렛][쉬즈미스]캐쥬얼점퍼야구점퍼(SWWJPI10040-KH),109000,103550,-5450
2018-06-01,121796821,F011130,홍삼,[농협홍삼/한삼인] 홍삼정 프라임 120g,92300,92300,0
2018-06-01,1324077349,E021020,커튼,루베스 콤비 블라인드 중형 1 플러스 1 암막커튼 블라,72750,70570,-2180
2018-06-01,1246774326,D031010,주택수선재료,[월데코]풀바른 소폭합지 간편한 셀프도배 [폭53cm],1300,1190,-110
2018-06-01,1649751743,A011110,당면,국내산 도토리전분 도토리 묵말랭이250g 2개,65720,65720,0
2018-06-01,1596107149,C011030,남자학생복,(남성의류도매)킹스맨 짚업 후드 조끼 베스트 면조끼,27210,27210,0
2018-06-01,895768550,A014010,우유,[매일]매일 우유속에 모카 과즙 310ML,1000,1000,0
2018-06-01,1010257318,A011010,쌀,경기미(추청/특 등급)20KG,59900,59900,0
2018-06-01,1368427255,A019090,카레,오뚜기카레1kg 매운맛 약간매운맛 순한맛 즉석요리,4290,4290,0
2018-06-01,483635335,E061010,세탁세제,플뤼에 패브릭클리너,34000,34000,0
2018-06-01,393826627,C011020,남자상의,MT-220 여름-초가을 패피 싱글수트 (M-2XL) 블루 남자,210890,210890,0
2018-06-01,1369450703,C013050,운동복,폴더 헤드레스트 미니 테이블 차량용수납포켓 자동,29690,29690,0
2018-06-01,1741579885,C015020,모자,볼캡모자 특가 커플모자/남성/여성/스냅백/야구모자,8900,8900,0
2018-06-01,2048757736,A018040,아이스크림,(롯데제과)본젤라또프리미엄요거트아이스크림5리터,25000,25000,0
2018-06-01,1535740876,E031110,청소기,키코스 스팀청소기용 초극세사 스팀패드 4장/리필걸레,11800,9900,-1900
2018-06-01,1409716394,A013090,전복,해감 모듬조개 2kg내외 조개구이 조개찜 해물탕,14900,14900,0
2018-06-01,1822875572,C013040,청바지,[크로커다일] 뱀부 다크네이비 쿨킨 팬츠 CDAA3PT2541_VIP,39000,31200,-7800
2018-06-01,1806323183,L021010,손목시계,[GUESS] 게스 W1059L1 여성용 가죽밴드 패션시계,119000,119000,0
2018-06-01,1501283488,A017220,양파,[우리가락]쪽파 한단,16600,16600,0
2018-06-01,1401423250,L021020,장신구,99.9% 테라헤르츠 은팔찌 테라헤르쯔 건강팔찌,17000,14000,-3000
2018-06-01,17017505,C013060,등산복,몽크로스 액티브 기능성 라운드 티셔츠 6종택1,6500,6500,0
2018-06-01,787423026,E041070,밀폐용기,보르미올리 정품 밀폐용기 무독성 압축패킹/보관용기/밀폐유리병/유리병/유리밀폐용기,1000,920,-80
2018-06-01,799712161,E031030,전자레인지,매직쉐프 전자렌지 전자레인지 20L MEM-GP20W 실속형,59800,59800,0
2018-06-01,794201981,E021020,커튼,리앤룸 잇 아이템 홈인테리어 가리개 커튼,5600,5600,0
2018-06-01,895768587,A021010,커피,[동서]동서 맥심 오리지날(리필/500g),19530,19530,0
2018-06-01,895768586,A021010,커피,[동서]동서 맥심 모카(리필/500g),19530,19530,0
2018-06-01,895768585,A021010,커피,[동서]동서 맥심 디카페인 (리필/170g),8990,8990,0
2018-06-01,1010233354,A012050,소시지,롯데 베이컨 120G*2기획,8980,6490,-2490
2018-06-01,1886112650,E061060,살충제,천연 탈취제/편백나무 피톤치드/원액/새집증후군,13000,13000,0
2018-06-01,121796848,F011130,홍삼,[농협홍삼/한삼인] 홍삼키즈 장원 15ml*30포 (450ml),99400,99400,0
2018-06-01,1387615624,C013010,점퍼,AG 가죽자켓 라이더자켓 가죽점퍼 P173 남성용라이더,99360,99360,0
2018-06-01,121796847,F011130,홍삼,[농협홍삼/한삼인] 홍삼키즈 장원 15ml*30포 (450ml) X 2상자,198800,198800,0
2018-06-01,727969991,E041020,컵,독일직배송 빌레로이앤보흐 디자인 나이프 머그컵#,19900,19900,0
2018-06-01,567793611,E021010,침구,국내산 뽀송뽀송 사계절 간절기이불/패드/세트,16000,14630,-1370
2018-06-01,927621959,A013050,오징어,오뚜기 꽁치 280g X 24EA 캔꽁치 가공음식 꽁치통조림,78440,78440,0
2018-06-01,1897879012,C011030,남자학생복,구제바람막이자켓반팔남방카라티긴팔빈폴폴로청바지옷,5000,5000,0
2018-06-01,389347193,C013040,청바지,투버튼일자진/데님팬츠/청스키니/스판스키니/일자청.,4900,4900,0
2018-06-01,611042166,A019050,간장,진간장 금F3 15L/금S/양조간장/국간장/양조식초/샘표,44000,32000,-12000
2018-06-01,179163422,I012060,저장장치,한성컴퓨터 GTune MKF30S Rainbow (청축/갈축/적축),35000,32900,-2100
2018-06-01,1144766938,L021030,가방,여행용 접이식 폴딩 배낭 가방 백팩 보조가방,24000,23500,-500
2018-06-01,240529146,E031030,전자레인지,[LG전자] LG전자 MW23BD 인버터 전자레인지 LG공식판매점(대명),157000,146000,-11000
2018-06-01,329743213,C011020,남자상의,PL쿨케어 슬랙스 정장바지 남자스판바지 여름쿨바지,19800,19800,0
2018-06-01,1143805587,E041030,솥,사은품증정 신상품 풍년 압력밥솥 압력솥 하이클래드,53500,53500,0
2018-06-01,1834685693,I012010,컴퓨터,APPLE Mac Mini MGEN2KH/A / SG / 애플코리아정품,851580,851580,0
2018-06-01,1146911912,L012010,면도기,카이 레그 트리머/체모 정리기/다리 면도기/당일발송,4400,4400,0
2018-06-01,986158230,E021010,침구,SANTOS rui 뮤즈 양면 구스이불,79000,59900,-19100
2018-06-01,1318197021,C013020,티셔츠,사선주름레이스랩나시/끈나시/섹시티/레이어드나시,5900,5900,0
2018-06-01,1687493494,A017210,파,첫출하! 正品토마토 3kg 판매,6900,6900,0
2018-06-01,887158821,A022020,두유,삼육 미숫가루 두유 파우치 195ml 60팩/곡물/담백한,29600,29600,0
2018-06-01,256054393,C013040,청바지,8900원 당일발송 하이웨스트 슬림일자/스판청바지,10990,10990,0
2018-06-01,613357615,E031110,청소기,유진로봇 로봇청소기 아이클레보 아르떼 YCR-M05-10//,399000,399000,0
2018-06-01,1271343150,C013040,청바지,[젤리스푼]스타일멋진워싱데님팬츠,25900,23310,-2590
2018-06-01,1126410989,E021020,커튼,벌집블라인드 그레이 호프발스 100x155 cm/ 롤스크린,56280,50090,-6190
2018-06-01,952243290,C012040,여자학생복,[대구백화점 I관] [베이직코데즈]캐이블니트가디건(CBA-CD151W1),69000,63480,-5520
2018-06-01,372480855,C013050,운동복,CW3778 아디다스 7/8 조거 팬츠 긴바지여성,34000,34000,0
2018-06-01,1495907834,C012060,여자내의,린넨 슬릿 스커트 MIWWH8621A/ 미쏘,39900,37910,-1990
2018-06-01,1144906028,E041070,밀폐용기,냉장고정리용기/소분용기 반찬통 양념통 주방수납,5500,5060,-440
2018-06-01,595405587,E011020,침대,아씨방가구 전국무료 저상형침대/퀸침대/슈퍼싱글침대,199000,199000,0
2018-06-01,1023692034,C013010,점퍼,안감양털 박시 오버사이즈 코트 DM-4043-이쁜코트 오,75000,74250,-750
2018-06-01,1277234257,A011050,콩,[가온애]대용량볶음땅콩3.75kg/볶음알땅콩1kg/피땅콩,9900,9900,0
2018-06-01,1864855,L021060,유모차,엘츠 3D 유모차 쿨매트 신생아 유아 아기 카시트 쿨시트 유모차라이너 유모차시트 출,18620,18620,0
2018-06-01,1790117332,A013070,굴,◈TV홈쇼핑정품!!◈조선대가 전통 양념 꽃게장 1.2Kg 양념게장/젓갈/게뚜껑/전통방식/,39410,39410,0
2018-06-01,1169750793,C013020,티셔츠,[꼼빠니아][꼼빠니아] 꽃레이스 나시 CA7U4-WKT050_110 (P000347049),25900,23310,-2590
2018-06-01,958573687,A014030,치즈,매일 유기농 아기 치즈 2단계(10매),5400,4400,-1000
2018-06-01,2053780349,E051030,디지털도어록,[자가설치]삼성 디지털도어락 SHS-H620/번호키/전자키,159000,159000,0
2018-06-01,31179539,E011070,식탁,(테이블의자포함)-4인식탁세트/식탁세트/4인식탁/식탁,154700,139230,-15470
2018-06-01,751255136,I031010,장난감,[토이스미스]스플래쉬대셔/점핑로봇피쉬 물속에서 스스로 움직이는 워터토이,17600,16720,-880
2018-06-01,2005141766,C011020,남자상의,(무료배송) AG 빅사이즈 슬림핏 고급모직자켓 슬림핏,180920,159210,-21710
2018-06-01,1306674779,E031070,에어컨,[한일] 한일 천장용선풍기 FC-62LB/연속선회형/한일선풍기,61900,58810,-3090
2018-06-01,1901331726,I031040,생화,[썬파인]아빠어디가 에 나온 바로 그 해먹/왕특대해먹,38800,34640,-4160
2018-06-01,742022138,L021060,유모차,프리메로 휴대용 유모차/원터치폴딩/풀커버캐노피,169000,169000,0
2018-06-01,159113422,E041010,식기,도기야 다온 매트 그릇모음/접시/공기/면기/심플,11900,9900,-2000
2018-06-01,1085577104,C012040,여자학생복,[엄마옷데드라]엄마옷 데드라 8B-BL005 샤프패턴남방,45800,35270,-10530
2018-06-01,1121564628,F012020,생리대,엘리스 생리대 초안심 오버나이트(롱) 14P x 2팩/ 엘리스,12500,11880,-620
2018-06-01,293298820,C013010,점퍼,[텐모어][텐모어] STRIPE JACKET - BLACK [1897998],78000,74100,-3900
2018-06-01,565687074,A017300,미역,우체국 직송/대천김 재래김/파래김 25봉/35봉선택,28900,28900,0
2018-06-01,233705254,F012010,종이기저귀,큐티 프리미엄 소프트 기저귀 밴드형 - 3팩,32900,32900,0
2018-06-01,1010343838,A018050,비스킷,오리온 쿠쉬쿠쉬 240G (6입),3600,3600,0
2018-06-01,1296786154,C014010,아동복,어린이 방한 마스크 MA0667 모모앨리블루스타,9810,9810,0
2018-06-01,456880718,C013010,점퍼,(보니알렉스)소매 배색 면 사파리(BBFZ502A),18990,18990,0
2018-06-01,825405619,A019110,드레싱,코리원/CJ 이츠웰 케이준드레싱 2kg/치킨/샐러드/소스,9600,9500,-100
2018-06-01,348367827,C012060,여자내의,[바비앤펌킨]메들린 멜빵 스커트,64800,58320,-6480
2018-06-01,1471862930,C011020,남자상의,2018/쇼윈도/여름정장세트/남성수트/남성정장/조끼,68800,68800,0
2018-06-01,2071879217,C012040,여자학생복,빅사이즈/훌/소매/블라우스 / 참고 훌소매블라우스 빅,58700,51660,-7040
2018-06-01,305336492,A016020,배,나주배선물세트 3호 7.5kg 14-15과 신고배세트 국산배,52600,52600,0
2018-06-01,1185579057,C013040,청바지,남성 구제 청바지 리바이스  디젤  CK  게스 등 다수,10900,10900,0
2018-06-01,1129395672,E031120,믹서,JB3060WHS 브라운 믹서기 [1.75L/내열강화유리] dk,87500,81970,-5530
2018-06-01,1233071991,A015020,식용유,콩식용유(백설 0.5L)X20 백식이 식용유 업소 식용유정,53090,53090,0
2018-06-01,1186286122,C012040,여자학생복,[메종블랑쉬]골지 롱 나시 여름 니트[M182PSW402](의정부점),29000,25880,-3120
2018-06-01,2057434734,C013010,점퍼,항공점퍼 남녀공용 야구점퍼 블루종 바람막이 점퍼,59700,59700,0
2018-06-01,1939516590,C012060,여자내의,밴드시보리 스판 기모바지 JE-2890 캐주얼의류 캐쥬얼,8060,7960,-100
2018-06-01,821037713,A019130,스프,Dole 돌 가든스프 5가지 맛! 덜 짜고 맛있는 스프,14900,14900,0
2018-06-01,252752807,F012010,종이기저귀,하기스 매직핏/팬티형/기저귀/2018년형/2팩/4팩,31900,31900,0
2018-06-01,451205237,C013010,점퍼,(SR)MHA326 남자빅사이즈후드패딩조끼-2온스,76320,76320,0
2018-06-01,1497809452,A011120,두부,포스트 골든그래놀라x2개+증정골든그래놀라틴케이스,13500,13500,0
2018-06-01,239301087,E011060,의자,빠텐 의자 빠 체어 바텐 바 스툴 식탁 홈바 인테리어,17900,16110,-1790
2018-06-01,1010412009,L012070,바디워시,코코펀치피치구아바샤워젤800ML,13600,4490,-9110
2018-06-01,1747307913,E061080,키친타월,미트페이퍼 (380X80m) 고급형 / 빨아쓰는 키친타올,23000,23000,0
2018-06-01,121796881,F011130,홍삼,[농협홍삼/한삼인] 안심홍삼순 50ml*30포 (1500ml),33200,33200,0
2018-06-01,341145524,C013050,운동복,캐릭터 반팔티셔츠 3부팬츠 트레이닝복 세트 홈웨어,15900,15900,0
2018-06-01,1010412010,L012070,바디워시,해피바스코코펀치라임레몬샤워젤800ML,13600,4490,-9110
2018-06-01,1604457681,F012020,생리대,[시크릿데이] 러브 일반 팬티라이너20PX10팩,11500,11500,0
2018-06-01,99683068,I031040,생화,2단 대형 파라솔/2층/타프/캠핑/비치/파라솔/그늘막,32800,22800,-10000
2018-06-01,109547949,C011030,남자학생복,디자이너핏/울혼방 가디건/짜임이 촘촘한 니트소재/간절기 숄가디건/남자 봄 니트/하프,29800,19800,-10000
2018-06-01,1010233385,E041070,밀폐용기,락앤락마임보온도시락450ml그린,41900,24900,-17000
2018-06-01,461016661,C011020,남자상의,체크 밍크털 코트 남성용털코트 코트 캐주얼코트 남성,107510,104290,-3220
2018-06-01,1441395036,L021030,가방,Targus TSB280AP backpack 타거스 17.3인치 노트북가,110000,99000,-11000
2018-06-01,1173897691,I011020,영상음향기기,비비텍 BX565   BW566 밝기4000 빔프로젝터 프로젝터,670000,609000,-61000
2018-06-01,91306265,C012040,여자학생복,단가라 하프 라운드 긴팔 니트 티 티셔츠 여성 캐주얼,16320,16320,0
2018-06-01,1632106521,F011150,건강기능식품,술친굼 2 박스  10개입,38900,38900,0
2018-06-01,1208730548,E031020,가스레인지,/욕실용 환풍기 (ESV-150G)/ 환풍기 공기정화기 욕실,18500,17300,-1200
2018-06-01,323550933,A017110,감자,제주 구좌 향당근 최상품 당근 산지직송 5kg,12900,12900,0
2018-06-01,1968662997,C013010,점퍼,(ACC(필골드) SL1010 프리미엄 탑 집업후드,47200,42010,-5190
2018-06-01,94024111,C013020,티셔츠,30%쿠폰! 반팔티셔츠/오버핏/7부티셔츠/국내생산,9900,9900,0
2018-06-01,1121539647,F012020,생리대,엘리스 생리대 순수감촉 날개형 소형 22P x 4팩/ 엘리스,8500,8080,-420
2018-06-01,1478282032,A013010,갈치,두툼한 왕특대 갈치500g~1Kg/고등어/젓갈/오징어,7900,7900,0
2018-06-01,1110405414,C021040,실내화,[리복(Reebok)][MENS RUNNING] 런 슈프림 4.0 (CN1428)(경기점),34900,29460,-5440
2018-06-01,1317167399,L012030,칫솔,2018 미피 유아 전동칫솔+케이스/리필 어린이,11500,11500,0
2018-06-01,1795859695,L021060,유모차,2018 허미듀얼웨건/고급승용웨건/유모차캠핑듀얼,99000,99000,0
2018-06-01,1010343844,F011150,건강기능식품,[CJ직배송] BYO 피부유산균 2.5g*100포,150000,65900,-84100
2018-06-01,985416432,E061050,청소용세제,암앤해머 내츄럴 쉐이커400G,3200,3200,0
2018-06-01,454578826,A019040,소금,꽃소금(우리 신한주15K),19300,19300,0
2018-06-01,1010343846,F011150,건강기능식품,[CJ직배송] BYO 피부유산균 2.5g*100포 X2개,300000,119900,-180100
2018-06-01,936354591,F012020,생리대,쏘피 바디피트 향 팬티라이너 40P x 3팩/생리대,10500,10500,0
2018-06-01,2056895645,A011170,떡,전북고창 울어매 모시잎송편 100개(25개 4팩),63640,63640,0
2018-06-01,763078527,C011030,남자학생복,여름신상 남방/솔리드남자옷/데님청/체크스판셔츠,13800,13800,0
2018-06-01,2063443863,C021040,실내화,[리복]리복 클래식 공용 인스타펌프 퓨리 컷아웃 CM9817[갤러리아],153300,122640,-30660
2018-06-01,2138658675,F012010,종이기저귀,팸퍼스 베이비드라이 팬티 5단계 XL48매 x3팩,49800,49800,0
2018-06-01,1457667825,C021020,구두,리차드 남성 U-TIP SIMPLE 드레스 2종 택1 MET3727FG37/ 리차드,100000,82000,-18000
2018-06-01,169369719,C014010,아동복,[밍크뮤] 깃털캐릭터티셔츠 (37433-332-01),18200,14930,-3270
2018-06-01,972298120,C013050,운동복,테라칸-미르웨이 후사경/4WD/RV용품/사각지대/후진주차/현대/기아/대우/쌍용,27000,24600,-2400
2018-06-01,1121540635,F012020,생리대,엘리스 생리대 순수감촉 날개형 대형 10P x 4팩/ 엘리스,8500,8080,-420
2018-06-01,231785301,E041050,냄비,2017년형 베이비맘 이유식조리도구세트 10종/밀크팬,49900,49900,0
2018-06-01,845849070,A011140,부침가루,[삼립] 삼립 냉동 달콤한 화이트슈 (8입),2680,2680,0
2018-06-01,231240882,C012060,여자내의,빅사이즈/로즈/레이스/스커트 로즈레이스스커트 빅사,42870,42870,0
2018-06-01,1220553414,A016030,복숭아,아삭아삭 껍질째 먹는 적포도(크림슨) 2kg이내 XL,19900,19230,-670
2018-06-01,1868419915,L021020,장신구,슬림 가죽 초커 목걸이 초코 골드스틱 레더 가죽 레이,11290,11290,0
2018-06-01,2017462539,C013050,운동복,여성트레이닝팬츠/빅사이즈/봄신상/여자추리닝,16900,16900,0
2018-06-01,1698710726,A022040,기능성음료,[코카콜라]토레타 500ml x 24펫/1.5Lx6펫,20900,20900,0
2018-06-01,1738290500,E031090,공기청정기,[쇼특] 클레어 클레어링 공기청정기 BF2025,69000,65550,-3450
2018-06-01,1209446017,C013040,청바지,여름신상 밴딩 팬츠 스키니 청바지 빅사이즈 허밍퍼플,12700,12700,0
2018-06-01,1084631714,C014010,아동복,[베네통키즈]아동 티셔츠 3종 택1 (3089C3303/3BG8C3036/3I1XC135T),19000,15200,-3800
2018-06-01,1292948920,A021020,차,빅트레인모음/빅트레인/바닐라라떼/파우더/자바칩파우더/쿠키앤크림파우더/요거트파우,29500,29500,0
2018-06-01,1290057390,C012040,여자학생복,여름신상 남방44-88빅사이즈 체크 셔츠 루즈핏 린넨,22800,22800,0
2018-06-01,378651838,L021020,장신구,(유색보석 나비 큐빅 귀걸이) 데일리 쥬얼리 연예인,16800,15120,-1680
2018-06-01,58087109,A012010,국산쇠고기,팔도 호두기름세트 3호(고품격 웰빙 선물세트)사은품,109090,109090,0
2018-06-01,248012364,I031040,생화,국산짱짱한 등산용 무릎보호대 등산 무릅 보호대 관절,9900,9900,0
2018-06-01,501018008,F012020,생리대,NEW 엘리스 생리대 골라담기(9900원이상 무배),3900,3900,0
2018-06-01,1223199470,I031040,생화,충전식 스틱 LED램프 캠핑랜턴 차량 작업등 후레쉬,13600,12520,-1080
2018-06-01,1291537459,C012040,여자학생복,막스엔코 여성 S 면 민소매 나시 티 정품 상태최상,27720,27720,0
2018-06-01,855298170,A019110,드레싱,CJ 드레싱 모음전,3980,3980,0
2018-06-01,1104891888,C013040,청바지,저스트원 청바지/자체제작/봄신상/스판/당일배송/바지,22900,18900,-4000
2018-06-01,570912487,C014010,아동복,로하스 한지 남아 체크 런닝 셋트 닥나무 원료의,28420,28420,0
2018-06-01,1196221989,C013010,점퍼,[홈런]블루종/항공점퍼/야구/점퍼/집업/남자/남성,19800,19800,0
2018-06-01,971441028,C013050,운동복,트라제XG-미르웨이 후사경/4WD/RV용품/사각지대/후진주차/현대/기아/대우/쌍용,27000,24600,-2400
2018-06-01,1986725392,E031120,믹서,신일 믹서기/스텐믹서기/다지기/블렌더/믹서기분쇄기,59600,59600,0
2018-06-01,896668980,A012020,수입쇠고기,E-호주산 곡물우 양지국거리용 (100G),3490,2280,-1210
2018-06-01,896668981,A012020,수입쇠고기,E-호주산 곡물우 척아이롤 (100G),3490,2826,-664
2018-06-01,499094027,C011030,남자학생복,쿨링프리미엄 얼음조끼,46310,46310,0
2018-06-01,1969437241,F012010,종이기저귀,[하기스] [2018]하기스 에어솔솔 썸머팬티 5단계 여아 80매,38700,38700,0
2018-06-01,1249563080,A011140,부침가루,하루노유키 피레네 플레인 바움쿠헨 답례품 디저트 간,30160,30160,0
2018-06-01,1765309315,I011010,TV,UHD43S / 43인치UHDTV / 100%무결점 패널2년무상AS,311460,299000,-12460
2018-06-01,1122197237,A017160,오이,건버섯 모음 500g/표고 버섯/건표고/목이/백목이,9400,9400,0
2018-06-01,1429803828,C012060,여자내의,매킷 헤지 청반바지 패션파지 데님반바지 여성바지 여,18250,18250,0
2018-06-01,681094571,E061030,전구,코콤 LED형광등 등기구 일체형/매입등/거실등/방등,64900,64900,0
2018-06-01,896668984,A012020,수입쇠고기,E-호주산 곡물우 앞다리 (부채살/100G),3290,2632,-658
2018-06-01,2084493684,A019140,이유식,[얼스베스트] 미국 유기농 이유식/아기/죽/간식,1500,1500,0
2018-06-01,398086958,C013020,티셔츠,헤짐펀칭빈티지티/망사반팔티/보트넥티/시스루티셔츠,4900,4900,0
2018-06-01,631196745,A017120,고구마,하루한끼 맥반석으로 구운 날씬이 황토 군고구마 150g,90000,79200,-10800
2018-06-01,181754161,A016020,배,찬바람N 앤 도라지배즙 100mg25포 도라지 배즙 겨울식,46750,46750,0
2018-06-01,452736646,C014010,아동복,아둘 패밀리룩 쥬니어 루즈핏 SANDIEGO 롱티셔츠 12,14300,14300,0
2018-06-01,976144194,C013050,운동복,싼타페SM-미르웨이 후사경/4WD/RV용품/사각지대/후진주차/현대/기아/대우/쌍용,27000,24600,-2400
2018-06-01,1893914618,L012040,치약,2080 진지발리스 치약 140g x 12개 외 칫솔 18개 택1,11900,11900,0
2018-06-01,1011149282,E041030,솥,[CUAN] 쿠앤 멀티 3구 에그팬,49000,12900,-36100
2018-06-01,896668979,A012020,수입쇠고기,E-호주산 냉장우 갈비찜용(100G),2490,1694,-796
2018-06-01,165928380,F012020,생리대,한결 카테킨 18Px3팩+증정6P녹차성분/생리대/바디피트,9900,9900,0
2018-06-01,721581621,C011030,남자학생복,패딩 빅사이즈 밀리터리 점퍼 빅사이즈,56190,54510,-1680
2018-06-01,632495233,C013020,티셔츠,NBA 여성 95 라운드 밀리터리 긴팔 티 봄 가을 상태굿,29510,29510,0
2018-06-01,1362692589,C011030,남자학생복,닥스 와이셔츠/남방/드레스셔츠/빈폴/반팔 사랑채,49000,49000,0
2018-06-01,1262506527,A013070,굴,건해삼(채 미국 600g)X12 해삼요리 서해삼치 건조해삼,1128710,1128710,0
2018-06-01,769453146,I011030,사진기,명품마을 캐논 정품 EOS M6 바디 새상품,658530,658530,0
2018-06-01,1840113843,I011010,TV,삼성65인치패널2년무상보증/특가65인치TV/당일출고,829000,799000,-30000
2018-06-01,1596651243,L021020,장신구,실팔찌 은팔찌 매듭 커플 이니셜 남자 팔찌 실발찌,7000,6900,-100
2018-06-01,504751463,C013050,운동복,프론트 리어 범퍼 가드 보호대 몰딩 화이트 범퍼 보호,22930,20470,-2460
2018-06-01,1116409770,C012060,여자내의,[윈]버튼포인트골지라인니트스커트,69800,65620,-4180
2018-06-01,1508366326,C014020,유아복,[대구백화점 II관] [카라멜플라츠]디어베이비 루키라인캣후드점퍼 3종택1(02L355002),19900,18510,-1390
2018-06-01,1929263148,E061010,세탁세제,세제 아기사랑3p선물세트 유아세제 유아세탁세제 액체,54420,54420,0
2018-06-01,1197737604,A015020,식용유,오뚜기 프레스코 포도씨유 500ml X 20EA 기름 식용기,138710,134550,-4160
2018-06-01,1322849033,C011050,남자내의,(색상:사이즈 : 블랙:XL) DON 1846 린넨9,28220,28220,0
2018-06-01,1553203993,C014020,유아복,여자아기패딩 베이비점퍼 여아겨울점퍼 여아롱패딩,29000,28000,-1000
2018-06-01,1001509424,A012060,햄및베이컨,스팸 클래식 200gx8캔 / 340gx6캔 통조림/햄/런천미트,16900,16900,0
2018-06-01,985416428,A013110,마른오징어,통영 멸치(볶음용) 200G/봉,8990,8990,0
2018-06-01,650908704,C012040,여자학생복,보이핏린넨팬츠 (J11PPT114)/ 매그제이(MAGJAY),42000,37800,-4200
2018-06-01,1054166547,C013020,티셔츠,[타미힐피거]TOMMY HILFIGER 반팔 슬림핏 카라티셔츠,39900,39900,0
2018-06-01,445023821,E061100,습기제거제,[생활공작소] 제습제 520ml x 24입 습기제거제,17900,17900,0
2018-06-01,89332986,C012040,여자학생복,[빌드]BISN108 세미 블랙 가디건/빅사이즈/미시/여성,34000,34000,0
2018-06-01,1999324134,C013020,티셔츠,빅사이즈민짱/설렘주의 신상티모음/롱/루즈핏/무지,12900,12900,0
2018-06-01,816953635,C012020,원피스,[케네스레이디]카치니 원피스 [EGOPHE9500](대구신세계),44000,35690,-8310
2018-06-01,1771537130,A016060,감,상주전통곶감 감말랭이 1kg 지함상자 곶감/상주곶감/,33900,33900,0
2018-06-01,631204559,A016020,배,2017 추석 미래로 VIP 배 선물세트 추석선물 감사선물,125900,110800,-15100
2018-06-01,1824354743,A011110,당면,차오름 파래김 (200G) x70,457950,457950,0
2018-06-01,524211940,A022020,두유,[매일두유]아몬드브리즈 언스위트/바나나/초코(24팩),17800,17800,0
2018-06-01,1016394308,L012010,면도기,골드플러스 금칫솔4P/숯칫솔/금칫솔/칫솔/칫솔세트,600,600,0
2018-06-01,895744620,A019010,고춧가루,[대상]청정원 멸치액젓 1kg,4490,4490,0
2018-06-01,1763926035,I031040,생화,빈슨메시프 미니 침낭-초경량 백패킹 등산 여행 캠핑,29800,29800,0
2018-06-01,989166187,E041080,부엌용용구,[지홈] 지홈 우드실리콘 뒤집게,7800,6800,-1000
2018-06-01,1011150278,A018070,파이,오리온 생크림파이 오리지널 264G,4000,4000,0
2018-06-01,1684741424,F012010,종이기저귀,킨도 독일 프리미엄 기저귀 팬티형 4단계 (42매x4팩),61600,61600,0
2018-06-01,1709401442,A016030,복숭아,경산자인농협 하우스 털복숭아 900g (6과),26900,26900,0
2018-06-01,1177456847,A011020,현미,[홈플러스][행사상품]찹쌀_3.8KG 봉,9990,9500,-490
2018-06-01,488083602,E041010,식기,히란야/액자/풍수지리/인테리어/소품/용품/개업선물,73300,71840,-1460
2018-06-01,742305831,I031070,애완동물관리비,나이키(휘트) 발목 모래 주머니 1.13KG(FE0179-007),26000,20710,-5290
2018-06-01,1298928752,I053010,공책,묶음상품 근영사)아이디얼 미싱노트(40절 9권세트)x3,56300,56300,0
2018-06-01,488083605,E041010,식기,황금/풍수/지리/인테리어/소품/닭/부부금실/금전대박,167400,164060,-3340
2018-06-01,472492652,A019070,양념소스,오뚜기 간장찜닭양념 180g X 20EA / 오뚜기(Hanworld2,66100,56190,-9910
2018-06-01,624872018,A012030,돼지고기,에스푸드 불고기탑핑 1kg 2개,49000,47530,-1470
2018-06-01,1179726516,A017170,풋고추,백오이(특품)10kg 두리반농산,24000,24000,0
2018-06-01,1746391514,A017140,콩나물,(18년도) 강원도 홍천 3~4년된 햇 약도라지 1kg,12900,12900,0
2018-06-01,1530698418,A021020,차,희창 카페크림 700g/원두용 전지분 800g/프림/프리마,3200,3200,0
2018-06-01,451146362,A019010,고춧가루,A김치 고추가루 1kg2개 가루 고추가루 김치고추가루,41520,37370,-4150
2018-06-01,1082885910,C012030,여자상의,V넥 린넨프릴 원피스,29900,29900,0
2018-06-01,337569992,C013010,점퍼,깜보KC 여름 매쉬 조던st 점퍼/5~17호 성인 바람막이,23700,23700,0
2018-06-01,1747665297,A021010,커피,맥심 모카골드 커피믹스 1kgx10/믹스커피/자판기,77900,67800,-10100
2018-06-01,423347765,C015020,모자,(컬러:사이즈 : 블랙:FREE) ACC-CAP102 베이,19630,19630,0
2018-06-01,441894535,A015020,식용유,도라지엑기스 백프로 110g-진한 도라지향과맛,30290,30290,0
2018-06-01,1625620908,C013050,운동복,안전삼각대.경광봉/비상봉/교통봉/비상경광봉/신호봉,2400,2100,-300
2018-06-01,205737857,I053010,공책,옥스포드 리갈패드(A5/A4/B5/기자수첩)/옥스포드노트,650,650,0
2018-06-01,1973315205,A013100,마른멸치,완도 활 참 전복 모음 1kg 특가구성,20920,20920,0
2018-06-01,1254057206,E031080,선풍기,나노카본 터보 온풍기 FU-4055 - 온풍기 터보온풍기,705760,628130,-77630
2018-06-01,66835124,A011100,라면,대한제분 내고향 국수(소면) 3kg,5300,5300,0
2018-06-01,2056930517,I053010,공책,초등 노트/공책 중고등 10권/5권 무제 알림장 줄 유선,1400,1400,0
2018-06-01,1992214830,A018090,잼,[오뚜기] 오뚜기 딸기쨈 (디스펜팩) 12g×96개,8000,8000,0
2018-06-01,1592707073,A011090,국수,최저가 컵라면 육개장 x 2개 99종 /사발면/왕뚜껑,500,500,0
2018-06-01,2133617664,C014010,아동복,[버블트리]~23호/여아/의류/아동복/주니어/원피스,19800,19800,0
2018-06-01,214737745,C012030,여자상의,~99까지 여름빅사이즈냉장고원피스/레이온엄마옷/인견,9800,9800,0
2018-06-01,515824538,A011140,부침가루,백설 컵케익 (쵸코) 55g,1900,1900,0
2018-06-01,138086984,A013170,생선통조림,한성 자연산 골뱅이 400g / 고등어/꽁치통조림 400g,4800,4800,0
2018-06-01,120987630,E031130,보온매트,프로방스체크 전기요(TP)(대형) 135X180CM,57000,57000,0
2018-06-01,1990436705,A013130,오징어채,정화 맥반석 진미오징어 ( 채 ) 30g x 5,17230,17230,0
2018-06-01,76059911,C011030,남자학생복,남성 브이넥 가디건 LCST AH4564-18ARQX/ 라코스테(의류),218000,207100,-10900
2018-06-01,221842145,E011060,의자,정품 타이탄 특가 의자 사무용 책상 학생 PC방 페라리,44910,44910,0
2018-06-01,350378557,L021030,가방,COPI_여자백팩 가죽백팩 무지백팩 학생백팩 책가방,19900,17900,-2000
2018-06-01,352436905,C012040,여자학생복,[화이트폭스]플라워패턴오프숄더블라우스,15500,14110,-1390
2018-06-01,2002745522,A013040,고등어,당일 생산 냉장 제주 고등어 大사이즈 한마리1000원대,10900,10900,0
2018-06-01,1779631282,L021020,장신구,[바보사랑]두산베어스 원형 손거울 스트라이프,4000,4000,0
2018-06-01,530510703,C012060,여자내의,허리조절 기모 스판 교복치마 네이비 교복 예쁜교복,49840,48350,-1490
2018-06-01,573933766,F012020,생리대,동아제약 뉴 템포 100P+라이너30P 레귤러/슈퍼/생리대,29900,29900,0
2018-06-01,1563156556,C013010,점퍼,카리프 아웃도어/여름 망사조끼/경량 기능성등산복,6800,6800,0
2018-06-01,320871864,C013050,운동복,DDK00218 트레이닝 져지 803 운동복집업 여성트레이닝,51010,51010,0
2018-06-01,177434636,L012040,치약,시린메드치약125gx5개+사은품증정 에프/안티프라그,24500,24500,0
2018-06-01,1766059556,A019170,냉동식품,포자찐만두 3kg 만두/찐만두/포자만두,14900,14900,0
2018-06-01,1121564572,F012020,생리대,엘리스 생리대 초안심 오버나이트 16P x 2팩/ 엘리스,12500,11880,-620
2018-06-01,581951269,C012020,원피스,S164S106_모던 진주장식 울96 숏자켓/ 샤틴(영패션),99000,81180,-17820
2018-06-01,1915407001,E041010,식기,크리스탈 면기 우동기 라면그릇 볼 공기 멜라민그릇,1000,910,-90
2018-06-01,451579084,A011120,두부,오레오 오즈 기획(500g+500g)+사은품/시리얼/과자,15900,15900,0
2018-06-01,696741907,A014020,분유,[일동후디스]트루맘 프리미엄 후레쉬 4단계 800g 3캔,66000,66000,0
2018-06-01,2033896003,C013010,점퍼,[써스데이아일랜드](T184MJK232W) 린넨 원버튼 자켓,299000,239200,-59800
2018-06-01,607893565,L012040,치약,(특가) 치약 x10개 2080/시스테마/클리오/뉴후레쉬,6900,6900,0
2018-06-01,1396218263,C011050,남자내의,여름 남성 면바지 치노팬츠 빅사이즈 스판면바지w019,16000,15800,-200
2018-06-01,1021209421,C013010,점퍼,봄신상할인/마크막스린넨코디/린넨자켓/롱원피스,7900,7900,0
2018-06-01,120987652,E031130,보온매트,프로방스체크 전기요(TP)(중형) 110X180CM,49500,49500,0
2018-06-01,996849178,I031040,생화,캡라이트 /헤드랜턴 /충전식/센서작동/usb충전,10900,8900,-2000
2018-06-01,895768646,A012060,햄및베이컨,목우촌 식빵위의 네모햄 (110G),2780,2490,-290
2018-06-01,876932793,C014020,유아복,두툼 따뜻_유아 롱패딩_유아 패딩점퍼_유아 퍼코트,29900,29010,-890
2018-06-01,494476397,C011030,남자학생복,커스텀멜로우 O ring zipper vest_CWUAA17951NYX/ 커스텀멜로우,239000,205540,-33460
2018-06-01,1124474438,A013010,갈치,제주 옥돔 프리미엄 3kg(마리당450g내외 선물포장) 탐,242600,235330,-7270
2018-06-01,1125613380,C013020,티셔츠,11남자긴팔티/절개티/남성티셔츠/배색티/단가라/엠보,14900,9900,-5000
2018-06-01,266517681,C011020,남자상의,MJ-1079 CONTINVE자켓-진청 야구점퍼 여성항공점퍼 야,64360,61150,-3210
2018-06-01,1382235919,A013090,전복,[제철]달달한! 자연산 가리비(비단가리비) 1kg,12900,12900,0
2018-06-01,754323317,C013020,티셔츠,[베네통키즈](여름신상품)남아그래픽반소매티셔츠(3BLOC1324)[갤러리아],19000,14630,-4370
2018-06-01,1897282546,C013020,티셔츠,블랙야크[L카메론티셔츠S-2]여름 여성용 등산티셔츠블랙야크 흡슥속건이 우수한 여름티,49000,41650,-7350
2018-06-01,367875222,F012020,생리대,(초특가)뉴 템포 100p/화이트 탐폰 96p/생리대,26900,26900,0
2018-06-01,921087731,C013010,점퍼,와펜심플패딩/겨울키즈남여공용패딩/아동패딩점퍼,33900,19900,-14000
2018-06-01,620059508,C013020,티셔츠,[그랜피니] 반팔/반바지/긴팔/오버핏/배색티/남녀공용,9900,9900,0
2018-06-01,466949666,A019060,된장,마루코메 미소된장 4종 32인분 576g/분말 타푸리 오토,10510,10510,0
2018-06-01,447957709,C013020,티셔츠,언더레이어티셔츠(사계절_기본형_여성용_민트) 케주얼,58730,58730,0
2018-06-01,2095759835,C012040,여자학생복,물결입술니트 /니트/기본니트/라운드니트/반팔니트/ 톰앤래빗,18000,16920,-1080
2018-06-01,529734280,C012060,여자내의,라인이 예뻐보이는 그레이주름치마 주름 교복치마 교,49840,48350,-1490
2018-06-01,264733195,C013040,청바지,생지느낌 그대로 팬츠 SXL 진청 DP278 데님스키니 생,24480,24480,0
2018-06-01,915351003,A016030,복숭아,산초가루(움트리 50g)X20개/산초 산초가루 산초분말,71330,67060,-4270
2018-06-01,758480694,G011070,자전거,알톤 로드마스터 R6021 /알로이 차체/콜리고,240000,211680,-28320
2018-06-01,1316767234,C012040,여자학생복,[앤썸][데일리스트앤섬] 페미닌 프레쉬 패턴 민소매 블라우스MDPNSSM3131,26800,24120,-2680
2018-06-01,953953265,A021020,차,동원 밀크앤퍼니 스트로우 초코 (35g(3.5g*10T)),3380,3380,0
2018-06-01,953953264,A021020,차,동원 밀크앤퍼니 스트로우 딸기 (35g(3.5g*10입)),3380,3380,0
2018-06-01,11294776,E031020,가스레인지,2018년형) 에코버너 화이트 2구 가스렌지 GRA-813SR,114000,114000,0
2018-06-01,1630143570,F012010,종이기저귀,팸퍼스기저귀 모음전 / 베이비드라이 크루저 러브스,59900,59900,0
2018-06-01,1813013012,E021010,침구,스누즈 봄신상품 이불세트 이불 차렵이불 침구세트,28000,24900,-3100
2018-06-01,895744683,A019080,고추장,[대상]대상 순창 초고추장 300g,2750,2750,0
2018-06-01,2017340105,E031010,전기밥솥,쿠첸 6인용 전기압력밥솥/전기밥솥/밥솥 CJS-FA0611V,126590,119000,-7590
2018-06-01,1318092895,C012060,여자내의,플로이 멜빵청치마 SD-6471 멜빵스커트 청스커트 멜빵,32380,32380,0
2018-06-01,1405157890,C013040,청바지,[올젠] ZPY2PP1503 뱀부소재가 함유된 나일론 혼방 팬츠 3종 택1,45000,36000,-9000
2018-06-01,2048182933,A011140,부침가루,딜리셔스 몽키 브라우니 22g x 40개/술이홀제과 수제 바나나맛 브라우니/미니브라우니,39800,39800,0
2018-06-01,1056874962,E061060,살충제,썸머패치144매/24시간효과/등산 낚시 캠핑/여름패치,9500,9500,0
2018-06-01,1452854154,A011010,쌀,[월향미] 달빛 머금은 쌀 5kg (골드퀸 3호) / 백미,21900,21900,0
2018-06-01,639170901,A019050,간장,계란에 뿌리는 간장소스300ml/타마고간장/계란간장,6800,6800,0
2018-06-01,546476450,E031020,가스레인지,RBO-618SE 린나이 빌트인 4구 가스쿡탑/가스오븐렌지/화재예방/황토오븐/자연대류형/마,930000,910000,-20000
2018-06-01,1162279952,A018080,설탕,브라질산 고이아사유기농 설탕 3kg/5kg/선택/무료배송,10900,10900,0
2018-06-01,1645138015,I031040,생화,접이식 롤테이블 캠핑테이블120cm/94cm,52500,48210,-4290
2018-06-01,654401977,E061050,청소용세제,몽블 화이트13kg 화장실 욕실 타일 청소세제 락스세제,14500,14500,0
2018-06-01,1851066990,L021030,가방,[피에르가르뎅] 80데니아 학생스타킹(검정색) 5족/10족[KJC] 학생양말 10족[고급품질],23120,23120,0
2018-06-01,1312364458,C012040,여자학생복,kk34 헨리넥st 하프버튼 데님셔츠_진청 여성청셔츠 하,16000,16000,0
2018-06-01,1093343885,L021010,손목시계,[바보사랑][JY]심플 아날로그시계(수능시계),10000,10000,0
2018-06-01,349233619,C012040,여자학생복,여성 겨울 원피스 KK 양 V 니트 OPS,45450,45450,0
2018-06-01,2042454525,C014020,유아복,[밀리밤]절개 프릴소매 반팔티 MLRA18401,15900,15900,0
2018-06-01,545782358,C013010,점퍼,[프린세스걸]베이지 라운드 넥 롱 패딩 점퍼긴 자켓 코트 리본 집업 짚업 지퍼 누빔 다,218100,174480,-43620
2018-06-01,1447147140,E011020,침대,인쏘노 퀸 침대 : 침대프레임 + 매트리스 베스트 특가,212970,212970,0
2018-06-01,1783207350,L021010,손목시계,[공식  백화점AS가능]사우스햄튼 여성시계(가죽)_W0833L2,108800,108800,0
2018-06-01,1783207351,L021010,손목시계,[공식  백화점AS가능]파크에비뉴 사우스 여성시계(가죽)_W0838L2,142800,142800,0
2018-06-01,530894628,C013020,티셔츠,남성오가닉 반팔티셔츠10170-031-403-05/ 행텐,9900,8620,-1280
2018-06-01,488058675,E041010,식기,옛날/엽전/풍수지리/인테리어/장식/소품/개업선물,93500,91630,-1870
2018-06-01,1321225424,A013040,고등어,노르웨이 순살 고등어 2kg 160g~220g,31800,31800,0
2018-06-01,1286168155,C011050,남자내의,남여공용 밴딩 슬랙스/링클프리/스판/원플/바지/S~2XL,11900,11900,0
2018-06-01,1783207349,L021010,손목시계,[공식  백화점AS가능]윌로우 여성시계(메탈)_W0822L4,278800,278800,0
2018-06-01,1661786137,E061030,전구,금호(LED 일자등 주광색 50w)/형광등/조명/램프/방등,17900,17900,0
2018-06-01,1383426040,C012020,원피스,라인모던 롱코트(NW7WH736)@털브롯지/ 온앤온,539000,431200,-107800
2018-06-01,1110909899,A017210,파,[완전특가]正品 영양만점 찰토마토 10kg 대용량,13900,13900,0
2018-06-01,187964829,E011020,침대,레이디가구 스칸딕 원목100% 데이베드침대+가드사은품,299000,299000,0
2018-06-01,889181269,E031080,선풍기,신일 탁상용 소형 전기온풍기 SEH-P20 [2단조절 / 코일 미니히터 / 탁상용 / 블로어팬],29900,29900,0
2018-06-01,889181268,E031080,선풍기,신일 석영관 2단 소형 전기히터 SEH-G800 [2단조절 / 무취 무연 무소음 / 전도안전스위치],17200,17200,0
2018-06-01,307601452,L021010,손목시계,패션 크로노그래프 스포츠 캐주얼 손목시계,38900,38900,0
2018-06-01,1556935091,E021010,침구,40수순면 차렵이불+요토퍼+베개/이불세트/패드세트,59900,59900,0
2018-06-01,1714862882,C012040,여자학생복,[이사베이]플라워 프린팅 집업 가디건 (VQCBD5171)_V8I4,35000,33250,-1750
2018-06-01,889181266,E031080,선풍기,신일 에코 전자식 코일 히터 SEH-ECO50 [저전력 / 3중안전장치 / 4시간타이머],62000,62000,0
2018-06-01,1783207343,L021010,손목시계,[공식  백화점AS가능]EYELET 여성시계(메탈 가죽)_W0712L2,278800,278800,0
2018-06-01,1783207344,L021010,손목시계,[공식  백화점AS가능]HARPER 여성시계(메탈)_W0730L1,159800,159800,0
2018-06-01,1663277544,C013050,운동복,(LED 블링크 경광등 (SWL-119)) 국내제작 LED 안전봉,20500,18250,-2250
2018-06-01,1783207342,L021010,손목시계,[공식  백화점AS가능]첼시 여성시계(가죽)_W0648L22,134300,134300,0
2018-06-01,1783207347,L021010,손목시계,[공식  백화점AS가능]파크 에비뉴 여성시계(메탈)_W0767L2,185300,185300,0
2018-06-01,1783207348,L021010,손목시계,[공식  백화점AS가능]라임라이트 여성시계(가죽)_W0775L7,236300,236300,0
2018-06-01,1783207345,L021010,손목시계,[공식  백화점AS가능]HARPER 여성시계(메탈)_W0730L2,168300,168300,0
2018-06-01,1783207346,L021010,손목시계,[공식  백화점AS가능]HARPER 여성시계(메탈)_W0730L3,185300,185300,0
2018-06-01,1319547596,A011140,부침가루,New! 필라델피아 치즈케익 794g 라즈베리 터틀,18000,18000,0
2018-06-01,542204569,I031010,장난감,Step2 멜로디 지붕차 지붕차 유아승용완구 유아완구,223280,223280,0
2018-06-01,1053455835,A012040,닭고기,[맛있닭] 닭가슴살 스테이크 외 35종 골라담기,1500,1500,0
2018-06-01,2080439090,A022050,탄산음료,탑씨 오렌지.파인애플.포도 190mlx30캔 170mlx30캔,5400,5400,0
2018-06-01,889181270,E031080,선풍기,신일 석영관 2단 전기 소형히터 SEH-G600 [2단조절 / 무취 무연 무소음 / 전도안전스위치],12560,12560,0
2018-06-01,990003444,A019180,즉석식품,CJ 비비고 설렁탕 500G,4580,3590,-990
2018-06-01,670662103,C011050,남자내의,[지오다노] 인생핏18S/S 남성 신상 슬랙스 특가 득템 찬스!/ 지오다노,17000,13430,-3570
2018-06-01,440946894,C012040,여자학생복,아이우먼 꽃 레이스 라인 팬티 VA0308M805 빅사이즈,26500,23300,-3200
2018-06-01,223948609,E011040,소파,[에보니아] 포니 1인 인조소파/방수패브릭/업소용쇼파,49000,46400,-2600
2018-06-01,1918755382,E061050,청소용세제,해피클럽[유한락스]곰팡이제거(500ml+500ml)x2개 P,10890,10890,0
2018-06-01,1387882994,C012020,원피스,[올리브데올리브]데일리한 양모코트@키링(OW7WH561),179000,139620,-39380
2018-06-01,897465741,L012040,치약,[LG]LG페리오키즈치약버블검75G*2,3990,3990,0
2018-06-01,504557103,C013020,티셔츠,카발라니 단추 후드티셔츠 DK-1696 트랜디후드 후드,27230,27230,0
2018-06-01,2079665711,C011050,남자내의,[캘빈클라인진] 남성 CK로고 스트레치 반팔 티셔츠(J307543),39000,33150,-5850
2018-06-01,1701955170,A019010,고춧가루,베트남고추가루 땡초 청양 수입 고춧가루 매운고추1kg,6000,6000,0
2018-06-01,1266660163,C011030,남자학생복,린넨 7부셔츠 BTT0167 셔츠 여름셔츠(YA02004) 남자셔,26160,26160,0
2018-06-01,448546223,C021040,실내화,[오닐] 런칭기념 취향저격 스니커즈 총집합,12900,12900,0
2018-06-01,509417567,A016100,수박,2018년 고창수박/ 애플수박 2.5kg내외/6월4일순차배송,17100,17100,0
2018-06-01,658305544,C014010,아동복,여름/주니어/아동티셔츠/반바지/아동바지/청바지/반팔,9900,9900,0
2018-06-01,1580550358,C014010,아동복,여아드레스 엘사 소피아 라푼젤 공주 백설 할로윈의상,19900,19900,0
2018-06-01,379523285,C013030,스웨터,아디다스 ZNE 스톰헤더 후드자켓(BQ5360) 아웃도어 케,176880,176880,0
2018-06-01,358040375,L021010,손목시계,로제타 손목시계 FW-29_색상임의배송 손목시계 패션시,15320,14870,-450
2018-06-01,631172752,A017120,고구마,하루한끼 맥반석으로 구운 날씬이 황토 군고구마 150g,53600,45560,-8040
2018-06-01,240483292,C015030,넥타이,(색상 : 브라운) BTIE_097 점자 보타이 정장,13420,13420,0
2018-06-01,884500052,A011030,찹쌀,고창예술농부가 만든 오색칼라 보리쌀 2kg,9500,9500,0
2018-06-01,12591090,C011030,남자학생복,꾸제꾸제/KAPPA 집업 니트 가디건/size XL/울혼방/스웨터/자켓/세일/브랜드/빈티지/중,17900,17900,0
2018-06-01,801648557,A011140,부침가루,샤니 골드버터롤파티 540G 빵,6000,5820,-180
2018-06-01,654130237,A013090,전복,통영 키조개5미/가리비/멍게/조개/산지직송,19000,19000,0
2018-06-01,867204664,L021060,유모차,[어비니] 에보베2X 쌍둥이 유모차/사은품 쁘띠몽 쿨매트 2장 (색상랜덤) 증정,159000,159000,0
2018-06-01,31263392,E041020,컵,[와드몰]사마도요 티포트세트 단독입고 (찻잔+티포트,21000,21000,0
2018-06-01,1783207320,L021010,손목시계,[공식  백화점AS가능]첼시 여성시계(가죽)_W0648L20,117300,117300,0
2018-06-01,1370479782,I031040,생화,싸파 커플 발레리 릴낚시대1+1파격 원투낚시대/방파제,8000,6720,-1280
2018-06-01,944105332,E041050,냄비,에코라믹 통주물 스톤냄비 세트,60900,57900,-3000
2018-06-01,1412748021,C013020,티셔츠,수술v넥쉬폰티/브이넥티/쉬폰블라우스/오피스블라우스,9900,9900,0
2018-06-01,1783207318,L021010,손목시계,[공식  백화점AS가능]소호 여성시계(메탈)_W0638L6,278800,278800,0
2018-06-01,1783207319,L021010,손목시계,[공식  백화점AS가능]첼시 여성시계(메탈)_W0647L4,236300,236300,0
2018-06-01,687529261,I012010,컴퓨터,애플 MF885KH/A 아이맥 레티나 5K 디스플레이/정품/SG/빠른배송,2321580,2321580,0
2018-06-01,1783207316,L021010,손목시계,[공식  백화점AS가능]MINI MYSTICAL 여성시계(가죽)_W0626L2,159800,159800,0
2018-06-01,1783207317,L021010,손목시계,[공식  백화점AS가능]소호 여성시계(메탈)_W0638L3,278800,278800,0
2018-06-01,2104265972,C013040,청바지,바닐라스토리 아동 수술 숏 청바지 남아반바지,22800,22800,0
2018-06-01,801250249,C013050,운동복,고급 가죽재질 차량용 다용도 멀티포켓 컵홀더,8500,7260,-1240
2018-06-01,1124449447,A013010,갈치,제주 은갈치 프리미엄 8마리(1마리당650g내외 선물포,572000,554840,-17160
2018-06-01,46220957,A013040,고등어,노르웨이 고등어 20팩 / 최신제조 / 소/중/대,17900,17900,0
2018-06-01,265505227,C013010,점퍼,[패션플러스][CLASSY][클래지앤] 28 믹키 롱 블루종 점퍼 3color,67200,63840,-3360
2018-06-01,895768620,A012050,소시지,목우촌 주부9단 프랑크 500G,7780,6490,-1290
2018-06-01,990003466,A019180,즉석식품,CJ 비비고 소고기미역국 500G,4580,3590,-990
2018-06-01,231215805,C021010,아동화,[꼴레지앙(Collegien)][3일내출고]Sunshine NOIR 누아 (공식수입정품/AS),72000,59040,-12960
2018-06-01,1333396816,F012010,종이기저귀,마미포코 360핏 대형42P/특대형30P 3팩,33000,33000,0
2018-06-01,895768617,A012060,햄및베이컨,[목우촌]목우촌 주부9단 김밥햄 (170G),2700,2700,0
2018-06-01,240603261,C021040,실내화,[푸마] (SIZE : 265) 플레어 2(18951703) 신발 러닝,85190,85190,0
2018-06-01,292277533,C013020,티셔츠,x자골지니트나시/민소매티/슬리브리스/크롭티/섹시티,6900,6900,0
2018-06-01,1042081468,F011150,건강기능식품,속편한에센셜 위건강 속쓰림역류구토개선 글라브리딘,39900,39900,0
2018-06-01,1006693116,A018070,파이,무배) 대용량 롯데 초코파이 420gx8갑 몽쉘/찰떡파이,21900,21900,0
2018-06-01,1141154365,A019180,즉석식품,정성온 즉석탕 육개장 갈비탕 전구매고객 떡갈비증정,2390,2390,0
2018-06-01,895768619,A012060,햄및베이컨,목우촌 주부9단 살코기햄 (1KG),11800,11200,-600
2018-06-01,338976213,C013020,티셔츠,줄배색레이스반티 RI1705 레이스티 라운드넥티셔츠 큐,42200,42200,0
2018-06-01,895768618,A012060,햄및베이컨,[목우촌]목우촌 9단 로스구이 (500G),7780,7780,0
2018-06-01,1783207314,L021010,손목시계,[공식  백화점AS가능]TEMPTRESS 여성시계(가죽)_W0455L3,168300,168300,0
2018-06-01,391280657,C014010,아동복,여아드레스/아동드레스/유아드레스/공주드레스/돌드레,33900,33900,0
2018-06-01,1783207315,L021010,손목시계,[공식  백화점AS가능]JET SETTER 여성시계(메탈)_W0564L1,202300,202300,0
2018-06-01,821108584,E061080,키친타월,깨끗한나라 마트행사용 데일리 키친타올 150매x8롤,6500,6500,0
2018-06-01,1783207313,L021010,손목시계,[공식  백화점AS가능]FIERCE 여성시계(메탈)_W0001L2,219300,219300,0
2018-06-01,54781280,A017090,열무,[토종원] 토종원/국산 무말랭이 100gx5팩/방부제 첨가제 무첨가,15400,15400,0
2018-06-01,1906495718,C011050,남자내의,남성빅사이즈 데님 청 면스판 반바지 큰옷~4XL~46SIZE,23800,23800,0
2018-06-01,937212786,I011010,TV,[상품평3만]인증점 삼성 55형 UHD TV UN55KU6250FXKR,1200000,879000,-321000
2018-06-01,1132551393,C011050,남자내의,28~40사이즈 신상특가 청반바지 카고 남자 면반바지,15800,15800,0
2018-06-01,1097974186,A021010,커피,[당일출고/무료배송]맥심 화이트/모카골드 160T,17900,17900,0
2018-06-01,242178072,E031050,냉장고,딤채스탠드형김치냉장고EDQ57BFRMT 전국본사무료설치,2072910,1990000,-82910
2018-06-01,1588708093,E031010,전기밥솥,(쿠쿠/전기/압력/밥솥/23종)IH/3인용/6인용/10인용,133900,133900,0
2018-06-01,895830957,A012060,햄및베이컨,[CJ]CJ 스팸마일드 200G,4150,4150,0
2018-06-01,1246003098,E031110,청소기,키코스 스팀청소기용 초극세사 슬림패드 4장/리필걸레,11800,10500,-1300
2018-06-01,1672246231,F012010,종이기저귀,(신상품)팸퍼스 베이비드라이 밴드 3단계 M 34Px1팩,12900,12900,0
2018-06-01,895830955,A019060,된장,[해찬들]해찬들 그대로 끓여먹는 된장찌개 (450g),5950,5950,0
2018-06-01,224100510,E061030,전구,LED T5 간접조명 형광등 led전구 모듈 램프,3180,3180,0
2018-06-01,895830956,A012060,햄및베이컨,[CJ]CJ 스팸마일드 340G,6250,6250,0
2018-06-01,895827301,A019090,카레,[오뚜기]오뚜기 백세카레 순한맛 100g,3590,3590,0
2018-06-01,1121057637,A014020,분유,[LG생활건강]베비언스 액상분유 12-24개월(3단계) 60개입 (니플미포함),92500,87850,-4650
2018-06-01,1279885795,C011030,남자학생복,남자 여름 린넨 롱가디건/봄/니트/얇은/브이넥/루즈핏,29800,29800,0
2018-06-01,268643009,E051030,디지털도어록,자가설치 UG-315N UG-315S 번호키 도어락 도어록,40000,36000,-4000
2018-06-01,1277163251,C013020,티셔츠,여름 아이스 카라티셔츠 골프웨어 냉감 인견 반팔티,23800,23800,0
2018-06-01,199132115,E041010,식기,어린이/청동/방짜/반상기/유기/식기/추천/가격/파는곳/참방짜/전통방식/건강지킴이/놋,198000,198000,0
2018-06-01,1290275575,F012010,종이기저귀,네추럴블라썸 팬티  밴드기저귀 4팩,36900,36900,0
2018-06-01,1555795806,C013010,점퍼,주니어패딩점퍼 주니어야상자켓 남아겨울옷 남아패딩,33000,28000,-5000
2018-06-01,266603965,A011050,콩,팔레오 오메가 사차인치 240g 1통/팔레오사차인치,23580,23580,0
2018-06-01,303644627,E011020,침대,[수도권무료배송]매트리스+받침대/침대/싱글/퀸/본넬,238000,238000,0
2018-06-01,1433005526,E011050,책상,집중력 독서실 실속형 책상 LED등기구,63400,63400,0
2018-06-01,156648603,A018090,잼,오뚜기)딸기쨈 300g x 5개 국산딸기 신선한 과일 알,21850,21850,0
2018-06-01,1935526742,E041070,밀폐용기,(1+1)보르미올리/유리용기 볼메이슨자 더치병 유리병,3500,2800,-700
2018-06-01,895827327,A012050,소시지,[CJ]CJ 숯불갈비 후랑크 (145G),1590,1590,0
2018-06-01,2104383210,C013010,점퍼,밀리터리 후드 점퍼 MA1 BW후드점퍼점퍼빅사이즈점퍼,130710,130710,0
2018-06-01,986183376,F011150,건강기능식품,[풍기][풍기인삼농협][황풍정] 6년근 황풍정 홍삼액골드 80ml * 30포,85000,85000,0
2018-06-01,1188801199,C012040,여자학생복,[대구백화점 I관] [라인][기존가:129 000]진주볼 숏가디건(NKCDHD0200),59000,53100,-5900
2018-06-01,1061977268,G011070,자전거,[삼천리] 시애틀레이디7+무료배송 여성용자전거 7단26,137000,123300,-13700
2018-06-01,1287567824,E011030,거실장,2단 서랍장/TV다이/2자/3자/4자/TV대/수납장/TV장식장,34900,34900,0
2018-06-01,1608261316,L021020,장신구,실버)로렌스 스틱 앤 펄 목걸이 주얼리 악세사리 기념,23950,23950,0
2018-06-01,510807704,A012010,국산쇠고기,[명절선물 Best][실속형 한우갈비세트 4호 4.8kg]1등,370000,366300,-3700
2018-06-01,1603836977,C012060,여자내의,쿠스피아 밍크퍼 밴드스키니 SD-5303 밴드스키니 블랙스키니 데님스키니 스키니진 청바,21070,18760,-2310
2018-06-01,600734705,L021010,손목시계,패션시계/스포츠시계/알람시계/전자시계/군인시계/SD1,6000,6000,0
2018-06-01,347583600,C021040,실내화,[푸마(PUMA)]푸마 이그나이트 에보니트 LO 189904-02-GRAY/WHITE,144000,122400,-21600
2018-06-01,1180771720,C013050,운동복,235_고구마베이비 아기옷- 무형광 곰돌이 민소매 상하,10910,10590,-320
2018-06-01,1437691624,C012040,여자학생복,V넥 카라 니트탑 (J11PNT180)/ 매그제이(MAGJAY),18000,16200,-1800
2018-06-01,448438388,C012040,여자학생복,킬라이트 옆트임 롱니트 SD-6467,16020,15060,-960
2018-06-01,1370526429,C012040,여자학생복,수지네 일본 구제 발렌시아가 하늘색 면 조끼 여성 S,12280,12280,0
2018-06-01,1557557131,C011030,남자학생복,빅사이즈 4XL 청남방 데님셔 남자 남성 남방 티 셔츠,17800,17800,0
2018-06-01,503785233,C013040,청바지,유니크 데미지 워싱 청반바지 스타일청반바지 남자청,15730,15730,0
2018-06-01,1902943449,C021040,실내화,슈스파글로벌cmm790,124200,124200,0
2018-06-01,492721727,C012060,여자내의,베이직린넨숏팬츠/ 립합(LIPHOP),35000,33250,-1750
2018-06-01,6482412,A018040,아이스크림,해태 부라보콘 맛있는 아이스크림 모음 24개 특가,18900,18900,0
2018-06-01,988158225,E061070,가정용비닐용품,초L) 롤팩30*40(CM) 200매,3800,3800,0
2018-06-01,1860271586,C013020,티셔츠,[화이트폭스] 여름신상 긴팔티셔츠/롱티셔츠/캐주얼룩,12500,12500,0
2018-06-01,1202811499,A012030,돼지고기,[미트아울렛] 돼지고기 모음전,2900,2900,0
2018-06-01,406177206,E041070,밀폐용기,대형 김치통 밀폐용기 8~20L 김장 김치냉장고 반찬통,4300,3960,-340
2018-06-01,742210,I031040,생화,피티타임 헤드랜턴 자전거전조등 캠핑용품 헤드라이트,22000,15820,-6180
2018-06-01,1435233994,L021020,장신구,실버 925 블랙 오닉스 드롭 여자 은반지,23000,23000,0
2018-06-01,595220104,I031040,생화,[특가]MTF 명품50인치파라솔 낚시파라솔/비치파라솔,39000,35880,-3120
2018-06-01,2055895488,A016030,복숭아,산초가루 산초 솔표 40g)/산초 산초가루 산초분말 산,3410,3210,-200
2018-06-01,862439099,A022010,주스,식자재 양념 음료 차 레몬쥬스 화남 골든크라운 946ML,92170,92170,0
2018-06-01,895768496,A014030,치즈,매일 상하 모짜렐라 피자치즈 (300G),6400,5600,-800
2018-06-01,1918863180,A013150,어묵,부산어묵 국민 오뎅탕 떡볶이 22종 골라담기 캠핑요리,13900,12900,-1000
2018-06-01,553144303,E031110,청소기,추가할인 단후이 물걸레로봇청소기 S100 카메라맵핑,439000,439000,0
2018-06-01,1375014959,E061010,세탁세제,[런칭특가]암웨이 SA8 프리워시 /프리미엄 세탁,24000,24000,0
2018-06-01,1317084686,C012060,여자내의,미시옷 A라인나염쿨치마_MN_1706 빅사이즈 여성의류 A,31050,31050,0
2018-06-01,2022325261,C013050,운동복,프론트 리어 범퍼 가드 보호대 몰딩 블랙 범퍼가드 범,22230,20250,-1980
2018-06-01,1843156527,A011020,현미,국내산찹쌀100%로 만든 찹쌀가루1Kg/CJ볶음참깨1Kg,4400,4400,0
2018-06-01,1109512847,I031040,생화,로티캠프 랜턴 스탠드 랜턴걸이 캠핑용품 캠핑 랜턴,21500,19250,-2250
2018-06-01,2111362254,E031110,청소기,아이클레보 로봇청소기 YCR-M05-20 악팩+필터2증정,369000,369000,0
2018-06-01,873718556,C013020,티셔츠,여름 아웃도어 아이스 스판티셔츠 반팔티 등산복,9800,9800,0
2018-06-01,245707515,C012040,여자학생복,(예사랑)여성 인견 조끼 16YB16,59000,58410,-590
2018-06-01,1223802738,C012040,여자학생복,[모다아울렛][나인스텝]향수Y레이스체크BL(N18NS8248R)블루,31500,29300,-2200
2018-06-01,549762714,C011030,남자학생복,여름셔츠/반팔셔츠/7부셔츠/체크남방/스트라이프,11900,9900,-2000
2018-06-01,1418608649,F012020,생리대,화이트 시크릿홀/애니데이 생리대 모음+증정,11900,11900,0
2018-06-01,862212574,A017040,양배추,[우리가락]미나리 4kg 한박스,43300,41830,-1470
2018-06-01,596391817,C014010,아동복,[빈] BS22BL01SB 여아 스카이블루 스트라이프 볼륨소매 블라우스,70400,58440,-11960
2018-06-01,569016589,E041070,밀폐용기,포스코정품 27종 스테인레스 반찬통/밀폐용기/김치통,7500,6630,-870
2018-06-01,393741034,C013010,점퍼,[비키][18년SS] 가벼운 여름후드점퍼 (MAE2150)(영등포점A),149400,133330,-16070
2018-06-01,1323641163,C013050,운동복,득템찬스.파격특가.추가금없는 자체제작.빅사이즈,27900,27900,0
2018-06-01,734336717,C012040,여자학생복,[모다아울렛][에고이스트]레이스패치 골지 가디건 EH2KG566 BK,65400,65400,0
2018-06-01,988244745,A019170,냉동식품,대상 논현동 포차스타일 불막창 180G,6990,6990,0
2018-06-01,988244744,A019170,냉동식품,대상 논현동 포차스타일 무뼈닭발 180G,6990,6990,0
2018-06-01,1968055915,L021020,장신구,[까옥이] 예쁜 피어싱 모음 바디피어싱 진주 큐빅 볼,2900,2500,-400
2018-06-01,2073418387,G022020,자동차타이어,금호타이어 마제스티 솔루스 KU50 245/40R19 무료배송,147600,125460,-22140
2018-06-01,986183367,F011150,건강기능식품,[풍기][풍기인삼농협][황풍정] 6년근 홍삼액 수(秀) 70ml*30포,68000,68000,0
2018-06-01,1279861774,E061020,섬유유연제,고농축섬유유연제 울트라 다우니 에이프릴3.06L/5.03L,14900,14900,0
2018-06-01,1864348577,I031070,애완동물관리비,[나인앤츠]헤드 YOUTEK 3 STAR 테니스라켓 유텍쓰리스타 무게235g 스마트소재d3o 헤드,169000,167310,-1690
2018-06-01,1559653746,C013020,티셔츠,여름 신상 빅사이즈 롱 나시 66~120 민소매 티 모음,7500,7500,0
2018-06-01,1450151917,C013040,청바지,유니크 디자인 빅사이즈 패치 디테일 루즈핏 청바지,21900,21900,0
2018-06-01,230278074,I053010,공책,신학기 과목노트(음악)(10개입)-랜덤 과목공책 학생노,11370,11370,0
2018-06-01,306074885,F012050,의료측정기,카스 귀적외선 체온계 RB600 사은품=건전지2개,34900,30140,-4760
2018-06-01,2095299105,C012030,여자상의,oo01 7부소매 스트랩 단가라 ops - 오렌지 여성원피스,19560,19560,0
2018-06-01,1884788017,E011020,침대,[안전한 베디스](프레임+ 매트포함)서랍형침대S/SS,137000,137000,0
2018-06-01,58087298,A012010,국산쇠고기,팔도 호두기름세트 4호(고품격 웰빙 선물세트)사은품,107620,107620,0
2018-06-01,772828648,C012060,여자내의,[리스트][LIST] 일자핏 9부 팬츠 TWWSLH60040 (3가지 색상),29000,24070,-4930
2018-06-01,834358879,I031040,생화,충전식 300만촉광 CREE 37구 LED 후레쉬 랜턴 손전등,20500,20500,0
2018-06-01,229806479,A013090,전복,정남진 장흥 장흥특산물 키조개 400g/200g 2팩,60200,60200,0
2018-06-01,1630423425,I031040,생화,오아 올라이트 USB충전식 캠핑등 LED 랜턴 OA-LP100,19900,19900,0
2018-06-01,688157164,A014030,치즈,코리원/임실 모짜렐라 피자 치즈 2.5kg/임실치즈/제주,36500,36500,0
2018-06-01,165769609,A014020,분유,[아이배냇] 순산양분유 1단계 800g,34800,33090,-1710
2018-06-01,895744499,A013160,맛살,[대림]대림 곤약 (250G),950,950,0
2018-06-01,210525495,C013010,점퍼,[헌트키즈]앵커경량 바람막이_HKJA184B2,19900,15900,-4000
2018-06-01,895827364,A012060,햄및베이컨,CJ 숯불김밥햄 110G,1880,1490,-390
2018-06-01,895827363,A011090,국수,[오뚜기]오뚜기 오동통면 120G*5입,3600,3600,0
2018-06-01,653690918,I053020,스케치북,(3s오피스) 도화지 켄트지 전문가용 200g 220g 모음,10000,10000,0
2018-06-01,1121539701,F012020,생리대,엘리스 생리대 순수감촉 날개형 소형22Px2팩 + 순수날개 대형2팩/ 엘리스,8500,8080,-420
2018-06-01,179163553,L021020,장신구,알러지 없는 써지컬스틸 피어싱 모음전,500,500,0
2018-06-01,1420661840,C011030,남자학생복,다니엘크레뮤 SUMMER 링클프리 린넨 셔츠 3종,39000,39000,0
2018-06-01,1430106758,L021010,손목시계,알마니시계 남성 80종 케이스 쇼핑백 풀셋,99000,98000,-1000
2018-06-01,1999973021,A015020,식용유,[무배한정]용카 수입프리미엄++엑스트라버진 올리브유,2900,2900,0
2018-06-01,231301207,C012040,여자학생복,데님 연청 청조끼 LDZ241 데님 데님조끼(YA02004),86610,86610,0
2018-06-01,895744495,A013160,맛살,[대림]대림 큰잔치 게맛살 (150G),1150,1150,0
2018-06-01,274486217,L021020,장신구,저렴처분/1.3캐럿 천연에메랄드/광택칼라굳,250000,250000,0
2018-06-01,1801321708,A019130,스프,[아지노모도] 보노스프 10각 묶음 구성/ 보노,23800,23800,0
2018-06-01,895744496,A013160,맛살,대림 게맛살 (216G),1990,1990,0
2018-06-01,1724184324,C012030,여자상의,원씨 여성 셀프웨딩 스몰웨딩 레이스 파티룩 빅사이즈,61100,61100,0
2018-06-01,26324091,A019100,식초,비프소스(하인즈 3K)/비프소스 소스 반찬 식당 업체,26460,26460,0
2018-06-01,1889766213,I031010,장난감,전동 오토바이 에버바이크 선물 유아 스쿠터 사이클,112370,112370,0
2018-06-01,1807526053,L012090,기초화장품,클렌징크림/마사지크림/더페이스샵 외,4000,4000,0
2018-06-01,785608546,A016070,귤,최고과일 - 천상천하 서귀포 명품감귤 3k,45900,35900,-10000
2018-06-01,985357716,A016160,과일가공품,냉동 애플망고 (페루산/1KG),19900,9900,-10000
2018-06-01,1573869453,C013020,티셔츠,블론디 77까지 매일 입고싶은 예쁜 반팔 7부티,6800,6800,0
2018-06-01,1835738472,I031070,애완동물관리비,2018바볼랏 테니스라켓 퓨어에어로 데시마RG/FO(300g),269630,225420,-44210
2018-06-01,345536343,C012030,여자상의,썸머룩 비치원피스 플라워 바캉스 여름휴가 비치웨어,12800,12800,0
2018-06-01,346766038,C014020,유아복,아둘 유아 여름 단가라 반팔 스마일 상하세트 12,15900,15900,0
2018-06-01,346766032,C014020,유아복,아둘 유아 여름 단가라 반팔 스마일 상하세트 11,15900,15900,0
2018-06-01,2106858002,A019050,간장,[샘표 간장 모음전]-[1.8L]-양조간장 진간장 국간장,6500,6500,0
2018-06-01,25310016,L021020,장신구,원석sale/천연시츄린/황수정/14.1캐럿/큼직/Sichyurin,88000,88000,0
2018-06-01,321986624,C013040,청바지,MPS18019 스톤 워싱 디스 진 슬림핏남자바지 남자워싱,33570,33570,0
2018-06-01,625257648,I012060,저장장치,커세어 K70 LUX 적축 기계식키보드 CORSAIR,186170,175000,-11170
2018-06-01,898573932,A012060,햄및베이컨,[동원]동원 순닭가슴살 기획 (90g*3캔),5980,5980,0
2018-06-01,440946837,C012040,여자학생복,아이우먼 리본 레이스 팬티 MG0307M805 빅사이즈,17400,15300,-2100
2018-06-01,990027248,E061100,습기제거제,초L)재사용습기제거제(포켓형),3900,2990,-910
2018-06-01,990027247,E061100,습기제거제,초L)재사용습기제거제(패드형),3900,2990,-910
2018-06-01,1701617346,L012010,면도기,[공식!+사은품]*도루코 페이스7Ⅱ 면도기+날 총11입,27900,27900,0
2018-06-01,1387105594,I031040,생화,♣30구 43구 53구 LED헤드랜턴♣/손전등/랜턴/후레쉬/LED후레쉬/헤드렌턴/LED랜턴/렌턴,8500,7430,-1070
2018-06-01,1241816367,C013010,점퍼,[무료배송](SR)BIG09 남자빅사이즈시카고시보리점퍼,86140,86140,0
2018-06-01,776965616,E031120,믹서,유닉스 멀티미니 믹서기 분쇄기 쥬서기스텐/UNB-A9002,24000,24000,0
2018-06-01,1896243530,C013010,점퍼,[리틀브렌]여름 통 바람막이 LBJA18401,27900,27900,0
2018-06-01,2120416236,A012010,국산쇠고기,[무항생제]안심 이유식 다짐육 200g 2등급(6구),20700,20700,0
2018-06-01,537279422,A017170,풋고추,푸른채 - 2018년 백오이(특) 2kg 특가한정판매,8900,8900,0
2018-06-01,358160126,I053010,공책,초등 노트 공책 10권(무제/일기장/과목/5칸/알림장),2400,2400,0
2018-06-01,953379871,C011050,남자내의,[지오다노]코튼/스판 데님숏 107541(인천점),19000,16150,-2850
2018-06-01,1010233296,E031070,에어컨,마이)클라우드TC전기요더블,99900,64900,-35000
2018-06-01,741687042,A017230,마늘,[농부마음]2018년 햇양파 20kg(대품),14900,14900,0
2018-06-01,1148244819,I031010,장난감,PS4 Pro 본체 + VR 본체 신형 풀세트 + 게임1종 증정,995780,946000,-49780
2018-06-01,563063788,C013010,점퍼,앙팡 래쉬가드 집엎 (핑크) 물놀이용품 아동복 아동의,26570,26570,0
2018-06-01,1010233297,E031070,에어컨,마이)극세사전기요싱글,84900,54900,-30000
2018-06-01,246630137,C013010,점퍼,빅사이즈 라이트도트바바리 LS1704 빅사이즈 여성의류,39920,39130,-790
2018-06-01,1430708455,G011070,자전거,무료조립 삼천리 도시형 하이브리드 자전거 리버스H,200000,183080,-16920
2018-06-01,1981744807,A011110,당면,국내생산 포두부 1kg(250gx4팩) 매일아침 생산 발송,10000,9900,-100
2018-06-01,1369449841,C013050,운동복,슬림 콘솔박스 - 체크,16370,16370,0
2018-06-01,2131319149,E061060,살충제,람다킬MC 람다킬 롱다운 롱다운플러스 아발론50 방역,25000,24500,-500
2018-06-01,1952434538,A019090,카레,(3개무료배송) 바몬드카레230g SB카레240g/일본카레,12400,12400,0
2018-06-01,1492971312,A017010,배추,치자(슬라이스 한진 500g)X10개/치자열매 통치자 천연염색 치자염색 노란색깔염색 말린,79600,75620,-3980
2018-06-01,321962698,C013010,점퍼,MJS18010 오버핏 베이직 워싱 중청자켓 남자데님자켓,73270,73270,0
2018-06-01,1557491868,E061010,세탁세제,겔업 액체세탁세제 2.5Lx4개(총10000ml)드럼/일반,10000,9800,-200
2018-06-01,1685978687,C013020,티셔츠,FREE 러블리넥반팔면티셔츠6장(묶음세일),58000,58000,0
2018-06-01,1458161254,I011020,영상음향기기,[실재고보유]EB-X31/3200안시/빔프로젝터/엡손/ABC,680000,578620,-101380
2018-06-01,1711269168,C013020,티셔츠,여자맨투맨/루즈핏티셔츠/스트라이프/레터링/티셔츠,12900,12900,0
2018-06-01,2127426106,C013010,점퍼,봄여름 기능성 아웃도어자켓 경량 바람막이점퍼 단체,17800,17800,0
2018-06-01,383369461,C013020,티셔츠,[지오지아][지오지아] 시원한 그래픽 브이넥 티(ABT2TP1110),5000,4750,-250
2018-06-01,162995664,C013010,점퍼,CN003 빅포켓 오버핏 코트 패션코트 포켓코트 여자코,60790,60790,0
2018-06-01,1998916849,E031010,전기밥솥,쿠첸 6인용 전기압력밥솥/전기밥솥 WPQ-LB0604FB,95000,89300,-5700
2018-06-01,1197916289,C014010,아동복,(숲자람) 기능성 키즈 바람막이 어린이바람막이 남아,71080,71080,0
2018-06-01,987051183,A017180,호박,SF)다다기오이(4입/봉),2990,2000,-990
2018-06-01,357174423,C011030,남자학생복,아디다스 솔리드 패딩 다운 베스트(AP9544),99540,82620,-16920
2018-06-01,1724971423,E031020,가스레인지,(사은품증정) 에코버너 2구가스렌지 GRA-821SR 원터치,139000,125870,-13130
2018-06-01,214162539,A011080,밀가루,종가집 간편쌀국수 12개/멸치쌀국수,20100,20100,0
2018-06-01,1006646880,A022010,주스,식자재 식당 양념 음료 차 레몬에이드 컨츄리타임 585,99090,99090,0
2018-06-01,1097230433,C012020,원피스,[나이스클랍]핸드 코트(N181MSG403)(센텀시티점),159000,141900,-17100
2018-06-01,1404804228,A011170,떡,쌀떡볶이떡500g/쌀떡국떡/떡국떡/떡국/떡볶이떡/쌀떡,950,950,0
2018-06-01,155502785,A019050,간장,홍게맛장소스 1.8L/6+1/홍게간장/홍게맛장/액젓,14900,14900,0
2018-06-01,1776062787,A018010,초콜릿,킷캣 오리지널 트라이얼 580g(11.6gx50개) 4곽 1박스,57900,57900,0
2018-06-01,871552905,C012040,여자학생복,데일리걸 봄신상 체크남방/스트라이프셔츠,25900,25900,0
2018-06-01,1241023050,C012040,여자학생복,[젬마월드]Yoghurt-시어서커셔츠 여름셔츠,24000,24000,0
2018-06-01,2056488844,A019030,생강,국산 봉동 생강 가루 250g,29010,29010,0
2018-06-01,1140654800,C015020,모자,[오늘출발] 6900~정품 스냅백/볼캡/힙합모자/야구모자,7900,6900,-1000
2018-06-01,989166344,E041060,수저,[지홈] 지홈 우드 뒤집게,7800,6800,-1000
2018-06-01,989166347,E041060,수저,[지홈] 지홈 우드 샐러드주걱,6800,6800,0
2018-06-01,1035219112,G022020,자동차타이어,넥센타이어 고급형 CP672 185/65R15 정품 무료배송,61300,51680,-9620
2018-06-01,960540974,A016090,참외,초L프레시)참살이사과(4~6입/봉),14900,7990,-6910
2018-06-01,1454069788,C011030,남자학생복,[레노마셔츠] 프리미엄 32종 택1 드레스셔츠,30000,23700,-6300
2018-06-01,297980970,C013010,점퍼,포인트패치집업점퍼 ZYD_1802 집업티셔츠 잠바 스포츠,31840,31840,0
2018-06-01,1083738929,C014010,아동복,한국생산 야구 상하복 모자 레드(0-24개월) 800025,61210,61210,0
2018-06-01,1241816392,C013010,점퍼,남자옷도매 MJ 977 카키데님배색 야상자켓 남성재킷,56380,56380,0
2018-06-01,123322886,A021010,커피,녹차라떼모음/세미/그린티/쟈뎅/타코/삼원/녹차파우더,6300,6300,0
2018-06-01,1505819589,C011030,남자학생복,빅사이즈 여름 반팔 린넨마 7부/셔츠/체크/남방/남자,21000,19800,-1200
2018-06-01,1046413125,A018060,스낵과자,[농심 업소용 대용량] 새우깡400g 외,23900,23900,0
2018-06-01,441542103,C015040,장갑,양가죽 무스탕 벙어리 여성장갑 워머장갑 디자인장갑,26280,26280,0
2018-06-01,1999520807,A014050,달걀,가농1+등급 40알 축산물품질평가1등 무살충제 계란,12400,11400,-1000
2018-06-01,812127660,A014030,치즈,슬라이스치즈 100매/슈레드 모짜렐라/대용량/업소용,22500,22500,0
2018-06-01,500985873,A019040,소금,안동 볶음천일염 100% 상황버섯 소금 320g /국물용,14900,14900,0
2018-06-01,422840790,C013010,점퍼,바이에른 뮌헨 UCL 프리젠테이션 자켓 자켓 트레이닝,121800,119370,-2430
2018-06-01,559401799,C013020,티셔츠,베이직 반팔 PK카라티 19색 쿨론 단체티 유니폼 반티,7500,7500,0
2018-06-01,900300632,A022030,생수,롯데 아이시스8.0 (500ML),430,350,-80
2018-06-01,1147567536,C021040,실내화,리복 매장정품 워크울트라 DMX맥스 AQ9220,59400,49310,-10090
2018-06-01,1443261554,C013010,점퍼,#NAME?,60290,54270,-6020
2018-06-01,1530529073,I031010,장난감,디럭스 메가 붕붕카 / 유아 자동차 카 장난감 안전,23700,23700,0
2018-06-01,2096912241,C011020,남자상의,MJSF18002 베이지 코튼 베이직 코트 남성코트 남성봄,91960,91960,0
2018-06-01,985029179,C011050,남자내의,[필골드] YS3080 기모 밴드무지 면트레이닝팬츠,16800,16800,0
2018-06-01,900300633,A022030,생수,롯데 아이시스8.0 (2L),840,680,-160
2018-06-01,1793152893,C013010,점퍼,슈퍼드라이 남성 95 라이더 리얼 가죽 빈티지 자켓 짱,266510,266510,0
2018-06-01,1010343722,A011110,당면,종가집 국산콩두부두모 400G*2입,4290,3990,-300
2018-06-01,855142420,E031080,선풍기,[기본배송무료][신일금속] 카페형난로 특대 SL-600 /연탄난로/화목난로/,882000,882000,0
2018-06-01,574632454,C012040,여자학생복,빅사이즈/제이스타일 프라미 카라 레이스 블라우스/ 제이스타일,51600,39740,-11860
2018-06-01,615690694,A018080,설탕,삼양사 큐원 하얀설탕 15kg /백설 갈색설탕 P,12500,12500,0
2018-06-01,1283280322,E011050,책상,[천사몰]스터디 접이식좌식책상/입식/좌식/컴퓨터책상,35000,32000,-3000
2018-06-01,989856349,A013150,어묵,풀무원 알래스칸우엉고추당근어묵 180G,1980,1690,-290
2018-06-01,1086641975,E021020,커튼,[디자인갤러리]국산/중.대형/프리미엄 사계절암막커튼,61000,54280,-6720
2018-06-01,855142421,E031080,선풍기,[기본배송무료][신일금속] 펠릿난로 대 SL-700L 일반형/연탄난로/화목난로/,745400,745400,0
2018-06-01,855142416,E031080,선풍기,[기본배송무료][신일금속] 사각난로 일반형 SL-500 /연탄난로/보일러/장작난로/,370800,370800,0
2018-06-01,917410887,A012050,소시지,천하장사 더블링1+1 콰트로치즈 할라피뇨 치즈 소세지,14900,14900,0
2018-06-01,855142417,E031080,선풍기,[기본배송무료][신일금속] 사각난로 칼라 대 SL-501/연탄난로/보일러/장작난로/,399000,399000,0
2018-06-01,2090165366,C012040,여자학생복,빅사이즈 헬로시스터 도트리[도트블라우스]/ 헬로시스터,37900,29570,-8330
2018-06-01,537196636,C011030,남자학생복,오투웜발열조끼(조끼+발열체+베터리+충전기)],134900,134900,0
2018-06-01,1240806544,C013020,티셔츠,링 오프숄더 쵸커 티셔츠 블루 /쵸커 포인트 섹시한,21630,21630,0
2018-06-01,1154115507,C012040,여자학생복,W 오프리미츠 사이드레이스나시니트 G80KT2602/ 오프리미츠,34000,32640,-1360
2018-06-01,924721798,A016100,수박,정용규 농부의 속노란 미니수박 (1.1kg~3kg),12900,12900,0
2018-06-01,341204494,C013040,청바지,[행텐] 여성 청 스판스키니팬츠 10070-155-411-10 NC아울렛,19800,9000,-10800
2018-06-01,855142418,E031080,선풍기,[기본배송무료][신일금속] 사각난로 칼라 특대 SL-502/연탄난로/보일러/장작난로/,489800,489800,0
2018-06-01,827519792,C013020,티셔츠,핵이득 여름 베스트 반팔티/데님/민소매 아이템,9900,9900,0
2018-06-01,855142419,E031080,선풍기,[기본배송무료][신일금속] 사각난로 특대형 온수겸용 SL-502H/연탄난로/,613900,613900,0
2018-06-01,1348420102,A013170,생선통조림,유동 번데기캔 (130g) x48,53780,53780,0
2018-06-01,1154115509,C012060,여자내의,W 오프리미츠 18333스커트 E80SK2601/ 오프리미츠,29000,27840,-1160
2018-06-01,6624148,A015020,식용유,최고급 유기농올리브유 오로OP/오일풀링 엑스트라버진,99000,99000,0
2018-06-01,1010343753,A017150,버섯,종가집 국산 아작콩나물 340G+60G,2190,1990,-200
2018-06-01,2017207303,F012020,생리대,좋은느낌 좋은순면생리대/슬림 날개 중형(18+18)x8팩,53900,53900,0
2018-06-01,348270313,E051020,건전지,3S6P 21Ah 리튬이온 12V (11.1V) 18650 배터리팩,102000,102000,0
2018-06-01,23294235,C013010,점퍼,[패션플러스][플레이팝][플레이팝]바코드자켓,54900,50510,-4390
2018-06-01,415964186,C013010,점퍼,바람막이 야상 WS-JM30 바람막이 야상 점퍼 남자야상,69700,68310,-1390
2018-06-01,222985896,C012040,여자학생복,수지네 일본 구제 브라운 베스트 여성 M 20-10,13170,13170,0
2018-06-01,1997292790,E011020,침대,[골든잼]원목 천연 생황토 더블 돌침대(백조)/흙침대,2072900,2010720,-62180
2018-06-01,660813211,C013010,점퍼,브랜드특가 기모야구점퍼/스타디움자켓/후드점퍼/야구,29800,29800,0
2018-06-01,1055949768,A011140,부침가루,백설 컵케익 (쵸코) 55g x 12,19560,19560,0
2018-06-01,2145680404,C014010,아동복,프릴줄무늬긴팔셔츠/여아블라우스/셔츠/합창복/신상,9900,9900,0
2018-06-01,1010343747,A011110,당면,종가집 고소한손두부 300G*2입,2490,2490,0
2018-06-01,1615699550,C013040,청바지,[행텐] 여성베이직 블랙스키니진 10110-155-202-10 NC아울렛,49800,10000,-39800
2018-06-01,403108134,A013130,오징어채,국내가공 진미채 모음 500g / 1kg,16900,16900,0
2018-06-01,784897375,E011010,장롱,엘린5단서랍장/엘린주니어장/엘린400주니어장,119000,119000,0
2018-06-01,2051832734,F011150,건강기능식품,여명808 119ml 10캔//음주전/음주후/헛개/숙취/음료,29500,29500,0
2018-06-01,26936226,A022010,주스,[정직한친구들] 녹색사랑 야채수 90포,70000,66860,-3140
2018-06-01,1994550219,A019020,참깨,검정깨가루 (한1K) X10,195220,173750,-21470
2018-06-01,162145152,E031030,전자레인지,대우전자 전자레인지 KR-M202BGP / 전자렌지 대우,53080,49900,-3180
2018-06-01,1284585993,I031040,생화,캠핑용 고강도 다용도 야전삽 캠핑공구 망치 해머,12790,12790,0
2018-06-01,1857020592,A017140,콩나물,도라지환/국산/도라지 가루 분말 청 차 약 건 목건강,50900,50900,0
2018-06-01,1249359517,C013010,점퍼,[쏭바이쏭]홀리브아인 린넨 도트자켓,88000,88000,0
2018-06-01,1209436590,C021040,실내화,[푸마] 남여공용 방탄운동화 튜린 Puma Turin BTS 368188-01,79000,67150,-11850
2018-06-01,1949955443,E021020,커튼,[파스텔데코] 촘촘함이틀린~1등급스팡클실커튼/비즈발,10000,10000,0
2018-06-01,1306008382,E031130,보온매트,@정품@일월/온수매트(퀸사이즈카페트매트,248000,245520,-2480
2018-06-01,1484137579,C012040,여자학생복,[악녀일기][악녀일기]버튼가디건(5col),26880,24730,-2150
2018-06-01,313944631,C012030,여자상의,샤인 멜빵 데님 스커트-M1057,33030,33030,0
2018-06-01,520326414,C011020,남자상의,국산 양복 중년정장 남성정장 자켓 정장 남성복,168000,166320,-1680
2018-06-01,1230528879,A014010,우유,남양 아인슈타인베이비 190ml 24팩 상자포장,15900,15900,0
2018-06-01,1786810466,E031070,에어컨,유니맥스 12인치 고품격 엔틱 메탈선풍기/황동 블랙펄,34900,34900,0
2018-06-01,269198771,C013010,점퍼,빅사이즈 터틀넥지퍼포켓자켓 DI1710 빅사이즈 여성의,49470,49470,0
2018-06-01,1002808075,E011030,거실장,동서가구 EDF 소파쿠션 2개 DF635975,99000,99000,0
2018-06-01,463712493,C013010,점퍼,아스토레 6018(NVY) 골프 캐주얼 남성 경량 다운자켓,217580,193650,-23930
2018-06-01,1002808077,E011030,거실장,[동서가구] 프라임 6인용 가죽소파 DF635968,1790000,1790000,0
2018-06-01,1002808076,E011030,거실장,동서가구 EDF 팔걸이스툴 DF635976,319000,319000,0
2018-06-01,1002808079,E011030,거실장,[동서가구] 프라임 4인용 가죽소파 DF635967,1290000,1290000,0
2018-06-01,890554042,E041060,수저,대나무 수저세트/숟가락 젓가락 조리도구 나무 옻칠,2500,2500,0
2018-06-01,356383121,A017300,미역,[특가]재래김10봉/가정용/김선물세트/광천김 대천김,7900,7900,0
2018-06-01,1002808078,E011030,거실장,[동서가구] 프라임 3인용 가죽소파 DF635966,990000,990000,0
2018-06-01,557190200,F012020,생리대,(1팩 골라담기) 시크릿데이 생리대 중형/대형/라이너,800,800,0
2018-06-01,469718581,F012010,종이기저귀,(공식) 18년 군 프리미엄 마시멜로 3팩 / 밴드  팬티,42900,42900,0
2018-06-01,615229325,A018070,파이,스낵팡/파이존/파이51종/카스타드/몽쉘/초코파이/갸또,4800,4800,0
2018-06-01,328724511,C013020,티셔츠,더다다/원피스형 롱티/신상/루즈/박시/빅사이즈,5900,5900,0
2018-06-01,476614701,C021010,아동화,터닝메카드 슬립온 남아 운동화 운동화 유아운동화 캐,21360,21360,0
2018-06-01,2059554453,C012040,여자학생복,매그제이 시스루이지가디건 J11PCD082,25650,25650,0
2018-06-01,1392650892,C021040,실내화,뉴발란스 의류 티셔츠 레깅스 후드 집업 자켓 팬츠,43000,43000,0
2018-06-01,1154890164,C012040,여자학생복,앤피오나 로렌 카라니트/ 앤피오나,47200,35880,-11320
2018-06-01,984778765,C013060,등산복,[웨스트우드] 바람막이/조끼 파이널 특가전,19000,19000,0
2018-06-01,1159627017,E031130,보온매트,싸파 버그킬러 5종 중 선택 SPB-4B-40B 날벌레 퇴치기,26900,25560,-1340
2018-06-01,1223501816,C011020,남자상의,MJ_1133 차콜 래글런코트,104180,92730,-11450
2018-06-01,2019927081,C013060,등산복,[NEPA]네파 정상 여름의류/쿨티셔츠 출시 기념 할인전,35000,35000,0
2018-06-01,206866883,A012010,국산쇠고기,축협 1+등급 정육 갈비세트 3.4kg 갈비 한우선물세트,240000,237600,-2400
2018-06-01,1392900235,L012090,기초화장품,마스크팩구매시 설화수/헤라/화장품/사은품/샘플증정,6500,6500,0
2018-06-01,1220553450,A016030,복숭아,아삭아삭 껍질째 먹는 적포도(크림슨) 1kg이내 XL,13900,13430,-470
2018-06-01,2134872433,F012050,의료측정기,[최신정품] 브라운 체온계 6030 / 6510 / 6520,70000,70000,0
2018-06-01,1712066107,I031040,생화,LED헤드랜턴 충전식 캡라이트 등산 낚시 줌 해드랜턴,10000,8510,-1490
2018-06-01,305855600,C011050,남자내의,남성_슬랙스 팬츠(PHY2PP1052)/ 폴햄,39900,33920,-5980
2018-06-01,440944169,C012040,여자학생복,[LAP] AF2WB664. 니트 시보리 배색 민소매 블라우스,26910,25240,-1670
2018-06-01,741868162,C012020,원피스,[모다아울렛][제이제이지고트]jj지고트환절기핸드메이드코트 (gi1a0ct11),207200,186480,-20720
2018-06-01,520519592,C014010,아동복,[로리앤콜린]신상업뎃상하복반값세일!!!국내생산,8900,8900,0
2018-06-01,818880026,C012040,여자학생복,알마니 여 95 니트 후드 집업 자켓 가디건 간절기 봄,38540,38540,0
2018-06-01,1483779820,C021010,아동화,[MLB키즈](여름신상품)뉴욕 양키스 메쉬 운동화(72SH10811-50L/72SH10811-50W)[갤러리,79000,67150,-11850
2018-06-01,1920648533,A022010,주스,웅진 자연은제주감귤180mlX12X4/오렌지/종합병/쥬스,23500,23500,0
2018-06-01,394030568,C013040,청바지,[리바이스]남성 LVC 1966 501 rigid 스트레이트 핏 데님 팬츠_ 다크 인디고 (66501-00,230300,201060,-29240
2018-06-01,892581629,A019060,된장,옹고집장집 호박보리된장 2kg/ PET/ 국산콩 저염된장,33000,33000,0
2018-06-01,735028291,L021030,가방,카티노 라만도 노트북가방 맥북파우치 서류 13.3 15.6,21900,21900,0
2018-06-01,1365045839,I031010,장난감,(Step2)이인용밴 (2016.4.1 소비자가인상) 자동차운전,230820,230820,0
2018-06-01,415219377,C013010,점퍼,바람막이 야상 WS-JM32 바람막이 야상 점퍼 남자야상,69700,68310,-1390
2018-06-01,1262531604,A013080,조개,건해삼(채 미국 600g) 해삼집게 건해삼채 해삼양식 일,95900,95900,0
2018-06-01,86263606,A016120,바나나,프리미엄 브랜드 바나나 2.7~3.2kg 1~2수,15900,15360,-540
2018-06-01,440920144,C012040,여자학생복,[LAP] AF2WB671. 레이스 배색 블라우스,22410,21020,-1390
2018-06-01,1010316124,A012030,돼지고기,E-제주돼지 냉장 목심 구이용 (100G),2490,2490,0
2018-06-01,895744501,A013150,어묵,[대림]대림 마당놀이 600G,3780,2990,-790
2018-06-01,1214025208,A019180,즉석식품,올반육즙가득왕교자X2개+새우왕교자X2개+당면만두20개,20900,20900,0
2018-06-01,371019261,C013040,청바지,[젤리스푼]큐티걸해지큐롯팬츠,15900,14310,-1590
2018-06-01,1148401946,I011020,영상음향기기,엡손 EB-X41 해상도UP EB-W41 와이드 빔프로젝터,850000,816000,-34000
2018-06-01,1489101148,C012040,여자학생복,여름티 스판티 흰티 면티 쫄티 롱티 긴팔티 라운드넥,7900,7900,0
2018-06-01,532300960,C012060,여자내의,스판 베이지 교복치마 교복 예쁜교복 교복쇼핑몰 중학,36090,35010,-1080
2018-06-01,2109241651,L021010,손목시계,카시오정품 전자손목시계 남성학생방수군용스포츠패션,12500,12500,0
2018-06-01,2120465222,L012010,면도기,도루코면도기 4중날 20개 / 6중날 10개 / 7중날,11700,11700,0
2018-06-01,867050994,A014040,발효유,아임요 요거트파우더1kg/망고 딸기 블루베리/홍차/치즈라떼/스무디/과일베이스/잼/빙수,12800,12800,0
2018-06-01,717913096,C013030,스웨터,티티뱅크 브이배색 터틀넥 후드 지퍼 후두집업 남자후,36790,36790,0
2018-06-01,675943167,A012060,햄및베이컨,코리원/CJ 베이컨 500g/돼지고기/삼겹살/베이컨말이,7500,7400,-100
2018-06-01,283103364,E011060,의자,BEST/학생의자/사무용의자/책상의자/컴퓨터의자 특가,23800,23800,0
2018-06-01,564954814,E061030,전구,산쿄 자외선 살균램프 G15T8-AN 15W 칫솔 식기건조기,11000,11000,0
2018-06-01,380471471,A011010,쌀,영미 추청 쌀20kg 아끼바레,50900,50900,0
2018-06-01,750901951,C012030,여자상의,비치원피스 웨어 롱 맥시 바캉스드레스 나시 빅사이즈,19800,19800,0
2018-06-01,1088838590,E031080,선풍기,파이로 가스히터/야외용/원적외선/원터치점화 ZAFHT0101,38000,38000,0
2018-06-01,311179704,A011090,국수,농심 사리면40개/라면사리/봉지라면,10700,10700,0
2018-06-01,985380038,L012030,칫솔,2080 칫솔 5+5 탄력모,9900,4990,-4910
2018-06-01,464991025,E061020,섬유유연제,[초고농촉+바구니증정!] 피죤리치 섬유유연제 1.35Lx3,11900,11900,0
2018-06-01,874352269,A014010,우유,[사은품] DHA 옳은 유기농우유 120ml 24팩,19900,19900,0
2018-06-01,899528109,E061040,부엌용세제,[LG]세이프 천연 소금 용기 (385ML),3000,3000,0
2018-06-01,595515993,A014010,우유,일회용핫소스(태원 4gx1000),40340,40340,0
2018-06-01,1545669041,C021020,구두,[금강제화] 리갈 201 MMX5029FG31(본점),250200,218430,-31770
2018-06-01,1286002993,C012030,여자상의,[피피걸] C032 미라클체크set 반팔+롱스커트/벨트스커트,31000,31000,0
2018-06-01,23869365,I031040,생화,카즈미 감성 야전침대 캠프코트 캠핑용품,55000,48950,-6050
2018-06-01,497664365,A011110,당면,(무)시골다람쥐동부묵2kgX2EA(BOX)X2개시골 묵 식자재,30100,26490,-3610
2018-06-01,456938581,C013010,점퍼,빅사이즈 여성 패딩조끼 WC 여 웰론조끼 VT 059W - 빅,104020,92580,-11440
2018-06-01,1215556630,E061060,살충제,컴배트 좀벌레싹 /옷장 서랍장 방충제 하마로이드,3500,3500,0
2018-06-01,586269441,C013010,점퍼,신상 남자 청자켓/데님자켓 워싱 블루종 남성 빈티지,29800,29800,0
2018-06-01,26936165,A011170,떡,[착한마을]SNS히트! 마음이가 바나나떡/콩쑥개떡/호박알떡 3종택1,19400,18530,-870
2018-06-01,1465952551,A011170,떡,소원 현미떡국떡 (2016 경북고령산 현미100%),3900,3900,0
2018-06-01,411478887,C012060,여자내의,[77까지]아트프린팅세미하이스커트/ 윈,59800,57410,-2390
2018-06-01,1005778260,A022010,주스,보해 매원 디럭스 1500ml 매실원액 매실주스,5880,5880,0
2018-06-01,1124450381,A013010,갈치,제주 은갈치 프리미엄 4마리(1마리당650g내외 선물포,296000,287120,-8880
2018-06-01,1363819079,F012010,종이기저귀,세일 폴맘오버나이트26px4팩/어린이용기저귀/하기스,51900,51900,0
2018-06-01,416978291,E011050,책상,ET101-L 전동식 높이 조절 워크스테이션 높이조절책,1326380,1326380,0
2018-06-01,1078920296,C012060,여자내의,실루엣이 예쁜 프리밴딩 슬랙스 ~3XL 여성빅사이즈,29800,29800,0
2018-06-01,1214025239,C013010,점퍼,[대구백화점 I관] [나이스클랍]야상후드점퍼(N182MSJ004),207000,175950,-31050
2018-06-01,1509393661,G011070,자전거,등나무바구니/26인치/여성용자전거/클래식자전거/7단,101000,92920,-8080
2018-06-01,987978608,E041060,수저,심플 티스푼 2P,2900,2900,0
2018-06-01,987978609,E041060,수저,심플 버터 나이프 2P,4900,4900,0
2018-06-01,774212959,A013070,굴,(맛나)박스/절단꽃게(2L)*12팩,60800,54720,-6080
2018-06-01,1398008497,A012010,국산쇠고기,두레생협 닭다리(2kg/무항/국산),76660,75130,-1530
2018-06-01,15829836,L012040,치약,[본사직영정품]플레시아 치약 100g x6(옵션),19800,19800,0
2018-06-01,452761511,C014020,유아복,아둘 패밀리룩 엄마랑 커플룩 SANDIEGO 롱티셔츠 11,14300,14300,0
2018-06-01,713369481,C012060,여자내의,빅사이즈 헬로시스터 비비안슈[플라워롱스커트]/ 헬로시스터,37900,29570,-8330
2018-06-01,1587639552,A019040,소금,3년간수뺀*신안비금도천일염*2015년산*신안소금,24800,24800,0
2018-06-01,1308740665,C012040,여자학생복,티렌 프릴 소매 블라우스 L173PSC060,41650,41650,0
2018-06-01,199930886,E031120,믹서,[SK매직] Magic 다용도 미니믹서기 MCH-B600,27760,26100,-1660
2018-06-01,241806321,C013010,점퍼,트렌치양털롱무스탕,92700,92700,0
2018-06-01,827759212,C011050,남자내의,아로미 915 편하고 착용감 좋은 고급패턴 9부남파자마,12950,11530,-1420
2018-06-01,1318224901,A014030,치즈,동원 이태리안 피자치즈280g,4900,4900,0
2018-06-01,923985776,C014010,아동복,네파키즈 벤토 칼라 메쉬자켓 KCD0681/ 네파키즈,20700,16980,-3720
2018-06-01,696799408,A014020,분유,[일동후디스]트루맘 프리미엄 1단계 800g 3캔,66000,66000,0
2018-06-01,461041576,E021010,침구,[무료배송]트리플 1인용 요차렵이불세트 / 대량생산,46800,46800,0
2018-06-01,985380036,L012030,칫솔,애경 2080 칫솔 미세모 5+5입,9900,4990,-4910
2018-06-01,1336980166,I031040,생화,휴대용 등산컵 스텐컵 이중컵 머그컵 캠핑컵 자바라컵,6000,5290,-710
2018-06-01,1002808080,E011030,거실장,동서가구 프라임 6인용 가죽소파 DF635968,1790000,1790000,0
2018-06-01,1120549528,C013020,티셔츠,슈프림 반팔티 여름 남자 여성 남성 반팔티셔츠 나시,13800,13800,0
2018-06-01,987978610,E041060,수저,심플 롱스푼 2P,3900,3900,0
2018-06-01,1002808081,E011030,거실장,동서가구 프라임 4인용 가죽소파 DF635967,1290000,1290000,0
2018-06-01,2078509138,C012030,여자상의,nn66 스트랩 베이직 린넨원피스 - 소라 여성패션원피,36390,36390,0
2018-06-01,1809681855,I031010,장난감,[레고]10404 해저 세계,47400,47400,0
2018-06-01,987978611,E041060,수저,심플 디너 포크 2P,4900,4900,0
2018-06-01,987978612,E041060,수저,심플 양식기 세트 3P,7900,7900,0
2018-06-01,280467499,C012030,여자상의,[공구우먼] 카엘로 플라워 랩원피스 29707 빅사이즈 여성의류,56000,56000,0
2018-06-01,1241422378,C013020,티셔츠,커터앤벅 남성 스판 기능성 카라 반팔티셔츠 11종 택1,39900,26620,-13280
2018-06-01,1289127089,A013090,전복,할인!!(전남오픈마켓/멸치신랑)건홍합1kg/건홍합/홍합,39000,39000,0
2018-06-01,463712429,C013010,점퍼,랜더스 남여공용 이누이트 파카(JK950W) 블랙,101980,90770,-11210
2018-06-01,440919121,C012040,여자학생복,[LAP] AF2WBM00. 민소매 롱 블라우스,22410,21020,-1390
2018-06-01,452761505,C014020,유아복,아둘 패밀리룩 엄마랑 커플룩 SANDIEGO 롱티셔츠 12,14300,14300,0
2018-06-01,497664339,A012060,햄및베이컨,(냉동)CJ 쉐프솔루션 맛있는베이컨1kg쉐프솔루션 반찬,34900,30720,-4180
2018-06-01,1010318734,E061020,섬유유연제,[테크] 울드라이 용기 2500ML 세탁세제,9900,5900,-4000
2018-06-01,1010318735,E061020,섬유유연제,[테크] 울드라이 리필 1300ML 세탁세제X10,38500,29800,-8700
2018-06-01,987291433,E041060,수저,초이스L)초L)부부수저(2벌),10900,10900,0
2018-06-01,1010318730,E061020,섬유유연제,[테크] 울드라이 리필 1300ML 세탁세제X5,19250,16500,-2750
2018-06-01,987291436,E041060,수저,초이스L)가든수저(1벌),5900,5900,0
2018-06-01,389120603,C015030,넥타이,(색상 : 와인) BTIE_116 작은점 와이드 보타,15140,15140,0
2018-06-01,895744556,A013160,맛살,대림 크라비아 270G,3990,3990,0
2018-06-01,1010318732,E061020,섬유유연제,[테크] 울드라이 용기 1500ML 세탁세제X2,11900,10200,-1700
2018-06-01,1041929926,A013130,오징어채,국내가공 진미채 1Kg / 버터구이 땅콩버터 오징어채,23000,21900,-1100
2018-06-01,563183429,A011130,시리얼,CJ제일제당 백설 부침가루1kg,1450,1450,0
2018-06-01,738919450,A019180,즉석식품,[교동전선생] 즉석국 육개장/청국장/짬뽕국/김치찌개,3870,3870,0
2018-06-01,1544601902,C013010,점퍼,네파키즈 에스티보 라이트 바람막이점퍼 KDD0605/ 네파키즈,42500,34850,-7650
2018-06-01,396568256,E061040,부엌용세제,유한락스 레귤러 18L/주방용 20L/플러스 18L/후레쉬 20L/살균 소독 악취제거/말통/욕실,11900,11900,0
2018-06-01,895768520,A014030,치즈,매일 뼈로가는칼슘치즈 180G,4600,4600,0
2018-06-01,1010318728,L012070,바디워시,도브뷰티너리싱바디워시1KG,12400,6490,-5910
2018-06-01,770782758,C014010,아동복,미니언즈 슈퍼맨 아이언맨 번개맨 스파이더맨 카봇/옷,19900,19900,0
2018-06-01,985380099,A018010,초콜릿,롯데 누드 빼빼로_43G,960,960,0
2018-06-01,1206766465,A017150,버섯,해물찜 삼겹살 비빔밥과 찰떡궁합 일자콩나물 1Kg,3130,3130,0
2018-06-01,1322211131,F012020,생리대,바디피트 내몸에순한면 18x3팩+gift키트/생리대/순면,10900,10900,0
2018-06-01,895744564,A019120,혼합조미료,[대상]대상 감칠맛 미원100g,2450,2450,0
2018-06-01,245888181,C013010,점퍼,빅사이즈 더블스판롱자켓 PG1704 빅사이즈 여성의류,116860,114530,-2330
2018-06-01,1282088362,A013090,전복,(경남고성)신선한가리비2kg/산지직송!,4900,4900,0
2018-06-01,240627318,C021040,실내화,[푸마] (SIZE : 260) 플레어 2(18951703) 신발 러닝,85190,85190,0
2018-06-01,954821141,A017300,미역,[정기배송]풀무원 들기름재래김 12봉,6990,6990,0
2018-06-01,1597303482,C013040,청바지,청반바지 청바지 칠부 7부 5부 반바지 데님 팬츠 바지,27700,27700,0
2018-06-01,456432502,A018030,껌,자일리톨껌 리필3개+증정3개 알파 후라보노 은단 왓따,9900,9900,0
2018-06-01,1662037517,A022040,기능성음료,수분보충음료 토레타 1.5Lx12PET/저칼로리,21500,21500,0
2018-06-01,950861213,C012040,여자학생복,V넥 캡소매 블라우스(SWWBLH21140)/ 쉬즈미스,29000,23200,-5800
2018-06-01,386461198,C011030,남자학생복,오투아이스_망사얼음조끼+머플러세트형,65790,61850,-3940
2018-06-01,2138223456,C013040,청바지,아둘 패밀리룩 여름 반팔 조던 쥬니어 상하세트 21,15900,15900,0
2018-06-01,591783568,A011090,국수,[컵라면43종]육개장사발면 24개 한박스 신라면/진라면,13800,13800,0
2018-06-01,1062951141,L021010,손목시계,MICHAEL KORS 마이클코어스 MK5465 여성 메탈 우레탄시계,344000,344000,0
2018-06-01,1062951142,L021010,손목시계,MICHAEL KORS 마이클코어스 MK5430 여성 메탈밴드시계,355000,355000,0
2018-06-01,1062951143,L021010,손목시계,MICHAEL KORS 마이클코어스 MK5309 여성 세라믹밴드시계,535000,535000,0
2018-06-01,1062951144,L021010,손목시계,MICHAEL KORS 마이클코어스 MK5308 여성 세라믹밴드 시계,535000,535000,0
2018-06-01,1062951145,L021010,손목시계,MICHAEL KORS 마이클코어스 MK5076 여성 메탈밴드시계,325000,325000,0
2018-06-01,1062951146,L021010,손목시계,MICHAEL KORS 마이클코어스 MK5039 여성 아크릴밴드 시계,282000,282000,0
2018-06-01,551356719,C014010,아동복,블랙야크키즈 사파리 형태 헤비다운자켓 BK럭키다운자켓,104000,104000,0
2018-06-01,1568610577,C013050,운동복,북유럽형 강화액소화기 EASY119 가정용 차량용 캠핑용,20000,17900,-2100
2018-06-01,1233813775,F011150,건강기능식품,마미아이 생유산균/60포/냉장발송/프로바이오틱스,45000,45000,0
2018-06-01,289913927,C013050,운동복,램프(LED 비상등) 9LED 경광등 경고등 자석내장/폴더,11800,11450,-350
2018-06-01,610252180,C013050,운동복,파보니 2차사고방지 차량용 접이식 안전콘,19200,18820,-380
2018-06-01,1605732313,C013050,운동복,뮤라스 트레이닝세트 핫팬츠 반바지 츄리닝 운동복,17900,17900,0
2018-06-01,681881554,A018050,비스킷,유명 스낵 과자 대용량모음전 세일특가~초코파이/간식,3000,2900,-100
2018-06-01,1241556779,C013020,티셔츠,강추 PK-Polo 카라T/맨투맨/집업,20900,18900,-2000
2018-06-01,318608077,C013050,운동복,[카렉스] 프론트 리어 범퍼 가드 보호대 몰딩 화이트 범퍼 차량,22120,20150,-1970
2018-06-01,1707791459,C013050,운동복,한벌몸빼/한벌옷/홈웨어/투피스/파자마/잠옷/실내복,7900,7900,0
2018-06-01,245565898,C011030,남자학생복,팝덕 포인트 후디 패딩 베스트_PPOEIPV01C,49000,44100,-4900
2018-06-01,446585706,C012030,여자상의,[무료배송]빅사이즈 DMO1259 빈티지 프리컷 원피스 80,44190,44190,0
2018-06-01,1521597264,A017210,파,첫출하! 正品토마토 5kg 판매,9900,9900,0
2018-06-01,196365038,A018080,설탕,CJ제일제당 백설 하얀설탕 3kg P,3350,3350,0
2018-06-01,1147724650,C013010,점퍼,[크로커다일레이디](17여름)홉겹점퍼(CL7MJP204)[갤러리아],49000,39200,-9800
2018-06-01,448223834,C015020,모자,신상 스냅백 모음전 뉴에라 힙합모자 연애인협찬 모자,9900,9900,0
2018-06-01,1298686013,I031010,장난감,콩순이자판기/냉장고 부푸러빵가게 동물병원 피아노,33000,29700,-3300
2018-06-01,1326406060,E021010,침구,무독성 PE놀이방매트 얼반파크 200×150 모서리보호대/ 어린이집놀이방매트 놀이방매트,47600,42780,-4820
2018-06-01,791252328,E011050,책상,[이스마트] 스틸메쉬 독서실책상,162000,162000,0
2018-06-01,895744588,A019010,고춧가루,[대상]대상 까나리액젓 1kg,4790,4790,0
2018-06-01,1673907211,C013010,점퍼,엑스톤즈 노르망디 MA-1 항공자켓 (블랙),191670,191670,0
2018-06-01,160716602,A018040,아이스크림,아이스크림볼/아이스크림제조기 /아이스크림컵틀/샤베트/쉐이커/팥빙수기계/당일배송,49000,49000,0
2018-06-01,628630840,C012060,여자내의,스카이 블루 디스트로이드 아이스 데님 (BF8421U05Q_)/ 빈폴레이디스,219000,197100,-21900
2018-06-01,1360366726,C012060,여자내의,허리밴딩 치마같은 큐롯팬츠 치마바지 숏팬츠,11500,10700,-800
2018-06-01,2047275442,L021060,유모차,크라운에스S 블랙에디션 유모차 요람형 절충형 디럭스,510000,510000,0
2018-06-01,954821167,L012080,화장지,초이스L 미용티슈 260매*6개,8490,8490,0
2018-06-01,546983617,C012060,여자내의,[비키]치마느낌의 와이드팬츠(TQPAF2267),39000,31590,-7410
2018-06-01,1806229942,L012090,기초화장품,더페이스샵 닥터벨머/클래리파잉/크림/토너/모이스처,13500,13300,-200
2018-06-01,834707040,E041010,식기,샤틴 이중 스텐냉면기 밥공기 국그릇 냉면그릇 면기,1500,1360,-140
2018-06-01,985379080,A011040,보리쌀,SF)흑태(봉)/450G,8990,8990,0
2018-06-01,1888964303,A015020,식용유,백설 포도씨유 900mlX4개 카놀라유 올리브유 식용유,22800,22800,0
2018-06-01,984487272,A018040,아이스크림,요맘때콘(프로즌요거트)10개,12000,7000,-5000
2018-06-01,118465312,A013020,명태,(맛나)대구(토막)1kg/해조은,10500,9450,-1050
2018-06-01,528939746,I053020,스케치북,스케치북 10권세트 반값 종합장 겨울왕국 터닝메카드,3900,3900,0
2018-06-01,401799011,A015020,식용유,아노스켈리 유기농 엑스트라버진 올리브오일 500ml,22000,22000,0
2018-06-01,442049318,C013050,운동복,IT 에보트레이닝 라이트 우븐 자켓(65472349) 트레이,95390,95390,0
2018-06-01,1180589657,F011150,건강기능식품,속편한에센셜2병 위건강 속쓰림 역류개선 글라브리딘,77700,77700,0
2018-06-01,907264890,A016070,귤,보석건귤 파우치 x 3박스(9개입)말린귤 귤,40790,40790,0
2018-06-01,1379671598,A013060,게,포항직송 국내산 총알오징어 1kg (40~50미)/ 푸르젠,21900,21900,0
2018-06-01,1225075366,A013090,전복,여수 껍질홍합 10kg /여수 청정 가막만,23000,21900,-1100
2018-06-01,1746268286,C013040,청바지,리바이스/리바이스청바지/청바지/남자청바지/남성/505,45000,45000,0
2018-06-01,1792168762,E061010,세탁세제,슈퍼타이 17kg 신형 특가! 스파크 비트 테크 수퍼타이,19800,19800,0
2018-06-01,1894752342,C014020,유아복,[플레이몰]아동반바지3부 냉장고 칼라버튼,4900,4660,-240
2018-06-01,272329529,C013020,티셔츠,[쿠비코][쿠비코]베이직 폴라 티셔츠 COT-NMGB525,9900,7920,-1980
2018-06-01,2119968344,A014050,달걀,[홈플러스]신선특란30입,4580,4360,-220
2018-06-01,1761836088,C011020,남자상의,봄여름10%추가할인/여름정장/수트/정장세트/양복,48900,43900,-5000
2018-06-01,1062951118,L021010,손목시계,MICHAEL KORS 마이클코어스 MK5547 여성 메탈밴드시계,355000,355000,0
2018-06-01,1062951119,L021010,손목시계,MICHAEL KORS 마이클코어스 MK8107 여성 메탈 우레탄시계,297000,297000,0
2018-06-01,436414977,I031010,장난감,무료배송 헬로키티 도라에몽 휴대용선풍기 미니선풍기,4950,4950,0
2018-06-01,189285416,C014020,유아복,민소매도트팬츠set/나시바지세트/여름신상/유아복,9900,9900,0
2018-06-01,433935351,E041050,냄비,키친아트 까망경질냄비/키친아트냄비/라면,7300,7300,0
2018-06-01,1778403284,A017300,미역,[장흥무산김] 먹거리 X-파일 도시락김 조미김 구운김,7800,7800,0
2018-06-01,2057787607,E041030,솥,풍년 압력밥솥 NEW 하이클래드IH하이브/ NEW 블랙펄,71900,69750,-2150
2018-06-01,2054366549,C013020,티셔츠,T2068-여성 데일리 미니멜 셔링 티셔츠 라운드티셔츠,17940,17050,-890
2018-06-01,407192351,E061030,전구,DC램프/DC전구/캠핑조명/12V LED/12V 전구/USB전구,7500,7500,0
2018-06-01,325596303,C012060,여자내의,[위쉬몰]BR 린넨끈치마바지(2238H805),47880,40700,-7180
2018-06-01,1092479695,E031080,선풍기,니코 1초 욕실히터/시력보호/3구램프 UMH-7033B,40500,40500,0
2018-06-01,1424534183,C013020,티셔츠,베스트핏 데일리룩 프리미엄 반팔티 / PK / 팬츠,19000,9900,-9100
2018-06-01,521418511,C013010,점퍼,[MRBOB] 두꺼운 헤비 기모 후드티 후드집업 빅사이즈,36800,33800,-3000
2018-06-01,1265865804,C011030,남자학생복,셀린 배색 롱가디건 KD 롱 루즈핏 여자롱가디건 가디,65000,64350,-650
2018-06-01,459814862,C012040,여자학생복,[CC콜렉트]나시 세트 프릴 블라우스 (C181MSC016[갤러리아],79000,63200,-15800
2018-06-01,1775930334,A018070,파이,후레쉬베리224gx4곽 몽쉘 카스타드 빅파이 오예스과자,17800,17800,0
2018-06-01,321876363,C012060,여자내의,보카시 찰떡레깅스 DM-6190 레깅스,9950,9950,0
2018-06-01,34112141,C012030,여자상의,7사이즈 하이웨스트 멜빵 롱데님원피스,22900,22900,0
2018-06-01,1359458537,A012050,소시지,사조오양 하이 비엔나 소세지 1kg/햄/소시지,4900,4900,0
2018-06-01,2028163988,I031040,생화,[09피싱]다이와 엑스트라서프 T/프라임서프/원투낚시,139000,114430,-24570
2018-06-01,118465319,A013020,명태,(맛나)청양초간장고추2kg/여우마을,21000,18900,-2100
2018-06-01,1497895502,C014010,아동복,알로봇 남아 아동 145 트렌치 코트 기모내피 가을겨울,44480,44480,0
2018-06-01,1305912474,C013010,점퍼,봄 후드 가죽자켓 PU03 A WS가죽점퍼가죽자켓라이다자,140720,140720,0
2018-06-01,984487264,A018040,아이스크림,라보떼 파르페 5개,7500,7500,0
2018-06-01,509863913,I031040,생화,이불같은 이지코튼 면침낭/확장연결/캠핑용품/200cm,42900,39470,-3430
2018-06-01,1264442128,C012040,여자학생복,리스트 7부 프릴소매 V넥 블라우스 TWWBLH60070,49000,44100,-4900
2018-06-01,463942538,E031070,에어컨,[윈드피아]천장용/천정용 리모콘선풍기,32900,31260,-1640
2018-06-01,1366222146,E061020,섬유유연제,아로마뷰 섬유유연제 2100mlx6개 /용기1+리필4 세제,10900,10900,0
2018-06-01,2048566512,C012060,여자내의,[에잇세컨즈] 베이지 리넨 블렌디드 미디 스커트 (128427B5FA),39900,37910,-1990
2018-06-01,725969829,A013140,북어채,용대리 자연건조 황태머리 500g 명태머리 북어머리,10400,9880,-520
2018-06-01,2356966,C014010,아동복,알로봇 아동 신장 110 반팔 점퍼 자켓 깨끗/811,12000,11880,-120
2018-06-01,1602161232,I011030,사진기,캐논 정품 EOS 800D + 18-55mm IS STM DSLR 명품,829900,829900,0
2018-06-01,1122452993,A022050,탄산음료,뚱캔 펩시 콜라 24캔 사이다 355ml 환타 맥콜 웰치스,12550,11800,-750
2018-06-01,895744530,A013150,어묵,[대림]대림 실속김밥세트 (560G),6480,6480,0
2018-06-01,2067932280,C012040,여자학생복,여성용 숄 겨울 담요 망토 자켓 패션 스타일 가디건,9320,9320,0
2018-06-01,946164603,L021030,가방,깔끔하고 튼튼한 국내산 에코백 숄더 캔버스 천 가방,14800,14800,0
2018-06-01,396798379,C013020,티셔츠,[레코브]자수 셔링 티셔츠 LU2176LT011P,15000,13800,-1200
2018-06-01,34136108,L021020,장신구,원석sale/천연아게이트/Agate/25.15ct,15000,15000,0
2018-06-01,1049291603,C013020,티셔츠,여성 망고 골지 롱나시 민소매티 끈나시 면나시 이너,4000,3900,-100
2018-06-01,787952204,E031030,전자레인지,SK매직 MWO-C1000/전자레인지/업소용/대용량/D1,300000,277000,-23000
2018-06-01,1208575905,C013010,점퍼,(스탭키즈 )메쉬안감바람막이점퍼,19900,15900,-4000
2018-06-01,1010509265,C011050,남자내의,여름신상/조거/배기/카고바지면바지/남자/청바지/남성,23800,23800,0
2018-06-01,1095931164,I053020,스케치북,올페이퍼/블랙스케치북/B4/B5/A4/A5/이벤트스케치북,4400,4400,0
2018-06-01,1092479671,E031080,선풍기,신일산업 팬히터/석유난로/온풍기 SFH-C304DMA,314500,314500,0
2018-06-01,730173444,C012040,여자학생복,(790)쉬폰조끼/니트조끼/기본조끼/마조끼/레이스조끼,28800,28800,0
2018-06-01,1895585393,L021020,장신구,8mm천연아코아진주반지/14k골드/pp,228000,228000,0
2018-06-01,1092479673,E031080,선풍기,니코 1초 욕실히터/시력보호/2구램프 UMH-7023B,32000,32000,0
2018-06-01,380059127,A018100,꿀,지리산벌꿀1.2kg/흑상감도자기+고가구/설명절선물세트,34800,34800,0
2018-06-01,2068350482,C013010,점퍼,봄신상 후리스집업 빅사이즈퍼프마자켓교복점퍼간절기,13900,13900,0
2018-06-01,246536912,C013010,점퍼,큰옷 빅사이즈 절개스트링야상-JP_WW_1704 빅사이즈,88480,86720,-1760
2018-06-01,210841037,A016160,과일가공품,[베리필드]야생(와일드) 아이스 블루베리 1kg/미국산,6900,6900,0
2018-06-01,504560881,C012060,여자내의,[위쉬몰]MD 밴딩롤업8부팬츠E14(2252H805),45360,38560,-6800
2018-06-01,1424859085,C012060,여자내의,씨드 린넨 와이드팬츠 인생슬랙스 찾았다,29900,29900,0
2018-06-01,521107532,E011060,의자,[의자다리]의자발/5발/6발/오발/육발/다리/우레탄/하이팩/철재/철제/스틸/의자부속품/,9000,8900,-100
2018-06-01,397062453,C013020,티셔츠,[나이키골프]AA1063-101 나이키 골프 에센셜 GRFX 폴로반팔티(영등포점B),59000,47650,-11350
2018-06-01,941198628,E031110,청소기,[11%카드추가할인]삼성 진공청소기 VC33M3120LU,129000,129000,0
2018-06-01,144541901,C013060,등산복,[블랙야크][빅사이즈입고] 18년 신상품 여름 남성용 등산기능성 반팔카라티셔츠[L라바,45000,36340,-8660
2018-06-01,345502432,E061010,세탁세제,비트 3kg x 2개 스파크 20kg 수퍼타이 세탁세제 테크,12600,12600,0
2018-06-01,1126290804,C013050,운동복,DYTMCN 이녹스 화이트 긴팔 져지 남성의류 긴팔슈트,138880,138880,0
2018-06-01,1696110239,I012060,저장장치,리줌 M1 RGB 인체공학 버티컬 마우스 /유선마우스,31800,29900,-1900
2018-06-01,264615760,C012020,원피스,[쉬즈미스][쉬즈미스] 플라이 프런트 심플 셔츠_SWWSTI11030_GN,59000,50150,-8850
2018-06-01,1911429361,C011030,남자학생복,앤드지 린넨 케쥬얼셔츠 12종택1[BZY2WC1181 BZY2WC1182 1183 1,29640,29640,0
2018-06-01,1915507534,A018100,꿀,오뚜기 벌꿀 아카시아 500g X 10EA(Hanworld2),216100,190170,-25930
2018-06-01,264615763,C012020,원피스,[쉬즈미스][쉬즈미스] 플라이 프런트 심플 셔츠_SWWSTI11030_CH,59000,50150,-8850
2018-06-01,537497494,C013020,티셔츠,[이동수스포츠] 핫썸머 쿨특가 골프웨어 티셔츠/팬츠,13860,13860,0
2018-06-01,379574702,C014020,유아복,여아 여자 아이 아동 순면 민소매 나시 상하 세트,10440,10440,0
2018-06-01,1384497746,C013040,청바지,공용_허리밴딩7부워싱데님팬츠_A182B3131A/ 에어워크주니어,29900,26910,-2990
2018-06-01,113353197,A022050,탄산음료,내몸에 착한수분 토레타 500ml x 24 PET,20900,20900,0
2018-06-01,2051565294,E021020,커튼,/벌집블라인드 베이지 호프발스 100x155 cm/ 롤스크린,56280,50090,-6190
2018-06-01,124378195,E011020,침대,순수국내산 수납침대/평상형통깔판/서랍장/정리함,217000,217000,0
2018-06-01,984404437,A016160,과일가공품,미국산 레몬(6~12입/봉),5990,5990,0
2018-06-01,1512487394,C013010,점퍼,[JEIKEI]제이케이 무지 항공점퍼(JH4JP003B)[갤러리아],29000,24940,-4060
2018-06-01,115691806,A019050,간장,일본 계란간장5종/타마고간장/일본간장 김맛 저당,3600,3600,0
2018-06-01,1805325748,E011020,침대,[가구야]매트리스+큰서랍포함 싱글/슈퍼싱글침대,129000,129000,0
2018-06-01,406870934,L021030,가방,(주)제노바 30년브랜드/서류가방/남성가방/출장가방,41800,41800,0
2018-06-01,268393547,C012040,여자학생복,[쉬즈미스][쉬즈미스] 코튼 블렌드 말드 가디건_SSKCDI21020_KH,99000,94050,-4950
2018-06-01,1178209591,C012060,여자내의,P패치 7부 트레이닝팬츠 DM-4148,12600,10080,-2520
2018-06-01,282201971,A011020,현미,남외정미소 2017년 찹쌀20kg/ 찹쌀선별해서보냄니다,55900,55900,0
2018-06-01,1533297516,C013020,티셔츠,봄 인기맨투티 주문폭주/ 3차재입고 인기좋아요,35000,35000,0
2018-06-01,1977830388,C014010,아동복,나이키키즈 드라이핏레거시 AOP세트 ANM11QTS97PT05/ 플레이키즈프로,78000,66300,-11700
2018-06-01,392070041,C015020,모자,디즈니 도날드 베이비커플 스냅백 일반모자,33060,33060,0
2018-06-01,1395522963,C012030,여자상의,에레네 면원피스 예쁜 스커트 DM-6257,19700,18720,-980
2018-06-01,1951993772,E021010,침구,20%쿠폰!올리비아데코 여름 간절기 홑이불/차렵이불,9900,9900,0
2018-06-01,2036541503,C011030,남자학생복,남성 봄 여름 린넨셔츠남방/롤업/헨리넥/차이나/시원,18000,18000,0
2018-06-01,1916157561,A011130,시리얼,오뚜기 바삭하고 고소한 부침가루 1kg X 10EA 튀김분,39360,39360,0
2018-06-01,2083145647,C013010,점퍼,오리털 롱패딩 S-3XL SD-6630 /(참고)빅사이즈 패딩점,168800,148550,-20250
2018-06-01,46508922,C015040,장갑,고품질 예식장갑/행사용장갑/망사장갑/흰장갑/속장갑,4200,4200,0
2018-06-01,2104238905,C013030,스웨터,목폴라 RTR 테이프 폴라남자 폴라니트 목폴라목폴라폴,54700,54700,0
2018-06-01,1421732874,A013070,굴,(나라수산) 박달급홍게3kg 선주직송 일등급 홍게,39900,39900,0
2018-06-01,2003611185,A011050,콩,산과들에 17년 국산 햇 생/볶음땅콩 수입산 벌크땅콩,10900,10900,0
2018-06-01,1490146996,A011140,부침가루,딤섬 화권꽃빵1.5kg 2개,29180,28310,-870
2018-06-01,300574615,C013010,점퍼,[카라]KARRA 7부메쉬니트점퍼_KBI6JP201A,53800,51110,-2690
2018-06-01,58061180,C012060,여자내의,편안하고 시원한 고품질 냉감통바지 SD-5668,12600,11220,-1380
2018-06-01,511852247,C013020,티셔츠,영문줄라인나시/슬리브리스/끈나시/슬림쫄티/섹시티,6900,6900,0
2018-06-01,632157682,C011030,남자학생복,바람막이 빅사이즈 7095 7102 빅사이즈,94370,91540,-2830
2018-06-01,724780578,C011030,남자학생복,TG패션 브랜드정품 드레스셔츠 면티 최저가% 모음전,42000,42000,0
2018-06-01,875765983,F012020,생리대,예지미인/팬티라이너 롱 40P 4팩~/생리대/중형,11900,11900,0
2018-06-01,1751208887,C012020,원피스,제작 간절기신상바지정장세트/하객용/직장/선자리,69900,69900,0
2018-06-01,1922947276,C011030,남자학생복,남자 여름셔츠 반팔 7부 롤업 린넨남방 와이셔츠 체크,21800,15800,-6000
2018-06-01,401706941,C012040,여자학생복,[퀵실버록시]니트 나시 탱크탑 R821SR224-WBT,59000,49560,-9440
2018-06-01,1347483141,A011010,쌀,2017년 햅쌀 철원오대쌀 10kg / 쌀 백미,28900,28900,0
2018-06-01,20564626,I031040,생화,빈슨메시프 마몬 침낭-이불과 침낭이 하나로 2in1침낭,29800,26680,-3120
2018-06-01,667988602,C013020,티셔츠,[지오다노] 048515 에어 쿨 셔츠,39800,35820,-3980
2018-06-01,593660551,C012020,원피스,[LINE(라인)]켈로그 원피스(NWOPHI07)(경기점),109000,88400,-20600
2018-06-01,568620037,E041050,냄비,[쿠첸] 인덕션 전용 24cm 양수 전골 냄비 AP-24J01SV,41000,41000,0
2018-06-01,1212616248,E031110,청소기,(행사)한경희 듀얼스팀청소기SI-7100DG[핸디스팀겸용],119000,99000,-20000
2018-06-01,1641013,L021030,가방,영 슬립 보정팬티,21500,21500,0
2018-06-01,1898762868,A019050,간장,계란간장 4종 & 버터 4종 & 명란소스 모음 혼밥 혼족,4250,4250,0
2018-06-01,863606163,A022050,탄산음료,[코카콜라] 몬스터 에너지 울트라/그린 355mlx24개,29800,29800,0
2018-06-01,1608283453,L021020,장신구,실버)엣지 크로스 목걸이 십자가 엔틱 실버 목걸이 주,36350,36350,0
2018-06-01,1896654488,C014010,아동복,[래핑차일드] 7부 스웨트 팬츠 (88329-402-01),12000,10800,-1200
2018-06-01,1174626061,C011030,남자학생복,[지오다노]남 크리스피 저지 반팔 스트라이프 티 028531,24800,19840,-4960
2018-06-01,420582938,C013010,점퍼,[나나살롱] 거즈 린넨야상 JUMPER,43000,43000,0
2018-06-01,2072097768,C013050,운동복,쿨서큘러 반팔트레이닝세트 반팔티반바지 남자운동복,17800,17800,0
2018-06-01,1924092715,G011070,자전거,엘레강스26+4종사은품 여성용자전거 7단 26인치,99000,99000,0
2018-06-01,1336448215,C013040,청바지,[Siwy (씨위)]블루핏[씨위진]NEW2018/SS[BC8S-417NEP]여성벨리시마크롭부츠컷(하남점),390000,359390,-30610
2018-06-01,1404375666,E061020,섬유유연제,피죤 건조기용/라피에스타/미스틱레인/중2팩 선택,12700,12700,0
2018-06-01,1046110079,E041060,수저,국산수저세트 5벌/업소용/유아수저세트/양식기/숟가락,6700,6700,0
2018-06-01,978504178,C011030,남자학생복,[필골드] SL S1TS603 네오프랜 와펜 오버핏 가디건,45800,45800,0
2018-06-01,1453469592,A011180,파스타면,판타넬라 58호 삼색푸실리 파스타 500g (1.30mm),1300,1300,0
2018-06-01,180071534,E061080,키친타월,깨끗한나라 빨아쓰는 행주타올 75매x2롤x1팩/ 무형광,6700,6700,0
2018-06-01,1706842311,E011040,소파,아리아퍼니쳐 블루 패브릭쇼파/천소파/컬러소파 모음,249000,249000,0
2018-06-01,1510974723,I012060,저장장치,DH) IPLEX VM712 휴 Ergo 손목보호 유선 버티컬마우스,21500,20120,-1380
2018-06-01,1875364405,L012060,샴푸,30%쿠폰! 려 자양윤모 탈모샴푸 400mlX3,19900,19900,0
2018-06-01,1395485487,C012030,여자상의,클레오 멜빵원피스 예쁜 스커트 DM-5806,44400,42180,-2220
2018-06-01,521565540,C013010,점퍼,[MRBOB] 두꺼운 헤비 기모 후드티 후드집업 M~3XL,36800,33800,-3000
2018-06-01,1210329136,C012040,여자학생복,[에이비에프지]쿨 가디건 AFS3Y11,29000,27550,-1450
2018-06-01,529009425,I053040,기타문구,미니 칼라 박스 메모지 60x83 600매 더블에이 1박스40,102300,99240,-3060
2018-06-01,1595846237,A014020,분유,비오타민 100g/120g/유산균/정장/소화/영양,17000,17000,0
2018-06-01,1732045442,C011050,남자내의,(아로미)(908/별대)시원한 기능성의 인견 9부 파자마,10790,9610,-1180
2018-06-01,624960464,A012030,돼지고기,그린쉘 오삼불고기 450g 2개,22000,21340,-660
2018-06-01,170383518,A012060,햄및베이컨,하림 밥싸먹는닭가슴살 슬라이스햄 129g 3봉(43gx9봉),9500,9500,0
2018-06-01,476339695,E011040,소파,[에보니아] 코지 라텍스폼 3인소파/스툴포함,139000,125100,-13900
2018-06-01,1111826994,E011040,소파,[폴리몰리] 빈백 소파 104K 오렌지,155000,155000,0
2018-06-01,268393575,C012040,여자학생복,[쉬즈미스][쉬즈미스] 코튼 블렌드 말드 가디건_SSKCDI21020_DG,99000,94050,-4950
2018-06-01,1055150146,C013010,점퍼,KD 양면 여자 무스탕 여성무스탕 무스탕 여자무스탕,133880,133880,0
2018-06-01,1797051364,E011050,책상,탑 데스크 1400 책상 컴퓨터 학생 다용도 h형 테이블,42900,42900,0
2018-06-01,1365070635,I031010,장난감,(Step2)멜로디지붕차 (2016.4.1 소비자가 인상) 승용,205630,205630,0
2018-06-01,440787163,A013120,낙지,정화식품 10봉/ 맥반석오징어 해오징어 전기구이,27900,22900,-5000
2018-06-01,1032633050,A017250,고사리,2018년 국내산 햇 레드비트 3kg실중량/출하기념 할인,9900,9900,0
2018-06-01,1944311768,I031040,생화,[코베아]무료배송레이백체어2 (KECM9CS-01),46500,46500,0
2018-06-01,434842838,C013020,티셔츠,[나이스클랍] 요즘 대세 꾸안꾸! 이런 가격 없어요,39000,39000,0
2018-06-01,509329185,C012040,여자학생복,보풀방지 블랙화이트라인 롱 교복조끼 남자 교복 교복,24430,23700,-730
2018-06-01,1199636856,C013010,점퍼,미노갤러리/유아/토들러/키즈/주니어/간절기/패딩점퍼,9900,9900,0
2018-06-01,266432302,C013010,점퍼,[체이스컬트]남성 배색 바람막이 경량 점퍼-DBMK4158CH0,19900,18910,-990
2018-06-01,266432301,C013010,점퍼,[체이스컬트]여성 메쉬 배색 윈드브레이크-DBMG4174C40,19900,18910,-990
2018-06-01,1477032013,A022010,주스,희창 자연생각 복숭아홍차 980ml x1페트 매실 음료베,3000,3000,0
2018-06-01,1914616038,E011010,장롱,[라자가구]리스본 화이트 갤러리 장롱/장농/옷장,286900,286900,0
2018-06-01,564521745,C013050,운동복,루즈핏 박스핏 반바지 반팔티 여름 트레이닝 세트,22900,22900,0
2018-06-01,1742580868,C021040,실내화,[넥스트큐]스타 운동화/키높이/로퍼/슬립온/스니커즈,26700,26700,0
2018-06-01,579636907,C014010,아동복,폴로 남아 아동 8 ~ 10 세 카라 면 긴팔 티 봄 가을,20000,19800,-200
2018-06-01,954011071,A017280,김,일미오이 피클(360G),2990,2990,0
2018-06-01,117252695,C013040,청바지,(SR) MHA508 남자빅사이즈청바지 빅사이,71820,70390,-1430
2018-06-01,793127011,A019020,참깨,수입 참깨 생 볶음참깨 1kg 검은깨 들깨가루 기피,6400,6400,0
2018-06-01,988122581,A019150,김치,CJ 비비고 썰은 배추김치 500G,6400,6400,0
2018-06-01,42213482,C013040,청바지,[크로커다일] 캐쥬얼 뱀부 팬츠 CDAA3PC2503_VIP,39000,31200,-7800
2018-06-01,1748144050,A011070,혼식곡,유기농 통밀가루 2.268kg,12800,12800,0
2018-06-01,648741599,D031010,주택수선재료,미앤미 데코끼움식마루 56p 조립식 바닥재발판 베란다,39500,37530,-1970
2018-06-01,149589028,E011030,거실장,[채우리] 나린 접이식 소나무 원목 테이블 600,35000,35000,0
2018-06-01,149589029,E011030,거실장,[채우리] 도래 소나무 원목 좌탁 1200,127000,127000,0
2018-06-01,149589027,E011030,거실장,[채우리] 나린 접이식 소나무 원목 테이블 800A,38000,38000,0
2018-06-01,1965677813,C012020,원피스,[지지피엑스]루즈핏 허리벨트 심플 핸드메이드 코트GHDCCT942F,79000,67150,-11850
2018-06-01,1471438459,A019180,즉석식품,썬리치 자연99 모짜렐라 치즈 2.5kg/피자치즈/썬리취,22750,21750,-1000
2018-06-01,1786858497,E051030,디지털도어록,[무료설치] 삼성 푸시풀 도어락 SHS-P710/카드키 2개,205000,184410,-20590
2018-06-01,664123528,A022040,기능성음료,포카리스웨트분말 20팩+물통/코스트코구매대행/포카리,19990,19990,0
2018-06-01,1990762682,A011100,라면,이츠웰당면 cj이츠웰당면14kg,35000,35000,0
2018-06-01,2083387135,A012010,국산쇠고기,신선닭갈비 1.3kg3,68950,68950,0
2018-06-01,1127057590,A016070,귤,싱싱몰 제주서귀포하우스감귤1kg 꼬마/2박스구매시3kg,15900,15900,0
2018-06-01,72523996,C012040,여자학생복,[YK]언발라인 니트가디건(Y174C946A다크그린),64900,61660,-3240
2018-06-01,1597915025,C012020,원피스,트랜디한체크롱자켓(N181MSF007)/ 나이스클랍,199500,163590,-35910
2018-06-01,1597915026,C012020,원피스,트랜디한원버튼체크재킷(N181MSF001)/ 나이스클랍,199500,163590,-35910
2018-06-01,1399698513,C012040,여자학생복,수지네 구제 르꼬끄 블랙 패딩조끼 여성 M 18-36,13770,13770,0
2018-06-01,2004515981,C013010,점퍼,신화어페럴/봄/여름/중년남성/점퍼/사파리/골프점퍼,48800,48800,0
2018-06-01,1847764584,A011030,찹쌀,찰보리 5kg 10kg,16700,16700,0
2018-06-01,982675628,A012050,소시지,목우촌 프라임 리얼프랑크 (300G*2),7980,6990,-990
2018-06-01,405446414,A021020,차,프리마 (가정용 동서 1K) X12,91040,81030,-10010
2018-06-01,982675627,A012060,햄및베이컨,목우촌 프라임 리얼비엔나 (300G*2),7980,6990,-990
2018-06-01,998050238,L021020,장신구,남자 여자 실버 체인 순은 은팔찌 10돈15돈20돈25돈,180000,180000,0
2018-06-01,917640138,C021040,실내화,나이키 다운쉬프터7 GS 검흰 여성 운동화 869969-001,56800,49990,-6810
2018-06-01,388913001,A022020,두유,한미전두유 200mlx32팩 발아콩검은콩 검은콩쌀눈,10910,10910,0
2018-06-01,1622188809,E031070,에어컨,(여름특가)정품/14형선풍기/리모콘/벽걸이/스탠드,19500,18500,-1000
2018-06-01,2083351186,C012030,여자상의,[스카이문]2018신상/데님/투피스/레이스/롱원피스,29900,29900,0
2018-06-01,1842408560,C013010,점퍼,바람막이 패딩수선 패딩수선패치 옷수선테이프 점퍼,9000,9000,0
2018-06-01,183187647,A014040,발효유,요거프레소 요거트 파우더 20T 메리딸기 요거스무디,9400,9400,0
2018-06-01,2022207742,C012060,여자내의,푸조 워테레깅스 (S26-3 ),29380,26150,-3230
2018-06-01,822733891,C012040,여자학생복,무료배송 180333B_퀄리티up!! 블라우스,19900,19900,0
2018-06-01,1490565368,C013010,점퍼,아이엠파인 봄여름신상 린네자켓/코트/야상,25900,25900,0
2018-06-01,959558030,A019090,카레,오뚜기짜장(분말)300G,3750,3750,0
2018-06-01,517022056,C011030,남자학생복,멋을아는남자의 7부셔츠 린넨셔츠 국내생산 22종 무배,19900,19900,0
2018-06-01,467805790,C011020,남자상의,남자의품격 솔리드정장/빅사이즈 수트 자켓 바지 조끼,129000,119000,-10000
2018-06-01,1356826754,C012030,여자상의,[캐주얼/미니원피스모음]66-120 쉬폰레이스 정장 치마,37800,37800,0
2018-06-01,1184413859,C013020,티셔츠,(정품)Levis 리바이스 로고 반팔티셔츠9종/100프로 미국직수입정품/신혼여행/커플티/빅,20900,20900,0
2018-06-01,1854650124,E061010,세탁세제,화미 식소다1kg x 24,75440,67150,-8290
2018-06-01,1720796699,L021020,장신구,1.8캐럿 천연루비반지/광택칼라굳/14k골드/어머님/JS,330000,330000,0
2018-06-01,1628759868,A017160,오이,러시아 차가버섯 1kg 차가버섯가루 분말 정 선물세트,23900,23900,0
2018-06-01,407757574,A011110,당면,배송지연7일 행복한 콩국물350g 채소 두부 콩나물,3720,3720,0
2018-06-01,982105322,C011030,남자학생복,[레노마_셔츠(남성)]20189SS 화이트블루 슬림핏 일반핏,30000,24000,-6000
2018-06-01,649437475,A012030,돼지고기,가야촌 한돈 암돼지 냉장육 부위별 300~2kg,2700,2700,0
2018-06-01,1287129133,C012040,여자학생복,[하프클럽/올리비아하슬러](올리비아하슬러) 레이어드 쉬폰 반팔 블라우스 (OH7MBL902,32300,29070,-3230
2018-06-01,948331614,E061040,부엌용세제,커피머신세정제 어넥스퓨로 퓨로세정제 어넥스퓨로 커,40080,40080,0
2018-06-01,1861920571,L021010,손목시계,젤리 아쿠아 방수시계 방수시계 패션팔찌시계 패션시,13870,13870,0
2018-06-01,617854015,C011030,남자학생복,폴로 남성 카라티 티셔츠 남방 면바지 반팔티,54900,54900,0
2018-06-01,1886051776,L021020,장신구,실버)블랙 스완 큐빅 목걸이 TRIBALE 트리발 백조 투,39450,39450,0
2018-06-01,1601450562,A013120,낙지,꼬꼬마오징어 350g 꽃보다오징어 숏다리 주전부리,12900,12900,0
2018-06-01,568619046,C011050,남자내의,린넨바지 린넨팬츠 여름 남자 남성 마바지 조거팬츠,19800,19800,0
2018-06-01,2091185044,C013060,등산복,쿨링스판 여름 등산복바지 남자아웃도어바지 여름바지,13800,12360,-1440
2018-06-01,440316727,A013170,생선통조림,(냉장)캐드레몬탕수육소스 2kgX6개탕수육소스 식품 탕,79200,67320,-11880
2018-06-01,149589030,E011030,거실장,[채우리] 도래 소나무 원목 좌탁 800,106000,106000,0
2018-06-01,677520862,E031130,보온매트,전기매트 온수매트 카페트 이불 보관/수납가방/케이스,7000,6900,-100
2018-06-01,671310230,I031010,장난감,[토이트론]아쿠아비즈-New 반짝반짝 쥬얼리 아트세트,30000,29500,-500
2018-06-01,633155772,L012010,면도기,도루코 일회용 면도기 3중날 4중날 6중날 휴대용,14000,14000,0
2018-06-01,1956415053,C012060,여자내의,[블루종][블루종] 스프링 데일리 와이드 팬츠_[B1803PT022A],19800,18810,-990
2018-06-01,606484850,E011020,침대,[안전한 베디스]SB208 로맨틱침대 고급침대 퀸/킹침대,339000,333600,-5400
2018-06-01,611732516,L021050,우산,우산/비닐우산/투명우산/파스텔우산/일회용우산,1300,1300,0
2018-06-01,268393521,C012040,여자학생복,[쉬즈미스][쉬즈미스] 스트라이프 버튼다운 가디건_SSKCDI20030_NA,69000,65550,-3450
2018-06-01,2056555065,C012030,여자상의,(AGC롱니트 여성 V넥 단가라 원피스 KK롱니트여자 롱,68710,68710,0
2018-06-01,1767539560,L021060,유모차,[아발론]2018 오샤인 쌍둥이 휴대용 유모차,199000,159200,-39800
2018-06-01,1942228702,C013060,등산복,마운티스트 봄신상 아웃도어 등산티 기능성 봄 작업복,8900,8100,-800
2018-06-01,506843493,C013020,티셔츠,빅사이즈/제이스타일 드칼리 버튼 린넨 나시/ 제이스타일,20500,16200,-4300
2018-06-01,1152889058,D031010,주택수선재료,(베어페인트)ZERO-VOC미국수입페인트(약1L/무광),23500,23500,0
2018-06-01,276577313,E021020,커튼,프리미엄 초대형 엔젤 캐노피 커튼 최고급 모기장,31800,31800,0
2018-06-01,248605163,L021030,가방,MiiM [ 12~15.6 인치 노트북가방 ] 다양한컬러,31000,28520,-2480
2018-06-01,2037614846,E061020,섬유유연제,1+1 섬유유연제 피죤(2.1L/2개)/샤프란(1.6L/2개),4700,4700,0
2018-06-01,1067587927,C013020,티셔츠,국내생산/교복면티/나시/202/반팔티/흰색면티/쿨론/면,4500,4500,0
2018-06-01,1374771190,F012020,생리대,[화이트] 생리대 팬티라이너 애니데이 일반 90개입 x3개,20500,20500,0
2018-06-01,1997290031,E011020,침대,[골든잼]원목 천연 생황토 싱글 돌침대(백조)/흙침대,1450900,1407380,-43520
2018-06-01,671576563,C013020,티셔츠,고퀄반팔티 44~99 빅사이즈 여성맨투맨 후드티셔츠,19800,19800,0
2018-06-01,649486407,I012060,저장장치,무료배송/삼성/LG/로지텍브랜드마우스모음/USB/게이밍,5000,3990,-1010
2018-06-01,1290760739,A017110,감자,하우스 햇 흙당근 3kg,6800,6800,0
2018-06-01,1504205611,E061100,습기제거제,물먹는 제습제/옷장용/8개입/1set,10350,10350,0
2018-06-01,268393513,C012040,여자학생복,[쉬즈미스][쉬즈미스] 스트라이프 버튼다운 가디건_SSKCDI20030_OR,69000,65550,-3450
2018-06-01,75141190,F012020,생리대,[중형20p+입오버2p+립밤] 오가닉 수퍼롱 오버나이트 16x2/ 좋은느낌,15500,15500,0
2018-06-01,926836675,A014010,우유,[가정배달] 불가리스 위쎈 150ml 주5회 4주(월20회),29000,29000,0
2018-06-01,1939120346,E061020,섬유유연제,라벤다 베이비전용 섬유유연제 bottle 아기옷빨래 빨,21300,21300,0
2018-06-01,2145665126,C012020,원피스,[파프리카]카렌 쉬폰 원피스_N82OP411(영등포점A),59000,52660,-6340
2018-06-01,1481669102,E061100,습기제거제,물먹는 하마 525ml 16개 옷장용 제습제 탈취 습기제거,15200,15200,0
2018-06-01,19426438,A014010,우유,원액(망고 참존 835ml)X12 엑 기스 액 음료 진액,66800,66800,0
2018-06-01,586027819,I053030,복사용지,더블에이 A4 복사용지(A4용지) 80g 2500매 1BOX,26890,23400,-3490
2018-06-01,1335267026,L021020,장신구,실버폭스 주얼리 반지 팔찌 목걸이 귀걸이,10000,10000,0
2018-06-01,479768628,D031010,주택수선재료,[WATCO] 왓코 텅오일 피니쉬(Tung Oil Finish)/946ml/빠른건조(폴리머라이즈드텅오일),27300,27300,0
2018-06-01,2093981446,I031040,생화,LED 스트링가드 /캠핑등/캠핑용품/휠라이트/텐트,900,900,0
2018-06-01,2104381193,C012030,여자상의,여성 단가라 박스 원피스박스 원피스원피스단가라 원,67620,67620,0
2018-06-01,930498897,F011150,건강기능식품,(미숫가루 40포)-(레몬/복숭아홍차100티/레몬에이드),11200,11200,0
2018-06-01,472235789,C013030,스웨터,남성 니트 네줄 라운드 MRO 남성니트티 니트 남자니트,44280,44280,0
2018-06-01,1305104452,A014030,치즈,코리원/썬리취 체다/무색소 슬라이스 치즈 100매/블럭,11900,11900,0
2018-06-01,149589005,E011030,거실장,[채우리] 나린 접이식 소나무 원목 테이블 800B,42000,42000,0
2018-06-01,1131433787,A014010,우유,푸르밀 가당연유 580g/빙수/토핑/제과/제빵/재료,4100,4100,0
2018-06-01,1231839262,C014010,아동복,아동 바람막이/후드집업가디건/번아웃점퍼/유아/여아,14800,14800,0
2018-06-01,961224338,A017180,호박,큰파프리카 (색상랜덤/개),1490,1490,0
2018-06-01,476496494,C013010,점퍼,MJ-996 ( 인기) 와펜워싱 청자켓 (FREE) 중청 남성청,45720,45720,0
2018-06-01,754411722,C012040,여자학생복,루즈핏 티셔츠 박스/반팔/롱/티 원피스 신상 허밍퍼플,10000,9800,-200
2018-06-01,416976373,E011050,책상,MT101-L 높이조절 워크스테이션 블랙 높이조절책상/,701790,701790,0
2018-06-01,1850558447,A015020,식용유,유기농 코코넛오일 엑스트라버진 오일풀링 냉압착,6500,6500,0
2018-06-01,592323021,C013060,등산복,[밀레]3팩 18ss 신상으로 입고!트리플팩18ss/데일리팩 라운드 티셔츠/TRIPLE PACK/ 네,29900,29900,0
2018-06-01,2070791965,C013010,점퍼,[대구백화점 I관] [유지아이지]소매배색 린넨 점퍼(UBUB601),59000,50740,-8260
2018-06-01,982675601,A019140,이유식,[남양]남양 아이엠마더 2단계 800G,37200,37200,0
2018-06-01,1525798126,C021010,아동화,아식스아동화 아동운동화 유아동화 키즈아동화,39000,36000,-3000
2018-06-01,1572943348,C013010,점퍼,[백화점SAY][블루독베이비]YE PK)레터링 린넨점퍼{48414-110-020},88000,64770,-23230
2018-06-01,1048844790,C011020,남자상의,KD 기모체크코트 기모체크코트,150840,147830,-3010
2018-06-01,2056919488,A011170,떡,전북고창 울어매 모시잎개떡 100개(25개 4팩),63640,63640,0
2018-06-01,1436833428,A019030,생강,국산 햇 흙생강 1kg 10키로이상 무배,6990,6990,0
2018-06-01,1469741654,E061030,전구,LED바/LED BAR/LED바30구/LED바60구/방수형LED바/알루미늄LED바/PCBLED바/PCB바/알루미,5800,5800,0
2018-06-01,144130303,I031040,생화,캠핑용품 캠핑 도끼 망치 해머 야전삽 팩망치 손도끼,8000,7900,-100
2018-06-01,825391072,A012010,국산쇠고기,[무항생제 한우선물세트]한우 불고기 3호2.5kg,174800,174800,0
2018-06-01,741146266,A015010,참기름,[천일유통] 백설 진한참기름1000ml/참기름/들기름/식용유/콩기름/카놀라유/포도씨유/옥,12500,12500,0
2018-06-01,1778708689,L021020,장신구,[바보사랑]925실버 심플 실버볼 귀걸이-5mm 16142025,25900,25900,0
2018-06-01,1067453550,A019080,고추장,[CJ직배송] 해찬들 우리쌀로 만든 태양초골드고추장 2kg + 500g 추가증정,10080,10080,0
2018-06-01,1067453551,A019080,고추장,[CJ직배송] 해찬들 사과듬뿍 비빔장470gX2개 +제일제면소 소면500gX2개,9900,9900,0
2018-06-01,2121619339,C011030,남자학생복,여름신상/남방/셔츠/체크/청/데님/빅사이즈/남자/남성,13700,13700,0
2018-06-01,331964741,C014010,아동복,여름 유아 아동 남아 여아 상하복 활동복 츄리닝,24000,24000,0
2018-06-01,2051309452,C013020,티셔츠,[공구우먼] 쏘쿨 유브이넥 티셔츠 29639 빅사이즈 여성의류,15000,15000,0
2018-06-01,928920921,L021020,장신구,[라라쥬얼리]실버 체인 팔찌,83000,83000,0
2018-06-01,487784114,D031010,주택수선재료,시멘트스타코 20kg 노출 콘크리트 빈티지 스터코 마감,65000,65000,0
2018-06-01,315218448,C012040,여자학생복,[조이너스][조이너스] 뒷판 레이스 레이어드 블라우스 JA7U4-WRB740_110 (P000337684),37900,34110,-3790
2018-06-01,1301726223,C011030,남자학생복,(색상 : 네이비) MTS-560 프리 플라워 패,34240,34240,0
2018-06-01,1835598844,L012060,샴푸,[아로마티카] 제리스베이비 논나노 썬쿠션 14g,18000,16200,-1800
2018-06-01,2103346164,C021040,실내화,리복 트레인플렉스2 BS9906 BS9904,38220,38220,0
2018-06-01,1091658517,F012050,의료측정기,녹십자 로즈맥스 팔뚝형 자동전자 혈압계 X1 혈압측정기 혈압기,52900,43380,-9520
2018-06-01,900767159,C013020,티셔츠,(정품) 챔피온 반팔티 반팔티셔츠 남여공용 빅사이즈,17900,17900,0
2018-06-01,165035243,A017300,미역,[동원] 더 바삭한 양반김 전장 10매*10봉,14900,14900,0
2018-06-01,1391828783,E011070,식탁,무료배송 카페티테이블2인세트 식탁세트/2인용식탁,111900,101830,-10070
2018-06-01,2045473814,E061010,세탁세제,스파크 리필 9.5kg x2개/가루세제/찬물세탁,24500,19500,-5000
2018-06-01,510622063,F012010,종이기저귀,[하기스] 네이처메이드 기저귀 밴드형3팩/팬티형2팩 택일,53400,53400,0
2018-06-01,96543456,C013020,티셔츠,T-216 K2 여성용 반짚업 티,19000,14000,-5000
2018-06-01,1560597495,C012060,여자내의,자밀라 3부 마바지 DM-5577 마반바지 반바지 마바지,15600,11700,-3900
2018-06-01,686572996,C013020,티셔츠,난닝구 몰리지 나염반팔티/ 난닝구,9000,8730,-270
2018-06-01,2069976314,C012020,원피스,빅사이즈/라운드/쉬폰/베스트 / 참고 라운드쉬폰베스,75500,66440,-9060
2018-06-01,1778708690,L021020,장신구,[바보사랑][액세서리키친] 925실버 심플포인트 귀걸이 택1 16141019,19900,19900,0
2018-06-01,326521712,A019010,고춧가루,바우내고추가루 2.5kg 업소용고추가루 고운고춧가루,51400,51400,0
2018-06-01,1324846187,A018010,초콜릿,닥터유 에너지바 30개 칼로리바란스 76g 24개,24800,24800,0
2018-06-01,440316787,A019100,식초,오뚜기일회용케찹(1000입) 9g케첩 오뚜기 일회용케찹,53800,45730,-8070
2018-06-01,1778708691,L021020,장신구,[바보사랑]925실버 베이직 심플 귀걸이 택1 16140015,15900,15900,0
2018-06-01,667903716,E011060,의자,[시니프]유니크메시의자12종/학생의자/사무용의자,62500,56250,-6250
2018-06-01,681662,C013040,청바지,리바이스/리바이스청바지/청바지/남자청바지/남성/511,45000,45000,0
2018-06-01,127965852,A016040,포도,송산포도과즙,40100,40100,0
2018-06-01,1852640188,E041060,수저,업소용수저 스텐 수저 숟가락 젓가락 인삼 민자 진공,300,300,0
2018-06-01,27152187,A012060,햄및베이컨,CJ제일제당 백설 스팸 1.8kg/통조림햄 /대용량 스팸,19900,19900,0
2018-06-01,2087514760,C014020,유아복,아둘 패밀리룩 유아 스트라이프 트레비 상하세트 12,19100,19100,0
2018-06-01,1695041280,E061060,살충제,개미약 잡스 페스트세븐앤트겔 맥스포스퀀텀 유령개미,12000,12000,0
2018-06-01,1067453553,A019080,고추장,[CJ직배송] 우리쌀로 만든 태양초 매운고추장 500g X3개,12900,12900,0
2018-06-01,1067453554,A019080,고추장,[CJ직배송] 우리쌀로 만든 태양초 골드고추장 500g X3개,12900,12900,0
2018-06-01,495887676,A016060,감,(품질보장) 2017년산 / 씨없는 곶감 청도감말랭이 1kg,14700,14300,-400
2018-06-01,2087514766,C014020,유아복,아둘 패밀리룩 유아 스트라이프 트레비 상하세트 11,19100,19100,0
2018-06-01,1255912436,C013020,티셔츠,[플레이키즈][플레이키즈프로][NIKE YA 주니어][140-170] 나이키 스퀘어 로고 티셔츠,35000,29750,-5250
2018-06-01,1130817081,A017110,감자,영동대명 표고버섯 동고 800g 국내산 건표고 버섯,96400,85800,-10600
2018-06-01,1551618974,A022050,탄산음료,코카콜라 1.25L(업소용)x12개,17600,17600,0
2018-06-01,268513884,D031010,주택수선재료,자전거보관대 자전거거치대 자전거주차 자전거보관소,109000,109000,0
2018-06-01,169801551,C012040,여자학생복,머플러 숄 스카프 목도리 보온 패션 스타일 여성 겨울,9920,9920,0
2018-06-01,1133596435,A014030,치즈,크래프트 파마산치즈 227g,6600,6600,0
2018-06-01,1214023375,C012060,여자내의,[대구백화점 I관] [나이스클랍]벨티드큐롯팬츠(N182MSA020),143000,121550,-21450
2018-06-01,78983694,A012030,돼지고기,오겹살/목살/항정살/갈매기살 꼬치 고기모듬,5300,5300,0
2018-06-01,1646440569,E041020,컵,(특가행사)북유럽 머그컵/커피잔 도자기 찻잔 머그잔,3400,2700,-700
2018-06-01,1923261447,G011070,자전거,18년 3월출시 엘레강스26 여성용자전거 7단 26인치,85000,76500,-8500
2018-06-01,893746810,E061030,전구,형광등 삼파장 전구 FPL 32W 36W 55W 오스람 램프,490,490,0
2018-06-01,248727508,C013010,점퍼,[홈런] 자켓 코트 블레이져 하프 모직 롱 남성 남자,29800,29800,0
2018-06-01,1206849117,G022020,자동차타이어,넥센타이어 N7000 플러스 215/60R16 정품 무료배송,76600,64690,-11910
2018-06-01,1360560800,E011050,책상,다용도테이블/노트북거치대/독서대/테이블/받침대,24500,24500,0
2018-06-01,1499529926,E041070,밀폐용기,과실주병 모음/대신유리병/청매실병/효소/담금주병/11,19800,18220,-1580
2018-06-01,1470235125,C013050,운동복,RT8 상하세트 유아상하세트 핑크상하세트,40850,40040,-810
2018-06-01,1102979620,A017250,고사리,새싹/새싹채소/새싹채소씨앗/정식허가제품/새싹채소묶음,10800,10800,0
2018-06-01,385500942,C011030,남자학생복,캘리포니아 프린팅 오픈카라 반팔셔츠,32580,30630,-1950
2018-06-01,477470633,C012030,여자상의,모던프릴줄배색원피스 BR1710 모던스탈원피스 예쁜원,68040,68040,0
2018-06-01,717281936,L012030,칫솔,조르단스텝칫솔 어린이칫솔 10개(1~4단계) /유아칫솔/,20800,20800,0
2018-06-01,1298951752,E021020,커튼,명품수작업 가죽액자 그림액자 인테리어 벽장식 명화,214700,210410,-4290
2018-06-01,1646919492,A017230,마늘,특가 - 2018년 국내산 창녕 햇양파 - 10kg/5kg,5700,5700,0
2018-06-01,1967116145,C011030,남자학생복,[준옴므]면스판 슬림핏셔츠/핏예술/다양한색상/기본,19900,19900,0
2018-06-01,988122611,F011150,건강기능식품,[CJ직배송]전립소 쏘팔메토 60캡슐 (2개월분),29800,13900,-15900
2018-06-01,1447015879,F012020,생리대,위스퍼 보송보송케어 날개 대형 32P x 2팩,22000,22000,0
2018-06-01,1185577141,C014020,유아복,아동바지 플라워통바지 KIDBOK-200 긴유아바지 바지,16690,16690,0
2018-06-01,988122604,A019150,김치,CJ 비비고 썰은 배추김치 900G,9900,7490,-2410
2018-06-01,1375797614,C015020,모자,야구모자 볼캡 빈티지 워싱캡 캡 모자 여자 청모자,7900,7900,0
2018-06-01,1961995327,E011050,책상,이지심플 126 TOP 선반 책상 / 다용도책상 / 조립,44700,44700,0
2018-06-01,908370116,L021030,가방,신학기 고학년 초등학생 책가방 여아 남자 학생 백팩,16900,16900,0
2018-06-01,1049940513,C013030,스웨터,KJN-NW100 남자레쉬가드요가복후드집업상의 트레이닝,31820,31820,0
2018-06-01,891216287,A017050,미나리,[꼬레촌엽채]양배추 8통 최상품 20kg이상,24400,24400,0
2018-06-01,954833434,C013050,운동복,여름 트레이닝세트/나시/반팔/5부/7부/박스핏/슬림핏,23800,23800,0
2018-06-01,2003542944,L021060,유모차,[BABYZEN] 베이비젠 요요 플러스 6+,585000,585000,0
2018-06-01,1987675465,C013010,점퍼,신상 아우터/야상/사파리/자켓 빅사이즈 허밍퍼플,72000,69800,-2200
2018-06-01,586992552,C013040,청바지,스티치 칠부 팬츠_QALG07831NY/ 베네통키즈,49000,36750,-12250
2018-06-01,1240613074,A014030,치즈,자연산99.3% 건국모짜렐라 피자치즈1kg /건국하모니,10900,10900,0
2018-06-01,1040940399,E031090,공기청정기,타워 XQ600 공기청정기 AGX660W-W0 [66㎡ / 1등급 / IOT장착 / UV제균]/ 위닉스,470000,465300,-4700
2018-06-01,1650208927,I012010,컴퓨터,!마지막기회!실구매 120만원/NT900X3N-K516S/램16G/,1367360,1299000,-68360
2018-06-01,812660549,A018030,껌,[캔디마을][초특가]껌9종/자일리톨/후라보노/스피아민트/쥬시후레쉬/이브/커피껌/금연,7200,7200,0
2018-06-01,2122086138,I012010,컴퓨터,LG데스크탑 Z71EV-AX7306 코어i3 4G 500G 윈도우없음,573400,539000,-34400
2018-06-01,747961936,C013050,운동복,차아네2 차량용 와이드 컵홀더 5단 차량용품악세사리,17700,17700,0
2018-06-01,1096978989,A011140,부침가루,크라운)베이키 뉴욕 102g x 6개 치즈케익,15800,15800,0
2018-06-01,1973994525,C012040,여자학생복,[케네스레이디]구르미 블라우스(EGBLHH95),35000,28700,-6300
2018-06-01,2065462047,E041050,냄비,라면냄비 최저가/국수냄비/편수/전골/양수/곰솥/찜기,9900,9900,0
2018-06-01,521926119,C013040,청바지,꼼마제이 5부 데님 청 반바지 맘커플,18000,17800,-200
2018-06-01,586992548,C013040,청바지,캐주얼 7부 데님 팬츠_QADP05831BL/ 베네통키즈,89000,66750,-22250
2018-06-01,1178814794,C012060,여자내의,라떼 반바지(f2472) 라이트블루 /바지/반바지/청반바지/여성반바지/청바지,27800,27800,0
2018-06-01,961310772,A018040,아이스크림,하겐다즈 쿼트 1통 + 리치몬드 3개,19500,19500,0
2018-06-01,259510797,L012040,치약,죽염치약 시린고 / 잇몸고 치약 120gx5,14900,14900,0
2018-06-01,1254779224,C013020,티셔츠,(특가9600원) 맨투맨/후드티/후드집업/점퍼/빅사이즈,18900,18900,0
2018-06-01,632096106,I011010,TV,인증점 삼성 43형 LED TV UN43K5110BF 삼성직배,650000,509000,-141000
2018-06-01,1657489576,E041070,밀폐용기,전자레인지용기 집밥 20개세트/밥팩/밥보관용기/1인용,6900,6350,-550
2018-06-01,1892322050,E031120,믹서,(HIT) 신일산업 다용도 믹서기/미니믹서기/분쇄기,29100,28200,-900
2018-06-01,1043382767,I011030,사진기,정품 니콘 D7200 +AF-P 18-55mm VR/DSLR /사은품증정,954150,876900,-77250
2018-06-01,451919193,E031130,보온매트,한일무자계카페트매트 대청마루15mm 거실대형 분리난,211920,211920,0
2018-06-01,563847645,C012060,여자내의,(해외직배송)여름신상 여성 패션 퀄리티 와이드팬츠,42960,42960,0
2018-06-01,398338437,C011050,남자내의,[휴아이지옴므]HU 히든밴딩 10부 슬랙스 HUIZ_SL613,15900,15900,0
2018-06-01,1620698977,E061100,습기제거제,천연 습기제거제 3개 100%천연성분 2년사용 제습제,9600,9600,0
2018-06-01,345164675,A018080,설탕,백설 하얀 설탕 15kg,11480,11480,0
2018-06-01,580473950,C014010,아동복,캐릭터 여아 여름원피스 세일 신데렐라/캐리/엘사,11900,11900,0
2018-06-01,988991352,L012090,기초화장품,그린핑거마이키즈크림200ML,26000,26000,0
2018-06-01,1152723780,F011150,건강기능식품,국산 영양미숫가루 선식 식사대용 간식 검은콩 검은곡,10000,10000,0
2018-06-01,1385737864,A011160,빵,안흥찐빵마을 국산팥 수제 단호박찐빵 1.5kg 30개 손,30370,30370,0
2018-06-01,128155232,E031120,믹서,[SK매직] 다용도 인기 미니믹서기 9종,21900,21900,0
2018-06-01,747958317,C014020,유아복,여자아기패딩 베이비점퍼 여아겨울점퍼 여아롱패딩,28000,26800,-1200
2018-06-01,988991350,L012090,기초화장품,그린핑거 베이비 세라마이드 로션 180G,28900,28900,0
2018-06-01,1666516826,C012020,원피스,[플라스틱아일랜드]털방울 라글란 롱 코트 (PH4EC081)(하남점),109000,88430,-20570
2018-06-01,988991351,L012090,기초화장품,그린핑거 베이비 세라마이드 크림 150G,29900,29900,0
2018-06-01,441870381,A015020,식용유,(냉장)썬리취체다슬라이스치즈1800g(100매),27850,27850,0
2018-06-01,216302910,A022010,주스,매일 피크닉200ml*24팩,6400,6400,0
2018-06-01,1067453527,A019080,고추장,[CJ직배송] 해찬들 우리쌀로 만든 태양초 골드고추장 2kg + 약고추장500g,12900,12900,0
2018-06-01,1067453528,A019080,고추장,[CJ직배송] 해찬들 우리쌀로 만든 태양초매운고추장 2kg + 500g 추가증정,10980,10980,0
2018-06-01,1234801837,C013020,티셔츠,품질좋은 후드티 후드집업 후드 기모후드티 맨투맨,13900,13900,0
2018-06-01,2109867140,C012060,여자내의,빅사이즈 블랙 가죽 스키니 바지 청바지 여성 캐주얼,27920,27920,0
2018-06-01,299349601,E061040,부엌용세제,애경 비움 주방세제 리필 파우치 300ml x3개/7무첨가,8500,8500,0
2018-06-01,1417251530,I031040,생화,스톰/5200루멘 /3발 /5발/ 초강력 /헤드랜턴/,17800,15800,-2000
2018-06-01,12135872,F012010,종이기저귀,보솜이 액티브팬티 기저귀 4팩,33900,33900,0
2018-06-01,1294015564,A014020,분유,[베비언스] 산양 액상분유 1단계 180ml 20입,34900,34900,0
2018-06-01,350356561,L012110,색조화장품,[천연선크림]자외선차단제+썬젤+주름+미백+유아+순한,28000,19800,-8200
2018-06-01,1991698221,C011030,남자학생복,(SR)KHM763-764 남성빅사이즈체크주머니긴팔남방셔츠,63950,63950,0
2018-06-01,1067453526,A019080,고추장,[CJ직배송] 해찬들 우리쌀로 만든 태양초 골드고추장 2kg + 구수한집된장 1kg,12900,12900,0
2018-06-01,533336883,C013050,운동복,여름 추천/겨울 앞유리 자동차커버 lf yf nf 소나타,12000,10860,-1140
2018-06-01,1941040810,L012090,기초화장품,1+1 무료 마몽드 트리플멀티 클렌징크림 190ml,13000,13000,0
2018-06-01,1143431467,C013050,운동복,모비스 크루저 루프백 자동차캠핑용품 차량용캠핑용품,257730,234750,-22980
2018-06-01,1939734675,C011020,남자상의,[제스]XESS 2017 S/S 남성 데일리 프리미엄 울 스트레치 정장 수트 X7ASU1264_038,129000,110940,-18060
2018-06-01,845480498,A014020,분유,일동후디스산양하이키드골드700g1 캔기한19년6월이후,26000,26000,0
2018-06-01,703330642,E061010,세탁세제,애경 팍스프라임 10kg x 2개 스파크 슈퍼타이 비트,16900,16900,0
2018-06-01,281609365,L021030,가방,타거스 TSB786AP/TSB78601AP 15.6인치 노트북가방,50000,49000,-1000
2018-06-01,1854674120,A019030,생강,리얼편강 (국산 200gX2통) 선물세트,32790,29190,-3600
2018-06-01,208416776,E041070,밀폐용기,스텐/보존식/보존/보관/용기/위생/반찬통/학교/급식실,33000,33000,0
2018-06-01,1319491786,E061010,세탁세제,울샴푸 후레쉬 퍼플 라일락 1L용기+1.3L파우치x3개(사은품1개증정)/ 애경,12200,12200,0
2018-06-01,693795515,C011030,남자학생복,여름 7부 리넨 셔츠 남성 편안한 케쥬얼남방 40여종,16700,16700,0
2018-06-01,898605360,A017300,미역,풀무원 들기름 재래김 도시락김 (12봉),6990,6990,0
2018-06-01,674896446,C015030,넥타이,고급 100%실크 나염 넥타이/캐릭터 넥타이/명품스타일,15900,15900,0
2018-06-01,2024939040,E011010,장롱,[동서가구]LV 10자 장롱 7종택일 /옷장세트,597000,597000,0
2018-06-01,1027625677,A013140,북어채,하늘갓 황태채 황태실채 500g,15010,15010,0
2018-06-01,891505438,E021020,커튼,럭셔리한 린넨 면 디자인 거실커튼 창 안방 소창 커튼,34900,32110,-2790
2018-06-01,1034875858,C013010,점퍼,보니스팍스 캐시미어코트/구스조끼 5종택일,35000,29750,-5250
2018-06-01,441869391,A015020,식용유,(냉장)제이에멘탈퐁듀치즈1kg,26770,26770,0
2018-06-01,774027615,E011020,침대,우드브라더스/친환경원목침대/소나무3.5T통원목/평상,278500,278500,0
2018-06-01,486390872,F011130,홍삼,천제명 6년근 홍삼정(240G),86900,86900,0
2018-06-01,270127195,C012060,여자내의,[더미니][1color]임부-에어핏 7부팬츠/임부바지,20240,19640,-600
2018-06-01,839303468,F011150,건강기능식품,종합비타민 12개월분 멀티 비타민 종합 영양제 선물,29800,29800,0
2018-06-01,1038818668,F011130,홍삼,[정원삼] 침향환 (3.75g x 30환),39400,39400,0
2018-06-01,2034241204,A011040,보리쌀,산과들에 국산 볶음검은콩 수입 볶음서리태 300/800g,5900,5900,0
2018-06-01,717340959,F012050,의료측정기,예꼬맘/체온계/써모체커/비접촉식/2초측정/감염예방,33500,33500,0
2018-06-01,1894720897,C013020,티셔츠,[에고이스트]글리터 레터링 펄 티셔츠 EJ2ET320,49000,39200,-9800
2018-06-01,989046248,A019150,김치,CJ 비비고 묵은지 400G,5980,5980,0
2018-06-01,598545499,F012050,의료측정기,브라운 귀체온계 3종 택1(IRT-6030/IRT-6520/IR-6510),70000,70000,0
2018-06-01,1693612847,E061020,섬유유연제,다우니 초고농축 섬유유연제 1L x 6개/4종택1,22900,22900,0
2018-06-01,599990859,L021010,손목시계,패션시계/스포츠시계/알람시계/전자시계/군용시계/SD3,6000,6000,0
2018-06-01,1272547976,A012030,돼지고기,[도드람한돈] 생 삼겹살 구이용 500g,12900,11900,-1000
2018-06-01,739300217,I053020,스케치북,세르지오 마카용 스케치북 캔손 스프링 제본 A4 A5 B5,2600,2600,0
2018-06-01,1871911468,C013020,티셔츠,아동 유아 주니어 카라티/PK티/반팔티/긴팔티/단체티,7500,7500,0
2018-06-01,15239967,E031130,보온매트,한일의료기 인체감지 Iot 인공지능 알파큐 전기매트,138000,138000,0
2018-06-01,1556018215,A014030,치즈,남양 아기치즈 1/2/3단계 40+24매/체다치즈/슬라이스,19400,19400,0
2018-06-01,1079039522,C013010,점퍼,나인후드바람막이점퍼/후드집업/항공점퍼/간절기점퍼,8900,8900,0
2018-06-01,326956563,C013040,청바지,핏예술 밴딩청바지 밴딩팬츠 밴드바지 남자 조거팬츠,15800,15800,0
2018-06-01,423634288,A018080,설탕,핀란드/프랑스 자일리톨 1kgx2봉 스테비아 코코넛슈거,30800,30800,0
2018-06-01,1744467316,E011020,침대,특가[잉글랜더]루나/샤인/라이트/스텔라 LED 수납침대,142900,142900,0
2018-06-01,1117044310,L021020,장신구,매일 착용해도 질리지 않는 14k피어싱 7종 20%할인,55000,44000,-11000
2018-06-01,215639379,C013060,등산복,남성 여름 반팔 등산티셔츠 등산복 냉감티 작업복,9800,9800,0
2018-06-01,574160346,E031050,냉장고,LG전자 K332S11 김냉 스탠드형 초이스,1093470,1073470,-20000
2018-06-01,987978521,A011140,부침가루,필라델피아 치즈케익10조각 794G,23000,23000,0
2018-06-01,930197583,A017010,배추,두충 나무껍질 무독식품 약초 토종약용식물 볶음두충,6500,6500,0
2018-06-01,778371103,E011040,소파,국내제작 인조가죽소파 3인용쇼파 좌식쇼파 소파베드,218900,218900,0
2018-06-01,1304238343,C012040,여자학생복,요하넥스s 에어러스 블라우스 3종,69000,68000,-1000
2018-06-01,2064154662,C012060,여자내의,SK1091-모던 플레어 밴딩 미디스커트 플레어치마 데일,24080,24080,0
2018-06-01,439677814,E061040,부엌용세제,2660ml 피앤지 울트라 조이 고농축주방세제 퐁퐁,8180,8180,0
2018-06-01,345815638,L021030,가방,[리뽀]PLUME BASIC 레터 에코백 화이트(AZ036017) 6차예약[6/7 순차발송],39000,32760,-6240
2018-06-01,703582398,A014020,분유,액상분유 1단계 48입 2/3단계 40입,44900,44900,0
2018-06-01,1774628587,A013010,갈치,[여수고기]국내산 손질 갈치/2마리 450g/4마리 500g,7900,7900,0
2018-06-01,484029798,C012030,여자상의,제작원피스!우리만있어플라워패턴무지원피스,49900,49900,0
2018-06-01,2043920215,E011060,의자,스툴 로망스 책상 사무용 컴퓨터 중역 PC방의자,50900,45810,-5090
2018-06-01,570880588,C012060,여자내의,[22XX]버튼고방체크스커트/ 엔비룩,18900,15880,-3020
2018-06-01,1778708630,L021020,장신구,[바보사랑]925실버 5mm cubic 귀걸이,13900,13900,0
2018-06-01,1766417222,I011030,사진기,캐논 정품 EOS M100 + 15-45mm KIT 새상품 명품마을,529500,487050,-42450
2018-06-01,1778708631,L021020,장신구,[바보사랑]925실버 Luck Set 귀걸이,29900,29900,0
2018-06-01,1290711800,A017150,버섯,[(주)녹지푸드]무르지 않는 데침 고사리 1Kg×10개,46940,46940,0
2018-06-01,451148354,A019020,참깨,해정원 검정깨 1kg2개 깨 검정깨 해정원깨 해정원검정,43590,39240,-4350
2018-06-01,539135854,A013170,생선통조림,[동원] 마일드참치200g*10캔,23500,23500,0
2018-06-01,1552022132,E051030,디지털도어록,게이트맨 WB-200 디지털도어락 고양시 김포 파주당일,223000,188750,-34250
2018-06-01,1832335262,L021060,유모차,초슬림 기내반입 티크미니 휴대용 컴팩트 포켓 유모차,260000,260000,0
2018-06-01,1778708627,L021020,장신구,[바보사랑]925실버 Moon cubic 귀걸이,19900,19900,0
2018-06-01,1778708629,L021020,장신구,[바보사랑]925실버 4mm cubic 귀걸이,11900,11900,0
2018-06-01,1778708628,L021020,장신구,[바보사랑]925실버 3mm cubic 귀걸이,9900,9900,0
2018-06-01,1425340409,A022010,주스,더진한 청포도 농축액 1.5kg/ 웰파인,27000,26190,-810
2018-06-01,902524750,A011090,국수,오뚜기 진라면 40개/순한맛/매운맛/봉지라면/라면,20900,20900,0
2018-06-01,989022228,A019150,김치,초L)한끼 열무김치 80G,1100,1100,0
2018-06-01,1214023315,C012040,여자학생복,[대구백화점 I관] [나이스클랍]레더링루즈핏가디건(N182KSL004),191000,162350,-28650
2018-06-01,989022229,A019150,김치,초L)한끼 깍두기 80G,1100,1100,0
2018-06-01,1650279211,A018100,꿀,국내산 사양벌꿀 500g/1kg 토종꿀 잡화꿀 천연벌꿀,4990,4990,0
2018-06-01,1719599486,G011070,자전거,삼천리 하이브리드자전거 시애틀모던F,119000,107100,-11900
2018-06-01,1723114425,F012010,종이기저귀,[CLEARANCE SALE] 보솜이 천연코튼/소프트 기저귀,39800,19900,-19900
2018-06-01,814304179,A019050,간장,진간장 덕용 14L/금F3/양조간장/국간장/식초/15L/샘표,18900,18900,0
2018-06-01,1232668087,L021030,가방,[명품 에드하디] 14인치 15.6인치 노프북커버 정품 에드하디 노트북 파우치 직수입제,19900,19900,0
2018-06-01,387894344,A018070,파이,초코파이 1170g (30봉입)x2 /바나나/몽쉘/카스타드,17400,17400,0
2018-06-01,756854592,E011050,책상,비카 다용도 책상/이케아/컴퓨터책상/국민책상,25920,25920,0
2018-06-01,942967556,C012040,여자학생복,루즈핏 박스핏 박시핏 66 77 빅 사이즈 롱 셔츠 남방,22900,22900,0
2018-06-01,676637136,L012060,샴푸,[제이숲] 여신세트(실크케라틴샴푸+헤어팩트리트먼트),58800,58800,0
2018-06-01,2084037705,C012060,여자내의,디얼 스트라이프 오버핏 남방- 스트라이프남방 단가라,58100,49390,-8710
2018-06-01,899557873,A018030,껌,[롯데]롯데 자일리톨 리필 클래식 (100G+25G),4000,3290,-710
2018-06-01,1612127993,A016150,아몬드,생아몬드/슬라이스/가루1Kg/호두/호두분태1Kg-햇견과,13200,13200,0
2018-06-01,2083121716,C013010,점퍼,#NAME?,54700,48140,-6560
2018-06-01,1778708653,L021020,장신구,[바보사랑][액세서리키친] 925실버 Linear 클러치 2종택1,19900,19900,0
2018-06-01,2075864559,E011050,책상,[더젠] 레베카 400서랍 H형책상세트,159000,146280,-12720
2018-06-01,1778708655,L021020,장신구,[바보사랑]925실버 Gemstone Simple 목걸이-Moonstone,79000,79000,0
2018-06-01,1381501104,C011030,남자학생복,MCD-906 베이직 하찌 가디건 / 봄 가을 겨울,17000,17000,0
2018-06-01,1239083594,C012040,여자학생복,#NAME?,20680,20680,0
2018-06-01,1495217060,C013020,티셔츠,반폴라 스튜디오 티셔츠 긴팔목폴라 남아폴라티 어린,10850,10850,0
2018-06-01,2101881239,D031010,주택수선재료,[안새내]욕실박사/4L/옥상방수/지붕방수/모든방수재,24500,24500,0
2018-06-01,1947367664,C013010,점퍼,프리미엄 봄 여름 자켓 정장 콤비 마이 블레이져 남성,59500,59500,0
2018-06-01,1821055186,I012010,컴퓨터,LG전자 데스크탑 Z70EV-AR7P06 LG 컴퓨터 WIN10탑재,565970,549000,-16970
2018-06-01,1267080333,C014020,유아복,[트윈키즈] 마블 링거 티셔츠,15000,7500,-7500
2018-06-01,988002664,A018060,스낵과자,오리온 눈을감자 56G,1200,1200,0
2018-06-01,1778708661,L021020,장신구,[바보사랑]925실버 별자리 귀걸이 (12자리),19900,19900,0
2018-06-01,899557840,L012070,바디워시,아모레 해피바스 로즈에센스 바디워시 (500G),9990,3490,-6500
2018-06-01,1718333390,C013010,점퍼,[시보니] 밍크롱코트무스탕,93700,93700,0
2018-06-01,899557841,L012070,바디워시,아모레 해피바스 라벤더 에센스 바디워시 (500G),9900,3490,-6410
2018-06-01,954941200,A012020,수입쇠고기,E-미국산 냉장 돈목심 100G,1390,1000,-390
2018-06-01,928037446,C013050,운동복,망치스토리 7부 반바지 트레이닝 아동복 주니어의류,6900,6900,0
2018-06-01,1096046005,E031080,선풍기,테스_ 욕실히터 TESS-750H 3구+골드램프1개추가,47800,47800,0
2018-06-01,1991275393,E011020,침대,아메리카나베드 프리미엄 투 매트리스 킹침대,1199000,1199000,0
2018-06-01,1807467541,C012040,여자학생복,수지네 구제 블랙 베스트 여성 M 5-33,11790,11790,0
2018-06-01,2115477067,A011080,밀가루,구포국수310gX3p.선물세트.돌.답례품.소면.사은품,2600,2600,0
2018-06-01,1273411604,L021030,가방,타거스정품 CN515AP 15-15.6인치 노트북가방/슬림형/탑로딩케이스,49000,49000,0
2018-06-01,2009759211,A017150,버섯,머리딴 두절 콩나물 1Kg,4440,4440,0
2018-06-01,1899374493,C013010,점퍼,아디다스 롱 다운 파카 ( M64172 ),121480,121480,0
2018-06-01,445515995,C012020,원피스,핸드메이드 가디건 스타일 코트(Z174MSG519)/ 쥬크,179000,152150,-26850
2018-06-01,1011091624,L012110,색조화장품,해피바스 퍼펙트페이스멀티선50G 2입,14900,11400,-3500
2018-06-01,23573944,E011040,소파,최고급소파 12종-1인용/소파/인조가죽소파/레자소파,92900,92900,0
2018-06-01,409693423,I031040,생화,초경량 휴대용 등산의자/캠핑/미니/체어/낚시/소형,7000,5640,-1360
2018-06-01,1402777971,C012020,원피스,트랜디한원버튼체크재킷(N181MSF001)/ 나이스클랍,139000,125100,-13900
2018-06-01,418588632,E061030,전구,필립스 적외선 램프 100W 150W 250W 근적외선전구 ir,4500,4500,0
2018-06-01,734035969,G011070,자전거,스마트 스켈레톤 TFX / TFX H 크로몰리 픽시 반값세일,139000,139000,0
2018-06-01,545179947,C012060,여자내의,스타일 멜빵 데님팬츠-M1054 데님팬츠 와이드 힙합청바지 멜빵청바지 데님스커트,36160,32190,-3970
2018-06-01,830641368,C012040,여자학생복,플라워프린트타슬장식블라우스 JRBL326A/ 쥬시쥬디,39000,33150,-5850
2018-06-01,1071765402,C012060,여자내의,여엠보7부 시원한 지지미원단 여성7부 엠보파자마,5710,5090,-620
2018-06-01,141205128,E041020,컵,리자인 무광 커피잔 60종 선택형 커피잔세트 찻잔,2800,2660,-140
2018-06-01,21088076,A014030,치즈,치즈(파마산 삼조 동원 227g)X12 가루 분말 파스타,52140,52140,0
2018-06-01,118854905,C013020,티셔츠,헤지스남성 OUTS7BH31N2 트임 면혼방 반팔카라티셔츠,58700,58700,0
2018-06-01,451946939,C013010,점퍼,노딕 패딩 점퍼(블랙 누빔안감) 패딩 겨울점퍼 노카라,17300,17300,0
2018-06-01,243673313,C013040,청바지,[게스키즈] G76KDP311게스키즈블루 밴딩진,76000,53200,-22800
2018-06-01,444505917,C013050,운동복,차량안전삼각대_450x400mm_비상시사용_(1EA) 차량안전,14870,13560,-1310
2018-06-01,891639700,A022050,탄산음료,데미소다 애플 250ml x 30캔 레몬/오렌지/복숭아,12900,12900,0
2018-06-01,351366447,C012020,원피스,빅사이즈/아이스/포켓/가디건 아이스포켓가디건 빅사,37430,37430,0
2018-06-01,1250169165,C012040,여자학생복,[보브(여성의류)] 2001중계아울렛]등판자수가디건(7116350931),379000,152000,-227000
2018-06-01,791000148,I053030,복사용지,HP A4 복사용지(A4용지) 75g 2500매 2BOX//,35930,30900,-5030
2018-06-01,1283064666,L012090,기초화장품,설화수 에센셜 립케어 15g /주름개선 기능성/선명하고 혈색있는 입술 한방 립케어 /,28910,28910,0
2018-06-01,2047069175,C015040,장갑,아놀드파마_APGW-BY1219(가죽장갑_여성용) 여성겨울장,27150,27150,0
2018-06-01,1277372656,A022030,생수,초정탄산수 500ML X 20개,13800,13800,0
2018-06-01,1748437552,A015010,참기름,70년 전통 최씨네참기름-국산참기름(실속형/350ml),18000,18000,0
2018-06-01,647055624,A019170,냉동식품,취영루 물만두4봉+교자2봉 골라담기,19900,19900,0
2018-06-01,1475987213,E041020,컵,el 커피잔세트 찻잔세트/다기세트/도자기 커피잔/찻잔,37900,37900,0
2018-06-01,1636885676,A013030,조기,법성포/영광/굴비/설/추석/선물세트/조기/말린/밥도둑,91900,91900,0
2018-06-01,1737893221,C013010,점퍼,기브배색점퍼/여아봄점퍼/유행/후드바람막이/아동점퍼,22900,17900,-5000
2018-06-01,2000447097,C021040,실내화,키높이 하이탑 스니커즈 운동화 통굽 슬립온 웨지힐,22700,22700,0
2018-06-01,633021194,C012060,여자내의,[피그먼트] a톰보이 점프수트,30000,26100,-3900
2018-06-01,989132774,A016150,아몬드,초이스엘 코코넛칩 90G,2490,2490,0
2018-06-01,1264106240,C012040,여자학생복,오픈루즈털조끼 IR1712 토끼털조끼 토끼퍼조끼 여성베,109080,109080,0
2018-06-01,594045741,C013040,청바지,[보리보리/클랜씨]클랜씨 클랜 도트 데님바지 C724S225-NY,23400,14040,-9360
2018-06-01,645708519,A017020,상추,쌈채소 6-9종 1kg 내외 모듬쌈채소,15000,15000,0
2018-06-01,2054329313,A013170,생선통조림,동원마일드참치 210g x 10캔 /사조참치/동원참치/참치,21900,21900,0
2018-06-01,1934561070,C012040,여자학생복,빅사이즈 DEB0031R 굵은 브이넥 조끼 801 빅사이즈여,38800,38800,0
2018-06-01,551330710,A019180,즉석식품,탕수육 모음전 1kg/탕수육소스/돼지고기/닭고기/,5500,5500,0
2018-06-01,5528093,C015020,모자,무료배송 빅사이즈 큰모자 프로야구모자 빈티지 패션,11900,11900,0
2018-06-01,169683879,L021010,손목시계,남자손목시계 메탈시계 군인시계 전자손목시계 모음전,15000,9800,-5200
2018-06-01,1093247599,E031080,선풍기,한솔일렉트로닉스_라디에이터 HSR-3000GH 15핀,92000,92000,0
2018-06-01,450307538,A019030,생강,은성 인하생강 1kg2개 생강 냉동생강 냉동식품 양념,28630,25770,-2860
2018-06-01,2127791455,C013040,청바지,균일가1+1 데일리 티셔츠/무지티/기본티/레터링티,15900,15900,0
2018-06-01,2141743080,A017010,배추,(yk) 절임배추 20kg/김치/배추/절임/김장,52870,52870,0
2018-06-01,416976215,E011050,책상,MT101W-S 높이조절 워크스테이션 화이트 높이조절책,496940,496940,0
2018-06-01,894502563,C013010,점퍼,[인터페이스]바람막이 야상 블루종점퍼 후드내장 멋쟁,37700,37700,0
2018-06-01,1760684801,E011030,거실장,거실장 5단 3단 서랍장 화장대 세트 [티비다이 tv장],144900,34900,-110000
2018-06-01,896668263,A012030,돼지고기,E-국내산 냉장 돈 뒷다리 다짐육용 100G,1090,1090,0
2018-06-01,896668264,A012030,돼지고기,E-국내산 냉장 돈 뒷다리 보쌈용 100G,1090,690,-400
2018-06-01,1384497647,C013040,청바지,공용_허리밴딩5부연청워싱데님팬츠_A182B3146A/ 에어워크주니어,39900,35910,-3990
2018-06-01,81393541,E061010,세탁세제,비트 4.4kg 바스켓 세탁 세제,13800,13800,0
2018-06-01,416049899,C011030,남자학생복,슬림 카라포인트 퍼피패턴 블루스카이 셔츠 패션셔츠,20390,20390,0
2018-06-01,671151070,A012010,국산쇠고기,축협 한우 1등급 갈비선물세트 3.2kg 한우갈비 찜갈비,270000,267300,-2700
2018-06-01,493153633,A013170,생선통조림,동원마일드참치100g x12/참치캔/고등어 꽁치캔/통조림,16900,16900,0
2018-06-01,1299877292,C021020,구두,2670 3.0cm 가죽 토오픈로우힐 수제화,104850,104850,0
2018-06-01,2100112899,A012060,햄및베이컨,동원 리챔 120g 10개 무료배송,13900,13900,0
2018-06-01,1672765983,F012020,생리대,(순면100%) 순수한면 생리대 x 4팩+에코백,19900,9900,-10000
2018-06-01,2083084299,C012030,여자상의,발리 V넥 프릴 원피스- 롱원피스 프릴원피스 V넥원피,59000,51920,-7080
2018-06-01,2118799373,F012010,종이기저귀,하기스 매직핏 기저귀 밴드형 1/2/3/4/5단계 3팩,48900,48900,0
2018-06-01,2025709481,C013050,운동복,[무스트]30수반팔/쿨론반팔/레이어드나시 반바지세트,13900,13900,0
2018-06-01,1024133286,C012040,여자학생복,브룩스브라더스 구제매니아 여 S 브이넥 램스 울 니트,20000,19800,-200
2018-06-01,1653168706,A022010,주스,음료수 캔음료 탄산 과즙 레쓰비 미닛메이드 주스,5210,4900,-310
2018-06-01,904400163,C013050,운동복,차량용컵홀더 거치대 자동차컵홀더 스마트폰거치대,4000,2900,-1100
2018-06-01,1287781366,C021020,구두,305남성캉캉구두 발목구두 정장구두 끈구두 신사구두,102770,102770,0
2018-06-01,1399818821,I053020,스케치북,스프링 컬러테라피 켈리그라피 그림그리기,5000,4950,-50
2018-06-01,342157842,G011070,자전거,700C 레브 7 자전거 커플하이브리드 하이브리드자전거,267470,238700,-28770
2018-06-01,243227319,A015020,식용유,CJ제일제당 포도씨유 900ml x 4개,17900,17900,0
2018-06-01,1909402003,I012060,저장장치,스카이디지탈 NKEYBOARD NKEY-R3 RGB 기계식키보드,132000,113400,-18600
2018-06-01,1010404540,E061040,부엌용세제,브레프파워곰팡이용500ML,5900,3540,-2360
2018-06-01,1010404541,E061040,부엌용세제,브레프파워욕실용500ML,5900,3540,-2360
2018-06-01,16276893,I031010,장난감,굿베이비 전동오토바이(21352),173130,173130,0
2018-06-01,1010404544,E061060,살충제,에프킬라스마트리퀴드본체+리필2입,10900,10900,0
2018-06-01,567020300,C013020,티셔츠,단가라레이스티(MYD_1605) 빅사이즈여성티셔츠 스트라,18820,18820,0
2018-06-01,1010404543,E061060,살충제,에프킬라스마트리퀴드(무향)본체+리필3입,16900,13520,-3380
2018-06-01,1398576166,I031040,생화,릴낚시대/다용도릴대/원투낚시대/바다낚시대/스피닝릴,10800,10800,0
2018-06-01,1294052393,A021020,차,가당전지밀 (서강 1K) X12,89660,79800,-9860
2018-06-01,1117635322,C013010,점퍼,[구김스]구김스 927_플라이 슈트 MA-1 항공점퍼 (G15WMPDA01),189000,179550,-9450
2018-06-01,896668241,A012030,돼지고기,E-국내산 냉장 돈 뒷다리 불고기용 100G,1090,690,-400
2018-06-01,1461150501,C013050,운동복,[OMT] OMT 차량용 멀티 3구 컵홀더 OCA-3HOLDER 핸드폰수납,4900,4500,-400
2018-06-01,267008419,C012060,여자내의,편안하고 시원한 고품질 냉감통바지 SD 5668,12200,12200,0
2018-06-01,896668240,A012030,돼지고기,E-국내산 냉장 돈 뒷다리 찌개용 100G,1090,690,-400
2018-06-01,1656923340,E031090,공기청정기,위닉스 타워 공기청정기 ATQE400-HWK,229000,229000,0
2018-06-01,1344814210,C013040,청바지,[모다아울렛][리바이스][LEVIS] 리바이스 여성 311 쉐이핑 스키니_(19626-0056),49000,46550,-2450
2018-06-01,1426883764,I031010,장난감,Step2 이인용 밴 지붕카 장난감 자동차장난감 지붕차,257040,251900,-5140
2018-06-01,2034108414,C011020,남자상의,봄여름 마이/자켓/콤비/남자/최고급소제/린넨/95-110,62800,62800,0
2018-06-01,1754058299,A013020,명태,[마산어시장e바다몰]냉동명태포/슬라이스 700g/제수용,4600,4600,0
2018-06-01,1964459813,I031040,생화,정글의법칙 카르닉PRO 무릎보호대 관절아 손목보호대,7900,7080,-820
2018-06-01,1857103625,A022050,탄산음료,닥터페퍼 355mlX24캔/캔음료/탄산음료/콜라/음료수,13000,13000,0
2018-06-01,2077509483,A017090,열무,뻥튀기무말랭이 300g 무말랭이차 뻥튀기무말랭이차,10000,10000,0
2018-06-01,317601580,E011020,침대,베스트리빙 비요크 원목 싱글침대(S)/오크,103000,103000,0
2018-06-01,1761981471,A017120,고구마,[홈플러스][행사상품]햇감자_1.2KG 봉,5490,5220,-270
2018-06-01,1010404537,E061080,키친타월,[유한킴벌리]유한킴벌리)스카트항균클리어핑크행주타올45매*2롤,8200,8200,0
2018-06-01,1969513896,C013010,점퍼,여름용 리빌모아 정품 남성 콤비 정장자켓 40종,58900,58900,0
2018-06-01,21091642,E031070,에어컨,((전기비~걱정끝))신지남~공업용/대형선풍기SGN-IF202,84900,84900,0
2018-06-01,1162578200,E061080,키친타월,4롤/키친타올/주방타올/행주타올/빨아쓰는타올/스카트,5900,5900,0
2018-06-01,896668232,A012030,돼지고기,E-국내산 냉장 돈 등심 돈까스용 100G,1790,1790,0
2018-06-01,1464964627,A011180,파스타면,요뽀끼 매콤달콤떡뽁이 140g외 7종,1850,1850,0
2018-06-01,1775013538,C013050,운동복,그리니치 요가복팬츠 스포츠레깅스 빅사이즈 gx071p,9900,6900,-3000
2018-06-01,1257548868,A013140,북어채,대관령 황태명태껍질 황태머리 북어머리 황태뼈,5500,5500,0
2018-06-01,1409218097,A014030,치즈,네츄럴푸드 모짜렐라치즈 1kg/자연치즈99%,8500,8500,0
2018-06-01,1964846658,A021010,커피,[당일출고/무료배송]카누200T+랜덤사은품+랜덤텀블러,34900,34900,0
2018-06-01,1787614372,C011050,남자내의,여름신상/마바지/린넨바지/밴딩/밴딩팬츠/남자/남성,17800,17800,0
2018-06-01,896668239,A012030,돼지고기,E-국내산 냉장 돈 등갈비(구이용) 100G,2990,1990,-1000
2018-06-01,33090012,I031040,생화,하야부사 카본스피닝릴/루어릴/선상릴/민물릴/낚시릴,44000,40480,-3520
2018-06-01,896668236,A012030,돼지고기,E-국내산냉장돈등심 다짐육용 100G,1790,1790,0
2018-06-01,2077970201,A018040,아이스크림,x DIA FOOD 바닐라 아몬드 아이스크림 DIY 쿠킹박스,23000,20000,-3000
2018-06-01,515423039,A012060,햄및베이컨,냉동 아닌 냉장! 동서 오스카마이어 베이컨 453g 3개,19900,19900,0
2018-06-01,2057519920,A012030,돼지고기,목삼겹 / 부드러운 목살 500g /개별진공포장/푸주,3900,3900,0
2018-06-01,2069335007,C011030,남자학생복,[올젠] OLZEN 남성 미니 깅엄체크 반소매 셔츠 남방 ZRY2WC1303 BL,30000,24000,-6000
2018-06-01,985270261,A019180,즉석식품,선비찬 가마솥 즉석국15종 육개장 된장 김치찌개 국류,2290,2290,0
2018-06-01,721275242,E041050,냄비,네오플램 꼬밀 이유식 조리도구세트 7종,39700,39700,0
2018-06-01,1414714781,A013070,굴,대게 2kg 선도특A급 스노우크랩,74900,74900,0
2018-06-01,2070066862,C012020,원피스,빅사이즈/이지/카라/롱/조끼 / 참고 미시옷 임부복 큰,54300,46160,-8140
2018-06-01,41805671,C013050,운동복,3M 샌딩 스폰지 페파 20장 2600 2601 2602 2604 2606/,53670,53670,0
2018-06-01,1397302445,A013160,맛살,(냉장)한성통통맛살H(1kg)x5개,37580,37580,0
2018-06-01,1823393855,E011040,소파,[잉글랜더]머스 수납 소파/서랍 소파/쇼파/쿠션포함,86900,86900,0
2018-06-01,975161837,C013050,운동복,뉴코란도-미르웨이 후사경/4WD/RV용품/사각지대/후진주차/현대/기아/대우/쌍용,27000,24600,-2400
2018-06-01,20598160,C021020,구두,[금강제화] 리갈 모던 플레인 더비 MMX5500FG17(본점),196200,171290,-24910
2018-06-01,759488934,F012050,의료측정기,그린닥터 혈당측정기+시험지100+멸균침110+솜100,41930,39000,-2930
2018-06-01,1170667151,C011050,남자내의,빅사이즈 바지 크롭 9부 면바지 DG - 빅사이즈 바지 9,72180,64250,-7930
2018-06-01,901250452,F012050,의료측정기,오토첵 귀체온계 TS-42 노필터체온계+사은품2종 _~,35000,35000,0
2018-06-01,121731320,E011030,거실장,전면형 책상세트 1600 (배송),159000,159000,0
2018-06-01,1154176399,C011050,남자내의,남자 롱라인 9부 바지/슬랙스 면바지 10부 남성,24800,19800,-5000
2018-06-01,1309380764,A022030,생수,커클랜드 풀무원 먹는 샘물 2L x 6병 무료배송 /생수,4890,4890,0
2018-06-01,1010318053,L012070,바디워시,해피바스 클렌져(촉촉),1990,1990,0
2018-06-01,1366598475,A017300,미역,지주식김 200장 /돌김/파래김/김밥김/곱창김/재래김,18000,18000,0
2018-06-01,212765447,C012040,여자학생복,[티탁]뷔스티에/나시/조끼/티셔츠/빅사이즈,16900,12900,-4000
2018-06-01,895622482,A017020,상추,양배추(통),3990,3990,0
2018-06-01,367060941,C015040,장갑,밍크 방울 모직 장갑 퍼장갑 방울장갑 모직장갑 캐주,20590,20590,0
2018-06-01,898630381,A013150,어묵,대림 국탕용종합어묵 300G*2입기획,4480,3590,-890
2018-06-01,961562621,E061060,살충제,플루건 살균기 에코하이진후레쉬 오레 포레 2L 리필용,47000,47000,0
2018-06-01,410888117,C012020,원피스,[대구백화점 I관] [SOUP](기존가:189 000원)테일러루즈핏자켓(SU5JK03A),129000,109650,-19350
2018-06-01,1387551117,C013010,점퍼,AG 후드 집업점퍼 오프화이트 오픈 CC 집업잠바 후드,49050,49050,0
2018-06-01,956552547,G022020,자동차타이어,[타이어플러스]피렐리 피제로 올시즌 245/45R19,330000,280500,-49500
2018-06-01,386424440,E021020,커튼,롤스크린 그림 일반_1420,31310,31310,0
2018-06-01,1000730813,F012010,종이기저귀,LG 토디앙 핑크퐁 밴드/팬티기저귀 7팩,74900,74900,0
2018-06-01,1706178214,E031050,냉장고,[삼성전자] 인증점 삼성 스탠드형 김치 냉장고 RQ28M6102S8,1027900,1027900,0
2018-06-01,400116802,A011170,떡,우리 쌀떡국 칠갑 1kg X 10,48020,48020,0
2018-06-01,189940913,L021030,가방,[메트로시티(metrocity)]크로스 겸 숄더백 M63MQ272Z(본점),338000,285240,-52760
2018-06-01,779224390,E011040,소파,모던프리미엄 2인용 3인용 쇼파/의자/csp1005/1006,65800,65800,0
2018-06-01,121731318,E011030,거실장,4단 600책장 (배송),69000,69000,0
2018-06-01,896668205,A012030,돼지고기,E-국내산 냉장 돈갈비 찜용 100G,1590,1193,-397
2018-06-01,121731317,E011030,거실장,스마트 책상 1200 (배송),45000,45000,0
2018-06-01,896668207,A012030,돼지고기,E-국내산 냉장 돈등심(카레용) 100G,1790,1790,0
2018-06-01,1851943276,C013020,티셔츠,[패션24시30%쿠폰]루즈핏 반팔티 롱 면티 박시 티셔츠,9700,9700,0
2018-06-01,666433246,E021010,침구,파크론 브리즈쿠션매트 키즈매트 120/사은품증정,49000,45080,-3920
2018-06-01,896668201,A012030,돼지고기,E-국내산 냉장 돈 앞다리 불고기용 100G,1590,1190,-400
2018-06-01,896668202,A012010,국산쇠고기,E-한우 1+등급 사태 국거리용 100G,6500,6500,0
2018-06-01,896668203,A012010,국산쇠고기,E-한우 1등급 사태 국거리용 100G,6500,2992,-3508
2018-06-01,121731315,E011030,거실장,스마트 이동식4단수납장 (배송),45000,45000,0
2018-06-01,198594947,C012040,여자학생복,44~99/국산 롱 셔츠 여자남방 체크남방 청남방 사은품,15800,15800,0
2018-06-01,1978057710,C013040,청바지,(해외직배송)봄신상 여아 패션 멜빵바지 청바지,69390,69390,0
2018-06-01,1244500435,C013010,점퍼,[모라도](M.MORADO) 슬리브 네트 후드 점퍼 [MFM1JP400화이트],60000,57000,-3000
2018-06-01,896668209,A012030,돼지고기,E-국내산냉장돈등심 잡채용 100G,1790,1790,0
2018-06-01,798944773,A011050,콩,후디즈 칵테일 피넛 1.19kg/땅콩/맥주안주/간식/견과,10390,10390,0
2018-06-01,1860765008,F012020,생리대,16년신상 좋은느낌 보너스팩 /좋은순면/화이트/생리대,9500,9500,0
2018-06-01,120987627,E031130,보온매트,프로방스 피치스킨 전기요 (대형) 135X180CM,56900,56900,0
2018-06-01,120987628,E031130,보온매트,프로방스 피치스킨 전기요 (중형) 110X180CM,51900,51900,0
2018-06-01,650149367,F012050,의료측정기,녹십자 CF155F 혈압계 혈압측정기+사은품3종,45000,45000,0
2018-06-01,1768575844,E031030,전자레인지,[LG전자] LG전자 MW22CD 인버터 전자레인지 22L LG공식(주)대명,136000,124000,-12000
2018-06-01,120987625,E031130,보온매트,한일의료기 한화 그림 프리미엄 카페트 매트 좌우분리형(183x230cm),178000,178000,0
2018-06-01,1823598565,F012050,의료측정기,케어센스2플러스 혈당측정기 시험지60장+침210+솜100,21550,21550,0
2018-06-01,120987629,E031130,보온매트,프로방스 황토 전기요(TC)(중형) 110X180CM,62000,62000,0
2018-06-01,494598687,C012060,여자내의,(더틸버리) 미니 데님 스커트 TI4M0SK52/ 더틸버리,47200,42480,-4720
2018-06-01,410891742,C012060,여자내의,[나인(NAIN)](SK-2868)셋업 언발란스 페플럼 니트 스커트(센텀시티점),49000,45160,-3840
2018-06-01,427291505,E041060,수저,국산 고급 수저세트 2인 5인 10인 / 쇼핑천국,10000,9900,-100
2018-06-01,2008098075,C012040,여자학생복,여성티 여성용면티 민소매 끈나시 기본나시 여학생티,3800,3800,0
2018-06-01,1349253202,A011010,쌀,2017년 농협햅쌀 섬진강메뚜기쌀10kg/신동진쌀/쌀10kg,27900,27900,0
2018-06-01,1410044462,E021010,침구,[이브수] 순면40수 먼지없는 이불 / 베개세트,39410,39410,0
2018-06-01,165879250,C015040,장갑,칼마노 오치드 긴장갑 (시원한 스포츠 쿨장갑) 자전거,13170,12000,-1170
2018-06-01,139060704,I031040,생화,시즌특가 1+1 카릭스 LED 후레쉬 라이트 XPL V6 L2,16000,16000,0
2018-06-01,1507079079,A013070,굴,[은하수산] 은하수산 항공직송 살아있는 랍스타 450g~550g 내외,23500,23500,0
2018-06-01,242360151,C015030,넥타이,(색상 : 핑크골드) BTIE_062 파스텔 유광 보,12740,12740,0
2018-06-01,1143103418,C013020,티셔츠,CBR/기능성쿨론/민소매후드/이중티/4XL/빅사이즈,11000,9900,-1100
2018-06-01,741596850,C013050,운동복,CDYABMCN02 첨이첨이 쿨 남유아 스포츠 실내복 세트,24000,24000,0
2018-06-01,120987623,E031130,보온매트,한일의료기 쟈가드 목련 전기매트 1인용,64000,64000,0
2018-06-01,232252402,A018020,사탕,미니멘토스벌크 2.5kg(약250입) 리필 간식 대용량사탕,23500,23500,0
2018-06-01,120987624,E031130,보온매트,한일의료기 마루격자 카페트 매트 좌우분리형(183x230cm),198000,198000,0
2018-06-01,1126373574,E021020,커튼,/벌집블라인드 화이트 호프발스 60x155 cm/ 롤스크린,41100,36580,-4520
2018-06-01,120987621,E031130,보온매트,한일의료기 악어장미 투톤매트 1인용,168000,168000,0
2018-06-01,1315939149,C014010,아동복,아동 슈프림 보드티 아동복,9000,9000,0
2018-06-01,120987622,E031130,보온매트,한일의료기 쟈가드 목련 전기매트 2인용,74000,74000,0
2018-06-01,820940213,C013020,티셔츠,무지티 라운드/브이넥/빅사이즈 박스티 반팔티 쁘니걸,15900,12900,-3000
2018-06-01,1295593204,C013040,청바지,[CKJ]남여 인기 데님팬츠 5종택1(4ASAJ24외4종),71640,60900,-10740
2018-06-01,948331735,A013050,오징어,자연산 골뱅이캔(롯데 140g)X4 can 골뱅이캔 깡통 식,18320,18320,0
2018-06-01,1716239539,L012040,치약,페리오 뉴 후레쉬 치약 150g x48개/충치케어/대용량,23900,23900,0
2018-06-01,573888940,I031040,생화,맥스펌프 플러스 캠핑용에어펌프 충전식 공기주입,32220,32220,0
2018-06-01,1315238067,L012060,샴푸,[초특가]려 함빛모 려샴푸 180mlx10개/트리트먼트,11900,11900,0
2018-06-01,628457430,C012020,원피스,말표구두약 이코노 흑색 40g,1980,1980,0
2018-06-01,1089667090,C013050,운동복,(초특가6900원)트레이닝 바지/반바지/요가복/빅사이즈,9900,9900,0
2018-06-01,1040939164,A019160,밑반찬,(전남오픈마켓/삼덕수산)갯푸른 즉석 매생이떡국 6개,14900,14900,0
2018-06-01,738400740,A022030,생수,[6월 1일이후 순차발송예정][무료배송] 스파클 생수 2리터×6병(4팩) - 총24병[예약상,12960,12450,-510
2018-06-01,2066887912,A012060,햄및베이컨,사조오양 부대찌개 모듬햄 1kg,8500,8500,0
2018-06-01,467783754,C013020,티셔츠,땡땡동그라미 맨투맨티 여자티 라운드넥티 여성티 패,36160,36160,0
2018-06-01,454471953,I053010,공책,신학기 과목노트(한문)(10개입)-랜덤 학교노트 한자공,11440,11440,0
2018-06-01,994662821,E061020,섬유유연제,[다우니]퍼퓸 고농축 섬유유연제1Lx3개,13900,13900,0
2018-06-01,358887616,A022020,두유,베지밀 64팩 A B 에이스 검은콩고칼슘 애플망고 두유,24900,24900,0
2018-06-01,268393644,C012020,원피스,[쉬즈미스][쉬즈미스] 펄 버튼 스트라이프 코튼 셔츠_SWWSTI21060_BL,69000,65550,-3450
2018-06-01,1279897101,C015020,모자,남녀공용 오리지널 메쉬캡 LA다저스 32CP74711-07U/ 엠엘비,29000,24650,-4350
2018-06-01,1010318015,A017070,부추,[청년]친환경 깻잎(30장),1290,1290,0
2018-06-01,268393642,C012020,원피스,[쉬즈미스][쉬즈미스] 펄 버튼 스트라이프 코튼 셔츠_SWWSTI21060_GN,69000,65550,-3450
2018-06-01,1010318018,A017070,부추,[청년]친환경 청상추(120G/봉),1790,1790,0
2018-06-01,1135545211,C013010,점퍼,꽃잎자수집업/시스루집업/레이스집업/간절기집업,8900,8900,0
2018-06-01,1653203478,A018010,초콜릿,한국마즈 초코바 골라담기/스니커즈/트윅스/엠앤엠즈,980,980,0
2018-06-01,1318899174,L021020,장신구,트윈 크로스 롱 목걸이 더블크로스목걸이 드롭목걸이,24080,24080,0
2018-06-01,1010321709,E061020,섬유유연제,테크베이킹구연산 리필기획2Lx2(일반),15650,12500,-3150
2018-06-01,555937459,C012040,여자학생복,[쉬즈미스]포켓 포인트 롱 가디건 (SSKCDH21030)(의정부점),30000,24230,-5770
2018-06-01,547848525,E061080,키친타월,코디 기름먹는 키친타올 4롤 4팩(16롤)/화장지/휴지,12900,12900,0
2018-06-01,1026652610,E061040,부엌용세제,LG생활건강 센스하이퐁1KG/2KG/12KG/럭키락스,14900,14900,0
2018-06-01,547848522,E061080,키친타월,[코디] 무표백 안심 키친타올 140매 4롤x3팩/화장지,10200,10200,0
2018-06-01,462972966,C012060,여자내의,#NAME?,28200,27360,-840
2018-06-01,998510617,A022040,기능성음료,파워오투 500mlx24펫 스포츠음료/이온음료/탄산음료,29500,29500,0
2018-06-01,1883622794,C011050,남자내의,푸마 트레이닝 팬츠 ( 65382437 ),69450,59040,-10410
2018-06-01,1843129536,A014030,치즈,코리원/썬리취 모짜렐라 네츄럴믹스 치즈 2.5kg/8URK,19900,19900,0
2018-06-01,510622036,F012010,종이기저귀,하기스 보송보송 드라이 밴드 기저귀 2∼5단계 3팩구성,36900,36900,0
2018-06-01,416050866,C015040,장갑,란체티 삼각퍼헤리 여성 순모장갑 TL-6503 모직장갑,27850,27850,0
2018-06-01,510622035,F012010,종이기저귀,하기스 보송팬티 드라이 기저귀 4∼6단계 4팩구성,34900,34900,0
2018-06-01,1010321711,E061020,섬유유연제,테크베이킹구연산 리필기획2Lx2(드럼),15650,12500,-3150
2018-06-01,503670998,C013010,점퍼,여성 밑단 셔링 노카라 루즈핏 점퍼(TUMAE2114)/ 비키,189000,170100,-18900
2018-06-01,138976233,A022010,주스,매실 농축액 원액 업소용 1.5L 매실액 액기스 매실청,12200,11840,-360
2018-06-01,216857687,A017010,배추,자연미가 배추우거지 1kg/냉장진공포장 고랭지농특산,4400,3960,-440
2018-06-01,310444531,I031010,장난감,[핫트랙스] 블루 아즈텍 - 마이크로킥보드공식_스쿠터_스프라이트 패턴 3종,161820,161820,0
2018-06-01,1385294991,C013020,티셔츠,[에디션 앤드지(EDITION ANDZ)]반팔 카라 티셔츠 6종 택1 (BEX2TT1616외)(강남점),31500,31500,0
2018-06-01,1428925158,C013040,청바지,1+1이벤트 남자청바지밴딩청바지빅사이즈/DF1000/1100,14900,14900,0
2018-06-01,1265033608,C012040,여자학생복,밍크털오픈조끼 BR1712 조끼 밍크털조끼 퍼조끼 털조,135990,135990,0
2018-06-01,924767797,C012040,여자학생복,[세인트마리]보들보들 기본 가디건실크레이온세트데일리기본,37300,33570,-3730
2018-06-01,1579044763,E031080,선풍기,(MIDFUJIKA 공기청정 온풍기히터 FU-408(3.5kw) 가정,702800,625500,-77300
2018-06-01,1702438687,A021010,커피,[메가마트] 동서 맥심 부드러운 모카 블랙 2.7g*100개,8900,8550,-350
2018-06-01,768551140,C013050,운동복,블랙앤데커 광택기 KP600/차량 광택/가구 광택/다목적,46500,42780,-3720
2018-06-01,240823825,A018060,스낵과자,추억과자 호박꿀쫀디기 호박꿀5봉 쫀디기 어포 호박꿀,6500,6500,0
2018-06-01,2046060325,F011150,건강기능식품,튼튼닷컴 종합비타민미네랄 (총12개월분) 비타 영양제,26900,26900,0
2018-06-01,2011325110,C011030,남자학생복,[올젠] OLZEN 남성 멀티 칼라 체크 반소매 셔츠 남방 ZRY2WC1306,30000,24000,-6000
2018-06-01,1456863755,C013010,점퍼,아도라블/나이키/앞.뒤 양면 잠바/55,21900,21900,0
2018-06-01,1245524553,L021050,우산,조아몰/오토바이전용우의/상하/코트우의/판쵸/우의/비옷/우비/바람막이/장화/우산/행사,33400,33400,0
2018-06-01,603151830,A022010,주스,참다음 매실 1.5L,6000,6000,0
2018-06-01,423766132,I031040,생화,다용도 멀티 야전삽 밀리터리 접이식 캠핑삽 모음,15500,14260,-1240
2018-06-01,2088198002,E031130,보온매트,2018년형 일월 카페트매트/온수매트/전기장판/요/거실,111000,97900,-13100
2018-06-01,414256108,A022010,주스,코카콜라 미닛메이드오리지널 포도100 1.8L,7440,7440,0
2018-06-01,59327910,E021010,침구,아동침구/쥬니어침구/이불세트 (패딩이불+베개커버),49000,49000,0
2018-06-01,1139035837,C012060,여자내의,데일리먼데이 Clean white cotton pants/팬츠/ 데일리먼데이,29900,23920,-5980
2018-06-01,635549762,C013050,운동복,[S5321ZFT01] 데상트 트레이닝복 집업 져지 [민트+남],139000,139000,0
2018-06-01,501946090,C013050,운동복,에탄올워셔액 친환경워셔액 12개1set 6개1set 워셔액,13900,13900,0
2018-06-01,121745909,F012020,생리대,유기농본 순면본 생리대 세트 오버나이트 팬티라이너,9900,9900,0
2018-06-01,2147145517,A011080,밀가루,(오뚜기) 오늘출발 [대용량] 옛날 국수 10kg 소면,20900,20900,0
2018-06-01,1176828699,E061100,습기제거제,순수크린 제습제 520ml x 24개 편백오일 제습제,15900,15900,0
2018-06-01,2135172951,C013050,운동복,코란도스포츠 리무진 콘솔박스 팔걸이 쿠션 차량용쿠,57440,51800,-5640
2018-06-01,1065094309,F012010,종이기저귀,국내/빠른배송) 미국산 팸퍼스 스와들러 N단계~6단계,44000,42000,-2000
2018-06-01,1420636296,F012020,생리대,좋은느낌 수퍼롱 오버나이트 10px4팩 바디피트 생리대,10000,9900,-100
2018-06-01,509647828,C014010,아동복,[MLB키즈] 여름 반팔 티셔츠(택1) 71TSD3831,36000,30600,-5400
2018-06-01,1272041652,C013010,점퍼,#NAME?,27900,27900,0
2018-06-01,638967889,C013010,점퍼,[크로커다일레이디] 펀칭메모리소재점퍼 CL5M-JP103_동수원점,19000,19000,0
2018-06-01,1613668745,C012030,여자상의,베니코코 여리핏 빅사이즈 여름신상 원피스/린넨,9900,9900,0
2018-06-01,377950259,A011030,찹쌀,보리쌀 (1K) X10,55740,49610,-6130
2018-06-01,863606219,A022050,탄산음료,씨그램 탄산음료 450ml x20개,13080,13080,0
2018-06-01,795646936,C021040,실내화,[나이키]다이나모 프리 (TD) 키즈인기신발 2종_택1w,33040,33040,0
2018-06-01,338148926,C013020,티셔츠,휠라키즈 기본 리니어반팔티셔츠 FK2RSA2662 X,20000,20000,0
2018-06-01,432347562,A019130,스프,청정원 우리쌀 구운마늘 크림수프 60g 3인분 X 30EA,57350,51050,-6300
2018-06-01,467504775,C013040,청바지,봄신상입고/아동 주니어 청바지/스키니/스판/밴드/,9900,9900,0
2018-06-01,545442604,L021030,가방,오비닐닷컴 J 노트북파우치2컬러(13/14/15인치)중택1,15900,15900,0
2018-06-01,2002759627,E031070,에어컨,공식파트너 삼성 선풍기 SFN-K40WRT 무료배송,123900,123900,0
2018-06-01,1999503212,D031010,주택수선재료,국산 최대 장폭 점착식 데코타일 22장/장판,16900,16900,0
2018-06-01,1206078092,C011030,남자학생복,킹스맨 남자셔츠 데님 레자 카라 셔츠 W0416001 긴팔,35930,35930,0
2018-06-01,293298794,C013010,점퍼,[텐모어][텐모어] STRIPE JACKET - NAVY [1897999],78000,74100,-3900
2018-06-01,293298792,C013010,점퍼,[텐모어][텐모어] WASHED LINEN JACKET - KHAKI [1898000],77000,73150,-3850
2018-06-01,1197543930,E041050,냄비,퀸센스 빅토리아 디오냄비 16cm 인덕션겸용,14700,14700,0
2018-06-01,209257279,G011070,자전거,[시애틀레이디7+무료배송] 삼천리 여성용 26인치7단,139000,125100,-13900
2018-06-01,895744718,A019080,고추장,[대상]순창 현미찰고추장 2KG,23900,9900,-14000
2018-06-01,1775131022,F011130,홍삼,정관장 레네세 캔디 수(240G),10000,10000,0
2018-06-01,1526818272,C013050,운동복,선글라스 클립/안경/걸이/거치대/차량용/자동차/홀더,3500,2800,-700
2018-06-01,2084072178,C012030,여자상의,벨류 허리리본 롱원피스- 베이직원피스 롱원피스 라운,63200,53720,-9480
2018-06-01,603690188,E031090,공기청정기,다이슨 공기청정 선풍기 TP03 /이벤트,670000,629800,-40200
2018-06-01,540645915,C013010,점퍼,[emcee(엠씨)](18여름)라운드 사파리 자켓 (C82J054)[갤러리아],159000,135150,-23850
2018-06-01,1795390375,E061020,섬유유연제,섬유유연제 피죤 3100ml×4개,11900,11900,0
2018-06-01,476557943,A017250,고사리,강원횡성 유기농 브로콜리 1kg,12500,12500,0
2018-06-01,416025909,C015040,장갑,란체티 등큘팅퍼 여성 순모장갑 TL-5604 여자모직장갑,33970,33970,0
2018-06-01,1450680869,C013010,점퍼,[치크]매쉬안감 바람막이 CKJA82300G,19900,18910,-990
2018-06-01,1034340189,A014030,치즈,치즈(파마산 동원 227g)X12/ 식자재 전문,85800,85800,0
2018-06-01,1536052535,A011100,라면,태평마트 중국당면 샤브 훠궈용 납작당면 300g,4690,4690,0
2018-06-01,665433306,A012060,햄및베이컨,동원) 런천미트 340g X 24입/1박스 / 동원 /(참고) 동,88900,78240,-10660
2018-06-01,609248392,L021010,손목시계,마블 어벤져스 인피니티워 아이언맨 캡틴아메리카 시,48900,48900,0
2018-06-01,989073908,L012080,화장지,[유한킴벌리]유한킴벌리)크리넥스티슈180매*3,4000,4000,0
2018-06-01,989915328,E061050,청소용세제,홈스타 향락스 2Lx3개 유한 락스 세정제 곰팡이제거제,10000,9900,-100
2018-06-01,714318593,L021030,가방,세인트스코트 빅토리아 숄더백 GBK548 블랙,125300,106510,-18790
2018-06-01,1393112051,A017050,미나리,동결건조 유기농 양배추가루 50g 양배추 분말 즙 주스,9900,9900,0
2018-06-01,469104950,A013170,생선통조림,동원 마일드참치100gx15+증정(라면참치x2or리챔120g),18900,18900,0
2018-06-01,242360086,C012040,여자학생복,[모다아울렛][쉬즈미스]프릴넥 올오버 프린트 블라우스(SWWBLI11060-PI),64000,60800,-3200
2018-06-01,430845695,C014010,아동복,[헤지스키즈] 한정수량 어린이날 세일,27000,27000,0
2018-06-01,1995103825,C013040,청바지,여름신상 스키니/일자/부츠컷/팬츠 특가 25~34,9900,9900,0
2018-06-01,1014086570,G011070,자전거,[시애틀레이디7] 삼천리 여성용자전거 26인치7단,129000,116100,-12900
2018-06-01,513840902,C013010,점퍼,CN003 빅포켓 오버핏 코트 포켓코트 롱코트 캐주얼코,64120,57070,-7050
2018-06-01,293298789,C013010,점퍼,[텐모어][텐모어] WASHED LINEN JACKET - WHITE [1898002],77000,73150,-3850
2018-06-01,526414726,C013050,운동복,여름신상 아이스 트레이닝바지/츄리닝/운동복/남자,16800,16800,0
2018-06-01,2003540225,A016070,귤,주스(크렌베리 오션스프레이 3L)/제주감귤 오렌지주스,9280,8730,-550
2018-06-01,1307306396,C013010,점퍼,[에프엔에스]아동 패딩점퍼 웰론 후드 패딩자켓80097,19800,19800,0
2018-06-01,149470183,A016110,딸기,23311307/ 냉동가당딸기(1kgX15개)-청솔,92660,92660,0
2018-06-01,360018274,C014010,아동복,여름 아동 주니어 여아 남아 팬츠 반바지 청 면바지,10000,9900,-100
2018-06-01,1674593125,E031010,전기밥솥,쿠첸/정품/쿠첸패킹/리홈패킹/클린커버패킹/핸들패킹/,5800,5800,0
2018-06-01,1731215239,A018020,사탕,이안에맛14/젤리빈 별사탕 왕구슬껌 땅콩 스톤 초코볼,3470,3470,0
2018-06-01,1214023250,C012060,여자내의,[대구백화점 I관] [나이스클랍]벨티드치마바지(N182MSA017),159000,135150,-23850
2018-06-01,635452018,C013020,티셔츠,빅사이즈 남성 나시 나시티 민소매 골지 남자 런닝 티,3900,2900,-1000
2018-06-01,744952575,A011170,떡,[신세계몰][시루아네] 무설탕 영양간식 현미영양찰떡 80g x 18개,19900,19900,0
2018-06-01,2083204391,C012060,여자내의,마가렛 프린지 린넨자켓- 프린지자켓 린넨자켓 패턴자,67400,57290,-10110
2018-06-01,1480564367,I031010,장난감,그루업 스마트 바이크,30530,30530,0
2018-06-01,1125241328,C013040,청바지,납자바지 TR 내추럴 조거 슬랙스 슬랙스바지 패션바지,26920,26920,0
2018-06-01,1752410442,C013050,운동복,[티탁]13900~반팔트레이닝세트/이지웨어/나,15900,13900,-2000
2018-06-01,985260938,A018060,스낵과자,[크라운]크라운 츄럿 84G,1200,990,-210
2018-06-01,988991440,A021010,커피,[남양]루카스나인 라떼 14.9G*30T,11500,11500,0
2018-06-01,895744746,A019100,식초,[대상]청정원 진한 토마토 케찹 300g,1500,1500,0
2018-06-01,2038394249,L021060,유모차,(추천) [엘르펀트 슈퍼조거 유모차] 휴대용유모차 삼륜유모차 신생아유모차 미니유모차,238300,238300,0
2018-06-01,188710897,E061020,섬유유연제,초특가 섬유유연제2.1x6개(아로마뷰/샤프란/피죤)3.1,11200,11200,0
2018-06-01,753558870,E011050,책상,고품질 칼라 포밍테이블) 공부/학원/사무용 책상/식탁,63500,63500,0
2018-06-01,1526365968,E031120,믹서,신일 푸드프로세서 파워블랜더 믹서기 SMX-700SKS 3종,39800,37900,-1900
2018-06-01,1728118753,L021020,장신구,투명 피어싱 실리콘 투명귀걸이 아웃컨츠 이너컨츠,1500,1500,0
2018-06-01,549725286,C013020,티셔츠,롱원피스/티셔츠 블라우스/박스티 빅사이즈/쁘니걸,26800,25800,-1000
2018-06-01,1082822059,A014020,분유,순산양분유 1단계 800g/ 아이배냇,32900,32900,0
2018-06-01,295247592,C013050,운동복,미르웨이 후사경 /RV전차종,42000,38260,-3740
2018-06-01,2046326867,E031070,에어컨,[LG전자 A/S]스타리온 타워팬 선풍기 리모컨 저소음,129000,129000,0
2018-06-01,355263241,C012060,여자내의,난닝구 모티브 점프수트/ 난닝구,32000,31040,-960
2018-06-01,1166838161,C012060,여자내의,(해외직배송) 하객룩 여성 프릴장식 미디움기장 스커,69540,69540,0
2018-06-01,1089584205,A011070,혼식곡,[오뚜기]베이킹소다400g x 12개,44900,44900,0
2018-06-01,889181300,E031130,보온매트,보이로 순면 전기요 UB55 [싱글 / 물세탁가능 / 면100% 순면소재 / 6단계 LED온도조절기],99000,99000,0
2018-06-01,1944705005,E011070,식탁,접이식 테이블 3종/식탁/스툴/식탁세트,169000,169000,0
2018-06-01,889181301,E031080,선풍기,미마 할로겐 히터 MHH-C19,24000,24000,0
2018-06-01,518913479,A016030,복숭아,경북 김천 하우스자두 1.5kg 1박스[35과내],36900,35650,-1250
2018-06-01,1436184387,C013040,청바지,남자바지 클래식 체크 핀턱 와이드 팬츠 와이드팬츠,62500,62500,0
2018-06-01,1968082840,C013050,운동복,[오토반] 핸드 커버 스크래퍼 스크래퍼 핸드 커버 내장 자동차,3850,3430,-420
2018-06-01,2084133619,C013040,청바지,(SR)MHA528 남자빅사이즈스판청바지 /(참고)남자빅사,67800,59670,-8130
2018-06-01,794754286,C013020,티셔츠,[PUMA]푸마 프리미엄 스판 카라넥 반팔티셔츠 8078,29800,29800,0
2018-06-01,1659665053,I031040,생화,아이스쿨러 물병주머니 물통커버 물병파우치 물통,3100,2860,-240
2018-06-01,1402161693,A013170,생선통조림,동원참치 150g 6캔 기획세트 스팸 리챔 200g 340g,8800,8800,0
2018-06-01,988036144,A014040,발효유,[빙그레]빙그레 빅 요구르트 280ML,1000,1000,0
2018-06-01,1010259245,E061020,섬유유연제,[테크] 울드라이 리필 1300ML 세탁세제X3,11550,9900,-1650
2018-06-01,1095774175,C013050,운동복,트레이닝복 세트/츄리닝 추리닝복/운동복/언더레이어,10900,10900,0
2018-06-01,2036470846,C012060,여자내의,기모 밍크 퍼 밴딩 스키니 레깅스 바지 여성 캐주얼,24260,24260,0
2018-06-01,325621967,C012040,여자학생복,[위쉬몰]DD 시보리패턴블라우스(2244H805),40320,34280,-6040
2018-06-01,597038117,A019180,즉석식품,[대복] 대복 육개장 600g*6팩(한복선의 궁중비법),21900,21900,0
2018-06-01,1511345622,C021040,실내화,리복 클럽 씨 85 오버브랜디드 BS5213,31790,31790,0
2018-06-01,539412851,C013040,청바지,닉스(NIX) 쿨 아이스 데님 2종,69000,68000,-1000
2018-06-01,31309926,A022010,주스,미닛 망고 175MLxCAN X 30개 SET,6890,6890,0
2018-06-01,1471438426,A012060,햄및베이컨,(소세지모음전) 그릴/화이트/컨츄리소세지/바베큐/,4200,4200,0
2018-06-01,988061105,A021020,차,E슈퍼)주식회사우정_행사(과세),11900,11900,0
2018-06-01,1166899480,C012060,여자내의,피핀 리코 린넨 밴딩팬츠 #73613/ 피핀,22900,18100,-4800
2018-06-01,635873031,C013020,티셔츠,[MLB키즈](신상품) MLB키즈 로고포인트 반팔 기능성 티셔츠(71TSD4831-07P/71TSD4831-,29000,24650,-4350
2018-06-01,988122547,A019150,김치,CJ 비비고 총각김치 500G,8590,8590,0
2018-06-01,357824112,L012090,기초화장품,바닐라코 클린잇제로 퓨리티 100ml,17000,17000,0
2018-06-01,913391014,A013070,굴,캐나다산 하드쉘 활 랍스타 500g - 2.5 kg 선택가능,20500,20500,0
2018-06-01,2112628990,A022010,주스,미닛메이드 알로에 175mlx30캔x3박스 건강음료 알로,35120,35120,0
2018-06-01,1047171685,L021010,손목시계,로제타 여성 손목시계 FW-15 손목시계 팔목시계 디지,14640,14640,0
2018-06-01,125269509,E041030,솥,일본 사나다 전자렌지 고구마찜기/옥수수찜기/야채찜,2480,2480,0
2018-06-01,384764011,A011100,라면,찰지고 쫄깃한 백설 햇당면 1kg,3700,3700,0
2018-06-01,322018367,C013050,운동복,USD251_2108 챠콜 츄리닝 운동복 스포츠의류 트레이닝,80270,80270,0
2018-06-01,1125241358,C013010,점퍼,남자자켓 와일드 라이더 레자자켓 자켓 남자자켓 가죽,133000,131670,-1330
2018-06-01,448379771,C013050,운동복,DYT 오픈져지(GLS-643) 스포츠의류 트레이닝복 긴팔져,85720,85720,0
2018-06-01,2009169795,A018080,설탕,자일리톨분말100%1kg2개/국내산자일리톨크리스탈/가루,24900,24900,0
2018-06-01,2046951027,C012020,원피스,[모조에스핀]벨티드 슬림 롱코트_S174MSG426(MR1),259000,246050,-12950
2018-06-01,1199962843,E011050,책상,BRICK책상 서재 사무 스틸 철재 컴퓨터 사무실 2인용,109000,101370,-7630
2018-06-01,783876295,E021010,침구,국내제품 시원한 여름이불 신상 양면 순면 스프레드,54800,39800,-15000
2018-06-01,1540207722,C013020,티셔츠,[블루독베이비]포켓포인트티셔츠(IV)4831933204,32000,25600,-6400
2018-06-01,1917226442,C013020,티셔츠,[이사베이]컬러 배색 스트라이프 옆트임 민소매 (VMIBF2847)_A6S5,13900,13210,-690
2018-06-01,1353434788,C013040,청바지,여름신상 키작녀 미니 청바지 8부 9부 일자 스키니,23800,23800,0
2018-06-01,1501161163,C011050,남자내의,(까르멧)(여특면9부)면100% 특수 실켓가공 파자마,8740,7780,-960
2018-06-01,2046951031,C012020,원피스,[모조에스핀]벨티드 슬림 롱코트_S174MSG426(LE1),259000,246050,-12950
2018-06-01,465048842,C013010,점퍼,랜더스 블루종 패딩점퍼(JK700W) 네이비 집업 점퍼 남,57970,57970,0
2018-06-01,631747518,E011020,침대,레이디가구 레이 수납 서랍침대 슈퍼싱글 + 매트리스,87000,87000,0
2018-06-01,1285158859,C013010,점퍼,걸크러쉬 슬림 가죽 자켓-m1071 (블랙) 여성가죽자켓,54000,54000,0
2018-06-01,566748971,C012040,여자학생복,PT1456-찡 포인트 밴딩 기모 팬츠,48890,47920,-970
2018-06-01,808852321,C013040,청바지,완전편한 핏! 여성청바지/반바지/특가 팬츠 모음전,9800,9800,0
2018-06-01,49430042,A018080,설탕,자일리톨 750g 코코넛슈가 1kg 스테비아 분말 가루,10900,10900,0
2018-06-01,2058938366,A022050,탄산음료,음료수 최저가콜라 칠성사이다 환타 맥콜 탑씨 탄산,8400,8400,0
2018-06-01,335162060,C012040,여자학생복,DWB1111 봉쥬 레터링 남방 801S 롱남방 블라우스 여자,58280,58280,0
2018-06-01,2006186684,C012060,여자내의,[KOOGI]린넨3부숏팬츠_KL1PT165A,14800,13720,-1080
2018-06-01,118470952,A012060,햄및베이컨,(맛나)박스/사조오양베이컨1kg*10,169890,169890,0
2018-06-01,1010284200,A011170,떡,[오뚜기]오뚜기 맛있는국물떡볶이 424G,4700,4700,0
2018-06-01,1010284201,A011170,떡,[오뚜기]오뚜기 맛있는라볶이 434G,4700,4700,0
2018-06-01,174075248,L021030,가방,팬티 브라 세트,23500,23500,0
2018-06-01,2074071832,E061060,살충제,쥐끈끈이10매+쥐약 모음/쥐끈끈이/쥐끈끈이틀/쥐트랩/쥐포수/쿠마펜펠렛/쌀쥐약/라쿠민,6600,6500,-100
2018-06-01,1054166613,C013020,티셔츠,[타미힐피거]TOMMY HILFIGER 반팔 커스텀핏 카라티셔츠,39900,39900,0
2018-06-01,1775131050,F011130,홍삼,정관장 레네세 캔디 수(500G),18000,18000,0
2018-06-01,2051309302,C013020,티셔츠,[TOMBOY][톰보이] 스퀘어 슬리브 레터링 티셔츠 9108222447(본점),35400,28730,-6670
2018-06-01,1064816432,C012040,여자학생복,배색 반팔 니트 MIWKA8433T/ 미쏘,39900,37910,-1990
2018-06-01,1844359643,C013050,운동복,접이식 트렁크정리함 트렁크콘솔박스 트렁크정리,12500,12500,0
2018-06-01,1978599001,I031010,장난감,펀앤키즈 로디 베이스 (8000) 로디 베이스 짐볼 유아,32450,28560,-3890
2018-06-01,1327807796,C013010,점퍼,[버블트리]~23호/여아/아동/유아/야상/자켓/점퍼,29800,29800,0
2018-06-01,1479730945,E021020,커튼,로만쉐이드/총집합47종/암막/창문/안방/커텐/커튼/,27800,27800,0
2018-06-01,665433361,C012040,여자학생복,심플 롱 가디건 ATSW8B612/ 앳코너,49000,41650,-7350
2018-06-01,1163762949,L012030,칫솔,오랄비 스테이지스 3단계 어린이 칫솔 8입 프린세스,13480,13480,0
2018-06-01,1028958048,A015010,참기름,국산 생들기름 참기름 들기름 통참깨 냉압착 저온압착,22000,22000,0
2018-06-01,2048011793,A011090,국수,팔도 비빔면 130g x 20+4봉 증정기획,15420,15420,0
2018-06-01,2144594325,C014020,유아복,배냇베이비 순면 알록달록 사과 아동 티셔츠,10780,10780,0
2018-06-01,892325860,C011030,남자학생복,무료배송/빅사이즈/ 라운드넥가디건/ 브이넥가디건,17800,17800,0
2018-06-01,1158086363,I053040,기타문구,3M 포스트잇 대용량팩 알뜰팩 모음 플래그 디스펜서,9700,9700,0
2018-06-01,1479465566,C013020,티셔츠,여름신상 맨투맨 남자 남성 티셔츠 오버핏 긴팔 기모,15800,15800,0
2018-06-01,1810537278,A018100,꿀,토종원 생로얄제리x1 강원영월 무농축생꿀 천혜자연,39800,39800,0
2018-06-01,1778708720,L021020,장신구,[바보사랑]CROSS EAR,16000,16000,0
2018-06-01,1778708722,L021020,장신구,[바보사랑]CHAIN EAR,16000,16000,0
2018-06-01,1356246452,C013010,점퍼,데님스판 청자켓 BDT062 남자자켓 남자청자켓 / 참고,123900,109040,-14860
2018-06-01,1778708721,L021020,장신구,[바보사랑]CROSS CHAIN EAR,18000,18000,0
2018-06-01,1385831078,A011160,빵,안흥찐빵마을 수제 슈크림찐빵 500g(10입) 2봉 슈크림,27490,27490,0
2018-06-01,58761106,A013090,전복,(맛나)히모가리비(중국)180g,5000,4500,-500
2018-06-01,1403820054,A011120,두부,[3개 골라담기]독일 하네 하이델 뮤즐리 시리얼 4종,20700,20700,0
2018-06-01,1500271061,C011050,남자내의,남자 남성 빅사이즈 마바지 면바지 밴딩 팬츠 면바지,29900,29900,0
2018-06-01,892652612,E061020,섬유유연제,다우니 대용량 섬유유연제 아로마플로럴 8.5L x2개,31600,31600,0
2018-06-01,1083763218,C013020,티셔츠,빅사이즈민짱/상콤한 인기티셔츠모음/루즈핏/라운드,10900,10900,0
2018-06-01,513055631,C012060,여자내의,[라인]18년]여름데님부츠컷 바지(NWSLIE05)[갤러리아],59000,47200,-11800
2018-06-01,1189634446,A022010,주스,코리원/시아스 깔라만시 1kg/원액/주스/디톡스/음료,5000,4900,-100
2018-06-01,2135821901,C013050,운동복,2선 백수추리닝 반티 체육대회 기모/폴리 남여공용,14900,14900,0
2018-06-01,1778708717,L021020,장신구,[바보사랑]MAGIC CIRCLE NEC,30000,30000,0
2018-06-01,513801387,C011050,남자내의,2018 S/S신상 남자 면바지/슬랙스/팬츠/밴딩/린넨,17900,17900,0
2018-06-01,12764733,A022050,탄산음료,슬로우카우 탄산음료 250ml x12캔/숙면음료/허브탄산,18000,16200,-1800
2018-06-01,1778708719,L021020,장신구,[바보사랑]ZIPPER TAG BRC,22000,22000,0
2018-06-01,1778708718,L021020,장신구,[바보사랑]BOX NEC,28000,28000,0
2018-06-01,889181359,E031130,보온매트,리만 커버 분리형 무자계 전기요 HI-5000 [더블 / 15시간타이머 / 면혼방 / 물세탁가능],47000,47000,0
2018-06-01,895685943,A017070,부추,아욱 (봉),1990,1990,0
2018-06-01,895685942,A017070,부추,쑥갓 (봉),1990,1990,0
2018-06-01,889181355,E031080,선풍기,마이프랜드 라디에이터 5핀 MFR-1605D [약 10㎡ / 열량조절 3단 / 오일내장형],49000,49000,0
2018-06-01,220528113,A022050,탄산음료,뚱캔/탄산음료/코카콜라/칠성사이다/트레비/캔음료수,9500,9500,0
2018-06-01,889181354,E031080,선풍기,마이프랜드 이동식 멀티 히터 MF-2400FH [약 16.5㎡ / 과열방지장치 / 3단계온도조절],69000,69000,0
2018-06-01,1144139489,L012010,면도기,쉬크 하이드로3 면도날 8입+면도기세트+라임폼60g,15900,15900,0
2018-06-01,1416360092,C013050,운동복,타이어 에어밸브/무시/튜브리스용/TR414/TR413/TR412,600,600,0
2018-06-01,393948606,A019040,소금,베타믹스(돈까스용 쇼켄 10K) 베타믹스 빵가루 식자재,155160,139650,-15510
2018-06-01,314763623,C013010,점퍼,[NC백화점 강서점]HUNTKIDS NC07 경량배색바람막이 hkja82405c,29900,29900,0
2018-06-01,1071559844,C012060,여자내의,여엠보7부 시원한 지지미원단 여성7부 엠보파자마,5700,5080,-620
2018-06-01,1700020735,A013070,굴,[손씨푸드]냉동랍스타 1마리(450g~1.2kg) 구이 파티용,17000,14900,-2100
2018-06-01,1739324729,A016070,귤,해울림/반건시세트/1호/반건시/선물용/선물세트/30과,66900,66900,0
2018-06-01,1302279176,C013020,티셔츠,기능성티셔츠 골프티셔츠 이너웨어 언더레이어 반팔티,9500,8380,-1120
2018-06-01,379067022,A013100,마른멸치,완도 활전복 대22미 1.5kg (750g+750g),52900,47610,-5290
2018-06-01,1899614958,C013020,티셔츠,[필골드] DB001 베이직 반목 폴라 티셔츠,19800,19800,0
2018-06-01,1778708724,L021020,장신구,[바보사랑][액세서리키친] 925실버 Maple Tree 목걸이 A7903N001,25900,25900,0
2018-06-01,1778708723,L021020,장신구,[바보사랑][액세서리키친] 925실버 Trainline 팔찌 2종택1,25900,25900,0
2018-06-01,889181360,E031130,보온매트,리만 커버 분리형 무자계 전기요 HI-500A [싱글 / 15시간타이머 / 면혼방 / 물세탁가능],62000,62000,0
2018-06-01,283512262,C014020,유아복,소프트 골지레깅스 유아레깅스 유아레깅스 유아바지,6120,5940,-180
2018-06-01,533309134,C013050,운동복,여름 추천/겨울 앞유리 자동차커버 sm5 sm3 sm7,12000,10860,-1140
2018-06-01,889181327,E031080,선풍기,모리타 카본히터 MKS-C30S [원적외선 방출 / 3시간 자동OFF타이머 / 300W 저전력],63000,63000,0
2018-06-01,889181324,E031080,선풍기,미마 석영관 히터 MFG-K902A [순간발열 / 화력조절2단계],17580,17580,0
2018-06-01,24025654,C013020,티셔츠,[에고이스트] 레터링 기본 티셔츠 (EJ2CH361),98000,87220,-10780
2018-06-01,179285342,C013010,점퍼,데시데 메쉬조직 플리츠 플레어자켓 (DHS420),198000,178200,-19800
2018-06-01,1420213462,E011020,침대,스텐피부관리평베드/bs-221/왁싱베드/피부관리실,152000,152000,0
2018-06-01,903135179,C013050,운동복,엑스믹스 남성여성 땀복 헬스복 반바지 운동복 쿨티,9900,9900,0
2018-06-01,889181328,E031130,보온매트,메리노 전기요 MES-305 [더블 / 9단계 온도조절 / 과열방지],48360,48360,0
2018-06-01,334369362,E051030,디지털도어록,포인트 샷시/디지털도어락/도어락/번호키/샷시문전용,57000,52440,-4560
2018-06-01,1238120478,A012060,햄및베이컨,(냉장)사조 불고기구이햄1kgx10개,97110,97110,0
2018-06-01,1615207995,E011050,책상,코너책상/책장세트/L형책상/학생책상/컴퓨터책상/책상,84000,79900,-4100
2018-06-01,690217494,C012020,원피스,세이나 자켓(EGJKHA95)/ 케네스 레이디,50000,45000,-5000
2018-06-01,1682706510,A017180,호박,[명가일품]껍질째 삶아먹는 국내산 피완두콩 4kg,29900,29900,0
2018-06-01,2097344033,L021010,손목시계,디앤지시계 샌드피퍼 3종 남성 돌체시계,123000,123000,0
2018-06-01,958658314,F012020,생리대,[유한킴벌리]화이트 시크릿 울트라날개중형 36P,10900,6500,-4400
2018-06-01,494912574,E011020,침대,정품 매트리스포함 일반형 침대/서랍형침대,99000,89100,-9900
2018-06-01,958658317,F012020,생리대,[유한킴벌리]유한킴벌리 화이트 시크릿홀 슬림 일반형 소형(18P),5090,5090,0
2018-06-01,895768775,A022020,두유,정식품 베지밀B 190ML,800,800,0
2018-06-01,2083121617,C013010,점퍼,#NAME?,50500,44440,-6060
2018-06-01,889181331,E031080,선풍기,마이프랜드 라디에이터 7핀 MFR-1607D [약 13.2㎡ / 열량조절 3단 / 오일내장형],59000,59000,0
2018-06-01,889181332,E031080,선풍기,마이프랜드 미니 PTC히터 MF-3650PH [전반향 발열 / 즉시난방 / 탁상용 / 버튼조작],79000,79000,0
2018-06-01,542410590,C014020,유아복,[뿌야뿌][뿌야뿌] 썸머7부통팬츠 PC2TGPT07N,14500,6530,-7970
2018-06-01,631916692,A016060,감,달콤샤르르 자연그대로 만든 아이스 홍시 100개(컵)/,115100,101290,-13810
2018-06-01,1897520694,A016150,아몬드,[가온애]아몬드가루 분말 호두 땅콩 견과 분태 피칸,8900,8900,0
2018-06-01,2140731045,C013020,티셔츠,BOD0020 BYC 여자 캐릭터 부드러운 순면 편면 큐티 여성 반팔 립브티 티셔츠 여 주니어,11250,11250,0
2018-06-01,344647029,C012020,원피스,[2001 OUTLET][COMPAGNA] 꼼빠니아 아래 옆트임 바지 (CA8U4-WPL900),79500,77910,-1590
2018-06-01,181359514,C021020,구두,파이어트랩 에거톤 더비슈즈 블랙,68000,68000,0
2018-06-01,1876964671,C013040,청바지,[포에버21]슬림핏 리브 라이더진/FOREVER21/청바지/배기팬츠,44900,17960,-26940
2018-06-01,353629921,E031120,믹서,비앙코믹서기 블렌더 BIANCO MB6100J 파워믹서기 5종,439000,424140,-14860
2018-06-01,2113758048,A019040,소금,섬들채 천일염 10kg 간수뺀 신안천일염 태평소금,24400,24400,0
2018-06-01,1436617886,C014010,아동복,[노블엔젤]여름 여아원피스/아동복/유아/상하복/엘사,14900,14900,0
2018-06-01,520938247,C013050,운동복,도어가드원6M ㅣ 문콕방지 도어라인 몰딩 도어가드 원,35820,34750,-1070
2018-06-01,899582704,A014030,치즈,덴마크 짜지않은치즈 (252G),6580,6580,0
2018-06-01,1918779285,C013050,운동복,차량용소화기 월드프로119 자동차 휴대용소화기 차량용 구난용품 비상용품 캠핑용 소형,9300,7730,-1570
2018-06-01,2046951004,C012020,원피스,[모조에스핀]체크 롱코트_S174MSG425(KA1),259000,246050,-12950
2018-06-01,964063153,A019130,스프,[오뚜기] 분말 스프 죽/쇠고기 야채 삼계 양송이,9300,9300,0
2018-06-01,1127008410,I031040,생화,MS 컴포트 에어베개/사각베개 목 배개 침낭 캠핑용품,5000,3740,-1260
2018-06-01,895685975,F011120,인삼,참느타리버섯 (200G/팩),2490,1490,-1000
2018-06-01,989073937,A019120,혼합조미료,초L 쇠고기다시 500G,5700,5700,0
2018-06-01,120999590,E011060,의자,[노노스인테리어] 메쉬 의자 특가!! 학생 책상 사무용,21500,21500,0
2018-06-01,807939996,C013010,점퍼,[톰키드]반소매후드집업점퍼(92272-16-201)33 83,15000,13500,-1500
2018-06-01,148462963,A018090,잼,오뚜기딸기쨈850g,14480,14480,0
2018-06-01,884551740,F011150,건강기능식품,복방앗간 엄마가만든 100% 국산 검은콩 미숫가루,15000,15000,0
2018-06-01,355179471,C012040,여자학생복,[나이스클랍]캐쥬얼한루즈핏니트(N182KSK016),239000,191200,-47800
2018-06-01,622831802,A018050,비스킷,로투스 쿠키 싱글팩 1박스 300개입/수입과자,21400,21400,0
2018-06-01,1530542604,I053020,스케치북,(3s오피스) 모조전지 1롤50장 70g 모조지 전지 상종이,5450,5450,0
2018-06-01,895685974,F011120,인삼,표고버섯(팩),3990,2000,-1990
2018-06-01,1529781369,I031010,장난감,그린토이즈 잠수함 : 임의배송 물놀이잠수합,12880,12880,0
2018-06-01,2034979955,D031010,주택수선재료,[던에드워드]친환경/미국수입/방문/벽지용/가구/벽면,22000,19140,-2860
2018-06-01,784696872,C014010,아동복,[M.K] 한국생산 아기정장 그린체크 5종세트(3-24개월)201929,74390,66210,-8180
2018-06-01,895685973,F011120,인삼,SF)양송이버섯 (팩),3990,3990,0
2018-06-01,1044489424,I031040,생화,빈슨메시프 아이테르 침낭-USA 써모라이트 극 동계용,89800,89800,0
2018-06-01,1156150144,A018010,초콜릿,킷캣 트라이얼팩 50개입(오리지널/그린티/다크)/키캣,14900,14900,0
2018-06-01,563242011,C014010,아동복,[블루독베이비] 도형포인트상하복 (47370-672-05),30000,24600,-5400
2018-06-01,451922888,C011030,남자학생복,(티티뱅크) AT5454 듀스포 배색 조끼,17880,17880,0
2018-06-01,288249094,I011030,사진기,[사은품증정][파나소닉]루믹스 디카 DMC-LX100,732700,732700,0
2018-06-01,531155127,C013020,티셔츠,그렌에코 2018 핫여름 골프웨어 신상할인/남여,39900,39900,0
2018-06-01,795044656,I012010,컴퓨터,Apple 공인판매점 2017 iMac [MNE02KH/A] 21.5형,1702000,1616900,-85100
2018-06-01,1966755085,E061010,세탁세제,소프넛 500g 열매껍질 샴푸 세탁세제 주방세제 솝베리,10000,9900,-100
2018-06-01,11715334,E031020,가스레인지,(사은품) SK매직 GRA-C2101R 2구렌지+그릴/블랙색상,275000,258000,-17000
2018-06-01,433181930,C013050,운동복,자동차 파워핸들봉 파워봉 핸들손잡이 차량 보조핸들,6470,5960,-510
2018-06-01,1836907796,C013010,점퍼,엠엘비MLB키즈 뉴욕 양키스 바람막이 점퍼 71JPSI831,159000,149000,-10000
2018-06-01,718502003,C014010,아동복,(숲자람) 기능성 키즈 바람막이 유아외출용바람막이,71220,69090,-2130
2018-06-01,1233597186,C013030,스웨터,폴라티 긴팔 MJ7614_7617 마르잔 빅사이즈 티,33090,32430,-660
2018-06-01,979385670,C013020,티셔츠,[셀덴]셀덴 PNC02 무지프릴티 EDRA82453J,7900,7750,-150
2018-06-01,1216733239,A019160,밑반찬,멸치볶음 200g-1.5kg 견과류 배즙 크렌베리 최적혼합,16900,16900,0
2018-06-01,389372315,C013010,점퍼,바람막이/아웃도어/윈드자켓/등산복/블루종/항공점퍼,27800,21800,-6000
2018-06-01,120987593,E031130,보온매트,한일투톤 절전형 슬림매트 4단(50x160cm),43000,43000,0
2018-06-01,120987594,E031130,보온매트,한일의료기 패밀리 슬림매트 3인용방석,34000,34000,0
2018-06-01,2039139508,L012060,샴푸,아도르 케라틴 LPP 샴푸 530ml /단백질 덩어리 크리닉,17800,17800,0
2018-06-01,120987597,E031130,보온매트,한일의료기 빨간장미 투톤매트 2인용,188000,188000,0
2018-06-01,1117999820,A012060,햄및베이컨,농협 목우촌 뚝심200gx8개/스팸/햄/국내산,16900,16900,0
2018-06-01,601778185,C013010,점퍼,[리안뉴욕][18여름] 초여름 홑겹야상 점퍼 RMDWJP700[갤러리아],39000,31200,-7800
2018-06-01,120987598,E031130,보온매트,한일의료기 빨간장미 투톤매트 1인용,168000,168000,0
2018-06-01,120987595,E031130,보온매트,한일의료기 낙엽금사 매트 2인용,89000,89000,0
2018-06-01,120987596,E031130,보온매트,한일의료기 낙엽금사 매트 1인용,99000,99000,0
2018-06-01,1522705236,F012050,의료측정기,오므론 HEM-7121+수첩 팔뚝형 자동혈압계 혈압측정기,67500,61500,-6000
2018-06-01,387592675,A017080,무,식용꽃 30송이 먹는꽃 화전용 데코용,3500,3500,0
2018-06-01,120987599,E031130,보온매트,한일의료기 악어장미 투톤매트 2인용,198000,198000,0
2018-06-01,323236468,C015040,장갑,COOL 제코 반장갑 쿨토시(장갑+팔토시),8900,7970,-930
2018-06-01,1312702003,C011050,남자내의,냉장고바지/신상파격가!/배기팬츠/몸빼/냉장고/바지,5900,5900,0
2018-06-01,444505853,A019010,고춧가루,산들샘 고운고추가루 1Kg 고춧가루 국산고추가루 업소,55400,55400,0
2018-06-01,889254789,C011020,남자상의,빅사이즈 패딩 패딩점퍼 WC 남 헤비패딩 JK 046M 패딩,114700,114700,0
2018-06-01,830738833,A012050,소시지,예환 복부어스트 순창명인 수제소시지 수제햄 특가,2900,2900,0
2018-06-01,2111207421,C013050,운동복,헤르만 이지후크(천연소가죽)/차량용 다용도 가방걸이,9000,8500,-500
2018-06-01,2056690484,F012030,안경,흘러내림방지 귀고무 안경다리 메가로크 운동용,6000,6000,0
2018-06-01,558210542,C012030,여자상의,빅사이즈 DBA1558 메리 플라워 원피스 803S 빅사이즈,65950,65950,0
2018-06-01,1223557209,E041030,솥,풍년 압력밥솥 업소용 하이클래드 15/20/25인용 HCPC,115000,115000,0
2018-06-01,2427967,C013050,운동복,코토 KHOTO 로드스타 370 루프박스 (무광그레이),650000,597910,-52090
2018-06-01,693563365,A013090,전복,(전남오픈마켓/바다수산)통통한 국내산 자숙피조개1kg,20500,20500,0
2018-06-01,984490210,A018040,아이스크림,서주아이스주 10개,12000,4500,-7500
2018-06-01,298941633,L012030,칫솔,CJ키즈세이프 어린이칫솔 x10 /치약 x6 /유아칫솔,9900,9900,0
2018-06-01,895768738,E051020,건전지,[벡셀]벡셀건전지AAA 2입,2990,2990,0
2018-06-01,895768737,E051020,건전지,[벡셀]벡셀건전지AA 4입,5290,5290,0
2018-06-01,895768736,E051020,건전지,[벡셀]벡셀건전지AA 2입,2990,2990,0
2018-06-01,895768739,E051020,건전지,[벡셀]벡셀건전지AAA 4입,5290,5290,0
2018-06-01,2121424106,A012010,국산쇠고기,[무항생제] 잡뼈 1kg 1등급,10900,10900,0
2018-06-01,2057519891,A012030,돼지고기,프리미엄삼겹살 500g / 개별 진공포장/푸주,3900,3900,0
2018-06-01,1731215294,E061030,전구,[LED전구 모음] 초절전 led램프/촛대구/형광등/볼전구,1300,1170,-130
2018-06-01,563473025,I031010,장난감,레고10715 클래식 브릭과 바퀴 조립박스/크리에이터,35500,31950,-3550
2018-06-01,2057519895,A012030,돼지고기,명품대패삼겹살500g 3초면 OK~ 한지삼겹,5500,4900,-600
2018-06-01,958658343,F012020,생리대,[유한킴벌리]화이트 시크릿 와이드&롱 슬림날개대형 32P,11490,11490,0
2018-06-01,992351665,C012060,여자내의,[피그먼트] 3색상 심플슬랙스 (PIG1801261646),34000,30600,-3400
2018-06-01,1153696267,C013010,점퍼,[Wilson]투습방풍발수/윈드자켓/바람막이/단체복/팀복,42500,39000,-3500
2018-06-01,958658348,F012020,생리대,[유한킴벌리]유한킴벌리 화이트 애니데이 무향 일반 팬티라이너(48P),4500,3500,-1000
2018-06-01,2057519897,A012030,돼지고기,목전지 목살 전지 /제육볶음 고추장불고기/ 푸주,2900,2900,0
2018-06-01,958658349,F012020,생리대,[유한킴벌리]유한킴벌리 화이트 애니데이 롱 40P,4500,3500,-1000
2018-06-01,988242636,A011080,밀가루,초L 소면기획 1.5KG+500G,3890,3890,0
2018-06-01,663519115,A016100,수박,델리참_국산가당딸기퓨레 1kg x 16개입 / (주)남양냉,129100,109740,-19360
2018-06-01,1266779397,E011050,책상,[집중력칸막이] 국내생산 독서실책상 독서책상 독서,82650,82650,0
2018-06-01,1647038212,F012020,생리대,위스퍼 코스모 메모리폼 생리대 4팩 모음전/ 위스퍼,28900,28900,0
2018-06-01,1993659777,E061050,청소용세제,2+2 유한락스 욕실청소/곰팡이제거제 500mlx4개/주방,9500,9500,0
2018-06-01,1668874571,I031040,생화,[KARNIK] 무릎관절을 위한 든든한 서포트밴드 카르닉 Pro 무릎보호대 무릎관절보호대,9900,9900,0
2018-06-01,1758862804,A018080,설탕,미네랄 풍부 100% 사탕수수 15kg 비정제설탕(원당),19900,19900,0
2018-06-01,1709957314,C013020,티셔츠,캡나시/브라탑/끈나시/나시브라/탑나시/뽕나시/여자티,6200,6200,0
2018-06-01,1301812585,C013030,스웨터,(사이즈 : 100) MNT_123 배색 니트 남자겨,45090,45090,0
2018-06-01,1048665878,E021020,커튼,완전신상 쁘띠 암막커튼 작은창 창문커텐 아이방 키즈,18400,15180,-3220
2018-06-01,632894866,A011170,떡,전북고창 울어매 복분자송편(2팩) 모시잎송편(1팩)/75,66000,58080,-7920
2018-06-01,1379727214,C012040,여자학생복,(보니알렉스) 셔링 디테일 민소매 매쉬 니트 (BBWX660A)/ 보니알렉스,9900,8910,-990
2018-06-01,1093247698,E031080,선풍기,대성셀틱_ 전기 라디에이터 DSRA-7,66000,66000,0
2018-06-01,1509077493,C013010,점퍼,남자 베이직 항공점퍼 블루종 아웃도어 청자켓 빅세일,15900,15900,0
2018-06-01,1093247697,E031080,선풍기,대성셀틱_ 전기 라디에이터 DSRA-5,58000,58000,0
2018-06-01,1354912079,C013020,티셔츠,데일리앤 여름 반폴라 나시 하이넥 민소매티 니트나시,8800,7800,-1000
2018-06-01,1093247694,E031080,선풍기,대성셀틱_ 원적외선 튜브히터 DSHT-13,840000,840000,0
2018-06-01,1093247693,E031080,선풍기,대성셀틱_ 원적외선 튜브히터 DSHT-11,770000,770000,0
2018-06-01,1093247696,E031080,선풍기,대성셀틱_ 원적외선 튜브히터 DSHT-21,1180000,1180000,0
2018-06-01,1093247695,E031080,선풍기,대성셀틱_ 원적외선 튜브히터 DSHT-16,940000,940000,0
2018-06-01,1093247692,E031080,선풍기,대성셀틱_ 원적외선 튜브히터 DSHT-08,690000,690000,0
2018-06-01,1656512436,E021010,침구,순면100% 고밀도 60수/80수/샤틴원단/홑겹이불커버,44000,44000,0
2018-06-01,1296304999,C013010,점퍼,남자청자켓 난스판 패치와팬 청자켓 C0216002 남성의,52450,52450,0
2018-06-01,400853936,C013050,운동복,아동기모바지/유아/주니어/겨울바지/배기바지/놀이복,6000,5800,-200
2018-06-01,1993660775,C013020,티셔츠,나이키 골프웨어 남성 반팔카라티 드라이 핏 당일출고,38000,32130,-5870
2018-06-01,283512549,C014020,유아복,엠보체크 레깅스 유아레깅스 유아레깅스 유아바지 아,5390,5230,-160
2018-06-01,1290977842,C013010,점퍼,[프랜치캣]번아웃점퍼3종택1(Q83DG36000-P1),36000,28800,-7200
2018-06-01,1517911062,A016070,귤,제주감귤 한라봉 5kg 가정용 랜덤과/제주귤/제주도감,52690,49530,-3160
2018-06-01,2115648794,C014010,아동복,라인포켓긴팔티/라운드티/긴팔티/남아티/공용티,9900,9900,0
2018-06-01,394814467,C013010,점퍼,캡스록 여성 초경량 바람막이 자켓(CSR-4025) 여성스,36060,36060,0
2018-06-01,2058363748,C013010,점퍼,[젤리스푼][젤리스푼] 썸머스타번아웃집업점퍼_MO,18900,17010,-1890
2018-06-01,1665503131,A013130,오징어채,서래푸드 국내가공 A급 진미채(오징어채) 1kg/명엽채,25900,25900,0
2018-06-01,1151473730,E011020,침대,고급PU가죽 침대프레임/정품매트리스/더블침대,369000,332100,-36900
2018-06-01,1057884224,C012020,원피스,말표구두약 이코노 갈색 40g,1990,1990,0
2018-06-01,1617998342,I053030,복사용지,한국제지 밀크 A4용지 80g 2박스(5000매)/복사용지,46040,39600,-6440
2018-06-01,1601850848,C013010,점퍼,[컨셉원] 10077511 / 077511 코튼/린넨 블레이저 자켓,70000,57400,-12600
2018-06-01,78645655,A019160,밑반찬,[금주MD추천best!]썬리치 체다슬라이스치즈 100매,14900,14900,0
2018-06-01,833661137,C013010,점퍼,[위쉬몰][위쉬몰]MS 루즈기모라이더자켓(Y711M),93600,79560,-14040
2018-06-01,220901190,A018060,스낵과자,농심 새우깡 10봉 + 바나나킥 10봉/자갈치/쿠폰,21500,21500,0
2018-06-01,1990204195,A011170,떡,현미떡볶이떡 600g 유기농현미로만들었읍니다,6200,6200,0
2018-06-01,2101484797,C021040,실내화,여성키높이운동화/슬립온/통굽슈즈/단화/큐빅신발로퍼,26900,26900,0
2018-06-01,969539835,A018090,잼,1+1 딸기쨈 사과쨈 포도 과일 블루베리 소스 디스펜펙,7500,7500,0
2018-06-01,484257281,A019110,드레싱,[소스모음전]오뚜기/청정원/돈가스/우스타/스테이크/,1300,1300,0
2018-06-01,1455273424,A013070,굴,청춘홍게 속초홍게 고급 3kg 5kg 러시아대게 자숙,45000,45000,0
2018-06-01,635789119,C021040,실내화,[리복Reebok] 남녀 클래식 NPC FVS 운동화/런닝화 - CM9261,35700,30260,-5440
2018-06-01,958693070,E061090,방향제,[썬가드광학] 멀티 프리미엄 /차량용 편광선글라스 /자동차,26000,19400,-6600
2018-06-01,371188201,C013050,운동복,모비스 크루저 루프백 캠핑루프백 차량용루프백 차량,266580,242810,-23770
2018-06-01,1548787715,E041060,수저,프리미엄 수저5P선물세트/답례품/명절선물,12900,12900,0
2018-06-01,987978360,F012010,종이기저귀,유한킴벌리 하기스네이처메이드팬티5여64P,50400,29900,-20500
2018-06-01,689385424,C012060,여자내의,[지지피엑스]와이드 멜빵 청바지(GGB6PT742F),49000,39200,-9800
2018-06-01,1633018181,E021020,커튼,[리앤룸] 2장/4장세트/린넨룩암막거튼//아일렛형,34800,33800,-1000
2018-06-01,410673348,A012010,국산쇠고기,광천해저파래김 도시락김 선물세트(3세트),64720,64720,0
2018-06-01,895801293,A021020,차,동서 미떼 핫초코 오리지날 430G,7980,7980,0
2018-06-01,2052043186,C013040,청바지,[난닝구]오디즌 린넨밴딩숏팬츠,19800,18220,-1580
2018-06-01,2086249585,A013070,굴,홍게 일반형 3kg 붉은대게 고급 프리,18900,18900,0
2018-06-01,895622509,A017020,상추,비트(통),5990,2000,-3990
2018-06-01,1010380392,L021050,우산,초이스엘)봄을부르는벚꽃우산,5990,5990,0
2018-06-01,1118742233,A019040,소금,[신안소금] 신안천일염 함초소금 400g+선물박스 /돌 잔치 답례품~,6500,5980,-520
2018-06-01,1298348615,C013040,청바지,[저스트원] 여성바지/팬츠/스키니/청바지/자체제작,22900,18900,-4000
2018-06-01,255591831,L021010,손목시계,토마스 블랙 손목시계 남성패션시계 패브릭시계 패션,47830,47830,0
2018-06-01,781555897,I031010,장난감,레고 호환 인도미누스 렉스 쥬라기월드 공룡 2종,39900,39900,0
2018-06-01,280832988,C011030,남자학생복,남성 반팔 청남방 셔츠 빅사이즈 슬림핏-jpsak72c3106,39900,38900,-1000
2018-06-01,955857965,A018060,스낵과자,[오리온]오리온 왕고래밥 56G,1050,1050,0
2018-06-01,895622511,A017020,상추,샐러리(봉),5990,3990,-2000
2018-06-01,1254951956,E061040,부엌용세제,그라인더세정제 퓨로그라인더클리너 - 그라인더세정제,52640,46850,-5790
2018-06-01,662886856,A018090,잼,(오뚜기) 1회용 딸기쨈 디스펜팩 머스타드 케찹 잼,33500,33500,0
2018-06-01,988038935,A018070,파이,롯데샌드 오리지날 315G,3590,1790,-1800
2018-06-01,1565191016,C013020,티셔츠,애플망고 여름신상! 빅사이즈 데일리룩,7900,7900,0
2018-06-01,262340118,C013050,운동복,프론트 리어 범퍼 가드 보호대 몰딩 화이트 보호대 몰,21590,19670,-1920
2018-06-01,1174144149,A019160,밑반찬,(전남오픈마켓/산들래식품)맛있는산들래오이소박이2kg,20000,20000,0
2018-06-01,884791255,A011070,혼식곡,밀가루 덕후를 위한 희소식! 아 놀라워라,1380,1380,0
2018-06-01,247390280,C013020,티셔츠,반팔 L~3XL 큐티/여성빅사이즈/롱티/무료배송/박스티,13900,12900,-1000
2018-06-01,1157982843,E011020,침대,[라자가구]37주년 기념 기획 침대/싱글침대/매트포함,69900,69900,0
2018-06-01,500021813,C013020,티셔츠,남성 쿨론티 쿨냉감티 긴팔티 반팔라운드티 스판w025,9900,9900,0
2018-06-01,2078220510,C013020,티셔츠,봄 여름 여성 등산티 등산조끼 바람막이 점퍼 등산복,18000,15220,-2780
2018-06-01,990064725,A018020,사탕,바닐라향 마쉬멜로 40G,990,990,0
2018-06-01,863186577,E061050,청소용세제,유한락스2kgx6개 소독/세정제/살균/화장실청소/펑크린,5900,5900,0
2018-06-01,1376129349,C013040,청바지,(SR)MHA516 남자빅사이즈청바지 빅사이즈진 남성워싱,65840,65840,0
2018-06-01,988242669,A019180,즉석식품,다향 훈제오리 슬라이스 600G,16900,10500,-6400
2018-06-01,105567856,E011020,침대,효암 흙보료 싱글 HM4000OGBS 6종모음/돌침대 숯침대,640000,590000,-50000
2018-06-01,1403690697,A021010,커피,이태리 무세띠포드커피 36개입포장 2종선택/파드커피,23000,23000,0
2018-06-01,1308548741,E011050,책상,스카이 각도조절 독서실 학생 공부 책상/스탠드별매,127000,127000,0
2018-06-01,1336448462,L021010,손목시계,큐빅 러블리 팔찌 겸용 손목시계 캐주얼시계 아날로그,14700,14700,0
2018-06-01,2032078990,E031070,에어컨,날개없는 선풍기 SF-T4611RJ 타워팬 LG전자 2년서비스,169000,160550,-8450
2018-06-01,229420593,C012060,여자내의,COMPAGNA 꼼빠니아 테이퍼드핏 린넨 블랜디드 팬츠 3종,69900,64310,-5590
2018-06-01,988242672,E061100,습기제거제,피죤습기제로8P,9900,9900,0
2018-06-01,1513246840,A017040,양배추,웰파인 황금부추 부추즙 건강즙 부모님선물 웰파인 부,30500,30500,0
2018-06-01,1979621205,A013070,굴,삼점 꽃게 3kg 25미내외 알배기 암꽃게 숫꽃게,19800,19800,0
2018-06-01,1770273151,C011020,남자상의,빅사이즈 패딩 패딩점퍼 WC 남 헤비패딩 JK043M 오리,110700,110700,0
2018-06-01,489494737,I011010,TV,공식파트너 삼성 163cm UHD TV UN65NU7150FXKR,1990000,1659000,-331000
2018-06-01,1323449164,E041020,컵,한국도자기 2인조 커피잔 모음 /필드플라워커피 머그,42400,40280,-2120
2018-06-01,746611795,C011030,남자학생복,오마샤리프 와이셔츠/단독판매 모달 남자셔츠,26900,26900,0
2018-06-01,2010871074,A017040,양배추,(면)(냉동)청학 부추1kg,4820,4820,0
2018-06-01,1561874774,A017040,양배추,(면)(냉동)청학 부추1kg,7730,7730,0
2018-06-01,1287274141,C012040,여자학생복,[대구백화점 I관] [제이케이]에이플레어펀칭블라우스(JH5BL029B),29000,26970,-2030
2018-06-01,532324437,C013010,점퍼,핸드메이드 STYLEENTER 남성무스탕 후드무스탕자켓,1490000,1490000,0
2018-06-01,922456567,I031040,생화,버팔로 슬림체어 1+1 릴렉스체어 캠핑의자 접이식체어,34800,34800,0
2018-06-01,376783120,C015040,장갑,서바이벌 전술장갑 등산장갑 밀리터리 캠핑 보호장갑,12400,12400,0
2018-06-01,470142377,I053020,스케치북,켄트지 100매묶음/4절지/8절지/130g/180g/200g/도화지/스케치북지/스케치북낱장/흰도화,7200,7200,0
2018-06-01,1337339995,C012030,여자상의,여성 스텔라 골지 V넥 니트V넥 니트니트골지니트여자,57980,57980,0
2018-06-01,297605690,A016120,바나나,동결건조 바나나가루 80g 3개 바나나 바나나분말,30000,29700,-300
2018-06-01,1027069208,I011030,사진기,(정품)소니 ILCE-5100L(SELP1650)/A5100/미러리스,539000,495880,-43120
2018-06-01,429386810,C014020,유아복,[백화점SAY][에어워크]절개배색져지후드 JP 182B0532 (기존가59900원),39900,30840,-9060
2018-06-01,1059217774,A011020,현미,두레생협 찹쌀백미(4kg 유기) 찹쌀백미 흰쌀 백미 찹,50490,50490,0
2018-06-01,633973165,C013060,등산복,남여공용 매킨리(Mckinley) (KMW16595)/ 케이투(의류),119000,98770,-20230
2018-06-01,404798768,A021020,차,자판기용 프리마 (동서 1K) X12,76040,67680,-8360
2018-06-01,2101374298,F011130,홍삼,김포파주인삼농협 홍삼이 좋아(15ML*30포),69000,69000,0
2018-06-01,457092310,A011080,밀가루,백제물산 백제쌀국수 멸치맛 18개 30개 무료배송,18000,18000,0
2018-06-01,1519319723,C013010,점퍼,아디다스 아디제로 트랙자켓 ( S99687 ),150570,135520,-15050
2018-06-01,2054848319,A016100,수박,한손에 쏙 애플수박 2.5kg 내외(2~3입) / 미니수박,14900,14900,0
2018-06-01,455059661,A011140,부침가루,베이킹 아크릴 스텐실도안 어린이날 제빵용케익스텐실,10340,10140,-200
2018-06-01,1522414038,C013060,등산복,여름 등산바지 등산복 작업복바지 단체복 남자 작업복,14380,14380,0
2018-06-01,1045079996,E061030,전구,오스람 안정기 내장형 램프 8w 11w 15w 20w 전구,5200,5200,0
2018-06-01,370793557,C013050,운동복,컴팩트 팜 광택기 6인치 3300RPM/울트라파워 9인치,51600,50570,-1030
2018-06-01,502897365,L021010,손목시계,아라비아라운드 화이트 손목 시계 MV21030W 가죽시계,90310,90310,0
2018-06-01,213655172,C011030,남자학생복,가디건 롱가디건 숄 남자가디건 남성 니트,16900,15900,-1000
2018-06-01,440942118,C012040,여자학생복,[블루종]카사리 골지 7부 가디건_[B1806CD031B],24800,19620,-5180
2018-06-01,1635366226,C015020,모자,메시캡 여름모자 썬캡 프리/빅사이즈 볼캡 스냅백,9900,9900,0
2018-06-01,2116452187,C014010,아동복,레이스자수망사원피스/원피스/드레스/주니어/결혼식,9900,9900,0
2018-06-01,1549314937,E041030,솥,풍년 신상품 와인펄 압력밥솥 4인~10인용 세원,69000,69000,0
2018-06-01,578288882,A014030,치즈,치즈(파마산크레프트 227g) / 파마산 치즈가루 피자에 뿌리는 스파게티에 파르메산 파,11020,10690,-330
2018-06-01,1105068298,F012010,종이기저귀,[+오가닉마스크]보솜이 디오가닉 밴드/팬티기저귀 3팩,35900,35900,0
2018-06-01,1210417610,C013040,청바지,[오즈세컨(o2nd)][오즈세컨] [여성] 절개 포인트 부츠컷 팬츠 2WMS2WP03500044,298000,286420,-11580
2018-06-01,729601323,C013050,운동복,밀워키 FUEL 폴리셔 M18 FAP180-502X 광택기 세차용품,723500,723500,0
2018-06-01,624284638,E061060,살충제,자연 순화 가습 효과 - 레인보우에어 휘산기 (HanGlob,159500,140360,-19140
2018-06-01,997211916,A017250,고사리,냉동 콜리플라워 1kg 화이트 브로콜리 / 아울몰,2900,2900,0
2018-06-01,135618263,E031020,가스레인지,SK매직(DM) 2구 고화력 화이트 가스렌지 GRA-813SR,125000,114000,-11000
2018-06-01,1387227503,C012040,여자학생복,빅사이즈민짱/핫한셔츠남방모음/롱/스트라이트/루즈핏,30900,30900,0
2018-06-01,322055107,C013020,티셔츠,추가금NO.summer 자체제작상품 44~120 빅사이즈까지,19900,19900,0
2018-06-01,808010674,A011180,파스타면,[Aida] [올리브유통] 아이다 스파게티면 500g X 24봉 (1박스),22100,22100,0
2018-06-01,468623605,C011030,남자학생복,레귤러 쉐도우스트라이프 블루 파란색 파란 하늘색 줄,20960,20960,0
2018-06-01,1684981504,A017120,고구마,18년산 포근포근한 감자 5/10kg,6500,6500,0
2018-06-01,294078198,C012040,여자학생복,[로로텐]썸머칠부가디건,20700,19890,-810
2018-06-01,2018437336,A013150,어묵,부산수제어묵 연육70%/전골/오뎅탕/어묵탕 330g,4500,4500,0
2018-06-01,528663467,F012010,종이기저귀,굿나이트 중24/대20/x4팩/어린이용 안심팬티,63500,63500,0
2018-06-01,766926088,A018090,잼,트라피스트수녀원 유기무화과잼 410g 무화과잼 과일,17590,17590,0
2018-06-01,1843286019,A012060,햄및베이컨,롯데햄 런천미트 340gx10캔 /스팸 /햄,21900,21900,0
2018-06-01,1663485953,C021040,실내화,가성비 끝판왕 운동화/트레킹화/등산화/슬립온,9900,9900,0
2018-06-01,300574438,C013040,청바지,여름/남자청바지/면바지/남성스키니/밴딩/일자팬츠,13800,12800,-1000
2018-06-01,1328610175,E061030,전구,LED매입등 LED다운라이트 LED조명 3 4 6 8인치 국산,3960,3960,0
2018-06-01,434044524,C021020,구두,Ferragamo 남성 구두 MASON 617509,430000,430000,0
2018-06-01,284982395,C013040,청바지,하이웨스트/반하이웨스트/하이/스키니/빅사이즈,12900,9900,-3000
2018-06-01,705978659,C012040,여자학생복,[대구백화점 I관] [클라이드]여성 집업가디건(FIASW650F),44900,38170,-6730
2018-06-01,1661451607,I011030,사진기,(컴온탑)캐논정품 EOS 1DX Mark II(18년3월),6835860,6289000,-546860
2018-06-01,890762425,E031110,청소기,오늘발송 삼성로봇청소기 VR10M7010U5 스타워즈에디션,432000,392460,-39540
2018-06-01,1283629077,L012040,치약,더유핏화이트니에스 치아미백SET/간편치아미백/사은품,24900,24900,0
2018-06-01,61627004,C013050,운동복,[안전지대] 자동차삼각대/점멸등/led후레쉬/비상등/랜턴/경관봉(,32420,32420,0
2018-06-01,332480145,C021020,구두,[구템즈/시즌오프] 발렌티노 LW0S0375 유광 슬링백,767000,667290,-99710
2018-06-01,1134787195,A011140,부침가루,삼립 / 조각케익 3개 /치즈케익 /티라미스/6가지중택,5500,5500,0
2018-06-01,541832080,C012040,여자학생복,[무지개공예] 한국전통문양 티셔츠/반팔티/한글티/외,15000,14800,-200
2018-06-01,508189576,A013170,생선통조림,동표 자연산 골뱅이 230g x1캔 /s/술안주/유동/번데기,3950,3950,0
2018-06-01,1742350730,F012020,생리대,시크릿데이 생리대 러브 산모패드10PX8팩,14900,14160,-740
2018-06-01,1170405910,C011050,남자내의,[리바이스] 남성 505 퍼포먼스 쿨맥스 반바지 다크 워시 34505-0166,69000,57270,-11730
2018-06-01,1552107026,A017090,열무,18년 6월1일부터 수확 제주 레드비트 10kg 산지직송,21900,21900,0
2018-06-01,1956055227,L012030,칫솔,대용량 일회용칫솔 모음 9종택1 1박스 1000개,32000,32000,0
2018-06-01,989913071,A021010,커피,트룽 G7 블랙인스턴트커피 30G,2290,2290,0
2018-06-01,490881265,C012060,여자내의,피핀 셰미즈 도트 점프수트 #73606/ 피핀,21800,17230,-4570
2018-06-01,639400904,E041050,냄비,[올리오] 통주물 세라믹냄비 4종세트/전골/곰솥,49900,46900,-3000
2018-06-01,990786149,C013020,티셔츠,18주니어의류초등학생옷주니어티셔츠여아티원피스롱티,8900,8010,-890
2018-06-01,1951303093,C012040,여자학생복,[스튜디오화이트]DB061물방울 니트 가디건 (MD419Q974),26000,24700,-1300
2018-06-01,1089826412,A011070,혼식곡,[오뚜기]찹쌀호떡믹스 540G x 14개,64900,64900,0
2018-06-01,2106596517,A021020,차,[동서식품] 휘핑프리마 1000ml/휘핑크림/액상프림,3900,3900,0
2018-06-01,254977887,C013020,티셔츠,나시/민소매/휘트니스나시/운동복/쿨론/반팔티/면티,3500,3500,0
2018-06-01,1057737252,C013050,운동복,dd98 슬림핏 트레이닝복 그레이 여자트레이닝복 추리,19560,19560,0
2018-06-01,1769656692,E031070,에어컨,실링팬 모음전 천장형선풍기 TV드라마 협찬 인기품목,109000,109000,0
2018-06-01,846575760,I012010,컴퓨터,정품WIN10탑재 DB-P400 인텔I7/I5탑재 게임및그래픽용,319000,319000,0
2018-06-01,897585958,A015010,참기름,[오뚜기]오뚜기 들기름 320ml,6990,6990,0
2018-06-01,1979743746,C013010,점퍼,보이즈 콘디보 14 트레이닝 자켓 남성자켓 운동점퍼,61740,61740,0
2018-06-01,59966907,C012040,여자학생복,#NAME?,49710,48720,-990
2018-06-01,1431588470,C013010,점퍼,[벤시몽] BENSIMON 엘리 그레이 여성 스니커즈 HTSO8G402G2,39200,34540,-4660
2018-06-01,1885352480,E031120,믹서,신일 믹서기 블렌더 미니믹서기 소형믹서기,25800,25800,0
2018-06-01,535101276,C012040,여자학생복,[악녀일기]포멀스틱블라우스,33380,30710,-2670
2018-06-01,982347469,A014010,우유,(가정배달) 서울우유 홈밀크 1000ml,36600,36600,0
2018-06-01,2084096233,C012060,여자내의,#NAME?,85000,72250,-12750
2018-06-01,1188357142,E011050,책상,프리퍼 책상 컴퓨터책상 철제책상 사무용책상,32500,29250,-3250
2018-06-01,1604746091,A022010,주스,시호스무디 5일 클렌즈세트 20팩+욕망뉴트리밀 4팩/욕망스무디 시즌2,89500,84450,-5050
2018-06-01,538931627,C013040,청바지,남자청바지/스판/남성바지/일자/슬림/블랙진/빅사이즈,12800,12800,0
2018-06-01,2142031426,C012060,여자내의,[플라스틱아일랜드]스칼럽 레이스 스커트(PJ1WS284),30000,25500,-4500
2018-06-01,984370798,A021010,커피,네슬레 수프리모 리필 (270G),15100,15100,0
2018-06-01,124030988,A014030,치즈,무배 미국 메세나 파마산 치즈 분말 가루 파우더 227g,10980,10980,0
2018-06-01,1979175168,C013030,스웨터,[로렌하이] 베스트상품모음 티셔츠/팬츠/셔츠/원피스,19000,19000,0
2018-06-01,1178562730,L021020,장신구,정품 14K피어싱 예쁜디자인 귀찌 귀걸이 이어커프,15900,15900,0
2018-06-01,452077918,C013020,티셔츠,(4926상)랩스타일 산전산후 수유가능한 면스판 임부8,20290,18060,-2230
2018-06-01,703618518,A018110,물엿,쌀조청 2kg 도라지 수제 생강조청 갱엿 생강 호박엿,14700,14700,0
2018-06-01,221650987,I031070,애완동물관리비,14 윌슨 테니스라켓 BLX 주스 100S (304g) JUICE,135500,113290,-22210
2018-06-01,1778501268,L021010,손목시계,[바보사랑]JA-1036 가죽시계,89100,89100,0
2018-06-01,1981599209,L012040,치약,TMC-7 치약/TMC7치약/입냄새/치아,39000,39000,0
2018-06-01,1778501269,L021010,손목시계,[바보사랑]JA-1056 가죽시계,48800,48800,0
2018-06-01,198638227,E021020,커튼,러브가랜드 커텐 가리개 커튼 식물커튼 패브릭포스터,18900,18900,0
2018-06-01,1247304649,C012030,여자상의,DZY1633 발포 꽃 루즈 원피스 803,44550,39650,-4900
2018-06-01,1813666190,A013150,어묵,부산어묵 어육90% 모듬 쌀어묵 840g 부산오뎅,9900,9900,0
2018-06-01,2115201519,A022010,주스,웰치스캔 포도맛 355ml 24ea,27800,27800,0
2018-06-01,1778501266,L021020,장신구,[바보사랑]가죽 카시오 WATCH,27000,27000,0
2018-06-01,1778501270,L021010,손목시계,[바보사랑]JA-1058 메탈시계,99000,99000,0
2018-06-01,1126289687,C013050,운동복,DYTMCN 칼리고 긴팔 져지 긴팔슈트 긴팔져지 자전거긴,138880,138880,0
2018-06-01,825393977,A012010,국산쇠고기,[무항생제 한우선물세트]한우 불고기 1호1.5kg,123500,123500,0
2018-06-01,711357242,I012010,컴퓨터,2017년 아이맥iMAC/16G/PC4-2400MHZ/삼성/SK/마이크론,219800,219800,0
2018-06-01,1600778714,I011010,TV,아남TV 가정의달 특가할인 / CST-650IM 65인치 UHD TV,799000,759000,-40000
2018-06-01,407226644,C013010,점퍼,스테판조셉 프린티드 레인코트 페이즐리 (택1) 어린이,65290,62680,-2610
2018-06-01,784574572,E021010,침구,[슈에뜨룸]리플 이불토퍼세트/여름이불세트/침대패드,39900,39900,0
2018-06-01,1573955323,A019040,소금,인산가 인산죽염(9회자죽염) 고체1kg /고체,264000,264000,0
2018-06-01,76092189,C013050,운동복,선작업NO 태양열충전 자동차LED 시큐리티 충격감지,8600,7520,-1080
2018-06-01,1838978565,A013170,생선통조림,{펭귄}펭귄번데기가미 130gx48캔,29900,29900,0
2018-06-01,871803109,A012030,돼지고기,프리미엄 듀록 돈목등심500g(숯불구이용),5400,5400,0
2018-06-01,165880329,A022010,주스,식자재 식당 양념 음료 차 레몬쥬스 화남 골든크라운,10880,10880,0
2018-06-01,427352909,C021040,실내화,[더원슈즈] Y8811 보석 장식 키높이 운동화 여성 스니커즈 슬립온,31000,29800,-1200
2018-06-01,1781577908,C012060,여자내의,빅사이즈 헬로시스터 마이주[레이스롱스커트]/ 헬로시스터,42500,33150,-9350
2018-06-01,1755972122,E011020,침대,국내산 고급 패밀리침대/국내산/하포스침대,369000,332100,-36900
2018-06-01,559256074,C011020,남자상의,밀란시아 빅사이즈 코팅자켓 ta9-2 빅사이즈 남성캐쥬,105170,105170,0
2018-06-01,1525206294,C011050,남자내의,전술바지/밀리터리/카고바지/등산바지/작업복/팬츠,42900,42900,0
2018-06-01,790811732,A018010,초콜릿,초코바/초콜릿/젤리/간식/초콜렛/카라멜/발렌타인데이,10800,10800,0
2018-06-01,1973908744,A013070,굴,청명호 살아있는 영덕대게 3kg(6~9마리)당일조업직송,46800,46800,0
2018-06-01,984370775,A021010,커피,[네슬레]네스카페 수프리모 (병)/90G,7900,7900,0
2018-06-01,1297253599,C013030,스웨터,MNT-044 베이직 3게이지 꽈배기 라운트 니트 니트티셔,42800,42800,0
2018-06-01,1889298294,A022050,탄산음료,음료수/캔음료/캔커피/콜라/사이다/코카콜라/레쓰비,5900,5900,0
2018-06-01,1072655875,C012040,여자학생복,쿨젠.린넨조끼니트조끼.시스루가디건.롱조끼.뷔스티에,25800,23800,-2000
2018-06-01,685728813,C013060,등산복,여름 남성 등산자켓 바람막이 아웃도어점퍼 w026,16000,15800,-200
2018-06-01,989913047,E061060,살충제,[헨켈]홈매트리퀴드기획45일*3번들,15900,15900,0
2018-06-01,627363431,C012040,여자학생복,[하루메이비] [하루메이비]A63 스트라이프 배색 루즈핏 롱 셔츠,34500,34500,0
2018-06-01,521830570,C013010,점퍼,[티렌]시스루점퍼 T172MSJ002,139000,111200,-27800
2018-06-01,175145422,G011070,자전거,삼천리 픽시 700C 랭스FS 불혼바 드롭바,109000,98100,-10900
2018-06-01,1391094331,L021060,유모차,쿨키즈 T4 쌍둥이유모차/T5/절충형/연년생/휴대용,180000,180000,0
2018-06-01,196571414,C013050,운동복,캔키즈 아동 52-120 나일론 바지 줄임끈 아주좋음/F01,6000,5940,-60
2018-06-01,1019886609,L012090,기초화장품,비오템 옴므 포스 수프림 젤 리엑티베이팅 50ml/로션,65900,65900,0
2018-06-01,187350354,C014010,아동복,(숲자람) 기능성 키즈 바람막이 남아바람막이 유아외,73200,73200,0
2018-06-01,1493958480,C012020,원피스,[로엠(ROEM)]파스텔 트렌치 코트 (3colors) RMJT813100,55900,55900,0
2018-06-01,454204791,C013020,티셔츠,[닥스/헤지스키즈] 이월 최대 70%할인  한정수량,17400,17400,0
2018-06-01,1211366116,C014010,아동복,[아자브키즈] 날개 블라우스 아동티셔츠 유아 여름 티셔츠,15800,15800,0
2018-06-01,1734948807,A014010,우유,연세 멸균흰우유1000mlx9입/멸균우유/ 연세우유,20900,20900,0
2018-06-01,1754494592,A019110,드레싱,[치즈몰]라베키아 발사믹비네거 그린라벨 250ml/8년산,31900,31900,0
2018-06-01,1195172657,C012060,여자내의,[걸스데일리]세이지 셔링 원피스(2size),50600,44040,-6560
2018-06-01,1244500378,C013010,점퍼,[모라도](M.MORADO) 슬리브 네트 후드 점퍼 [MFM1JP400블랙],60000,57000,-3000
2018-06-01,133310836,E021010,침구,아이르 알러지케어 기능성 침구 /이불커버/이불세트,36900,36900,0
2018-06-01,1754494593,A019110,드레싱,[치즈몰]라베키아 발사믹비네거 레드라벨 250ml/10년산,41900,41900,0
2018-06-01,140967463,A011140,부침가루,편한가게딤섬 화권꽃빵1.5kg 2개,27330,26790,-540
2018-06-01,386458130,C021020,구두,산드라 샌들 LKR273 여자샌들 여성샌들(YA02004),64700,60820,-3880
2018-06-01,1754494591,A019110,드레싱,[치즈몰]뷰포 사과 사이다 비네거 (식초) 500ml,8100,8100,0
2018-06-01,1474483252,C013020,티셔츠,[티탁]기본티5900~루즈핏 롱티셔츠/무지,10000,6900,-3100
2018-06-01,1379849640,C013020,티셔츠,지오치 라운드 티셔츠 7D45311 여성 티/ 네파,34500,32780,-1720
2018-06-01,150184087,A018090,잼,오뚜기딸기쨈850g,11570,11570,0
2018-06-01,827688146,E061010,세탁세제,한국존슨 에프킬라 킨 [24개] Y,49390,49390,0
2018-06-01,1437047087,F012010,종이기저귀,2018 보솜이 리얼코튼 밴드 공용 3팩,34900,33160,-1740
2018-06-01,689456241,C012040,여자학생복,[포에버21]청키 리브 니트/FOREVER21/니트/스웨터/롱니트,37900,15160,-22740
2018-06-01,1513533483,E021010,침구,드라마 그 상품 신상 이불+베개세트/차렵이불+베개,56000,44900,-11100
2018-06-01,390967807,C013050,운동복,푸조 남여공용 니트 트레이닝 세트(FZ133-2) 긴팔체육,65310,65310,0
2018-06-01,755107782,E031120,믹서,포시엠 CM-410B 클래식블렌더 믹서기 6편칼날 분쇠 D1,188000,188000,0
2018-06-01,1403121212,A011170,떡,(냉장)두솔 초밥나라600g(초밥용유부)x10개,86600,84010,-2590
2018-06-01,458234267,F012020,생리대,100%유기농본 생리대 팬티라이너 순면커버 사은품증정,14900,13900,-1000
2018-06-01,1185628921,I031040,생화,로티캠프 대형 파라솔 비치파라솔 카페파라솔 초대형,25500,22830,-2670
2018-06-01,2090454574,C013020,티셔츠,수맘 미시원피스 빅사이즈원피스 블라우스 롱티,9900,9900,0
2018-06-01,654844429,C013040,청바지,[게스]GUESS 남성_[기획] 블랙블랙 스키니(MH3D9130),59000,49560,-9440
2018-06-01,1903654472,F011130,홍삼,한삼인 홍삼정진(250G),29900,29900,0
2018-06-01,909781839,F011130,홍삼,[강원인삼농협] 6년근 수삼 소 750g 14-15편,71900,71900,0
2018-06-01,909781838,F011130,홍삼,[강원인삼농협] 6년근 수삼 중 750g 11-12편,76900,76900,0
2018-06-01,1715725737,L012090,기초화장품,리리코스 수분앰플 리스토어링 v콜라겐 플라센타 옥시,27000,27000,0
2018-06-01,1539674623,A015020,식용유,올리타리아 포도씨유500ml 5병 (스티로폼),27900,27900,0
2018-06-01,193673892,E041010,식기,[거북 도자기수저4P-우단케이스] 스푼세트 수저세트 숟가락세트 부부수저세트 예쁜수저,44500,44500,0
2018-06-01,1262195587,E041060,수저,유아 아동 스푼 포크 수저 케이스 에디슨 세트 숟가락,7500,4000,-3500
2018-06-01,260187130,C011030,남자학생복,[커스텀멜로우] 스트라이프 트위드니트 블루종 CWWAS17111NYX,99000,81180,-17820
2018-06-01,1525233883,L021020,장신구,로즈골드 반지/곡선라인/큐빅/신상/OPR893,165000,165000,0
2018-06-01,392072924,C013020,티셔츠,T1389-스크래치 페인팅 언발 티셔츠 여자티셔츠 라운,12620,12620,0
2018-06-01,1761017718,A018080,설탕,삼양사 큐원 하얀설탕 갈색설탕 3kg/백설탕/황설탕,3600,3600,0
2018-06-01,1795235926,L021020,장신구,특가/5mm천연진주 세줄비드/88cm드롭/Pearl beads,120000,120000,0
2018-06-01,587882400,A021010,커피,맥심 모카골드 오리지날 500g 알커피,13510,12700,-810
2018-06-01,501660945,L021030,가방,타거스 CN418EU 17-18인치 탑로드 노트북 서류가방/WR,56000,55000,-1000
2018-06-01,826571577,E011020,침대,홈잡스 침대테이블/다용도책상 싱글/슈퍼/퀸,49900,49900,0
2018-06-01,1468621681,A012010,국산쇠고기,{TV홈쇼핑정품}목우촌 한우사골세트 1+1/꼬리반골소뼈,148000,146520,-1480
2018-06-01,2065655074,D031010,주택수선재료,진성산업 베란다조립식마루발판 바닥재 욕실매트 타일,32800,31820,-980
2018-06-01,884705664,C011030,남자학생복,4XL 빅사이즈 셔츠 남방 무지 체크남방 청남방 남자,13800,13800,0
2018-06-01,878118339,A011010,쌀,2017햅쌀/찹쌀섞인쌀/서산간척지쌀/황금햇쌀20kg/10kg,48900,48900,0
2018-06-01,1444307118,C021020,구두,VA-132 남성구두 정장화 천연가죽 남자신발 슬립온 로,63110,56800,-6310
2018-06-01,2010077888,A013090,전복,그린홍합800g 초록입홍합 초록잎홍합 녹색잎 푸른홍합,9200,9200,0
2018-06-01,595511221,C012040,여자학생복,LAP V 스트라이프 니트 (AJ2KH460),35400,31860,-3540
2018-06-01,311562193,C012060,여자내의,[화이트폭스]라인포인트와이드일자핏스판팬츠,8000,6970,-1030
2018-06-01,498593684,A012060,햄및베이컨,(냉동)사조남부햄 베이콘(베이컨)1kgX8개베이콘 베이,209000,183920,-25080
2018-06-01,1140085595,A012060,햄및베이컨,에스푸드 후레쉬베이컨 1kg2개 후레쉬베이컨 베이컨,77390,69660,-7730
2018-06-01,770275405,E011010,장롱,[잉글랜더]베를린 드레스룸 800 행거형/서랍형 옷장,62900,62900,0
2018-06-01,1518888377,C012060,여자내의,여성용 방한 밴딩 레깅스 밴딩레깅스 방한레깅스 캐주,23640,23640,0
2018-06-01,440294530,A015020,식용유,해표 포도씨유900mlx12개(B)카놀라유 식용유 해표 올,116200,102260,-13940
2018-06-01,1218261671,C014010,아동복,한국 코사지 프릴 소매 정장3종 핑크(3-24개월)800012,56950,55250,-1700
2018-06-01,1208546059,C012040,여자학생복,[공구우먼] 얼리브 7부스트라이프 셔츠 29792 빅사이즈 여성의류,38000,38000,0
2018-06-01,677098848,C012060,여자내의,BYC여성 기모 무발 레깅스타이즈(T1104) 스타킹 BYC 팬티스타킹 타이즈 레깅스,12250,10910,-1340
2018-06-01,588989541,I031040,생화,[타이탄코리아] 후레쉬/랜턴/줌라이트/손전등/지진,9800,9800,0
2018-06-01,277060678,C021040,실내화,나이키 운동화/런닝화/신발/트레이닝화/남자 운동화,89000,88110,-890
2018-06-01,1731952501,I031010,장난감,레고10836 듀플로 타운 광장/듀플로,84010,84010,0
2018-06-01,1402905152,E061060,살충제,새집증후군 제거제-새가구 새차냄새 완벽제거 2년사용,15000,15000,0
2018-06-01,1471367351,C013020,티셔츠,[그랜피니] 맨투맨/긴팔/후드/티셔츠/무료배송/데일리,24900,24900,0
2018-06-01,1288032496,E021010,침구,국산 올바른 순면 차렵이불/이불/솜이불,16900,16900,0
2018-06-01,430568387,A019030,생강,적초생강 (참존 1.2k) X10,41770,37180,-4590
2018-06-01,2124516150,C013010,점퍼,[탑기어] 봄 자켓/팬츠 최종균일가29종_DK98C721,15000,14070,-930
2018-06-01,898425871,A013170,생선통조림,슈퍼스타 오뚜기 마일드참치 (150g*5입),11500,6990,-4510
2018-06-01,859030712,C012060,여자내의,[에이인]modern linen wrap skirts (3 colors),37000,35150,-1850
2018-06-01,1666986696,A012030,돼지고기,[델리미트] 이베리코 흑돼지 꽃목살 1kg,33000,33000,0
2018-06-01,1507669020,L012060,샴푸,케라시스 대용량 퍼퓸 샴푸 린스 600ml X5개 3000ml,19900,19900,0
2018-06-01,1232259170,A015010,참기름,참기름/들기름/참다온기름세트/참기름세트/참다온,24800,24800,0
2018-06-01,2002204608,A013090,전복,[마산어시장 이바다몰]국내산 생물재첩 2kg/어패류,16000,16000,0
2018-06-01,887810483,C012040,여자학생복,당일발송[ Equipment ] 누드 슬림시그니처블라우스,159000,159000,0
2018-06-01,1479188999,E061030,전구,금호전기 20W 삼파장 전구 장수 번개표 15W 형광등 등,1500,1500,0
2018-06-01,265591334,I053010,공책,빈티지 양장노트 7종 양장줄노트 줄양장노트 줄노트,15180,15180,0
2018-06-01,552533578,C015030,넥타이,젠키/젠키정장/주니어타이/나비타이/성인타이/보타이,990,990,0
2018-06-01,897561931,A012020,수입쇠고기,E-호주산 곡물우 우둔(홍두깨/장조림용) 100G,3500,3500,0
2018-06-01,1395402806,C013010,점퍼,롱우스 롱코트 예쁜여성코트 DM-5081,83550,79380,-4170
2018-06-01,714571140,A013030,조기,영광굴비세트 2kg 굴비 영광 참조기 법성포 선물세트/,707000,699900,-7100
2018-06-01,2087984581,C013050,운동복,코리아 울트라파워9인치광택기 12V전용/차량용 광택기,54300,53220,-1080
2018-06-01,527751885,L012060,샴푸,아모스/O2녹차실감샴푸/스마트샴푸/헤어팩/컬링에센스,19900,19900,0
2018-06-01,269113491,C011030,남자학생복,(신상)빅사이즈 소매나염집업후드 가디건 eku1711-002,71570,71570,0
2018-06-01,724042129,A013090,전복,신일수산 모듬조개 2kg 조개 조개구이 조개찜 조개탕,12900,12900,0
2018-06-01,1898171783,E011040,소파,무료배송! 라일 2인 수납소파/2인용쇼파/패브릭소파,139900,115110,-24790
2018-06-01,1238119552,A011170,떡,(냉장)두솔 초밥나라600g(초밥용유부)x10개,87620,87620,0
2018-06-01,1848185709,C013020,티셔츠,[핫핑] 맨투맨 후드티 후드집업 단가라 루즈핏 프린팅,17800,12800,-5000
2018-06-01,578624512,I031010,장난감,SLIDING CAR 포크레인 붕붕카 / 굴삭기 모래놀이,23700,23700,0
2018-06-01,392265888,E011050,책상,비즈니스 보루네오 페이 스틸 테이블 겸용 책상시리즈,69000,69000,0
2018-06-01,266745323,A013070,굴,속초시장 울릉도 홍게 울릉도 심해 2 000m 홍게 어획,23800,23800,0
2018-06-01,427893032,A022030,생수,[백산수] 백산수 2리터 18병 / 생수,16300,16300,0
2018-06-01,741158058,A016160,과일가공품,슈퍼푸드 마키베리분말 150g 동결건조 칠레 마키베리,23000,22770,-230
2018-06-01,1317177230,C015040,장갑,실버D 통기성이 좋은 성인용 매쉬 손싸게 할아버지장,55640,55640,0
2018-06-01,1443165189,L021030,가방,ML-1901 메신저백 크로스백 남자 여성 학생 여행가방,21800,21800,0
2018-06-01,1899675589,C013020,티셔츠,[필골드] SLKN505 엔리코 와펜 오버핏 폴라니트,39800,39800,0
2018-06-01,1480564464,I031010,장난감,바이킹토이 커비 바이크 4종세트,40360,40360,0
2018-06-01,1875144154,C013020,티셔츠,아쿠아 냉감티셔츠/여름티셔츠/비치웨어/래쉬가드,19800,19800,0
2018-06-01,1011186670,F011150,건강기능식품,[홈쇼핑 완판 상품] 먹으면서 빼는 먹슬림 복숭아맛 150G*10팩,33000,17500,-15500
2018-06-01,759077261,C015030,넥타이,나비넥타이/커머밴드/리본/유아/아동/교복넥타이/학생,2800,2800,0
2018-06-01,2055751194,C013020,티셔츠,타미힐피거 반팔티 시그니처 물량확보 당일출고!!,39800,39800,0
2018-06-01,1778503964,L021010,손목시계,[바보사랑]보이런던 게르마늄 시계 BLD821-SV,102600,102600,0
2018-06-01,2042488338,A018050,비스킷,무배[해태]1500 아이비 크래커(1박스-24갑)/참크래커,17800,17800,0
2018-06-01,432372360,A012050,소시지,진주햄 천하장사 28g x 3개 X 60EA_1BOX,100730,89650,-11080
2018-06-01,1778503961,L021010,손목시계,[바보사랑]보이런던 게르마늄 시계 BLD821-RG,111600,111600,0
2018-06-01,762284679,A021020,차,세미 고구마라떼/홍차라떼/녹차라떼/블랙빈 라떼/등,8800,8800,0
2018-06-01,1676902460,I012010,컴퓨터,특가 65만! 1TB HDD행사 삼성데스크탑 DM500T7A-A34A,735780,699000,-36780
2018-06-01,1375817027,C012020,원피스,히포크라테스 스프 350g 9병,132960,132960,0
2018-06-01,520821811,G022020,자동차타이어,콘티넨탈 타이어 컨티넨탈 타이어 g80 19인치,209600,180260,-29340
2018-06-01,559871063,L021030,가방,노트북가방 백팩 남성 태블릿 파우치 남자,19900,19900,0
2018-06-01,391312486,A012010,국산쇠고기,[홈플러스]양념소불고기_1.5kg,19500,18530,-970
2018-06-01,909781816,F011130,홍삼,[강원인삼농협] 6년근 수삼 대 750g 9-10편,85900,85900,0
2018-06-01,909781815,F011130,홍삼,[강원인삼농협] 6년근 수삼 특대 750g 7-8편,93900,93900,0
2018-06-01,304629883,C012060,여자내의,여자슬랙스 KAA 8879 1개 슬랙스 슬렉스 여자슬랙스,31500,31500,0
2018-06-01,909781814,F011130,홍삼,[강원인삼농협] 6년근 수삼 왕대 750g 5-6편,102900,102900,0
2018-06-01,599833997,C012030,여자상의,여름신상 미니롱 나시원피스 빅사이즈 임부복 홈웨어,8900,8900,0
2018-06-01,63419352,C015040,장갑,매쉬 반장갑/긴장갑/여름 등산장갑/트래킹장갑/스포츠,5800,5340,-460
2018-06-01,95895745,C014010,아동복,토미힐피거 남 아동 5 세 패딩 코트 기모안쪽 초겨울,36540,36540,0
2018-06-01,1258896738,C013020,티셔츠,여름/티셔츠/반팔/커플티/나염티/청자켓/데님,9900,9900,0
2018-06-01,897739688,A014030,치즈,매일 체다슬라이스치즈 (200G/10매)+3매추가,4100,2200,-1900
2018-06-01,1305084964,C011050,남자내의,빅톤 빅사이즈 카고 반바지,27800,27800,0
2018-06-01,1749700660,A012010,국산쇠고기,마슘환 고급말뼈환 말뼈가루환 천연칼슘식품 말뼈효능,61000,59170,-1830
2018-06-01,1082293082,A011170,떡,정선 수리취인절미 2kg/수리취떡/찹쌀떡/취떡/두텁떡,31000,30690,-310
2018-06-01,1404265423,F012020,생리대,[위스퍼] 보송보송 생리대 알찬구성,13900,13900,0
2018-06-01,621265638,C013050,운동복,포인트 LED 무드램프 재털이/재떨이/차량용재털이/재떨이/재털이/자동차용품,2900,2580,-320
2018-06-01,2041407964,C013020,티셔츠,면스판 슬림나시 스판쫄/나시티/나시/남자나시/민소매,5900,5900,0
2018-06-01,597460098,C012020,원피스,MSG (대원미 대원 3K) x4,119150,119150,0
2018-06-01,1028887176,C012060,여자내의,가죽반바지 가죽바지 래터링 벨트세트 SD-6145 래더바,24150,24150,0
2018-06-01,951188879,C011030,남자학생복,[테이트]남녀공용 솔리드 헨리넥 마 셔츠(KA7U4-URC810YP),14000,12320,-1680
2018-06-01,440294587,A015020,식용유,해표 포도씨유500mlx20개(B)식용유 카놀라유 해표 올,112400,98920,-13480
2018-06-01,656360550,L021030,가방,블루 펄 레이스_가터벨트EBFC637011BL/ 에블린,9000,7380,-1620
2018-06-01,344770552,L021020,장신구,14k 골드핀 귀걸이 나비 별 크리스탈 귀걸이 큐빅 18k 이어링 패션귀걸이 주얼리,30900,30900,0
2018-06-01,416025814,C011030,남자학생복,슬림 카라포인트 비취패턴 블루스카이 셔츠 남자남방,20390,20390,0
2018-06-01,1299843946,C013010,점퍼,[시보니] 퍼트리밍 롱무스탕,97900,97900,0
2018-06-01,1405084659,A013170,생선통조림,동원 자연산골뱅이400g,5500,5500,0
2018-06-01,988036273,A016160,과일가공품,스위티오 파인애플 2입(봉),6990,6990,0
2018-06-01,1537375564,C012040,여자학생복,지나블리스 체크 롤업 긴팔 셔츠 7422,19800,19800,0
2018-06-01,255395360,C013050,운동복,EXO 논슬립패드 논슬립거치대 스마트폰거치대,2500,2290,-210
2018-06-01,2103554871,F012020,생리대,[파우치증정]화이트 생리대 특가 구성 모음전 최저가,10500,10500,0
2018-06-01,897739692,A014030,치즈,매일 유기농 어린이 치즈 (180G),5400,4400,-1000
2018-06-01,1317478372,C013010,점퍼,[대구백화점 I관] [트윈키즈]와샤 바람막이점퍼(T8MT5J01),28000,24360,-3640
2018-06-01,129432883,I031040,생화,강철 단조팩 20cm 30cm 40cm 캠핑용품,1100,1000,-100
2018-06-01,718685222,A019080,고추장,청정원 순창쇠고기볶음고추장 2팩+증정 쌈장200g,9040,9040,0
2018-06-01,1112304375,C014010,아동복,한국 리본 베어 아기정장 5종세트(3-36개월) 202287,66030,66030,0
2018-06-01,1614461664,A015020,식용유,[사조해표]해표 올리브유 900mlx2병,12900,12900,0
2018-06-01,612925964,C013010,점퍼,[프랜치캣]레드캣돌항공점퍼(Q71DAJ090),99000,79200,-19800
2018-06-01,1342263268,C012040,여자학생복,수지네 구제 콜롬비아 핑크 패딩조끼 여성 M 19-34,21590,21590,0
2018-06-01,1071028697,A018090,잼,오뚜기딸기쨈850g,14480,14480,0
2018-06-01,451173549,A019010,고춧가루,늘푸른 특 청양고추가루 2.4kg2개 가루 고추가루 청양,81790,73620,-8170
2018-06-01,311021757,L012090,기초화장품,애터미 스킨케어 특가!/치약/칫솔/토너/선크림/세제,14900,14900,0
2018-06-01,776639260,L021020,장신구,루비사파이어반지/화이트도금/스털링실버/신상,119000,119000,0
2018-06-01,1470658427,A017040,양배추,(맛나)신선야채모듬4kg/덕양식품,29300,26370,-2930
2018-06-01,1620660130,C013010,점퍼,[다바걸][다바걸] 반전매력투웨이점퍼,122000,115900,-6100
2018-06-01,706459805,A022050,탄산음료,트레비 400mlx20펫(라임/레몬)+보틀/마스크팩 증정,13900,13900,0
2018-06-01,687845599,C012040,여자학생복,엄마옷 데드라 8B-BL001 에트로프릴블라우스,50400,39870,-10530
2018-06-01,770104092,A015020,식용유,[올리타리아] [올리타리아]포도씨유(1L)/포도씨기름,10000,10000,0
2018-06-01,272199420,L021050,우산,해피레인 3단우산 실버코팅우산2단우산 돌답례품,2800,2500,-300
2018-06-01,979828470,E021010,침구,[쁘리엘르]포근한~순면 차렵이불/세트/마이크로화이바,24900,24900,0
2018-06-01,670804334,C014010,아동복,단추리본심플원피스/여름원피스/여름신상/원피스등,9900,9900,0
2018-06-01,420891132,A015020,식용유,[사조해표] 식용유 500ml x 5개 콩기름 포도씨유 카놀라유 튀김유,9900,9900,0
2018-06-01,1461424213,E021010,침구,[까사리빙]모달쿨시어서커침구풀세트Q 이불+패드+베개커버,89900,89900,0
2018-06-01,429881939,C012040,여자학생복,미스틱 아사면 셔츠,14900,14900,0
2018-06-01,691156340,A011100,라면,감자사리(면) 2kg 휴먼앤푸드 / 아울몰,3700,3700,0
2018-06-01,1093247603,E031080,선풍기,한솔일렉트로닉스_라디에이터 HSR-1000GH 5핀,46000,46000,0
2018-06-01,1190613767,E011060,의자,베스트리빙 원목내츄럴의자/식탁의자/원목의자,19900,19900,0
2018-06-01,1093247602,E031080,선풍기,한솔일렉트로닉스_라디에이터 HSR-1500GH 7핀,54000,54000,0
2018-06-01,1093247605,E031080,선풍기,한솔넥스코_라디에이터 (타이머형) HSI-R100T 5핀,51000,51000,0
2018-06-01,1093247604,E031080,선풍기,한솔넥스코_라디에이터 (타이머형) HSI-R150T 7핀,59000,59000,0
2018-06-01,1916904530,C013040,청바지,[바지킹]당일출고/빅사이즈/슬랙스/면바지/신상/일자,11900,11900,0
2018-06-01,1093247601,E031080,선풍기,한솔일렉트로닉스_라디에이터 HSR-2000GH 9핀,61000,61000,0
2018-06-01,1093247600,E031080,선풍기,한솔일렉트로닉스_라디에이터 HSR-2500GH 13핀,78000,78000,0
2018-06-01,1778708845,L021020,장신구,[바보사랑][액세서리키친] 925실버 Side Star 귀걸이 A7904E001,15900,15900,0
2018-06-01,1778708847,L021020,장신구,[바보사랑][액세서리키친] 925실버 Allie Message 팔찌 A7916B002,23900,23900,0
2018-06-01,2132715460,C013010,점퍼,봄 여름 바람막이 스판 블루종 사파리 야상 니트 홑겹,20800,20800,0
2018-06-01,56402684,C013010,점퍼,[리스트][LIST] 심플 스트링 점퍼 TWWJPH60020 (3가지 색상),50000,41500,-8500
2018-06-01,1778708846,L021020,장신구,[바보사랑][액세서리키친] 925실버 Allie Daily 팔찌 A7916B001,19900,19900,0
2018-06-01,2089111017,A022010,주스,태평마트 필리핀 수입 프로푸드 망고 퓨레 스위트 1kg 농축 망고 쥬스 주스 과즙 음료,15880,15880,0
2018-06-01,1143308320,D031010,주택수선재료,돼지표/슈퍼코트/바닥전용왁스/데코타일/타일코팅제,12500,12500,0
2018-06-01,300633299,C012060,여자내의,[SOUP][숲] 스트라이프점프슈트 ST6OV71 47055 (P000364030),39700,35730,-3970
2018-06-01,1765640993,A011100,라면,구포국수 중면 소면 콩 메밀 녹차 감자 기능성국수,1850,1850,0
2018-06-01,1336571850,I053030,복사용지,더블에이 A4 복사용지(A4용지) 80g 2000매 2BOX,41600,41600,0
2018-06-01,1319079658,C011050,남자내의,와인 남녀공용 가디건 교복몰 학생복 교복조끼 남자교,45220,45220,0
2018-06-01,744482793,C011050,남자내의,레노마 18 S S 새롭게돌아온 밴딩면스판팬츠 4종택1 RKAIBP00A,48970,48970,0
2018-06-01,1629308104,C011050,남자내의,스판쫀쫀착용감굿 빅사이즈가능 카고일자 워싱카고11,33900,31900,-2000
2018-06-01,1093247629,E031080,선풍기,신일금속_주물 화목 벽난로 SL-094,1260000,1260000,0
2018-06-01,1093247628,E031080,선풍기,한솔넥스코_컨벡터히터 HSH-C1600AP,53000,53000,0
2018-06-01,1093247636,E031080,선풍기,이노크아든_ 원통형 카본히터 IA-1000 (1000w),69000,69000,0
2018-06-01,2084133713,C013040,청바지,(SR)MHA523 남자빅사이즈스판청바지 /(참고)남성빅사,67800,59670,-8130
2018-06-01,1093247632,E031080,선풍기,신일금속_화목겸용 펠렛 난로 SL-740,930000,930000,0
2018-06-01,1093247631,E031080,선풍기,신일금속_펠렛 전용 난로 SL-720,710000,710000,0
2018-06-01,123466899,A014050,달걀,특허받은 동물복지! 메리골드 유정란 계란 20구,11900,11900,0
2018-06-01,1093247634,E031080,선풍기,한일 원적외선 선풍기형 히터 EHB-1468C,75200,75200,0
2018-06-01,1397169478,C013010,점퍼,코콤 LED시스템 주방등 25W 주광색 전등 거실등 조명-,65250,65250,0
2018-06-01,1093247630,E031080,선풍기,신일금속_주물 화목 벽난로 SL-095,930000,930000,0
2018-06-01,2069421386,A017180,호박,[e-제주푸드][제주우다영농조합] 제주 초당옥수수 20개입(개당 14cm이상  180g이상)6월,32000,32000,0
2018-06-01,522225296,C013010,점퍼,T2137-여성 데일리 보송 후리스 반 집업 양털집업 포,49910,47420,-2490
2018-06-01,1666369211,A011050,콩,서래푸드 볶음땅콩 500g x 2개 커피땅콩/찹쌀/견과류,6900,6900,0
2018-06-01,907009457,F011150,건강기능식품,27곡 참선식 700g/선식/미숫가루,11900,10900,-1000
2018-06-01,1151992846,C013010,점퍼,내구성좋고 100퍼센트방수 여성 슬림 코트형 우의우비,28900,27460,-1440
2018-06-01,1093247627,E031080,선풍기,한솔넥스코_컨벡터히터 HSH-C2000AP,63000,63000,0
2018-06-01,241882355,E011020,침대,[잉글랜더]루미 빅사이즈 평상형 침대/1+1 패밀리침대,239000,214900,-24100
2018-06-01,2126154465,E031140,비데,비데모음 계림비데 전자식비데 방수비데,155000,155000,0
2018-06-01,85842095,A017040,양배추,(면)(냉동)청학 부추1kg,7730,7730,0
2018-06-01,375026666,C012060,여자내의,빅사이즈/망사/주름/롱/스커트 망사주름롱스커트 빅사,42510,41240,-1270
2018-06-01,1352795012,A016090,참외,꿀벌 성주참외 7kg/ 실속가정용,13900,13900,0
2018-06-01,1032246063,E031010,전기밥솥,쿠쿠 내솥 [C422] CRP-M112FD 밥솥 교체용,33690,33690,0
2018-06-01,97396092,L021030,가방,[국산] 신사 시원한 여름양말// 정장양말 7족/10족 [고급 손봉조/사계절용][KJC/피에르,25190,25190,0
2018-06-01,180950084,I011030,사진기,니콘 D5600 본체 정품 대박사은품+이벤트 명품마을,610430,589670,-20760
2018-06-01,504679929,C012040,여자학생복,[모다아울렛][반에이크]반에이크 뒷목셔링블라우스 VA86BLM204Z-RD,39800,36220,-3580
2018-06-01,1093247658,E031080,선풍기,이노크아든_ 원통형 카본히터 온풍팬장착 IA-2000F (2000w),99000,99000,0
2018-06-01,1862641126,L012010,면도기,도루코 페이스 6 x10개 6중날 4중날/일회용면도기,11500,11500,0
2018-06-01,742915068,A022050,탄산음료,펫트음료써니텐 1.5L오렌지/파인애플/포도맛 탄산음료,13600,13600,0
2018-06-01,489129487,C014010,아동복,[젤리스푼][젤리스푼] 멋나는배기데님팬츠_MO,12900,11610,-1290
2018-06-01,2132487260,E061100,습기제거제,물먹는 하마 옷장용x24/제습제 습기제거제 피죤 뽀송,26800,26800,0
2018-06-01,1347859854,A019030,생강,하지카미 (생강순 605g) X10,282890,251780,-31110
2018-06-01,77138348,C011030,남자학생복,마크 패션 오리털 자켓솜털 깃털 보온 따뜻 패딩 후드 이중주머니 YKK 지퍼 착한 가격,209340,209340,0
2018-06-01,779674858,C013050,운동복,오토 에어맨 TOUR 에어컴프레셔 차량용공기주입기 차,73970,73970,0
2018-06-01,895801233,A022020,두유,[정식품]정식품 베지밀 A (190ML/병),1100,1100,0
2018-06-01,2089548919,A019050,간장,홍일식품 홍게맛장소스 레드  골드  천연 만능 맛간장,14900,14900,0
2018-06-01,1999265707,C013020,티셔츠,빅사이즈민짱/심쿵 신상티모음/루즈핏/롱/박시,9900,9900,0
2018-06-01,735442639,C011050,남자내의,아디다스 맨유 카프리 팬츠 (AP6128 ),64730,57610,-7120
2018-06-01,38890327,E061020,섬유유연제,(반짝특가)펠체아주라 퍼퓸 섬유유연제 3L x 2개,10900,10900,0
2018-06-01,620289415,A014030,치즈,파마산 치즈블랜드 1kg 대용량치즈 파마산가루 치즈,21900,21900,0
2018-06-01,1063953870,C011030,남자학생복,남자 린넨 여름/셔츠/체크/단가라/난방/반팔/남자셔츠,29800,29800,0
2018-06-01,145671630,C013020,티셔츠,[그랜피니] 맨투맨/긴팔/후드/티셔츠/무료배송/데일리,24900,24900,0
2018-06-01,1854552202,A016120,바나나,유기농 바나나/무방부제/아침대용/페루산900g내외 3봉,17500,17500,0
2018-06-01,1880132709,I012010,컴퓨터,리퍼 i5 3세대 올인원PC/ SSD 탑재 완벽한 가성비,329000,269000,-60000
2018-06-01,958418997,A019180,즉석식품,[CJ]CJ 햇반 발아 현미밥 (210G*4입+2입),6990,6990,0
2018-06-01,895864808,A018090,잼,[청정원]청정원 유기농 블루베리쨈 300g,9700,9700,0
2018-06-01,1280020247,I031040,생화,컨텐더 시합용헤드기어CHG-730,97500,95550,-1950
2018-06-01,752088623,C011050,남자내의,남 린넨/코튼 이지 팬츠 118529/ 지오다노,39800,32640,-7160
2018-06-01,664196792,A011010,쌀,2017년 햅쌀 지리산메뚜기쌀 플러스 / 수라간쌀 10kg,26700,26700,0
2018-06-01,864050212,C013010,점퍼,럭셔리야상베스트(SF6MVT130)/ 스테파넬,50000,42500,-7500
2018-06-01,895864805,A011080,밀가루,[오뚜기]오뚜기 옛날국수 (소면/1.5KG),4090,4090,0
2018-06-01,83797066,A014020,분유,헤모틴틴베이비(1gx60포)1캔/비타민/철분제,11900,11900,0
2018-06-01,983093216,C013050,운동복,CAREX 자동차 문콕방지 도어가드 스펀지 패드 4P,5000,4950,-50
2018-06-01,63902424,A018110,물엿,[두레촌] 식품 명인 쌀 조청 1병(480g) 전통 물엿 꿀 조미료 엿,7000,7000,0
2018-06-01,1095568174,C013020,티셔츠,(아띠벗) 봄심상/M~2XL/맨투맨/빅사이즈여성의류,17800,11800,-6000
2018-06-01,58109423,A012010,국산쇠고기,팔도 견과세트 1호(고품격 웰빙 선물세트)사은품 답례,78700,78700,0
2018-06-01,193673834,E041010,식기,[청홍매화 은수저 4P-우단케이스] 스푼세트 수저세트 숟가락세트 부부수저세트 예쁜수,50000,50000,0
2018-06-01,58110416,A012010,국산쇠고기,팔도 견과세트 3호(고품격 웰빙 선물세트)사은품 답례,72350,72350,0
2018-06-01,102668991,F011150,건강기능식품,종합비타민 6개월분 멀티 비타민 미네랄 종합 영양제,16800,16800,0
2018-06-01,1295509647,A011140,부침가루,두레생협 포도컵푸딩(78g)5개,18000,17460,-540
2018-06-01,524695720,C012020,원피스,브로치장식 심플자켓 Z181MSF002/ 쥬크,159000,135150,-23850
2018-06-01,293757859,E061020,섬유유연제,FC 베이비전용 세탁세제 refill 유아용 베이비세제 어,21570,21570,0
2018-06-01,1372331852,C013020,티셔츠,(4926상)랩스타일 산전산후 수유가능한 면스판 임부상,17160,17160,0
2018-06-01,2098731671,A013170,생선통조림,동원 자연산 골뱅이 400g 골라담기/자연산/구운/한입,6500,6500,0
2018-06-01,578940885,C015040,장갑,버튼예식장갑 M 10개입 다용도장갑 예식용장갑 결혼장,18690,18690,0
2018-06-01,958418962,A012060,햄및베이컨,목우촌 김밥에 쏙 100G,1490,1490,0
2018-06-01,756482860,C015040,장갑,시원한 봄 여름 가을 남 여 등산 스포츠 자전거 장갑,5500,5020,-480
2018-06-01,895801255,A022020,두유,[정식품]정식품 베지밀 B (190ML/병),1100,1100,0
2018-06-01,590905414,C013010,점퍼,JK261-러브미 블루종 점퍼-점퍼 캐주얼룩 데일리룩 아,57000,50730,-6270
2018-06-01,1742881829,E031110,청소기,[LG전자] LG판매점 (JS) C40BGMY 7종흡입구 싸이킹 진공청소기,169890,158000,-11890
2018-06-01,1221440138,C012060,여자내의,소피아 5부 마 반바지 핫팬츠 밴딩 바지 여성 캐주얼,8840,8740,-100
2018-06-01,1736689125,A016110,딸기,2017년 산딸기 1kg (냉동) / 특별감사할인행사,9900,9900,0
2018-06-01,1280020275,I031040,생화,컨텐더 이글헤드기어CHG-731-합피,73500,72030,-1470
2018-06-01,1569764604,A011010,쌀,[2017년햅쌀 백진주 10kg]현미부터 백미까지 분도선택,29000,29000,0
2018-06-01,1280020279,I031040,생화,컨텐더 이글헤드기어CHG-732-가죽,121500,119070,-2430
2018-06-01,1619345656,C013020,티셔츠,스위트바니 여름신상 매일업뎃! 무지/반팔/롱티,5900,5900,0
2018-06-01,1923476368,C015020,모자,베이스볼캡 야구모자 볼캡 스판캡 메시캡 MLB스타일,13300,13300,0
2018-06-01,1010379364,A011170,떡,청정원 부산남포동식 왕떡볶이 412gx3봉,16900,16900,0
2018-06-01,1983380176,A019080,고추장,쇠고기볶음고추장 800g 전통의 재래식 장 담그는 방법,12000,12000,0
2018-06-01,1152121744,A021010,커피,조지아 고티카 에스프레소 마일드10mlX30개-액상커피,11400,11400,0
2018-06-01,225317882,A018010,초콜릿,자유시간 미니690gx3개 가나미니 핫브레이크 초코초코,25200,25200,0
2018-06-01,1542590294,C012020,원피스,[플리츠미] 꽃보다 플리츠미 29000원 균일가 4종택1,29000,25520,-3480
2018-06-01,50145106,C011030,남자학생복,인터페이스 제작 양면가디건 ROMANCE 후드집업자켓,29700,29700,0
2018-06-01,2071111630,C013020,티셔츠,국산 민소매 티셔츠/라운드/쿨론/반팔티/나시티/흰티,3400,3400,0
2018-06-01,1358751469,L021030,가방,백팩 여성 남자 학생 책가방 노트북 여행용 배낭 등산,17900,16900,-1000
2018-06-01,1229924602,C013040,청바지,[탑걸]허리밴딩와이드데님팬츠(TIZ1DP607F)(의정부점),34300,27830,-6470
2018-06-01,1142034727,A014010,우유,바른목장우유190ml(24팩)/내츄럴/딸기/쵸코,16900,16900,0
2018-06-01,50980786,C015040,장갑,랜드스케이프_모장갑W(여성용) 모직장갑 보온장갑 따,16620,16620,0
2018-06-01,410949436,C013030,스웨터,MRO 부클사 폴라 니트 세터 남성겨울폴라티 넥니트 목,63660,63660,0
2018-06-01,1178491935,C013020,티셔츠,[대구백화점 II관] [베네통키즈]플라워레터프린트티셔츠(3L7NC13JO),29000,24650,-4350
2018-06-01,1265033417,C011030,남자학생복,[마인드브릿지]남성오픈카라세미오버반팔셔츠MSWS3151,49900,40920,-8980
2018-06-01,1018996714,C021040,실내화,윌슨 러쉬 프로2.5 테니스화 (WRS322600 ) 차콜,149570,133120,-16450
2018-06-01,415161999,C013010,점퍼,바람막이 야상 WS-JM24 바람막이 야상 점퍼 남자야상,69700,68310,-1390
2018-06-01,1005009862,L021020,장신구,1캐럿시그니티반지/베스트디자인/40-60대/MS-A364C,330000,330000,0
2018-06-01,44667106,C014010,아동복,[여아조끼정장]아동정장 합창복 연주복 단체복,49900,49900,0
2018-06-01,2122475900,C012020,원피스,김발 겉대x10,10420,10420,0
2018-06-01,1744913718,I011010,TV,아도니스139cm(55)평면/커브드UHDTV삼성패널2년무상,411340,399000,-12340
2018-06-01,166601804,C012060,여자내의,[포에버21]크리스탈 다이 그로밋 반바지/FOREVER21/바지/팬츠/핫팬츠,21900,15330,-6570
2018-06-01,527158422,C013010,점퍼,아스토레 6018(NVY) 골프 캐주얼 남성 경량 다운자켓,188300,182660,-5640
2018-06-01,422370245,C013010,점퍼,MJ-1062 (겨울) 윈터클로저 투버튼 코트 (L-2XL) 베이,106830,106830,0
2018-06-01,1530591405,C012020,원피스,MELODY F106 모카/코트/여자코트/겨울코디/겨울코트/자켓/점퍼 미국 여성토탈브랜드 멜,84700,84700,0
2018-06-01,241869455,A016100,수박,꿀달달! 달콤 시원 하우스 수박 4~9kg 내외,9900,9900,0
2018-06-01,380625398,A019160,밑반찬,썬스위트 프룬쥬스 1.89리터 4병/ 코스트코 푸룬주스,30950,30950,0
2018-06-01,1233681180,F011150,건강기능식품,[중외제약] 3+1 락토팜 키즈 생유산균 240포 총4박스,29900,29900,0
2018-06-01,702294034,E061060,살충제,살충제 싸이퍼킬/롱다운 플러스 바퀴벌레약/모기/파리,30000,21900,-8100
2018-06-01,2111161763,C012060,여자내의,매리빌 쭈리 3부 반바지 JE-2479 반바지 팬츠 속바지,6180,6180,0
2018-06-01,1531493405,C014010,아동복,아동 긴팔 기본티셔츠/아동 긴팔 컬러풀티셔츠/톡톡한 컬러티셔츠/면이좋은 긴팔티셔츠,9900,9800,-100
2018-06-01,1673616137,E041050,냄비,무수분요리 키친아트 세라믹 매직전골팬 베스트매직팬,26650,26650,0
2018-06-01,1350026309,C012060,여자내의,9부 카치온 팬츠(M77SLP425A)/ 미센스(여성의류),17900,16110,-1790
2018-06-01,1010137191,A014030,치즈,[동원]동원 이태리안피자치즈 280G,6150,4950,-1200
2018-06-01,621804075,E021010,침구,쿨~시어서커 여름이불세트/침구세트/토퍼세트,46900,43150,-3750
2018-06-01,1204023532,C011030,남자학생복,95~130 반팔 남자 남성 와이셔츠 셔츠 남방,12800,12800,0
2018-06-01,1603425936,E011050,책상,자이너스 원목 노트북테이블 스페셜 NT004A,50900,46900,-4000
2018-06-01,484548748,C013010,점퍼,WWS1814G 남여후드시보리롱패딩점퍼 /(관련) 여성점퍼,69700,59250,-10450
2018-06-01,2104177555,C013010,점퍼,남자 바람막이 야상 JM09 WS바람막이점퍼야상남자 바,90210,90210,0
2018-06-01,1549155056,C013050,운동복,남성용 반팔트레이닝복세트/트레이닝복/세트/반바지,12000,11800,-200
2018-06-01,983477072,A015010,참기름,백설 건강을 생각한 리그난 참기름(430ML),9490,3990,-5500
2018-06-01,1782465451,L021020,장신구,[바보사랑]파베 크리스탈 라인스톤 초커 Necklace,25000,25000,0
2018-06-01,270937665,E061020,섬유유연제,FC 베이비전용 세탁세제 (refill) (#10046),18230,18230,0
2018-06-01,983477073,E061040,부엌용세제,트리오 베이킹소다 리필 1.2L,4990,4990,0
2018-06-01,1803509988,A019050,간장,계란간장 4종 버터 4종 타마고간장 일회용버터 무염,4250,4250,0
2018-06-01,94896541,C011030,남자학생복,[2018] NEW헨리넥 셔츠 시리즈 X 셔츠 남방,35600,35600,0
2018-06-01,1492826037,C013040,청바지,[크로커다일레이디스]포켓 비즈장식 심플 데님팬츠,15900,15110,-790
2018-06-01,1535487573,E031110,청소기,바로바로 핸디형 스팀 살균 청소기 MSC-503 고온 살균,42900,35000,-7900
2018-06-01,128938358,C013050,운동복,자동차용컵홀더/차량용컵받침/컵거치대/컵홀더..,1500,1380,-120
2018-06-01,349605834,C012040,여자학생복,나팔소매루즈핏니트 ENKT72303B/ 이앤씨,89500,80550,-8950
2018-06-01,1612874625,E031010,전기밥솥,CRP-QS1010FG/쿠쿠/전기압력/10인용/음성/GH,169770,155920,-13850
2018-06-01,1964107240,E041020,컵,머그컵 모음 변색머그 변색인쇄 커피잔 컵 돌답례품,1090,1090,0
2018-06-01,690278283,C012060,여자내의,[케네스레이디]로지자가드 스커트(EWSKHA02),47000,39950,-7050
2018-06-01,1187950311,I031040,생화,GC LED LENSER 뉴T7.2-9807/P7.2-9407/뉴M7-8307,51200,45830,-5370
2018-06-01,1692842816,E051030,디지털도어록,[빠른배송] 삼성 푸시풀 도어락 SHS-P710/카드키 2개,176000,158400,-17600
2018-06-01,451680529,C012040,여자학생복,[악녀일기]진주슬립나시,32260,28080,-4180
2018-06-01,518842442,F012010,종이기저귀,폴맘 팬티형 세일24900 밴드형 팬티형 기저귀 하기스,25900,25900,0
2018-06-01,1356305135,C014010,아동복,한국생산 야구 상하복과 모자 레드(0-24개월)800023 /,80000,70400,-9600
2018-06-01,475990140,C012040,여자학생복,지나블리스 체크 롤업 긴팔 셔츠 남방 1803042,19800,19800,0
2018-06-01,1804399476,A014030,치즈,동서 리치골드 모짜렐라 슈레드 치즈 2.5kg / 피자치즈,19900,19900,0
2018-06-01,1760403316,C013020,티셔츠,[체리온]여름신상 루즈롱 박스티셔츠/맨투맨/반팔티,9900,9900,0
2018-06-01,1077924669,A014030,치즈,코리원/썬리취 모짜렐라 OK피자치즈 2.5kg/자연치즈,18500,18500,0
2018-06-01,1178934462,C012040,여자학생복,[밸리걸]플라워 패턴 롱 가디건 295100,14900,12670,-2230
2018-06-01,2134328862,I031040,생화,VIP논슬립썬커버 모음전/리무진엠보썬커버/벨벳썬커버,32000,29440,-2560
2018-06-01,767130278,E031010,전기밥솥,CRP-KHT1010FB 쿠쿠 10인용 무압/ 인덕션 사은품,569000,523390,-45610
2018-06-01,895864779,A011130,시리얼,[CJ]백설 빵가루 (450g),3280,3280,0
2018-06-01,1010137166,A013100,마른멸치,RF)논우렁살 200G,8990,8990,0
2018-06-01,895864774,A019080,고추장,[청정원]청정원 순창 매운고추장 2kg,26800,26800,0
2018-06-01,1873327023,C013010,점퍼,득템찬스..무조건 이가격..44-120사이즈,17900,17900,0
2018-06-01,1010137161,A013100,마른멸치,RF)날치알(골드) 100G,4990,4990,0
2018-06-01,895801198,A022020,두유,[정식품]정식품 검은콩과 검은참깨 베지밀 (190ML*16입),14880,7440,-7440
2018-06-01,858164563,C013060,등산복,[블랙야크] 남성 기능성 봄 여름 밴드형 캐주얼 바지 L트리코팬츠 2종 택1,79000,63200,-15800
2018-06-01,423272280,C012060,여자내의,A-86 버버리 여아용 하의,15000,10000,-5000
2018-06-01,1401488979,L021020,장신구,[라라쥬얼리] 테라헤르츠 팔찌/실버팔찌/진주팔찌,43800,43800,0
2018-06-01,241678976,C013010,점퍼,[대구백화점 I관] [비지트인뉴욕]노카라홑겹점퍼(VU3JPA32),79000,67150,-11850
2018-06-01,1275817237,C015030,넥타이,남녀공용 롱 쁘띠 스카프 스톨 머플러 200종,9800,9800,0
2018-06-01,2026154591,E011050,책상,[동서가구/착불]리빙스DL 도토2인용 슬림 책장책상세트 DF901971,198000,137220,-60780
2018-06-01,2087428430,C014020,유아복,아둘 가족티 유아 스트라이프 트레비 상하세트 12,19100,19100,0
2018-06-01,2117222454,A013080,조개,국내산 새꼬막1.5kg (중품) 새벽조업후 발송 산지,31330,31330,0
2018-06-01,1433379021,A012010,국산쇠고기,[무항생제] 꼬리반골 5kg 1+등급,103800,103800,0
2018-06-01,551521024,E061030,전구,LED 면조명 평판조명 매입개방 슬림매입 평판등 매립,44000,44000,0
2018-06-01,1345091507,C014010,아동복,[모다아울렛][꼬망스]OS 레이펑키데님팬츠C1821Q210,32500,29250,-3250
2018-06-01,789420325,E061100,습기제거제,물먹는하마 525ml x 16개 제습제 탈취제 습기제거제,15100,15100,0
2018-06-01,1648158465,A013090,전복,[통영직송]오동통한 제철 홍가리비 1kg~,5900,5900,0
2018-06-01,306818703,A018010,초콜릿,미니자유시간690gX1개/미니핫브레이크/미니아트라스/대용량초코바/초콜릿/초콜렛/가나,8500,8500,0
2018-06-01,150752476,I012010,컴퓨터,삼성게이밍 DM800V7A-A716A 포토행사 마우스증정 SI,2247940,2097000,-150940
2018-06-01,827605697,C011050,남자내의,삼성 마이크로여파자마 부드러운 면 여성 파자마,8980,8000,-980
2018-06-01,2118714182,A012010,국산쇠고기,[무항생제] 우족 1kg 1+등급,28000,28000,0
2018-06-01,92695703,C011030,남자학생복,[지오다노]여 코튼 린넨 셔츠 348510(영등포점B),39800,32820,-6980
2018-06-01,1940341527,C013010,점퍼,블루종/바람막이/네오프렌/스타디움/자켓/항공점퍼,26000,22800,-3200
2018-06-01,1079283594,A018110,물엿,[청정원] 대상 청정원 물엿 10kg×2개,20600,20600,0
2018-06-01,700034879,C021040,실내화,아디다스 남녀공용 이큅먼트16 런닝화 ( AF4969 ),93880,93880,0
2018-06-01,1817371077,C012030,여자상의,[하루메이비] [하루메이비]1573 루즈핏 레이스 소매 원피스,39900,39900,0
2018-06-01,295921422,L021030,가방,키링증정/ 백팩/여성백팩/학생배낭 /남성백팩/책가방,14600,14600,0
2018-06-01,1726461845,L021030,가방,여성 가방 숄더백 크로스백 핸드백 쇼퍼백 여자 빅백,10000,9900,-100
2018-06-01,1452952269,A017200,토마토,무배 냉동 프랑스 튀긴 혼합 야채 월드믹스 2.5kg,22170,22170,0
2018-06-01,63530589,F012010,종이기저귀,팸퍼스 베이비드라이 밴드/팬티 기저귀 모음,39800,37800,-2000
2018-06-01,1658271720,E061020,섬유유연제,드라이시트 500매 빨래 의류 건조기 유연제 코스트코,12980,12980,0
2018-06-01,1856237824,C015030,넥타이,나비넥타이 리본넥타이 보타이 멜빵 서스펜더 행사용품 파티용품,1000,990,-10
2018-06-01,467504923,A011160,빵,모듬빵50개1박스/기업체/단체간식/급식/봉지빵/삼립,17900,17900,0
2018-06-01,276797719,E011070,식탁,베스트리빙 캘빈에코 2인식탁세트/대리석식탁/2인용,99000,89100,-9900
2018-06-01,1692842845,E061040,부엌용세제,참그린 순수발효 곡물 720ml 용기x3개 주방 세제,11900,11900,0
2018-06-01,1448169282,A017160,오이,[남도장터]김예식 농부의 장흥표고버섯 선물세트,22500,22500,0
2018-06-01,2086757800,A015020,식용유,냉압착유기농올리브유 오로오피/오로op 750ml 2병,190000,190000,0
2018-06-01,1676069034,E021020,커튼,데코뱅크 루시 아일렛린넨암막커튼/거실커텐 /창커튼,25300,25300,0
2018-06-01,1468559307,A012010,국산쇠고기,[무항생제] 불고기샤브샤브500g 1+등급,30800,30800,0
2018-06-01,1574424870,E031010,전기밥솥,쿠첸 정품 원터치 커버 분리형 패킹 세트/SY,15900,15900,0
2018-06-01,1737956900,C012060,여자내의,[탐나나]핏대박 숏 일자 롱 부츠컷 면 청 바지 팬츠,16900,16900,0
2018-06-01,1293814684,L012090,기초화장품,스케다 아쿠아 모이스처 남성 크림(남성수분크림),23000,23000,0
2018-06-01,1139309463,L021020,장신구,미러볼 피어싱 5mm/6mm 써지컬스틸/ 미니아트,2900,2900,0
2018-06-01,1085832492,C012020,원피스,[올리비아로렌] 베이직 솔리드 밑단 롤업 팬츠 VOCDLRM3361,21500,20210,-1290
2018-06-01,453086637,I053030,복사용지,[무료배송] 밀크 복사용지 A4용지 75g 2BOX(5000매),43720,37600,-6120
2018-06-01,807046429,L021030,가방,델라스텔라옴므 소가죽_DH01001,79800,67830,-11970
2018-06-01,225848719,C011030,남자학생복,남성)자켓형 가디건 O152TJ110P/ 앤듀,10000,9000,-1000
2018-06-01,2013976554,F012020,생리대,(당일발송)의료용실리콘 생리컵 에널컵 레나컵 디바컵,13800,13800,0
2018-06-01,1385977124,A018090,잼,(오뚜기) 1회용 딸기쨈 디스펜팩 머스타드 케찹 잼,100,100,0
2018-06-01,1027985066,I011030,사진기,(풀패키지)소니 ILCE-5100L(SELP1650포함)(A5100),589000,541880,-47120
2018-06-01,755590265,A019170,냉동식품,[청정원공식몰] 청정원 불고기브라더스 왕교자 4팩,16590,16590,0
2018-06-01,1354466220,C012040,여자학생복,[메이비베이비] Picnic (bl) -단독입고!,38000,38000,0
2018-06-01,489249172,I031070,애완동물관리비,16 바볼랏 테니스라켓 퓨어 에어로 팀 PURE AERO TEAM,217190,181580,-35610
2018-06-01,280541434,G011070,자전거,[어린이날특가세일]하이브리드/MTB/로드/여성용자전거,124580,114620,-9960
2018-06-01,2075729044,C013010,점퍼,AGC가죽자켓 라이더자켓 가죽점퍼 P171가죽가죽점퍼가,99360,99360,0
2018-06-01,246658965,C013010,점퍼,빅사이즈 모던이중지자켓 DN1703 빅사이즈 여성의류,90800,88990,-1810
2018-06-01,956578931,A019060,된장,CJ 다담 정통된장찌개전용 (140G),1580,1580,0
2018-06-01,1272051237,G022020,자동차타이어,전국무료장착 넥센타이어 엔페라 NFERA RU5 235/60R18,131400,111270,-20130
2018-06-01,1197649133,A015020,식용유,청정원 포도씨유 500ml X 15EA 청정원오일 스페인산기,128310,124470,-3840
2018-06-01,2008654863,L012090,기초화장품,헤라 옴므 수퍼 아쿠아 크림 40ml 수분크림 보습크림,54640,54640,0
2018-06-01,92005460,I011010,TV,[와이드뷰]WV320HD-S01/32인치HDTV/FULL(풀)HDTV/당출,130340,130340,0
2018-06-01,870878384,A013150,어묵,밀가루NO/쌀로 만든 프리미엄 명품 부산어묵/소스증정,6500,6500,0
2018-06-01,461414211,L021060,유모차,유모차 윙스 크라운 세스토 방풍커버 방한커버 모음전,29000,29000,0
2018-06-01,607047938,F012030,안경,초경량 안경테/메탈 안경/콤비/카본/티타늄,39000,39000,0
2018-06-01,3097011,A022010,주스,[보해] 보해 매원 1.5L×8개,45300,45300,0
2018-06-01,1255755538,C021040,실내화,[리복(Reebok)][REEBOK CLASSIC/UNISEX] 리복 로얄 컴플리스2 (CM9636 CM9635)(경기점,32900,27780,-5120
2018-06-01,1332622242,C013020,티셔츠,베이직 긴팔 PK카라티 19색 쿨론 단체티 유니폼 반티,8500,8500,0
2018-06-01,1441698001,L021020,장신구,럭셔리 특가3 최신상 18종 고급 실버반지 (svr15) 커플반지 선물 골드조아,89000,89000,0
2018-06-01,432347340,A019130,스프,청정원 우리쌀 콘크림 컵수프 60g(20g x 3개입) X 24E,101470,90310,-11160
2018-06-01,2131755814,E061020,섬유유연제,샤프란 섬유유연제 용기 8L,8900,8900,0
2018-06-01,1938012360,C013010,점퍼,맨투맨/무지맨투맨/기모맨투맨/후드티/후드집업/기모,10000,9900,-100
2018-06-01,158524917,C013010,점퍼,아디다스 여성 ZNE 2 후드집업 자켓 점퍼 스포츠,88900,88900,0
2018-06-01,1057270658,A021010,커피,UCC드립커피/블랜디드립커피/유씨씨드립커피 UCC커피,2600,2600,0
2018-06-01,870323231,A017250,고사리,랜시 냉동 브로콜리 1kg(1kgx1ea)/냉동야채 냉동채소,7000,5950,-1050
2018-06-01,1979598458,C013040,청바지,[펠릭스키즈]6부 세미 배기 데님_FXTJ74G1,9900,4900,-5000
2018-06-01,807590311,C013050,운동복,아동 하의모음/고무줄바지/아동트레이닝복 하의/배기팬츠/아동츄리닝/면배기/아동 고무,14800,14800,0
2018-06-01,450283449,A013060,게,덕운수산 대왕오징어채 900g2개 오징어채 대왕오징어,27300,24570,-2730
2018-06-01,218189197,A011080,밀가루,구포국수 5색 선물세트.답례품.명절.국수.사은품.돌,3600,3600,0
2018-06-01,559971991,C013040,청바지,AMM928-1 남자블랙워싱톡톡한기모청바지 청바지 남자,27200,27200,0
2018-06-01,1333646795,A018020,사탕,무료배송10k모음과일종합카라멜대용량벌크 업소용사탕,30900,30900,0
2018-06-01,1950934884,E021020,커튼,[파스텔데코] 침실캐노피+봉포함 / 레이스 이중커튼,29800,29800,0
2018-06-01,1299019185,C012060,여자내의,[VIKI(비키)](17여름)심플 베이직 와이드 팬츠 (TQPAE2229)[갤러리아],29000,23200,-5800
2018-06-01,1557670837,E021010,침구,굿몽 면 요 토퍼 이불세트 침구세트 이불 침구,49900,49900,0
2018-06-01,1484111432,A017160,오이,[농협]무농약 청정지역 장성 새송이버섯 정품 2kg이내,12900,12900,0
2018-06-01,1430542558,I011030,사진기,명품 니콘 D7500 body 정품 새상품+사은품+이벤트,1146590,1146590,0
2018-06-01,1187203709,D031010,주택수선재료,유성오일스테인3.5L/칼라스테인/목재방부용/속건오일,27000,27000,0
2018-06-01,2120211583,A017150,버섯,[이팜] 무농약 콩나물(국내산)300g,1800,1800,0
2018-06-01,2049369355,A014050,달걀,참숯먹은 오골계750g이상x3봉/급속 냉동/백숙/하림,37900,37900,0
2018-06-01,605903009,F012010,종이기저귀,[마미포코] 마미포코 에어핏팬티기저귀 특대형 남아 30매x4팩,43500,43500,0
2018-06-01,631049630,E011030,거실장,거실장/벽걸이장식장/티비다이/티비선반/거실장식장,29900,29900,0
2018-06-01,1039432921,F012020,생리대,화이트(36+20)/생리대/좋은느낌/애니데이/팬티라이너,9900,9900,0
2018-06-01,983622183,A019070,양념소스,청정원 양푼 매운갈비 양념 (화끈한맛) 500ML,3900,3900,0
2018-06-01,300540987,C012060,여자내의,[모다아울렛][지컷]A라인반바지 7217330007,79500,75530,-3970
2018-06-01,983622187,E061090,방향제,페브리즈 차량용 다우니향(2ML),5900,5900,0
2018-06-01,1167234344,C011050,남자내의,[지오다노] 108506 코튼 라운지 쇼츠 팬츠/ 지오다노,16800,13610,-3190
2018-06-01,467878829,C013020,티셔츠,T1338-베이직 사선 슬릿 브이넥 티셔츠 반팔티 사선반,12620,12620,0
2018-06-01,983622185,A019070,양념소스,[청정원]청정원 매운갈비 양념 (매콤한맛) 500G,3900,3900,0
2018-06-01,1368391207,A021010,커피,동서 맥심 아이스커피믹스 110T(100T+10T),15300,15300,0
2018-06-01,730425881,I031040,생화,MTF 3단접이식명품황토파라솔 45인치 비치파라솔,29000,26680,-2320
2018-06-01,1321007673,L012090,기초화장품,세레느 올리브 딥 크린 크린싱 크림310ml(기획세트)/★무료배송★,6900,6900,0
2018-06-01,961189712,A019030,생강,한봉가득깐마늘 (1KG/봉)(매장별 포장이 상이할수있습니다.),15900,10900,-5000
2018-06-01,79353308,C012020,원피스,[드넬]투버튼박시롱자켓DJ81790A,29540,26590,-2950
2018-06-01,1668935735,D031010,주택수선재료,노루페인트 친환경 프리미엄 팬톤페인트 1L 풀세트,23900,23900,0
2018-06-01,1261075327,C013010,점퍼,신화어페럴/봄/여름/중년남성/자켓/정장/사파리/점퍼,48800,48800,0
2018-06-01,769306078,E061020,섬유유연제,다우니 퍼퓸 고농축 섬유유연제 8종류 1LX4개,20900,20900,0
2018-06-01,542942648,L021010,손목시계,만보기 스포츠 다이어트 혈당체크/측정 칼로리 시계,6900,5900,-1000
2018-06-01,2006621840,L021060,유모차,[스토케][SSG 선런칭] 스토케 익스플로리 V6 블랙프레임(블랙핸들) - 베이직 컬렉션 (,1640000,1640000,0
2018-06-01,988927121,E061020,섬유유연제,NEW)샤프란아로마리필기획2.1Lx2_2p,14100,11000,-3100
2018-06-01,954759132,C013050,운동복,[M~2XL] 5부 반바지 3부 핫팬츠 오버핏 반팔티 밴딩,6900,6900,0
2018-06-01,2080983578,I031040,생화,스웨덴 명품 웨코 캠핑/차량용냉장고 TC-35,349000,298610,-50390
2018-06-01,1548410171,L021060,유모차,토이A 아이와 즐거운 외출을 즐기세요 코지 유모차 가,234320,229640,-4680
2018-06-01,255044108,C021020,구두,[단골쿠폰 15%] 에스콰이아 남여봄신상+샌들 베스트,39000,39000,0
2018-06-01,161078759,A019160,밑반찬,고추부각(국내산)/500g/직접 농사지은 말린 고추부각,8900,8900,0
2018-06-01,1234316014,C013030,스웨터,폴라티 반팔 MJ7621_7624 마르잔 빅사이즈 반팔티,35580,34870,-710
2018-06-01,2003072970,F012010,종이기저귀,[VIP 5%쿠폰]팸퍼스 스와들러 신생아 기저귀 1/2단계,36900,36900,0
2018-06-01,509175386,C012040,여자학생복,[모다아울렛][크로커다일레이디스]체형커버형 인견 셔츠형 블라우스(CL8MBL134),99400,94430,-4970
2018-06-01,562742986,C013020,티셔츠,기능성티셔츠 ufc mma 이종격투기 래쉬가드 주짓수,30000,30000,0
2018-06-01,1744901701,E011070,식탁,2인 대리석식탁 20종/2인식탁/식탁/2인용식탁,130000,116820,-13180
2018-06-01,1538894906,A011180,파스타면,[파스타모음전] 스파게티 페투치니 마카로니 파르펠레,4900,4900,0
2018-06-01,1778501147,L021020,장신구,[바보사랑]scenuerdo 향수팔찌 black edition,42000,42000,0
2018-06-01,1778501142,L021020,장신구,[바보사랑]BUBBLE HEART 2WAY EARRING,35000,35000,0
2018-06-01,1778501145,L021020,장신구,[바보사랑]scenuerdo 향수팔찌 platinum gold edition,42000,42000,0
2018-06-01,1945191900,C011050,남자내의,아이스바지 2장무료배송/냉장고/점프슈트/팬츠/밴딩,4900,4900,0
2018-06-01,1407478708,L021030,가방,리바케이스8262 (블랙) 15.6인치 노트북백팩/가방,49000,48020,-980
2018-06-01,85817056,A013090,전복,국내산 새꼬막 1.5kg (상) 새벽조업후 발송 산지,32980,32980,0
2018-06-01,551293094,A019130,스프,청정원 우리쌀 포테이토 컵수프 60g(20g x 3개입) X 2,89570,89570,0
2018-06-01,564773313,C013040,청바지,아둘 NEW YORK 쥬니어 기모 후드 양키 상하세트 38,31900,31900,0
2018-06-01,450283451,C013010,점퍼,6497 삐에로 오버핏 항공점퍼_블랙,34570,34570,0
2018-06-01,1274905858,A015020,식용유,골든 호호바오일 500ml 비정제호호바오일 몸신,29000,29000,0
2018-06-01,1202630728,A014020,분유,산양 하이키드 골드 700g,29000,29000,0
2018-06-01,755349771,A012050,소시지,15+1 오쿡 닭가슴살/소시지/큐브 총16팩,28800,28800,0
2018-06-01,1277153479,C021040,실내화,드라이버 2(런닝화) 남성런닝화 달리기신발 러닝화 트,78860,78860,0
2018-06-01,1778501176,L021020,장신구,[바보사랑]scenuerdo 향수팔찌 bermuda green,42000,42000,0
2018-06-01,1778501178,L021020,장신구,[바보사랑]scenuerdo 향수팔찌 peach yellow,42000,42000,0
2018-06-01,2084096324,C012060,여자내의,#NAME?,112000,95200,-16800
2018-06-01,795162022,I012010,컴퓨터,Apple 공인판매점 2017 iMac [MMQA2KH/A] 21.5형,1353600,1285920,-67680
2018-06-01,1085700645,E021010,침구,겨울왕국 면기모 패드 - 뷰티선샤인 (064187) 침구 까,64300,58570,-5730
2018-06-01,631050642,C012060,여자내의,빅사이즈/페이즐/시스루/스커트 빅사이즈,29630,28750,-880
2018-06-01,20684614,L021020,장신구,1부5리 다이아반지/0.15ct/14K골드/diamond ring,250000,250000,0
2018-06-01,103158361,C012060,여자내의,160cm 중독진 속밴딩스키니팬츠/ 큐니걸스,32200,26410,-5790
2018-06-01,268429743,I011010,TV,공식파트너 삼성 123cm LED TV UN49K5110BF,640000,579000,-61000
2018-06-01,1981323663,A019170,냉동식품,2개무배 아하만두 꼬물이 왕 메밀 전병 감자 새우,7500,7500,0
2018-06-01,464411454,C013020,티셔츠,[RUDDER] 신상 기모 맨투맨 후드티 후드집업 ~3XL,24800,24800,0
2018-06-01,1381405638,C013050,운동복,빵구닥터 타이어 DH 펑크씰 끈끈이 지렁이 펑크수리킷,3400,3400,0
2018-06-01,1010259426,A013100,마른멸치,[한산도수산]통영직송!! 자연산 바지락 1kg,29900,10700,-19200
2018-06-01,2071145184,A018100,꿀,담터 사양벌꿀 1kg+1kg 총2kg/아카시아꿀/꽃샘/국산꿀,14700,14700,0
2018-06-01,383502941,I031040,생화,버팔로 와이드릴렉스 필드체어세트/캠핑의자 낚시의자,58000,46980,-11020
2018-06-01,1960924961,A015020,식용유,백설 식용유 1.5리터x2개 콩기름 유지류 해표,10700,10700,0
2018-06-01,102510493,C013020,티셔츠,커터앤벅 남성 스판 카라 반팔티셔츠 - 1462-101-03,44900,39900,-5000
2018-06-01,388396178,E011040,소파,폴리몰리 빈백 607C 브라운,269000,186420,-82580
2018-06-01,1778501172,L021020,장신구,[바보사랑]scenuerdo 향수팔찌 flamingo pink,42000,42000,0
2018-06-01,1778501173,L021020,장신구,[바보사랑]scenuerdo 향수팔찌 turquoise green,42000,42000,0
2018-06-01,1415677913,F012020,생리대,[릴리안] 순수한면 대형 14+4매 릴리안 생리대,2200,2200,0
2018-06-01,1778501174,L021020,장신구,[바보사랑]scenuerdo 향수팔찌 vermillion orange,42000,42000,0
2018-06-01,559016693,A019060,된장,DS049/몽고 백된장 4kg 가공식품 조미료 소스 식자재,18610,18610,0
2018-06-01,1150233963,A016090,참외,가정용 성주 참외 대용량10kg 햇참외 무료배송,15900,15900,0
2018-06-01,15577543,E061030,전구,필립스/PHILIPS/FL/32W/25개/1박스/절전형/TL-D/주광색/백색/삼파장/형광등/직관형/삼,51000,51000,0
2018-06-01,1778501170,L021020,장신구,[바보사랑]scenuerdo 향수팔찌 royal blue,42000,42000,0
2018-06-01,309208016,C013020,티셔츠,테이프 프릴 티(AJ2CT450)/ 랩,59000,50150,-8850
2018-06-01,1552205647,A016150,아몬드,2017년산 출시 햇아몬드400g+햇호두400g / 견과류,10900,10900,0
2018-06-01,1176527531,A011180,파스타면,면사랑 렌지용 크림우동  해물볶음우동  볶음짬뽕면,2750,2750,0
2018-06-01,427026917,A013030,조기,가거도 참조기 ( 12 마리 ) - 조기 참조기 청정해역,43270,38520,-4750
2018-06-01,1355055344,E061020,섬유유연제,피죤 3100ml x 4개/샤프란 다우니 리큐 섬유유연제,11800,11800,0
2018-06-01,56233338,C013010,점퍼,땡..추가금없는 무조건 이가격 마지막 선착순 주문..,18900,18900,0
2018-06-01,968782601,C013020,티셔츠,특가 국내산/쿨원단 카라티셔츠-라운드티,6000,5900,-100
2018-06-01,1778501235,L021020,장신구,[바보사랑][액세서리키친] 925실버 별자리 코인반지,25900,25900,0
2018-06-01,1577479444,C012060,여자내의,푸조 여성 워테레깅스 ( S26-1 ),28550,24270,-4280
2018-06-01,2141405397,A022020,두유,매일 뼈로가는칼슘두유 진眞(190mlx64팩),23800,23800,0
2018-06-01,606589175,C011030,남자학생복,국내제조 남성 폴리마셔츠 나염 프린트 체크 110까지,20800,20800,0
2018-06-01,1201629389,C011050,남자내의,[겐트] 스트링 린넨 9부 팬츠 GP5222C,16800,16140,-660
2018-06-01,1778501232,L021020,장신구,[바보사랑]G캔디팝 포인트 데일리 크리스탈 은침 귀걸이,18000,18000,0
2018-06-01,870022388,L012030,칫솔,터닝/페어리루 어린이칫솔 20개+증정,20900,20900,0
2018-06-01,333707550,A012040,닭고기,국내산 훈제닭가슴살3kg 판매1위 푸드월드 다이어트,27900,27900,0
2018-06-01,1897088911,A012060,햄및베이컨,녹차먹인 다향오리 훈제슬라이스 180g 12팩 총2 16kg,27900,27900,0
2018-06-01,796585607,F012020,생리대,릴리안파우더향중형16px10팩/파우더향대형14px10팩,18900,18900,0
2018-06-01,1340931987,C012060,여자내의,jj42 꽈배기니트 미디스커트_진그레이 니트스커트 여,14280,14280,0
2018-06-01,944433579,E041070,밀폐용기,글라스락 세트구성/밀폐용기/반찬통/유리밀폐용기,24000,22080,-1920
2018-06-01,1090276742,C013050,운동복,[스탭키즈] 스탭키즈 7부솔리드츄키니 SITM73G2 NC아울렛,9900,4900,-5000
2018-06-01,406072615,E061030,전구,필립스 오스람 산쿄 살균램프 자외선4w 6w 8w 10w 15w,2350,2120,-230
2018-06-01,1468824263,E041050,냄비,키친아트 통5중 네오 스텐냄비,21900,21900,0
2018-06-01,696983710,C013050,운동복,[야토] 야토 자동차 루프백 NW300L RV용 캠핑 가방 자동차루,82980,75590,-7390
2018-06-01,577085700,C013040,청바지,[애플핑크/JCB] 봄에는 청청패션 하나쯤은 있어야죠~,24100,16900,-7200
2018-06-01,1702642363,I031010,장난감,버키 유아 오리발 수영연습 수영장오리발,12900,12900,0
2018-06-01,1570537344,A012030,돼지고기,차원이 다른 프리미엄 목삼겹 500g 구이용/보쌈용,3900,3900,0
2018-06-01,766373308,A012040,닭고기,[허닭] 슬라이스 훈제 닭가슴살 15+1팩 100g~200g,30900,30900,0
2018-06-01,982494899,F012020,생리대,[동아]동아제약 템포 슈퍼 20P,8250,8250,0
2018-06-01,51313572,I012010,컴퓨터,삼성컴퓨터/데스크탑PC/배틀그라운드/전시렌탈/WIN7,599000,539100,-59900
2018-06-01,441184699,C013010,점퍼,앙팡 래쉬가드 집엎 (핑크) 아이옷 아동의류 집업 물,24980,24980,0
2018-06-01,466893954,L012010,면도기,도루코 이중날 일회용면도기 100P 박스,32050,28530,-3520
2018-06-01,2000856019,A021010,커피,맥심 카누 아이스블렌드 아메리카노 미니 100T,19300,19300,0
2018-06-01,1152241576,C013040,청바지,[컨셉원] 117903 TR 히든밴딩 스트레치 슬림핏 슬랙스 10117903,39000,32370,-6630
2018-06-01,1607515987,I012060,저장장치,볼텍스 TYPE EF 기계식키보드 게이밍 2년무상보증 sc,59900,59900,0
2018-06-01,440294654,A019100,식초,(무)오뚜기 토마토케찹800gX12개케첩 식재료 토마토,63600,55970,-7630
2018-06-01,1077141647,C012060,여자내의,[에잇세컨즈] (258121TP1R) 네이비 테이퍼드 워싱 데님 팬츠,39900,37910,-1990
2018-06-01,445696566,C013020,티셔츠,HH 언더레이어티셔츠(사계절_기본형_여성용_민트) 케,60000,59400,-600
2018-06-01,983622211,E061090,방향제,불스원 폴라 패밀리 마요클립,6500,6500,0
2018-06-01,525896199,A012030,돼지고기,[흑돼지*목살*]암돼지 고기만 거세돼지는 NO) *세일중,11000,11000,0
2018-06-01,2120959782,C012040,여자학생복,트임목폴라니트조끼 WW13112 여성니트조끼 목폴라니트,37050,37050,0
2018-06-01,1619864796,C012020,원피스,D포인트 하프반코트 모직코트 남성의류 캐주얼의 아웃웨어 하프트렌치코트 남성의류 트,113200,100750,-12450
2018-06-01,900358318,A014010,우유,[푸르밀]푸르밀 고칼슘 저지방우유 900ML*2입기획,4500,3590,-910
2018-06-01,1171381991,C013040,청바지,[R.ROBOT](BL)크레이지5부데님(18329-412-01),47200,36350,-10850
2018-06-01,536742980,I011030,사진기,P 후지필름 Finepix XP130/XP120 방수카메라/방수디,289000,275100,-13900
2018-06-01,1887183939,A022050,탄산음료,씨그램 라임 345ml x24can,13500,13500,0
2018-06-01,79377264,A017050,미나리,무배 프랑스산 냉동 미니양배추 야채 간편포장 1kg,11480,11480,0
2018-06-01,983622210,G022010,자동차용품,불스원 2스텝 컴파운드,8990,8990,0
2018-06-01,2045640141,E031070,에어컨,신일 벽걸이 선풍기 SIF-14WKP/업소용 가정용,45800,45800,0
2018-06-01,930329830,A016120,바나나,[그린팜]필리핀산 바나나 13kg 1박스 (6송이),36900,35650,-1250
2018-06-01,1894103793,A017090,열무,[e-fresh] 산지직송 무 3개 / 개당 1.5kg 내외,14900,14400,-500
2018-06-01,1282451262,E021020,커튼,화이트 페이즐리 레이스커튼,19000,19000,0
2018-06-01,1280020337,I031040,생화,컨텐더 스틸안면보호헤드기어CHG-735-합피,113000,110740,-2260
2018-06-01,403655713,A014030,치즈,코리원/서도물산 치즈스틱 1kg/치스스틱/치즈/핫도그,7000,6900,-100
2018-06-01,810410968,I031070,애완동물관리비,헤드 가와사키 테니스라켓 초급자용 입문용 테니스채,32800,29030,-3770
2018-06-01,119115438,F011130,홍삼,[풍기수삼] 수삼 200g (7-10뿌리) 삼계탕용 / 삼계탕재료증정,28000,28000,0
2018-06-01,2038888435,C015020,모자,고퀄리티 스냅백 프리사이즈 빅사이즈 힙합모자,13900,13900,0
2018-06-01,1010321897,A016050,밤,상주곶감(16입/팩),11900,11900,0
2018-06-01,1145017778,C012040,여자학생복,[공구우먼] 로니블 스트라이프 롱 남방 29127 빅사이즈여성의류,20000,20000,0
2018-06-01,1251603482,C011030,남자학생복,(사이즈 : 100) FS-247 블루버튼 반팔 슬,25640,25640,0
2018-06-01,988122731,A014050,달걀,초이스엘 백색란 (20입/대란),2490,2490,0
2018-06-01,1317202790,C011050,남자내의,노턱 링클프리 기모본딩 네이비 겨울슬랙스_AJ5933 겨,39150,39150,0
2018-06-01,2147011467,E011050,책상,401 접이식테이블 사무용책상 컴퓨터책상 절탁,43500,43500,0
2018-06-01,2066621937,C013040,청바지,남아 4부배기핏아이스데님(R1724Q260_53)/ 레노마키즈,17100,15390,-1710
2018-06-01,275917587,C011050,남자내의,롤업/면바지/남자/슬림일자핏/치노팬츠슬렉스스키니,15800,15800,0
2018-06-01,559944308,C015030,넥타이,남성 루프타이 볼로타이 자동넥타이 보타이 07-21 루,41260,41260,0
2018-06-01,298485944,C012040,여자학생복,블루페페 VEST(P172MSB004),77100,65540,-11560
2018-06-01,930317866,I053010,공책,초등노트 중등 고등 노트 공책 학생 무제 수학 영어,250,250,0
2018-06-01,447426368,I053020,스케치북,켄트지 도화지 4절 130g 125매 종이류 도화지 흰도화,18040,18040,0
2018-06-01,244225340,E031010,전기밥솥,CRP-FHR0610FD/쿠쿠/IH압력/6인용/GH,330000,306810,-23190
2018-06-01,321842505,C013040,청바지,MPS18017 스틸 워싱 빈티지 진 청바지 남자청바지 남,33570,33570,0
2018-06-01,1441446674,C012060,여자내의,PT1341-데일리 베이직 롤업 숏 팬츠 여자반바지 롤업,20230,20230,0
2018-06-01,1722645151,C013020,티셔츠,유니크나시모음/니트나시/체인나시/레이스나시/랩나시,10900,10900,0
2018-06-01,116894845,E061010,세탁세제,세제혁명 지엘 GIEL 플러스 1.3L * 10통,39900,39900,0
2018-06-01,2084157829,C012030,여자상의,#NAME?,64800,57030,-7770
2018-06-01,551594013,C013040,청바지,나와니스 방수 유아 놀이복/우주복형식 놀이옷.모래놀이복 미술놀이 미술가운 유치원,12200,12200,0
2018-06-01,71606560,A011130,시리얼,오뚜기 부침가루 500g X 20EA 바삭한튀김가루 볶음쌀,36040,36040,0
2018-06-01,1396774515,I031040,생화,에어박스 에어매트 카렌스2 쏘렌토 투싼 뉴카니발,242000,222550,-19450
2018-06-01,1394741664,C014010,아동복,펑키 로봇 후드 티셔츠 (3-24개월) 201965,16930,16930,0
2018-06-01,1296157254,C013010,점퍼,리즈코 바스트절개 데님자켓 재킷 캐주얼청자켓 남성,92420,92420,0
2018-06-01,1579127802,E061020,섬유유연제,FC 베이비전용 세탁세제 (refill) (#10046),18230,18230,0
2018-06-01,362753838,C013020,티셔츠,미넴옴므 남자 티셔츠 아이스 비즈니스 셔츠 4종 세트 (티셔츠형3종 + 셔츠형1종),39000,39000,0
2018-06-01,348111308,C013050,운동복,11st/차량용안전봉/경광등/경광봉/삼각대/자동차/후레쉬,2500,2300,-200
2018-06-01,858056877,L021020,장신구,원석sale/천연투어멀린/25.05ct/tourmaline,70000,70000,0
2018-06-01,1914449690,F012020,생리대,릴리안 초흡수 파우더향 대형 14P,3900,3900,0
2018-06-01,496956399,C012040,여자학생복,MJ_1219 네이비 양털 조끼 조끼 캐주얼조끼 여성조끼,30370,30370,0
2018-06-01,415991219,C012040,여자학생복,[밸리걸] 밑단 언발 로브 가디건 249620,29900,25420,-4480
2018-06-01,1313667819,E031110,청소기,오늘발송 삼성 컴팩트 프리미엄 청소기 VC-TU62B,80000,74400,-5600
2018-06-01,255662890,A022050,탄산음료,코카콜라 355mlx24캔 음료수/스프라이트/환타/사이다,13900,13900,0
2018-06-01,1152180170,C012020,원피스,[랭앤루]랭앤루 18S ESMERALDA ROBE에스메랄다 로브_01,199000,177110,-21890
2018-06-01,451148412,A019010,고춧가루,가을 다데기 청양 고추가루 2.5kg2개 가루 고추가루,100010,90010,-10000
2018-06-01,1869558146,C011050,남자내의,푸마 트레이닝 팬츠(65382437),69460,61820,-7640
2018-06-01,1229297482,E061050,청소용세제,청소혁명 탱크샷 / 찌든때 기름때 욕실&주방 청소세제,29800,29800,0
2018-06-01,1294849868,A014020,분유,[베비언스] 액상분유 2단계 240ml 25입,33900,33900,0
2018-06-01,2130838115,I031010,장난감,PS4 언틸 던 (Until Dawn) 한글판 / 언틸돈 / 언틸던,27800,27500,-300
2018-06-01,1129948736,L012030,칫솔,NEW 명약원 골드 5일비책 칫솔 1박스/뉴명약원칫솔,3730,3730,0
2018-06-01,1379366129,A018080,설탕,천연원당 3kg 원당/사탕수수100%/천연당/비정제 설탕,6900,6400,-500
2018-06-01,1372619872,C014010,아동복,행키 조끼 반바지세트 검정 /남아정장 유아정장 돌복,49000,49000,0
2018-06-01,399422740,C015040,장갑,해피타운_2색털장갑(어른용) 패션장갑 겨울장갑 손가,18360,18360,0
2018-06-01,443290603,C013010,점퍼,지스타 로우 데님 여성 80 85 면 워싱 자켓 점퍼 가을,52180,52180,0
2018-06-01,647777394,C013020,티셔츠,여름 루즈핏임부복 임산부원피스 빅사이즈임부복 임신,16900,16900,0
2018-06-01,1659968889,I031040,생화,허킨스 오빗 LED 헤드랜턴 180도 시야각,59000,59000,0
2018-06-01,241025556,I031070,애완동물관리비,스피드스택스 스탠다드 컵쌓기 지능발달 유아 아동,20600,20600,0
2018-06-01,246658869,C012040,여자학생복,큰옷 빅사이즈 데님롱셔츠원피스 WW-1704 빅사이즈 여,50160,49160,-1000
2018-06-01,1778501209,L021020,장신구,[바보사랑][액세서리키친] 키즈 Name/Number 팔찌,19900,19900,0
2018-06-01,112683937,D031010,주택수선재료,페인트마트 노루페인트 유성페인트 슈퍼에나멜 300ml 샘플페인트 소분판매 유성 에나멜,4000,4000,0
2018-06-01,1778501205,L021020,장신구,[바보사랑][액세서리키친] 925실버프레임 좋은기운 원석목걸이,29900,29900,0
2018-06-01,1778501206,L021020,장신구,[바보사랑][액세서리키친] 925실버 30mm 링귀걸이 A8203E002,19900,19900,0
2018-06-01,1902849997,C013010,점퍼,아디다스 유소년 콘디보16 스타디움자켓 (AN9871 ),139560,124210,-15350
2018-06-01,1778501207,L021020,장신구,[바보사랑][액세서리키친] 925실버 20mm 링귀걸이 A8203E001,15900,15900,0
2018-06-01,1778501208,L021020,장신구,[바보사랑][액세서리키친] 925실버 3mm 실버볼 팔찌 3종택1,39900,39900,0
2018-06-01,473402417,C012040,여자학생복,아크릴겹브이조끼(N17NW7707)/ 나인스텝,20000,19000,-1000
2018-06-01,930329861,A016120,바나나,[그린팜]필리핀산 바나나 13kg 1박스 (8송이),36900,35650,-1250
2018-06-01,1084787886,E031140,비데,필터가 필요없는 대림도비도스 방수비데 DLB-712W,178000,178000,0
2018-06-01,1778501202,L021020,장신구,[바보사랑]scenuerdo 향수팔찌 sky blue,42000,42000,0
2018-06-01,911985033,C011020,남자상의,패딩 코트 PD23 WS패딩코트코트남자코트트랜치코트남,154230,154230,0
2018-06-01,1778501204,L021020,장신구,[바보사랑]scenuerdo 향수팔찌 venetian red,42000,42000,0
2018-06-01,1737012035,I031040,생화,K4Camp고강도 접이식 야전침대/등받이/특대형,24900,24900,0
2018-06-01,1300922700,C013030,스웨터,[동대문] (색상 : 네이비 | 사이즈 : 2XL(110)) BIG,56200,56200,0
2018-06-01,1478103480,E061030,전구,LED미니크립톤 LED인찌구 LED촛대구 장식구 크립톤,2890,2890,0
2018-06-01,826162753,A012010,국산쇠고기,[무항생제 한우선물세트]한우 보신2호약 3.1kg,114000,114000,0
2018-06-01,396091922,E051020,건전지,페어맨 리튬이온 26650 배터리 충전지 5200mAh 건전지,20000,20000,0
2018-06-01,1280020305,I031040,생화,컨텐더 리베로헤드기어CHG-733,121500,119070,-2430
2018-06-01,1914449660,F012020,생리대,릴리안 초흡수 파우더향 중형 16P,3900,3900,0
2018-06-01,1805699547,E011050,책상,OMT 접이식 노트북 테이블 각도높이조절 책상 ONA-Q8,18000,17500,-500
2018-06-01,1459062385,E011020,침대,특가[잉글랜더]NEW머쉬 프리미엄 서랍형 가죽헤드침대,277900,277900,0
2018-06-01,496956361,C012060,여자내의,[화이트폭스]일자핏데일리린넨슬랙스,29000,25810,-3190
2018-06-01,292405090,E021010,침구,의자패드 블루 라티오/ 의자패드 의자매트 디자인방석,7500,6680,-820
2018-06-01,431857821,C014010,아동복,[프렌치캣]YL 캣 MTM Q62DKT411,18000,15300,-2700
2018-06-01,1691431189,L012030,칫솔,[오랄-비]스테이지스 어린이칫솔 8개,21400,21400,0
2018-06-01,1122836204,E011050,책상,이노센트 루이카 1200 베이직 테이블 책상,36000,32400,-3600
2018-06-01,661888887,L021020,장신구,실버/팔찌/은팔찌/팔찌/염주/불교용품/합장주/부적/향,59900,59900,0
2018-06-01,238171634,A022050,탄산음료,경기오픈마켓 코카콜라 코크제로 185CAN X30 무료배송,14800,14800,0
2018-06-01,823478369,E011030,거실장,데코라인 타미LPM TV다이 1200/1800거실장,34900,34900,0
2018-06-01,655687757,A017220,양파,동결건조 대파가루 30g 대파분말 국산 대파,9900,9900,0
2018-06-01,1199925647,C013010,점퍼,남자 바람막이 점퍼 간절기에 입기 딱 좋은 잠바 모음,29700,29700,0
2018-06-01,1657222434,L021060,유모차,[초특가]쥬비 카부스 초경량 쌍둥이유모차(사은품3종),393000,393000,0
2018-06-01,465905991,A018110,물엿,초지일관 천연발효 현미식초 500ml x 3병세트 샐러드,60080,54080,-6000
2018-06-01,967011750,C013020,티셔츠,힙덮는 길이 무지롱티 심플 여성박스티 데일리티셔츠,6900,6900,0
2018-06-01,1871766396,E061060,살충제,제트파워 울트라 바퀴살충제(500ml) 개미 거미 살충제,5650,5650,0
2018-06-01,1768609813,L012110,색조화장품,1+1+1 백탁 끈적임NO/선크림 수분썬 SPF50PA+++화장품,15000,14000,-1000
2018-06-01,469547188,E041010,식기,풍수인테리어/풍수/지리/삼족두꺼비/대박재운/재운발,125600,123090,-2510
2018-06-01,482792228,C012060,여자내의,-크로스 무지 티셔츠- 크로스티 무지티 반팔티셔츠 V(,36000,31680,-4320
2018-06-01,555516515,F011120,인삼,산삼배양근분말x70g 국산 산삼배양근 부모님선물,128000,126720,-1280
2018-06-01,1931107556,A011070,혼식곡,초이스엘 엿기름가루(700G),5380,5380,0
2018-06-01,1093247724,E031080,선풍기,대성셀틱_ 전기 컨벡터히터 DSCV-200S,136000,136000,0
2018-06-01,1093247723,E031080,선풍기,대성셀틱_ 전기 컨벡터히터 DSCV-150S,122000,122000,0
2018-06-01,1093247726,E031080,선풍기,대성셀틱_ 전기 라디에이터 DSRA-15,106000,106000,0
2018-06-01,1998519781,A014020,분유,안심 멸균수! 마미하트 우리아이워터 루이보스 240ml 48개입,43190,41020,-2170
2018-06-01,1093247725,E031080,선풍기,대성셀틱_ 전기 컨벡터히터 DSCV-250S,151000,151000,0
2018-06-01,1628142249,C013050,운동복,팔아유/유리면에 손상을 주지않는 PVC특수코팅 프리미엄 스텐레스 성에제거기/당일발송,3900,3340,-560
2018-06-01,745744409,C011050,남자내의,[상세페이지참조] 푸마 트레이닝 팬츠(65382437),58600,58600,0
2018-06-01,1093247720,E031080,선풍기,대성셀틱_ 전기 라디에이터 DSRA-9,74000,74000,0
2018-06-01,1637735037,C013010,점퍼,[코코애비뉴][코코애비뉴]스웨이드지퍼자켓_71103,104500,100320,-4180
2018-06-01,1093247722,E031080,선풍기,대성셀틱_ 전기 컨벡터히터 DSCV-100S,108000,108000,0
2018-06-01,1093247721,E031080,선풍기,대성셀틱_ 전기 라디에이터 DSRA-13,94000,94000,0
2018-06-01,989022165,A012010,국산쇠고기,홍성한우 차돌박이 600g 1등급,51900,49200,-2700
2018-06-01,439638352,A019100,식초,(무)오뚜기 식당용케찹(캔)3.3kgX6개식당용케찹 케첩,54800,46580,-8220
2018-06-01,896791776,A011170,떡,농협에서 우리쌀로 만든 떡 3총사떡국떡 조랭이떡 떡볶이떡,2500,2500,0
2018-06-01,1350450607,C014010,아동복,싱글투버튼 유아정장 3종세트(0-24개월)203294,29800,29800,0
2018-06-01,546611967,C013020,티셔츠,[반에이크]네버마인드T (VA84TSQ391Z),19800,17820,-1980
2018-06-01,1723080750,F012010,종이기저귀,보솜이 스타일베베 밴드/팬티 1BOX,24900,24900,0
2018-06-01,294152639,A017250,고사리,청학 냉동브로콜리-1kg/냉동채소야채업소용식당식자재,5700,5130,-570
2018-06-01,1392598257,I031010,장난감,마트쇼핑카트위에있는지붕차/12월특가,69800,69800,0
2018-06-01,196292007,C012030,여자상의,데일리 랩롱원피스 린넨 쉬폰 플레어 나시 캉캉 면,15800,15800,0
2018-06-01,1853072263,E011040,소파,[까로네까사]론칭특가!!헤드틸팅 4인천연면피가죽소파,598500,598500,0
2018-06-01,2125386854,C012040,여자학생복,바네사 양 V넥 뒷트임 하찌 조끼 KD 여자조끼 뒷트임,42970,42970,0
2018-06-01,236075075,C013010,점퍼,#NAME?,45310,45310,0
2018-06-01,1546449165,A011010,쌀,미강가루 2kg/생미강가루/볶은미강/쌀눈/쌀겨/현미/쌀,11900,11900,0
2018-06-01,898450796,A017130,도라지,흙당근(100G),599,599,0
2018-06-01,1342637662,A014020,분유,트루맘 프리미엄 후레쉬 1  2 3  4 단계- 3 캔x800g,58000,58000,0
2018-06-01,941994817,A021010,커피,더치커피 다이어트커피 빼자까페 + 명품키홀더 증정,20000,20000,0
2018-06-01,1085435768,C021010,아동화,[스케쳐스]TWINKLE TOES / 트윙클토 SK0GL17X361 351 321(센텀시티점),42000,36670,-5330
2018-06-01,483790049,C012040,여자학생복,[저스트원] 테레사 린넨 반팔셔츠,18900,18900,0
2018-06-01,240571759,C021040,실내화,[푸마] (SIZE : 275) 플레어 2(18951703) 신발 러닝,85190,85190,0
2018-06-01,488422755,F012020,생리대,생리대 좋은느낌 36+12/순면/팬티라이너/오버나이트,7900,7900,0
2018-06-01,1319080773,C021020,구두,901 끈 3목 3.0 cm 남성로퍼 cm 901 남성로퍼 정장화,40670,40670,0
2018-06-01,1096700571,C012030,여자상의,나시원피스/미니원피스/섹시/홀복/클럽의상/오프숄더,18900,18900,0
2018-06-01,475808355,C011030,남자학생복,FS-172 화이트단추 데님셔츠 샴브레이셔츠 캐쥬얼셔츠,34240,34240,0
2018-06-01,376903305,A013010,갈치,반기수라 양희경 손질갈치 7팩/21토막,24900,24900,0
2018-06-01,1054345357,C011030,남자학생복,밀란시아 빅사이즈 오버니트조끼 man앤11-1 빅사이즈,46750,45820,-930
2018-06-01,690122477,C011030,남자학생복,(AGC셀린 배색 롱가디건 KD 롱배색원피스 카디건 A라,65390,65390,0
2018-06-01,2087428456,C014020,유아복,아둘 가족티 유아 스트라이프 트레비 상하세트 11,19100,19100,0
2018-06-01,1156947983,A017120,고구마,{3kg 6 500원} 포근포근 햇감자 5kg/10kg,8900,8900,0
2018-06-01,1890084166,C013020,티셔츠,30%쿠폰! 홈쇼핑인기 여름신상 단독찬스~85%,19900,19900,0
2018-06-01,1260329486,A017040,양배추,시금치가루(국산) 300g,9700,9700,0
2018-06-01,529553460,C012060,여자내의,라인이 예뻐보이는 베이지체크주름치마 주름 교복치마,49840,48350,-1490
2018-06-01,1260329487,A017040,양배추,시금치가루(국산) 100g,3800,3800,0
2018-06-01,104844304,E011020,침대,라자가구 LED 슈퍼싱글 퀸 평상형 침대 세트 매트리스,319000,234000,-85000
2018-06-01,548571485,A016120,바나나,필리핀산 고당도 바나나 13kg(7발내외),33000,33000,0
2018-06-01,1913427868,L021060,유모차,빈지오 유모차 초경량/기내용유모차/에어폴딩유모차/,58000,58000,0
2018-06-01,1283992064,C012060,여자내의,[올리비아하슬러]심플절개 H스커트_L9S7,15900,15110,-790
2018-06-01,2118594056,A012010,국산쇠고기,[무항생제] 양지 600g 1등급,38400,38400,0
2018-06-01,290542164,C011050,남자내의,빅사이즈 남자 남성 면 반바지 스판 여름 5부 린넨,9900,9900,0
2018-06-01,1090482832,E031080,선풍기,마그마_욕실난방기 2구 실버램프,59000,59000,0
2018-06-01,1692323841,A017220,양파,(맛나)#깐대파(국산)10kg,43760,43760,0
2018-06-01,550320759,C012020,원피스,[올리비아하슬러]와이드배색시크코트_D3P2,47900,45510,-2390
2018-06-01,1238842254,C013040,청바지,[무료배송]생지 밴딩 청반바지 남성반바지 캐주얼반바,34090,34090,0
2018-06-01,1160234759,D031010,주택수선재료,[데코아트]간단한 우리집 꾸미기 풀바른 합지벽지,2800,2800,0
2018-06-01,2096576169,A016120,바나나,[거북농산]멕시코바나나10봉지 필리핀바나나 9손 6손,29800,29800,0
2018-06-01,440594254,E011040,소파,(수납형추가)300조한정특가 쇼파/장의자-csp130,59800,59800,0
2018-06-01,1476602922,E061010,세탁세제,테크 실내건조냄새끝 액체세제 리필 2L x 4개 외,14900,14900,0
2018-06-01,1326724777,C012040,여자학생복,BL228-반오픈 스트라이프 블라우스 여자블라우스 반오,18720,18720,0
2018-06-01,165759747,E051030,디지털도어록,UG7000S/도어락/카드4장/무타공도어락/디지털도어락,95000,68080,-26920
2018-06-01,1396145161,E031140,비데,{사은품증정} 노비타 비데 BD-KT320BL 착좌센서 건조,159000,159000,0
2018-06-01,1263337495,C012030,여자상의,[온더리버]온더리버 여름신상 데일리룩 특가,9900,9900,0
2018-06-01,1021900900,C012030,여자상의,베니토 델러스 원피스/레이스/A라인/반소매/미니/하객,68000,68000,0
2018-06-01,859957375,A013020,명태,(맛나)박스/코다리(12코 러시아),70810,70810,0
2018-06-01,2111533548,I012060,저장장치,버티컬마우스 손목 터널증후군 예방 인체공학 M1189,9000,8640,-360
2018-06-01,988038965,A018070,파이,[롯데]롯데 빼빼로 바닐라 블랙쿠키 32G,960,960,0
2018-06-01,1356305040,C014010,아동복,한국생산 야구 상하복 모자 레드(0-24개월) 800025 /,80000,70400,-9600
2018-06-01,427120001,L021030,가방,휴가필수! 리햅 신상 네트백/왕골백/에코백,16900,16900,0
2018-06-01,1931107500,A011070,혼식곡,초이스엘 고구마전분맛(350G),4580,4580,0
2018-06-01,2018643533,C021040,실내화,LIVITY 비오는날신는 초경량 AIR반장화 남녀공용 레인부츠 남자장화 여자장화 장마장화,12800,11800,-1000
2018-06-01,982553641,A019080,고추장,해찬들 태양초골드고추장 1.5KG+300G 증량기획,20600,14900,-5700
2018-06-01,1308729840,C012040,여자학생복,진주 리본 니트 MIWKA8533T/ 미쏘,39900,37910,-1990
2018-06-01,1645535024,C013010,점퍼,여름점퍼.신사점퍼.할아버지옷.어르신옷.효도선물,39800,39800,0
2018-06-01,1052434803,C013020,티셔츠,RT6 무화확 천연염색 브이넥숯티셔츠(남여공용),44350,43470,-880
2018-06-01,439638381,A018090,잼,오뚜기 후루츠잼300gX15개(1박스)후루츠잼 잼 포도잼,80500,70840,-9660
2018-06-01,290312064,E021020,커튼,단색 실 커튼 문발 인테리어커튼 커튼 비즈발 인테리,9580,9580,0
2018-06-01,1378766372,E011040,소파,소네즈쇼파/쇼파/소파/3인용쇼파/3인쇼파/패브릭쇼파,179100,179100,0
2018-06-01,1085734045,C013020,티셔츠,흰색면티/기본티/무지티/흰티/빅사이즈/단체티/런닝,2900,2900,0
2018-06-01,1095100909,C014010,아동복,[나이키조던키즈]AJ하드블러반바지세트(NMM11QST51),49000,41650,-7350
2018-06-01,1905517495,I031010,장난감,[아이코닉스 춤추는 타요] 꼬마버스 타요 자동차장난감 장난감 완구 아이코닉스 춤추는,39200,38030,-1170
2018-06-01,1518888466,C012060,여자내의,여성용 방한 레깅스 스키니바지 캐주얼레깅스 쫄바지,20010,20010,0
2018-06-01,1625088712,A016150,아몬드,산과들에 17년 캘리포니아산 당일가공 구운 햇 아몬드,11900,11900,0
2018-06-01,148411125,F012010,종이기저귀,LG 토디앙 핑크퐁 밴드/팬티 3팩,39900,39900,0
2018-06-01,1280020370,I031040,생화,컨텐더 스파링헤드기어CHG-737-합피,97500,95550,-1950
2018-06-01,245079,L012090,기초화장품,키엘 울트라 훼이셜 모이스처라이저 125ml/페이셜,34900,34900,0
2018-06-01,1090482835,E031080,선풍기,마그마_욕실난방기 3구 골드램프,88500,88500,0
2018-06-01,1939264215,C021010,아동화,아동 운동화 아동화 유아 신발 키즈 남아 여아 벨크로,24900,24900,0
2018-06-01,1090482833,E031080,선풍기,마그마_욕실난방기 2구 골드램프,69000,69000,0
2018-06-01,1090482834,E031080,선풍기,마그마_욕실난방기 3구 실버램프,79000,79000,0
2018-06-01,1090482839,E031080,선풍기,대동해모로_ 클래식 원통형 전기스토브 DW-300A (2.9kw),71200,71200,0
2018-06-01,983852375,E011040,소파,삼익가구 몽블랑 이태리 천연소가죽 라텍스 4인 소파,486000,486000,0
2018-06-01,985548695,A019070,양념소스,오뚜기 통닭양념 소스 2kg 떡볶이 닭강정 치킨 소스,5000,5000,0
2018-06-01,1090482838,E031080,선풍기,대동해모로_ 클래식 원통형 전기스토브 DW-200 (1.8kw),62000,62000,0
2018-06-01,529528499,C012060,여자내의,허리조절 레드체크 교복치마 교복 예쁜교복 교복쇼핑,49840,48350,-1490
2018-06-01,312645473,C013050,운동복,[맥스파이더] 3D이지웨빙-루프랙없는 차량용 루프백 장착 악세서리,37000,34040,-2960
2018-06-01,1945597049,C014010,아동복,[아이러브제이] 여름 쿨 썸머 쫀쫀 나시 티 JMUTO10,3900,3530,-370
2018-06-01,89596197,C012040,여자학생복,[MLB]엠엘비 2종택1 남성 실켓쭈리 MLB 후드집업(31TRC6811),79000,67150,-11850
2018-06-01,447451384,C012030,여자상의,[무료배송]빅사이즈 DNB0083R 딥브이 ST 원피스 802,41590,41590,0
2018-06-01,1565577548,A011110,당면,국산콩 무소포제 포두부 건두부 두부피 바른먹거리,14900,14900,0
2018-06-01,2084277593,E011050,책상,OLLSON 책상,33900,33900,0
2018-06-01,51857872,A019110,드레싱,● ♣ 오뚜기 참깨 드레싱(245G),1970,1970,0
2018-06-01,1083065834,A014040,발효유,탐앤탐스 티요 요거트파우더800g/아이스크림/스무디,11480,11480,0
2018-06-01,1180803409,C013050,운동복,44_고구마베이비 아기옷-무형광 에니멀 자카드 민소매,10910,10590,-320
2018-06-01,631169468,F012050,의료측정기,마이크로라이프 IR150 귀체온계,56000,52000,-4000
2018-06-01,170442363,L021020,장신구,14K 정품 Gold 슬림큐빅스틱 반지 오하나 스타일 일자,216400,209910,-6490
2018-06-01,1931107528,A011070,혼식곡,초이스엘 감자전분맛(450G),4320,4320,0
2018-06-01,440294625,A015020,식용유,해표 포도씨유250mlx30개(B)카놀라유 포도씨유 올리브,113400,99800,-13600
2018-06-01,1090482861,E031080,선풍기,대동해모로_ 욕실용 1초 순간발열 난방기(2구) DD-500,79000,79000,0
2018-06-01,565881475,C013010,점퍼,내구성좋고 100퍼센트방수 여성 슬림 코트형 우의우비,23960,23960,0
2018-06-01,1090482862,E031080,선풍기,대동해모로_ 욕실용 1초 순간발열 난방기(3구) DD-800,99000,99000,0
2018-06-01,1280020399,I031040,생화,컨텐더 투명헤드기어파랑CHG-739BL,97500,95550,-1950
2018-06-01,1734415310,A011090,국수,농심 짜파게티 범벅 컵라면 70g 30개 짜장범벅 라면,20900,20900,0
2018-06-01,1034004686,C013020,티셔츠,[이동수스포츠] 골프웨어 상/하의 코디특가 100종,14900,14900,0
2018-06-01,820086612,I012060,저장장치,로지텍코리아 G413 게이밍키보드 Romer-G 기계식,99000,99000,0
2018-06-01,1991963268,C011030,남자학생복,더피스타일 남성 스트라이프 차이나 카라 셔츠,40000,32000,-8000
2018-06-01,1589226932,A013090,전복,통영 산지직송 가리비1kg,3800,3800,0
2018-06-01,1555069719,A021010,커피,an 갓볶은 신선한 원두커피 빈스프레소 1kg part_1,12900,12900,0
2018-06-01,327952095,I053010,공책,신학기 과목노트(한문)(10개입)-랜덤 과목노트 학교노,10960,10960,0
2018-06-01,112862477,C013020,티셔츠,빅사이즈 기본매치30수긴팔티 WW03409 임부복 미시옷,13940,13940,0
2018-06-01,1972295508,C012040,여자학생복,단추 트임 비죠 린넨 베스트 (SF8XVT105)[예약상품 2018.06.01 부터 발송]/ 스테파넬,39000,33150,-5850
2018-06-01,1024749072,A014020,분유,프리미엄 산양분유 1~4단계 800gX3캔,119900,119900,0
2018-06-01,1547473623,F012020,생리대,[릴리안]슈퍼롱 오버나이트 모음/숨쉬다/순수한면,9900,9900,0
2018-06-01,2067237464,C015040,장갑,랜드스케이프_양가죽렉스털장갑(여성용) 가죽장갑 털,23940,23940,0
2018-06-01,263195276,E021020,커튼,데코지오 린넨 아일렛 거실 안방 암막커튼 1+1,28900,28900,0
2018-06-01,1324754888,I031070,애완동물관리비,당구 큐 케이스 모음전/ 보급형 케이스 명품 케이스 다양한구성 큐 가방 큐빽 당구 총,4900,4340,-560
2018-06-01,563640062,E011050,책상,/코너책상R 블랙브라운 블랙 베칸트 160x110 cm/ 코너,475000,422750,-52250
2018-06-01,481500519,E061030,전구,LED방등/LED 등기구/LED조명/LED전등/LED거실등,28000,28000,0
2018-06-01,339800405,L012110,색조화장품,NEW시즌4 2018 AHC 선스틱(1+1)/썬스틱/선크림,15900,15900,0
2018-06-01,1433840694,E031080,선풍기,나노카본 터보 온풍기 FU-4033 - 온풍기 터보온풍기,597220,531530,-65690
2018-06-01,1770240484,A013030,조기,제주 해바라기 참조기 5호700g이상 x 3줄 깨끗한 해역,109300,109300,0
2018-06-01,555359401,C013040,청바지,나나진)당일발송 아동청바지/아동의류/아동바지/키즈,9900,9800,-100
2018-06-01,384097326,E011050,책상,입식컴퓨터책상+에스백체어 의자 책상세트,91900,91900,0
2018-06-01,1433345162,A012010,국산쇠고기,[무항생제] 꼬리반골 2kg 1+등급,42000,42000,0
2018-06-01,466754285,A012060,햄및베이컨,리챔 200g x 12캔 (외 리챔120g or 리챔340g)/ 동원,25900,22020,-3880
2018-06-01,1423833651,C021040,실내화,나이키 에어맥스 제로에센셜 100%정품 허라취런울트라,79000,79000,0
2018-06-01,550153630,L021010,손목시계,전자손목시계 남성스포츠시계 군용군인방수시계 N42,12500,12500,0
2018-06-01,545787747,I011030,사진기,명품마을 캐논 정품 EOS M50 + 18-150mm 이벤트,1497850,1497850,0
2018-06-01,572192625,C021020,구두,레노마 남성 드레스 MEX9725FG17,60000,49200,-10800
2018-06-01,1428510250,C014020,유아복,아둘 패밀리룩 가족티 성조기 유아반팔 티셔츠 12,9600,9500,-100
2018-06-01,1777592080,C021040,실내화,[주문폭주]11800원 균일가! 월드컵 성인 키즈 운동화,11800,11800,0
2018-06-01,393738175,A016090,참외,[오늘만 이가격!]달콤한 성주참외 5kg,7500,7500,0
2018-06-01,552070426,C013020,티셔츠,mm17 러플 반폴라 TOP_화이트 반폴라티셔츠 화이트티,16090,16090,0
2018-06-01,450167289,C015040,장갑,아놀드파마_APGW-BY1221(여성가죽장갑) 장갑 가죽장갑,21010,18910,-2100
2018-06-01,1216702485,A016060,감,달콤샤르르 자연그대로 만든 아이스 홍시 50개(컵)/개,53770,48400,-5370
2018-06-01,420583838,C012030,여자상의,[나나살롱] 에이미 나염 DRESS,45000,45000,0
2018-06-01,1326010916,L012090,기초화장품,헤라 미네랄 비비/HD 퍼펙트 파운데이션/파우더 팩트,30700,30700,0
2018-06-01,956694094,A017020,상추,초이스L 양상추(통),5490,2490,-3000
2018-06-01,353353302,A012050,소시지,CJ 맥스봉 35gx32/55gx15/맥스봉 할라피뇨 신제품출시,12000,12000,0
2018-06-01,1539046584,L021020,장신구,물방울 크리스탈 초커 목걸이 슬림팔찌 슬림목걸이 초,12000,11880,-120
2018-06-01,369508920,C021040,실내화,망사 에어 키높이운동화 스니커즈 여름운동화,34500,34500,0
2018-06-01,1342403473,A018010,초콜릿,린트 카카오99% 다크초콜릿 100gX2개/닙스/초콜렛,11500,11500,0
2018-06-01,5985956,C013010,점퍼,아디다스 롱 다운 파카(M64172),183570,170730,-12840
2018-06-01,99861105,C021040,실내화,2018 신상 나이키 운동화 모음/에어맥스/코르테즈/코,69000,61760,-7240
2018-06-01,632797027,C012020,원피스,[미니멈][MINIMUM]수리알파카 롱코트 MRDOWL1730-MG,359000,341050,-17950
2018-06-01,1780617201,L021020,장신구,[바보사랑]빌리지골드 초커목걸이,8900,8900,0
2018-06-01,489853290,A019100,식초,오뚜기 델리 토마토 케찹 1kg,3670,3670,0
2018-06-01,1780617200,L021020,장신구,[바보사랑]셜리진주실버 초커목걸이,8900,8900,0
2018-06-01,1780617203,L021020,장신구,[바보사랑]베슬슬림골드 초커목걸이,5900,5900,0
2018-06-01,1780617202,L021020,장신구,[바보사랑]빌리지실버 초커목걸이,8900,8900,0
2018-06-01,1780617205,L021020,장신구,[바보사랑]소렌크리스탈 레이어드 초커목걸이,7500,7500,0
2018-06-01,1780617204,L021020,장신구,[바보사랑]베슬슬림실버 초커목걸이,5900,5900,0
2018-06-01,1780617207,L021020,장신구,[바보사랑]베라실버원 초커목걸이,7900,7900,0
2018-06-01,207532751,A019170,냉동식품,[동원] 개성왕새우만두 315gx6봉+왕만두 350gx2봉+미니돈까스 450g 증정,19900,19110,-790
2018-06-01,1780617206,L021020,장신구,[바보사랑]솔렘라운드 초커목걸이,8900,8900,0
2018-06-01,1244467015,I012010,컴퓨터,LG데스크탑 B71EV-AX7716 코어i7 4G 1TB 윈도우없음,924460,869000,-55460
2018-06-01,1780617208,L021020,장신구,[바보사랑]솔더큐빅포인트 초커목걸이,7900,7900,0
2018-06-01,193254414,F011130,홍삼,6년근 홍삼으로 매일매일 원기보충!,20000,20000,0
2018-06-01,458726868,C011050,남자내의,9부 남자쿨팬츠여름아이스쿨바지고무줄일몸빼잠옷여성,5260,5000,-260
2018-06-01,1039568469,C014010,아동복,[에꼴리에]소이 PNC02 3부 롤업데님바지 18M0263,27800,27250,-550
2018-06-01,1307669481,E011070,식탁,[아이솔] 투에버 홈바/아일랜드식탁/광파오븐수납,277800,277800,0
2018-06-01,1920780988,E041070,밀폐용기,글라스락/국산/유리병/유리밀폐용기/잼/공병/선물상자,500,460,-40
2018-06-01,984518017,A017180,호박,초L프라임) 애호박(특),2990,1000,-1990
2018-06-01,586416805,C013010,점퍼,봄여름가을 남자마이 버튼자켓 콤비 카라 블레이져,49900,49900,0
2018-06-01,1525688954,C013020,티셔츠,특반팔V넥YN/Lㅡ4XL/2018신상품/빅사이즈/반팔티/큰옷,5000,4900,-100
2018-06-01,1048492779,C011030,남자학생복,핏이 예술 청남방 데님 남자 남성 셔츠 남방 빅사이즈,17800,17800,0
2018-06-01,1493902672,I031040,생화,빈슨메시프 여행라이너 초경량 침낭 내피 담요 모포,8900,8900,0
2018-06-01,901225178,A013140,북어채,초이스L 통북어 100G,8990,8990,0
2018-06-01,1056902142,I012060,저장장치,데빌스킬 MK108RGB 청축 기계식키보드,50850,47800,-3050
2018-06-01,1555083931,A018110,물엿,식용빙초산 400ml 24 개입box/pet Tel.032 674 0284,34000,34000,0
2018-06-01,1163581369,A019100,식초,휘피드 라이트 스프레이 휘핑크림 425G X 3개 / 휩트,22910,22910,0
2018-06-01,2086455691,A011010,쌀,철원오대쌀 20kg /쌀20kg,56900,56900,0
2018-06-01,145368785,A012040,닭고기,푸드원[훈제/무염/칠리/마늘[국내산100%]닭가슴살 3kg,29200,28900,-300
2018-06-01,901225179,A013140,북어채,초이스L 황태채(100G),6990,6990,0
2018-06-01,563461348,E061030,전구,일광전구 볼전구크립톤촛대/G80G50G95G125M5060W40W,1600,1600,0
2018-06-01,1610468297,A013150,어묵,(부산 꼬지어묵)90GX10꼬치 모듬꼬치어묵 종합꼬지,6100,6100,0
2018-06-01,799957353,A017230,마늘,2018년 햇양파 대용량 10kg 6900원~ 출하특가!,6900,6900,0
2018-06-01,592756489,C012040,여자학생복,빅사이즈/단체복/블라우스/여자/쉬폰/스트라이프/화이,12900,12900,0
2018-06-01,255094322,C012060,여자내의,언발란스 쉬폰스커트 JE-2568 치마 롱치마 스커트 실,10680,10260,-420
2018-06-01,1537117772,C013010,점퍼,여 오버사이즈 레인코트 378513/ 지오다노,29800,24440,-5360
2018-06-01,350088602,C013010,점퍼,지오지아 바람막이 택1/ 지오지아,10000,7800,-2200
2018-06-01,433155026,C013050,운동복,빅사이즈 도어가드2P 자동차 차량 문콕방지 범퍼가드,8450,7780,-670
2018-06-01,485060874,C013010,점퍼,팬지로브자켓 BR1704 롱자켓 캐주얼롱자켓 로브자켓,88240,88240,0
2018-06-01,959468498,A012040,닭고기,다향오리 정육 슬라이스(500G),7990,7990,0
2018-06-01,983390736,A016060,감,씨없는 청도 반시로 만든 아이스홍시(60gX48개/탈피/개별포장),48500,38800,-9700
2018-06-01,895709188,A017070,부추,청상추(봉),1990,1990,0
2018-06-01,238541924,C011030,남자학생복,MCD-905 믹스매치 컬러배색 브이넥 가디건/봄가을겨울,19000,19000,0
2018-06-01,895709187,A017070,부추,적상추(100G/봉),2990,1990,-1000
2018-06-01,703642009,A016110,딸기,[딜라잇가든]냉동과일34종_딸기/망고/살구/수박/포도,5900,5900,0
2018-06-01,1326754500,C013020,티셔츠,무지 반팔 후드티셔츠 S-XL SD-6601,14020,13740,-280
2018-06-01,983390735,A016060,감,씨없는 청도 반시로 만든 아이스홍시(60gX24개/탈피/개별포장),29000,23200,-5800
2018-06-01,1154827663,C012060,여자내의,[에잇세컨즈] 베이지 코튼 솔리드 슬릿 미디 스커트 (128427B56A),39900,37910,-1990
2018-06-01,695908063,A017210,파,정품 찰토마토 5kg/10kg토마토 드시고 건강하세요,8900,8900,0
2018-06-01,451528437,C011020,남자상의,MJSF18003 차콜 코튼 베이직 코트 남자베이직코트 남,91580,91580,0
2018-06-01,1148693800,C012040,여자학생복,[펀쇼] 린넨반오픈셔츠 빅사이즈 블라우스 루즈핏 마직,32700,29700,-3000
2018-06-01,1477699357,C012060,여자내의,핫탈부착점프슈트 VT2OP23/ 비지트인뉴욕,64000,57600,-6400
2018-06-01,452096020,C012020,원피스,[오즈세컨] [여성] 프릴 플라이트 점퍼 2WMS1PN001Q1048,598000,538200,-59800
2018-06-01,931402589,C013010,점퍼,아디다스 오리지널 롱 다운파카 (M64172 ),144410,128530,-15880
2018-06-01,2100179436,A022050,탄산음료,웰치스 355mlx24캔 3종/탄산음료/캔음료/음료수,14400,14400,0
2018-06-01,1196722572,A013070,굴,바다소리 새우가루 20포,10000,9660,-340
2018-06-01,1297997743,A016090,참외,참외/성주참외 출하 특가판매/ 5kg옵션선택,10900,10900,0
2018-06-01,433613540,I031040,생화,접이식 캠핑테이블 브로몰딩 야외테이블 매대 행사,12900,11490,-1410
2018-06-01,987114708,A016160,과일가공품,냉동망고 (베트남/1KG),19900,9900,-10000
2018-06-01,1394714732,C013010,점퍼,누빔 패딩 유니크 니트자켓 여성쟈켓 DM-4615,83550,79380,-4170
2018-06-01,407247389,A019180,즉석식품,육개장/갈비탕/설렁탕/곰탕/불고기/내맘대로 골라담기,1490,1490,0
2018-06-01,1982865314,A018110,물엿,명인 쌀조청 5kg/꿀 조청 물엿/국가지정명인 강봉석,25000,25000,0
2018-06-01,544160266,L012030,칫솔,(특가)유아칫솔x30개/어린이칫솔/브랜드칫솔/아기칫솔,5000,4900,-100
2018-06-01,55810704,I011030,사진기,명품 니콘 COOLPIX A10 정품 + 카메라 한정 사은품,100000,91900,-8100
2018-06-01,2028345688,A017120,고구마,2018년 국내산 하우스 햇감자 3kg,8900,8900,0
2018-06-01,1743571346,A022010,주스,Dole 돌100%스위티오주스 (120mlx32개) 망고/파인애플,11400,11400,0
2018-06-01,1180172575,A013020,명태,[마산어시장 이바다몰]절단명태코다리10kg1box,49000,49000,0
2018-06-01,1997285069,E011020,침대,[골든잼]더블 보료/흙침대 돌침대 보료매트 매트리스,1209200,1172930,-36270
2018-06-01,1391593546,C013060,등산복,밴드형 경량 트레킹팬츠/등산바지/등산복/남성바지,9900,9900,0
2018-06-01,325622119,C012040,여자학생복,[위쉬몰]RW 셔링플라워블라우스(2250H805),22680,19280,-3400
2018-06-01,2097510711,C015030,넥타이,LTIE-055 심플블랙넥타이 (솔리드) 블랙,19250,19250,0
2018-06-01,1534886823,E051020,건전지,자전거라이트 다이빙 수중 랜턴 라이칸 프로 1200루멘,78000,78000,0
2018-06-01,1258094596,C012060,여자내의,[디어제인][디어제인]마리니핀턱와이드팬츠M4474,12700,12070,-630
2018-06-01,646760619,C011030,남자학생복,[JEEP]공용_여러가지와펜다운베스트 JG4JPU610,99000,84150,-14850
2018-06-01,1426137581,F012020,생리대,[에리에르]엘리스 생리대 고쿠수이 중형21px4팩,15400,15400,0
2018-06-01,12314907,A018100,꿀,(로얄제리 50g*10개) 꿀선물세트/설선물/추석선물/명절선물세트,599900,599900,0
2018-06-01,1472998705,C013030,스웨터,AGC후드집업 MJ5002_5009 남성의류 후드집업 후드티집,53440,53440,0
2018-06-01,1743101355,E011050,책상,니오플러스 인포메이션 안내데스크 카운터 로비데스크,225800,225800,0
2018-06-01,1780617230,L021020,장신구,[바보사랑]허밍라운드 초커목걸이,6900,6900,0
2018-06-01,1780617232,L021020,장신구,[바보사랑]심상치않아 별 초커,6900,6900,0
2018-06-01,1780617231,L021020,장신구,[바보사랑]심상치않아 나뭇잎 초커목걸이,6900,6900,0
2018-06-01,988093937,L012030,칫솔,초L) 이중코어 미세모 칫솔 (자일리톨) 2P,1990,1990,0
2018-06-01,1780617234,L021020,장신구,[바보사랑]트위드하트 초커목걸이,6900,6900,0
2018-06-01,1780617233,L021020,장신구,[바보사랑]페퍼라인 초커목걸이,6900,6900,0
2018-06-01,1780617236,L021020,장신구,[바보사랑]별따라라인 초커목걸이,7900,7900,0
2018-06-01,1780617235,L021020,장신구,[바보사랑]트위드스퀘어 초커목걸이,6900,6900,0
2018-06-01,912486316,A019110,드레싱,A.I.모데나 발사믹크림 400ml,23750,23750,0
2018-06-01,1780617238,L021020,장신구,[바보사랑]버브진주골드 초커목걸이,6900,6900,0
2018-06-01,2037868784,E061030,전구,오스람 번개표 삼파장 전구 20W 15W 형광등 36W 램프,1380,1380,0
2018-06-01,1780617237,L021020,장신구,[바보사랑]버브진주 초커목걸이,6900,6900,0
2018-06-01,1727631163,A016090,참외,농민직접 성주 꿀참외 5kg 9800원 한정특가,9800,9800,0
2018-06-01,1780617239,L021020,장신구,[바보사랑]버브진주실버 초커목걸이,6900,6900,0
2018-06-01,439604466,A013160,맛살,(냉동)한성 꽃맛살F 2kg식품 식자재 맛살 한성 꽃맛살,32200,27370,-4830
2018-06-01,1266063601,C012060,여자내의,린넨7부팬츠/M4539/ 디어제인,6700,6300,-400
2018-06-01,535922103,E031020,가스레인지,린나이/SK매직가스렌지RT-1004J/GRA-S2084/인기모델,117730,106700,-11030
2018-06-01,1289725409,A014030,치즈,라끌렛치즈(Raclette) 200g 1박스(8팩)/라클렛 치즈,115000,115000,0
2018-06-01,441067891,C013050,운동복,차량용소화기 소방차250/차량용소화기/휴대용소화기,28290,25770,-2520
2018-06-01,921299161,F012020,생리대,시크릿데이 생리대 러브 일반 팬티라이너 20p,1200,1140,-60
2018-06-01,1780617261,L021020,장신구,[바보사랑]리슬리진주화이트 초커목걸이,3900,3900,0
2018-06-01,1488261130,C014010,아동복,[블루독] 7부이지팬츠 (27425-411-50),43000,35260,-7740
2018-06-01,624757699,A013040,고등어,고등어밥상 100% 가시제거 순살노르웨이고등어,10900,10900,0
2018-06-01,619535037,L021020,장신구,스와로브스키 은침귀걸이 이어링 귀고리 유색 크리스탈 여성악세사리선물 패션쥬얼리,14200,13780,-420
2018-06-01,620359929,E021020,커튼,[파스텔데코] 블링블링 비즈발 무한감동 굿 아이템,19900,19900,0
2018-06-01,721067620,I012010,컴퓨터,7세대 카비레이크+사은품증정 DM500T7Z-AD3S 비즈,608560,578140,-30420
2018-06-01,289547262,E031010,전기밥솥,국민밥솥 원쿡 미니 전기밥솥(1인용~2인용/3인용~4인),31000,29800,-1200
2018-06-01,12060182,C013050,운동복,JPM여름 커플 트레이닝복 세트 남자 여자 냉장고 바지,23800,21800,-2000
2018-06-01,687016660,A022050,탄산음료,웰치스 포도 355mlx24캔 음료수/탄산음료/콜라/사이다,12900,12900,0
2018-06-01,1623452100,L021050,우산,MLB 키즈 우산 프리미엄 아동 어린이 자동우산,13900,13900,0
2018-06-01,394754914,C015040,장갑,고양이발 장갑 반장갑 겨울 털 장갑 보온장갑 귀여운,11650,11650,0
2018-06-01,1570547532,A011170,떡,국내산 햅쌀 떡볶이떡 가래떡 떡국떡 구워먹는 떡 3kg,15500,15500,0
2018-06-01,1361740263,E011050,책상,[이스마트] 1인실 드림 독서실책상/혼공책상,679000,679000,0
2018-06-01,663468087,A016100,수박,델리참_국산무가당딸기 IQF 1kg x 10개입 / (주)남양,116800,99280,-17520
2018-06-01,1398597616,C013050,운동복,경광등/ 경광등 경광봉 안전봉 지시봉 신호봉,11700,10600,-1100
2018-06-01,2850684,A012060,햄및베이컨,미국산 커클랜드 저염 베이컨 454gX4팩 + 아이스박스,25290,25290,0
2018-06-01,2040463962,D031010,주택수선재료,결로방지페인트/세라믹플러스18리터/곰팡이방지,98000,98000,0
2018-06-01,502001614,E031070,에어컨,JJH신일산업 천정용 선풍기 SIF-16CSH 여름선풍기 계,122520,122520,0
2018-06-01,1458338585,C013020,티셔츠,[케이투]여성 NEO 라운드 반팔티 3 W (KWM17242),19000,15200,-3800
2018-06-01,922121834,F012010,종이기저귀,[벨라베이비해피]형광물질 안전 프리미엄 유럽기저귀 벨트형 4팩(슬리핏/대,87500,87500,0
2018-06-01,1122350454,C011030,남자학생복,[바쏘옴므]화이트 면스판 와이드카라 타이트핏 드레스셔츠 (WSR1TD01C),29000,24940,-4060
2018-06-01,1160123878,C011030,남자학생복,신상 청남방 데님셔츠 연청 차이나 남자 남성 셔츠,21000,19800,-1200
2018-06-01,900237360,A012060,햄및베이컨,CJ 더 건강한 슬라이스 햄 (100G),4390,1990,-2400
2018-06-01,590502488,I031040,생화,접이식 캠핑테이블 야외테이블 바베큐 화로대 파라솔,15500,13710,-1790
2018-06-01,1373843018,E031110,청소기,유진로봇 아이클레보 로봇청소기 A1/A3 물걸레 겸용,299000,299000,0
2018-06-01,100326624,C013020,티셔츠,M~3XL 비침적은 20수 반팔티 쿨론 반팔 남자 면티 티,7900,7900,0
2018-06-01,1272054411,C011030,남자학생복,슬림)버튼다운 블루그레이 셔츠 남성상의 캐주얼남방,25800,25800,0
2018-06-01,1540192379,E011060,의자,학생의자 인테리어 식탁 등받이 쿠션 접이식 간이,5900,5900,0
2018-06-01,1407559954,A017160,오이,착한송이송향버섯 실속형1kg,20000,18000,-2000
2018-06-01,1771503162,A011170,떡,진공포장 쌀떡볶이 20kg 1kgx20개 대용량 떡볶이 떡,44000,44000,0
2018-06-01,988093900,E061080,키친타월,초L)물·기름 잘먹는 2겹 키친타올 200매*4,4990,4490,-500
2018-06-01,64828986,A018110,물엿,[두레촌] 식품 명인 쌀 조청 세트(8병) 물엿 꿀 조미료 엿 기름,44900,44900,0
2018-06-01,635943212,A019060,된장,청정원 순창재래식숙성된장(4.8Kg),14800,14800,0
2018-06-01,1644237271,A017110,감자,장흥표고_백화고세트350g건강식품 명절선물세트 특산품 추석선물세트 효도선물 표고세,148760,148760,0
2018-06-01,1400119249,L012090,기초화장품,피부관리실 클렌징크림 타이디밀크로션 1000ml 대용량,14900,14900,0
2018-06-01,1903934432,E041050,냄비,[해피콜] 해피콜 IH 진공냄비 4종세트(블루) + IH 인덕션레인지,209000,209000,0
2018-06-01,121868328,C012040,여자학생복,[모다아울렛][막스카라]막스카라MAX KARRA 17FW 신상 립 네크라인 와이드 롱 니트-M,39000,35100,-3900
2018-06-01,494125970,A017020,상추,제이제이몰 맛치마 상추 종자 씨앗 8g 채소 재배 쌈,5250,5250,0
2018-06-01,1974198065,C012030,여자상의,반셀 신상 베스트 원피스/블라우스/스커트/팬츠,14160,14160,0
2018-06-01,2134284020,E011050,책상,[EONC]최고의개인독서실책상/실속형 /우등생/집중력UP,38600,38600,0
2018-06-01,1597179216,F011130,홍삼,정관장 아이패스파워(power)(50ML*14입),95000,95000,0
2018-06-01,151455426,A017180,호박,고추(통 오포원 삐끼누 1K)X8 식자재 업소용식자재 대,113260,107600,-5660
2018-06-01,451120483,A019010,고춧가루,A안매운맛 고추가루 1Kg2개 가루 고추가루 안매운고추,41520,37370,-4150
2018-06-01,1726247578,A019080,고추장,(기획)순창 찰고추장1kgx2+450gx2/양념/소스,16900,16900,0
2018-06-01,177774898,F012010,종이기저귀,킨도 독일 프리미엄 기저귀 밴드형 3단계 (52매x3팩),43500,43500,0
2018-06-01,312266203,E011070,식탁,[동서가구]특가 LV북유럽풍내츄럴 4인 식탁세트,157000,139000,-18000
2018-06-01,1523361501,F012050,의료측정기,오므론 손목형 자동혈압계 HEM-6121+수첩 혈압측정기,77000,71500,-5500
2018-06-01,1509964480,I031040,생화,쭈꾸미대/갑오징어/선상낚시대/에깅대/초릿대+1추가,35000,35000,0
2018-06-01,1531207114,C013020,티셔츠,[아보키]아릭스 목폴라,10600,10070,-530
2018-06-01,1258285227,A014020,분유,프리미엄 산양분유 1- 3 단계 4캔*400g,90000,90000,0
2018-06-01,392908929,C015040,장갑,랜드스케이프_양가죽렉스털장갑(여성용) 장갑 여성용,24180,24180,0
2018-06-01,2107639494,A011160,빵,천연발효종*곡물치아바타(110g*4개),5900,5900,0
2018-06-01,557637616,C013020,티셔츠,베일리 단가라 롱폴라티 SD-9024 티셔츠 목티 목폴라,11150,11150,0
2018-06-01,2146413684,C021040,실내화,나이키 에어맥스2017 블랙 화이트 2종,76800,76800,0
2018-06-01,1559431363,A018010,초콜릿,(1+1초특가)트윅스/스니커즈540g//자유시간/초콜릿,18000,18000,0
2018-06-01,776413341,A011010,쌀,[거시기장터]17년 햅쌀 쌀의1번지 10kg,24900,24900,0
2018-06-01,305394129,C013020,티셔츠,여름 골프티셔츠 카라티 냉감 인견 반팔티 골프웨어,23800,23800,0
2018-06-01,815899080,E031070,에어컨,캠핑용 천장형 선풍기 실링팬 S-FAN50 화이트,19070,19070,0
2018-06-01,2103373203,C013030,스웨터,폴라폴리스 자켓 JK430W등산자켓패딩점퍼패딩점퍼패딩,54700,54700,0
2018-06-01,1006617181,C013040,청바지,(SR)MHA701 남자기모빅사이즈스판기모본딩청바지 기모,83000,82170,-830
2018-06-01,1772097407,L012040,치약,無합성세제 나무코니치약(2개~5개)+(여행용 7개까지),30000,29500,-500
2018-06-01,1667419190,L021020,장신구,[매드킨]여름신상입고/NO알러지/피어싱/써지컬,500,500,0
2018-06-01,1493468141,E041030,솥,풍년 결질 압력밥솥 6인8인 선택 신형추 인디게이터,56000,56000,0
2018-06-01,1035709520,I031040,생화,원형 파라솔의자 야외용의자 플라스틱의자,4100,3780,-320
2018-06-01,2087323600,E031010,전기밥솥,쿠첸 6인용 전기보온밥솥/전기밥솥/밥솥 WM-0619F,61410,57730,-3680
2018-06-01,1915377387,E041070,밀폐용기,담금주병 과실주병 5L~25L 매실병 유리병 술병,8000,7360,-640
2018-06-01,1299311374,C014020,유아복,데일리베베 린넨자켓세트/아동여름정장/반바지상하복,49000,47530,-1470
2018-06-01,1496518422,A011130,시리얼,오뚜기 바삭하고 고소한 부침가루 1kg X 10EA 고소한,37990,37990,0
2018-06-01,1429285775,C014020,유아복,유아 아동 반팔 상하복세트[디즈니정품],14800,14800,0
2018-06-01,1096052204,F012020,생리대,위스퍼 피부애 슈퍼롱 오버나이트10pX3(총30매)-나이,13600,13600,0
2018-06-01,1270295799,E011020,침대,[베디스]SALE! 정품6회전 단면매트리스+발통포함 SS/Q,71900,71900,0
2018-06-01,2004258827,E031130,보온매트,전기매트 온수매트 카페트 보관/부직포가방/케이스,4000,3670,-330
2018-06-01,1366705041,C015040,장갑,해피타운_2색털장갑(어른용) 방한장갑 남성장갑 니트,18330,18330,0
2018-06-01,312002547,C015040,장갑,[지맥스] 브랜뉴 아웃도어 반장갑 GMS10061-등산장갑/자전거장,6900,6180,-720
2018-06-01,549260486,E031110,청소기,한경희스팀청소기 SLO-500BL/분리형물통/30초순간가열,90000,90000,0
2018-06-01,984545669,A014050,달걀,초L프레시)햇달걀 (10입/중란),1590,1590,0
2018-06-01,820891031,A019110,드레싱,코리원/백설 크리미양파 드레싱 소스 2kg/양파/케이준,10500,10500,0
2018-06-01,545832058,I011030,사진기,정품 니콘 쿨픽스 A900 35배줌 카메라 디카 2018 신형,468240,421590,-46650
2018-06-01,1775350017,A019040,소금,한주소금25kg 본소금 장소금 정제염 최저가판매!! 마,12000,12000,0
2018-06-01,716783057,C012020,원피스,[보니알렉스](보니알렉스)부클 트리밍 배색 라인코트(BCHY182C),27700,24380,-3320
2018-06-01,1360393673,C012060,여자내의,시원한 냉장고면 큐롯팬츠 치마바지 숏팬츠 밴딩팬츠,11500,10700,-800
2018-06-01,437483102,A018080,설탕,캐인슈가 태국 비정제 사탕수수원당 천연 무정제 10kg,14500,14500,0
2018-06-01,984545668,A014050,달걀,초L프레시)왕란 (15입),3590,3590,0
2018-06-01,1828017999,A011030,찹쌀,오색보리2kg/국산/2017년산,7700,7700,0
2018-06-01,1347515758,A011020,현미,국산 찹쌀4kg/현미찹쌀/현미/찰현미/사은품,12500,12500,0
2018-06-01,422497015,E061040,부엌용세제,자연퐁 주방세제 용기 3kgx4개,16900,16900,0
2018-06-01,1354341932,C013020,티셔츠,양털 안감 후드집업 LDZ221 후드집업 집업,35780,35070,-710
2018-06-01,2005150450,C011020,남자상의,(무료배송) AG DB 280 럭셔리 마도비곤색 자켓 빅사이,130370,114730,-15640
2018-06-01,679060665,C011030,남자학생복,[TI포맨][TI FOR MEN] 티아이포맨 스트라이프 베스트 M144MVT275M1NV5,15300,13770,-1530
2018-06-01,1742628102,C015020,모자,슈프림 모자 볼캡 스냅백 썬캡 야구모자 성 남자모자,19800,19800,0
2018-06-01,1072051935,C013050,운동복,유노/EC-131/EB-191/EB-178 헤드레스트 뒷좌석컵홀더,17400,17400,0
2018-06-01,2112607694,A022010,주스,델몬트 오리지널 매실180mlx12병x4각(48병) 병음료,30780,30780,0
2018-06-01,1235235781,C011020,남자상의,MJ_1134 그레이 래글런코트 트렌치코트 겨울자켓 코트,93080,93080,0
2018-06-01,851396695,C012060,여자내의,파파야 ( CNHRSK914B ) 기본 면 스커트,10000,9000,-1000
2018-06-01,1904396857,C012060,여자내의,여성 팬츠 봄신상 정장 슬랙스 면치마 바지 청바지,22900,19900,-3000
2018-06-01,50144079,C011030,남자학생복,인터페이스 제작 양면가디건 바나나 포켓후드집업자,29700,29700,0
2018-06-01,683076996,E031120,믹서,정품/신일믹서기 모음/분쇄기/SMX-350SKH/주서기,29000,27900,-1100
2018-06-01,453086477,I053030,복사용지,더블에이 복사용지 A4용지 80g 2BOX(5000매),53830,46300,-7530
2018-06-01,562472226,E011040,소파,[아리아퍼니처 (ARIA FURNITURE) ]8531-Grey Sofa w/ Chaise 페브릭 소파,1199900,1117120,-82780
2018-06-01,1902007476,C013010,점퍼,[포에버21]A Bientot 시어 스카잔/FOREVER21/점퍼/블루종,33900,16950,-16950
2018-06-01,2047071929,C015040,장갑,아놀드파마_APGW-BY1207(가죽장갑_여성용) 양털장갑,27150,27150,0
2018-06-01,990093523,F011150,건강기능식품,<비타민뱅크>올앤원 어린이 프리미엄 90T,49000,46000,-3000
2018-06-01,1193674920,C013010,점퍼,[모다아울렛][탑걸]순천모다 썸머롱jp THB4JP701F,39000,37050,-1950
2018-06-01,698802036,A019110,드레싱,청정원 프렌치발사믹 드레싱(325G),3000,3000,0
2018-06-01,990093521,F011150,건강기능식품,<비타민뱅크>비타민C 아연꾸미,29000,18000,-11000
2018-06-01,1118901963,C011030,남자학생복,남자셔츠 슬림핏 도트 와이셔츠 패션남방 도트와이셔,26830,26830,0
2018-06-01,852865770,A019080,고추장,해찬들 100%국산고추장(1KG),15000,15000,0
2018-06-01,659973725,L021030,가방,"Targus 타거스 TSB226AP 15.6"" 배낭형 노트북 백팩 HC",40500,39500,-1000
2018-06-01,846906272,C012030,여자상의,(도도한걸)레이스원피스/롱/데님/플라워/쉬폰/세트,9900,9900,0
2018-06-01,282161743,F012010,종이기저귀,하기스 에어솔솔 썸머 밴드형/팬티형 기저귀,39500,39500,0
2018-06-01,1249315513,E011030,거실장,FR-501 TV거실장 AV보드/이동식테이블/선반/TV다이,25900,23900,-2000
2018-06-01,958514291,E061080,키친타월,[쌍용씨앤비]코디 기름먹는 키친타올 140매*4입,4650,4650,0
2018-06-01,1544504171,L021020,장신구,다우니 초커 목걸이 20대 초커 밍크 선물 목걸이 겨울,27570,27570,0
2018-06-01,1385829966,C014020,유아복,큐티 해마 상하복(0-12개월) 203051 아기옷 상하복 밴,25470,25470,0
2018-06-01,1538346548,E031020,가스레인지,[SK매직] 2구 원터치 고화력 가스렌지 GRA-812SR (LPG),137230,129000,-8230
2018-06-01,1090183885,I031010,장난감,Step2 멜로디 지붕차 장난감 지붕카 승용완구 지붕차,233280,233280,0
2018-06-01,1237298986,A017210,파,맛좋은 正品토마토 5kg 판매,9900,9900,0
2018-06-01,895893512,A018080,설탕,[CJ]CJ 유기농 갈색 설탕 400g,3600,3600,0
2018-06-01,895893515,A019120,혼합조미료,[CJ]CJ 다시다 산들애 쇠고기 (150g),6400,6400,0
2018-06-01,1538635709,A014030,치즈,코리원/리얼 그레이티드 파마산 치즈 가루 1kg/리필형,22900,22900,0
2018-06-01,895893518,A011070,혼식곡,[CJ]CJ 유기농 밀가루 400g,2990,2990,0
2018-06-01,1573836249,A019040,소금,인산가 인산죽염(9회죽염) 고체1kg /고체/회백색,215000,215000,0
2018-06-01,151418385,C014020,유아복,팝덕 키즈 셋업 실내복 _PKOIULW52W,22000,19800,-2200
2018-06-01,747132874,C012060,여자내의,밴딩 스판 기모 바지 레깅스 스키니 팬츠 여성 캐주얼,11560,11560,0
2018-06-01,981640629,A013030,조기,영광굴비세트 1.8kg 굴비 참 조기 법성포 선물 명절//,555500,549900,-5600
2018-06-01,970451139,C013050,운동복,카렌스1용-미르웨이 후사경/4WD/RV용품/사각지대/후진주차/현대/기아/대우/쌍용/겔로퍼,27000,24600,-2400
2018-06-01,477101675,A011120,두부,아몬드/콘푸라이트 대용량 1100g+사은품/씨리얼/과자,8900,8900,0
2018-06-01,799068494,C013040,청바지,지오다노 01118515 라이트웨이트 테이퍼드 슬랙스 118515 [2018년 S/S],39800,31840,-7960
2018-06-01,2005149422,C011020,남자상의,(무료배송) AG 스트라이크 자켓 남성자켓 OP로이줄지,237720,209200,-28520
2018-06-01,488470762,C012040,여자학생복,[달콩시럽]고져스로브,11500,10930,-570
2018-06-01,1579470702,C012060,여자내의,푸조 여성 워테레깅스 ( S26-2 ),28540,25690,-2850
2018-06-01,2078751764,A019140,이유식,채식 베지버거 170g/ 베지미트 채식장조림 채식찹스테이크 다이어트 콩고기 채식소세지,1700,1700,0
2018-06-01,367374225,A018080,설탕,정품 100% 스테비아 500g 4월미국직수입(홈쇼핑상품),17300,17300,0
2018-06-01,1121794214,C013050,운동복,애니원 119 소화기 스프레이형 가정용차량용+핫팩증정,21390,19680,-1710
2018-06-01,1939739089,E061030,전구,우리조명 장수램프 삼파장 형광등 EL 11W ~ 75W,1460,1460,0
2018-06-01,150419931,E061030,전구,국산 삼파장전구 11w~35w 시그마 두영 오스람 램프,1750,1750,0
2018-06-01,1348624622,C012040,여자학생복,여성 옆트임 롱 니트 티셔츠 박스 티 스웨터 캐주얼,17570,17570,0
2018-06-01,595636057,A017280,김,초생강(적색 참존 1.2k)X10,35200,35200,0
2018-06-01,693824157,C011030,남자학생복,여름신상 체크 남방 7부 솔리드남방 반팔셔츠 남자 스,14700,14700,0
2018-06-01,827630127,E031120,믹서,[SK매직] 텀블러 버튼식 미니믹서기 MCH-TT01,27870,26200,-1670
2018-06-01,1748717592,E011020,침대,리버퍼니쳐 65T 캐미칼 코모드라텍스매트리스 퀸(벨로,155150,155150,0
2018-06-01,1943096546,A017170,풋고추,(맛나)백오이(국내산)2개,4800,4320,-480
2018-06-01,1424761386,I053020,스케치북,[학습용 지류]흰도화지/마분지/색종이/전지/코팅필름,7200,7200,0
2018-06-01,445511124,A022010,주스,제주감귤농장 주스1500ml / 감귤주스,1000,1000,0
2018-06-01,1355917881,C012060,여자내의,아디다스 여성 M10 쇼트 ( CE2013 ),43360,43360,0
2018-06-01,2005150416,C011020,남자상의,(무료배송) AG 체크자켓 자켓 DB791 사각체크 자켓 체,208920,183850,-25070
2018-06-01,684700758,C015020,모자,봄 여름 남성 군모 캡모자 야구모자 사파리 벙거지,9900,9900,0
2018-06-01,1943842989,C011030,남자학생복,[예작셔츠] 남성 와이셔츠 10종 택1,30000,23790,-6210
2018-06-01,739004398,E061040,부엌용세제,참그린 녹차 뽀드득 주방세제 4kg x 2개,17900,17900,0
2018-06-01,711241734,A019180,즉석식품,비비고 사골곰탕 8개/육개장/미역국/닭곰탕/곰탕,10500,10500,0
2018-06-01,1936931297,C012020,원피스,데시데 린넨소재 사선랩 배기팬츠 (DGS233),90000,72000,-18000
2018-06-01,1994237965,L021050,우산,우산.브랜드특가.2단3단5단장우산.완전자동수동선물용,6000,5900,-100
2018-06-01,1945483845,E011020,침대,프리미엄 아카시아 원목 퀸침대세트 + 매트포함,211900,190620,-21280
2018-06-01,1383083558,A017120,고구마,요리&간식 필템! 포근포근 18년 햇감자 5kg 외,7900,7900,0
2018-06-01,1335616937,A022030,생수,산펠레그리노(250ml/24병)스파클링워터/무료배송/빠른배송/특가판매,28500,28200,-300
2018-06-01,1323862821,C013050,운동복,[아스토레] (SIZE : 105) 본딩 히트자켓(ABL) - 우븐+,110640,110640,0
2018-06-01,453158776,I031040,생화,브로몰딩 캠핑 접이식 이동식 행사 야외 테이블,26400,23540,-2860
2018-06-01,365420170,A021010,커피,네스카페 커피믹스 마일드 마일드모카 300T 440T,25900,25900,0
2018-06-01,423981644,L021030,가방,유앤미샵/닥스남성가방/서류가방/크로스백/백팩,270000,270000,0
2018-06-01,1010322642,A019150,김치,종가집 한입열무김치 200G,3280,3280,0
2018-06-01,1257404534,C011020,남자상의,블랙 체크 밍크털 코트 남자코트 남성코트 남성용코트,102370,102370,0
2018-06-01,369063377,A014030,치즈,코리원/썬리취 펜시 모짜렐라/체다치즈 2kg/눈꽃/치즈,19900,19900,0
2018-06-01,463631098,C015040,장갑,스마트 터치 토끼털 모직 장갑 캐주얼장갑 여성장갑,31810,31810,0
2018-06-01,1171070522,A021010,커피,카페베네 아이스커피 190mlx20팩/커피,10900,10900,0
2018-06-01,525785406,A017250,고사리,[코스트코 냉장냉동] KIRKLAND SIGNATURE 노르망디 베지터블 2.49KG (냉동야채),15690,15690,0
2018-06-01,109199351,C014010,아동복,여름/아동/아동옷/아동의류/아동복/상하복/여아반팔,14400,14400,0
2018-06-01,189156863,I031040,생화,손도끼 멀티툴 캠핑도끼 야전삽 망치 빠루망치 해머,19900,18310,-1590
2018-06-01,1662684620,A013030,조기,법성포굴비/영광/참/조기/오가/굴비/추석/설/선물세트,114900,114900,0
2018-06-01,1523300599,C021020,구두,[레노마]레노마 남성 컴포트 드레스 MEX1809FG37,70000,57400,-12600
2018-06-01,590923430,E041050,냄비,해피콜 IH 레드에디션 진공냄비 모음전 20~28cm 양수,37930,37930,0
2018-06-01,945594903,C011050,남자내의,S-2XL 쿨링 남자 허리밴드 린넨팬츠 슬림마바지/BJP67,14800,14800,0
2018-06-01,595612127,A017280,김,초생강(백색 참존 1.2k),4560,4560,0
2018-06-01,1395616016,C012040,여자학생복,데일리앤 봄 뷔스티에 니트조끼 롱 니트 꽈배기,20800,19800,-1000
2018-06-01,469719362,E041010,식기,결혼기념/선물/부부화합/대박재물/풍수지리/인테리어,165000,161700,-3300
2018-06-01,1296274438,C013010,점퍼,자외선으로부터 나를 지켜줘 후드점퍼(BBFB650A)/ 보니알렉스,62100,55890,-6210
2018-06-01,737990163,A022050,탄산음료,스프라이트 185ml x30,14500,14500,0
2018-06-01,2112607756,A022010,주스,웅진 초록매실180mlx30캔x3박스 캔음료 과즙음료 건,32580,32580,0
2018-06-01,802108118,C012040,여자학생복,[아날도바시니] 봄 역대급 특가! 최대 94%+30%쿠폰,9800,9800,0
2018-06-01,571743625,C011020,남자상의,아이보리 체크 밍크털 코트 남성용털코트 캐쥬얼코트,114550,114550,0
2018-06-01,502867638,C013020,티셔츠,T1434-셔링 무지 티셔츠 캐주얼티셔츠 여성데일리셔츠,12080,12080,0
2018-06-01,493761569,C012060,여자내의,(JJ지고트) 머메이드 스커트 GI4A0SK80/ 제이제이지고트,89000,80100,-8900
2018-06-01,1304955255,C015040,장갑,스마트터치 양가죽 장갑 4종 남성장갑 장갑 스웨이드,37680,37680,0
2018-06-01,1297912784,C011030,남자학생복,MCD-903 4단 배색 블로그 브이넥 가디건 남자가디건,20220,20220,0
2018-06-01,1316313230,C021040,실내화,슈마커 공식! 매장판 코트 밴티지 외,26140,26140,0
2018-06-01,1633303617,A019180,즉석식품,남향 밀 또띠아 8인치(약 21cm) 496g(12장),3000,3000,0
2018-06-01,1242769800,I031010,장난감,로봇피쉬 스펀지밥 목욕놀이 물놀이 장난감 완구,23980,21110,-2870
2018-06-01,549729963,C015040,장갑,스마트터치 눈꽃 니트 벙어리 여자 장갑 따뜻한장갑,24950,24950,0
2018-06-01,1168932463,C011030,남자학생복,빅사이즈 가디건 니트짚업 JA 주머니 블루종 큰사이즈,52090,52090,0
2018-06-01,549729967,C012040,여자학생복,MJ_1221 카키 양털 조끼 퍼조끼 여성털조끼 양털조끼,32330,32330,0
2018-06-01,987053174,E061040,부엌용세제,초L)자연을 담은 EM 주방세제_1200ML,2990,2990,0
2018-06-01,2033050997,C012040,여자학생복,빅사이즈 남성 여성 탭스 라운드 반팔 티셔츠 티 셔츠,13200,13200,0
2018-06-01,896639380,A014010,우유,파스퇴르 후레쉬우유 930ML*2기획,5280,4850,-430
2018-06-01,1439796698,E061010,세탁세제,퍼실 듀오캡스 38개입 센서티브 캡슐형 세탁세제,12900,12900,0
2018-06-01,2041738728,C014010,아동복,[에꼴리에]에꼴리에 PNC02 4부스키니롤업아이스진 18B1257,37800,36290,-1510
2018-06-01,739004367,E061040,부엌용세제,참그린 순수발효 곡물 1.2L x 6개 주방 세제 식물성,14900,14900,0
2018-06-01,1600787353,A019090,카레,오뚜기 3분요리 카레/짜장/컵밥/즉석밥/즉석식품/햇반,790,790,0
2018-06-01,1257355079,E011030,거실장,샤이프 메탈 거실장 TV다이 티비다이 협탁 장식장,130000,119000,-11000
2018-06-01,349459664,C012060,여자내의,[공구우먼] 페리 트임 뒷밴딩 슬랙스 29786 빅사이즈 여성의류,32000,32000,0
2018-06-01,1192010408,C011050,남자내의,아디다스 여성 오리지널 이큐티 블록드 타이츠 (BP927,54580,48580,-6000
2018-06-01,2028656198,C013010,점퍼,KD 양면 여자 무스탕 - 여성무스탕 무스탕 여자무스탕,167340,148940,-18400
2018-06-01,922827155,G011070,자전거,삼천리 스트로크24 WIND 7단/하이브리드자전거 제오7,148000,126000,-22000
2018-06-01,1534297836,A011100,라면,무배 태평마트 중국당면 샤브 납작 당면 300g 4봉,21350,21350,0
2018-06-01,1135465134,C013050,운동복,유비콘솔박스 소 차량용 트렁크콘솔박스 트렁크정리함,18470,17920,-550
2018-06-01,1257908338,A022050,탄산음료,일화 탑씨 1.5L x 12병/8.15콜라/코카콜라/사이다,10900,10900,0
2018-06-01,1312623112,C013020,티셔츠,[크리비아] (4926상)랩스타일 산전산후 수유가능한 면스판 임부상,17340,17340,0
2018-06-01,690125266,A013090,전복,오동통 국내산 가리비/해만/홍가리비/1kg (18미),5900,5900,0
2018-06-01,1541455128,E061010,세탁세제,CJ라이온 바르는 비트 220ml 3개 얼룩제거 찌든때 부,13670,13670,0
2018-06-01,860411032,E011040,소파,레이디가구 위트홈 풀커버 커버링 3인 패브릭 소파,269000,269000,0
2018-06-01,48793333,C013020,티셔츠,TheMountain 더마운틴 정품동물티셔츠 3D그래픽티셔츠,16900,16100,-800
2018-06-01,1708522056,A013020,명태,도매 냉동 대구목살 15Kg 대구뽈찜,68000,68000,0
2018-06-01,1090854478,E061050,청소용세제,매직크린/청소박사/크린맘/곰팡이제거/욕실청소,9000,9000,0
2018-06-01,1160916821,C012060,여자내의,플라스틱아일랜드 (PJ2DS561) 앞트임데님A라인 스커트,71100,58310,-12790
2018-06-01,1718482232,L021020,장신구,925 실버 은반지 은발찌 은팔찌 진주반지 체인팔찌,9900,9900,0
2018-06-01,1867005618,A012050,소시지,도나우 국내산 소세지 20개입/불갈비맛 핫도그 후랑크,8500,8500,0
2018-06-01,352077651,F012050,의료측정기,카스 팔뚝형 자동혈압계 LS-808 혈압측정기 혈압기,58480,54390,-4090
2018-06-01,1080367516,A022010,주스,웅진식품 자연은 지중해 햇살 착즙100 포도/오렌지 1Lx12펫/ 웅진식품,41000,40180,-820
2018-06-01,1004884756,C011030,남자학생복,[해피바이러스](빅사이즈 솔리드 5버튼가디건411),38120,38120,0
2018-06-01,1933222978,A013120,낙지,[윈지커머스]주전부리해오징어 버터구이 35gx5봉 건어물 버터구이오징어 맥반석오징어,21250,19130,-2120
2018-06-01,932714238,A012030,돼지고기,프리미엄 삼겹살500g /돼지고기,3900,3900,0
2018-06-01,1451924928,C013010,점퍼,주니어롱점퍼/초등학생점퍼/주니어야상/초등학생옷,43200,43200,0
2018-06-01,1888297725,C013050,운동복,여름트레이닝복세트/반팔/반바지/7부/나시/빅사이즈,10900,10900,0
2018-06-01,1010346635,E041070,밀폐용기,신선보관용기 직사각세트 2P,5490,5490,0
2018-06-01,641023743,C021040,실내화,나이키 다운쉬프터7 검흰 운동화 런닝화 852459-002,56800,49990,-6810
2018-06-01,1150717985,A018060,스낵과자,두부과자 단호박과자 90g 담백 고소한맛,2000,1980,-20
2018-06-01,2127750518,C013060,등산복,남여 기능성 반팔 카라 폴로 티셔츠 9종택1 5217EL222 5217EL251/ 머렐(레저),26700,23500,-3200
2018-06-01,1010285282,A019170,냉동식품,오뚜기 떠먹는컵피자트리플햄 150G,3500,3500,0
2018-06-01,56412235,C013010,점퍼,봄기획.득템찬스.자켓트렌치야상.55-110..빅사이즈,29900,29900,0
2018-06-01,1212172457,C013040,청바지,키즈 여아 미디엄 워시 데님 반바지 5218232511051/ 갭 키즈,39000,33150,-5850
2018-06-01,722066198,C014010,아동복,와이셔츠 남방 9종/5세-14세/퀄리티,3900,3900,0
2018-06-01,1478353980,E011050,책상,[퍼닉 에스엠]코너 책상세트/코너 공간활용/양면상판/L형 책상세트/공장직판/책장+상판,109000,109000,0
2018-06-01,608048213,A011140,부침가루,두레생협 호두파이(200g),30220,29620,-600
2018-06-01,458305707,A016160,과일가공품,블루베리안주 (소울 350g),26940,23980,-2960
2018-06-01,989138351,A013070,굴,RF)점보새우살200G,13900,9900,-4000
2018-06-01,1317353938,C011030,남자학생복,(32종 택1) 샵매니저가 엄선한 반소매 슬림핏&일반핏 (선물포장가능)/ 에스티듀퐁(셔츠,49000,40180,-8820
2018-06-01,608048210,A011140,부침가루,두레생협 호두타르트(60g 2개),19140,18760,-380
2018-06-01,531428524,C012040,여자학생복,칠부나팔소매스트라이프니트(RMKA738G11)/ 로엠,10000,9000,-1000
2018-06-01,1797327105,F012010,종이기저귀,[에코제네시스 친환경기저귀] L/XL팬티형8팩,129900,129900,0
2018-06-01,1906609082,E031010,전기밥솥,쿠첸 10인용 IH압력밥솥/전기밥솥/밥솥 CJH-PA1071iC,279000,279000,0
2018-06-01,1541372319,A011010,쌀,김포 고시히카리쌀10kg 밥선생,36900,36900,0
2018-06-01,1810835811,A018020,사탕,썬키스트대용량애니타임스카치말랑카우망고청포도사탕,3900,3900,0
2018-06-01,1644130362,F012020,생리대,좋은느낌 좋은순면 에어핏 슬날중 18+18 2팩/생리대,14700,14700,0
2018-06-01,2134984900,F012020,생리대,바디피트 생리대 볼록맞춤/순간흡수 128매/144매,16900,16900,0
2018-06-01,362227787,F012010,종이기저귀,하기스 팬티형(매직핏/보송/썸머/꿀벅지) 3~6단계,30900,30900,0
2018-06-01,297195867,E011050,책상,미자크 화이트책상/800책장/23T곡선상판/h형책상/컴퓨터책상/학생책상/책장,154900,149900,-5000
2018-06-01,605528784,A014020,분유,일동후디스 비오타민 100g(1g*100포/캔),17000,17000,0
2018-06-01,1740508593,E031040,전기레인지,차량 휴대용 냉온장고 175x320x315 7.5L 휴대용냉장고,72460,70290,-2170
2018-06-01,908161912,A021010,커피,[사은품 직접선택/당일출고]카누100T/카누아이스+증정,18500,18500,0
2018-06-01,960758707,A022010,주스,썬업 녹황 레드 사과 자몽 오렌지 과일야채주스,14500,14500,0
2018-06-01,1331335057,I012060,저장장치,로지텍코리아 G502 RGB 게이밍마우스 A/S 3년 정품,84900,84900,0
2018-06-01,989138324,A013070,굴,RF)칵테일새우200G,9900,9900,0
2018-06-01,293107995,E021010,침구,부드러운 실크감촉의 침대커버 세트 차렵이불 요커버,25800,25800,0
2018-06-01,1771841403,F011150,건강기능식품,광동 생록천 10병X10박스 총100병 소화 과식소화제,42000,42000,0
2018-06-01,1808270830,C012040,여자학생복,데님포켓원피스 (J11POP023)/ 매그제이(MAGJAY),25000,22500,-2500
2018-06-01,268701150,A019180,즉석식품,[삼진어묵] 모듬어묵3종세트(해물+매운+야채),30000,30000,0
2018-06-01,1193179447,E031080,선풍기,리모컨 벽걸이 온풍기 25000WR / 참고 생활용품 생필,94000,79900,-14100
2018-06-01,1306620349,C013030,스웨터,티티뱅크 피에로 터틀넥 후드 지퍼 집업후드 후드집업,22250,22250,0
2018-06-01,7853861,C014010,아동복,30%할인쿠폰/릴리푸리/캔키즈/여름신상OPEN/신상추가,6900,6900,0
2018-06-01,989138320,A011100,라면,백설 국산100%햇당면 400G,6290,6290,0
2018-06-01,875805217,A022040,기능성음료,게토레이 레몬 600ml x 20펫 / 1.5L x 12펫 이온음료,21900,21900,0
2018-06-01,989138321,A011100,라면,백설 제일제면소 고구마전분100%당면 300G,3380,3380,0
2018-06-01,989138322,A013070,굴,RF)새우살200G,6990,6990,0
2018-06-01,1607673864,I031040,생화,캠핑 테이블/피크닉/접이/바베큐/야외/용품/키친/그릴,30000,26680,-3320
2018-06-01,1955199463,L012040,치약,시린메드 에프 치약 125g x 5개 + 치약30gx5개증정,23500,23500,0
2018-06-01,987173171,A018040,아이스크림,[롯데] 팥빙수 12개,24000,19200,-4800
2018-06-01,2042392879,C011020,남자상의,패딩 바버왁스 WS 패딩자켓 PD19A,119700,106540,-13160
2018-06-01,590359810,A018010,초콜릿,트뤼플/허쉬/스니커즈/트윅스/페레로/코스트코초콜릿,14990,14990,0
2018-06-01,2118180649,C013040,청바지,아둘 패밀리룩 여름 반팔 조던 쥬니어 상하세트 46,15900,15900,0
2018-06-01,1979418691,E011020,침대,[잉글랜더]루이스 원목 침대/슈퍼싱글침대/퀸침대,151900,151900,0
2018-06-01,296611026,A011080,밀가루,오뚜기 대용량 옛날국수 소면10kg(H),18900,18900,0
2018-06-01,723079278,E011060,의자,[동서가구]LV 식탁의자 3종택일 DF902140,25000,21900,-3100
2018-06-01,871482949,C012030,여자상의,레이스원피스66~110/빅사이즈 행사복/데일리룩,19800,19800,0
2018-06-01,2134370482,A022010,주스,웅진)초록매실(병) 180ml12개입 과즙 매실음료병 매실,15250,14950,-300
2018-06-01,1254982959,E041020,컵,칼라 머그컵 모음 머그잔 커피잔 컵 물컵 답례품 인쇄,1390,1390,0
2018-06-01,1458519990,C013040,청바지,남자 청 반바지 데님 반바지/7부/5부/면반바지,20800,19800,-1000
2018-06-01,1548233842,I053040,기타문구,[3M]이젤패드/포스트잇/메모지/월패드/보드/회의실,39900,39900,0
2018-06-01,1428510285,C014020,유아복,아둘 패밀리룩 가족티 성조기 유아반팔 티셔츠 11,9600,9500,-100
2018-06-01,493761502,C012060,여자내의,(JJ지고트) 라인 디테일 스커트 GI4A0SK31/ 제이제이지고트,159000,143100,-15900
2018-06-01,1467957471,I031040,생화,등산용품/등산장비/캠핑/등산/야영/스틱/나침반/로프,3500,2500,-1000
2018-06-01,1974260506,A019130,스프,나가사끼짬뽕소스 (초담원 2K) X8,213540,190060,-23480
2018-06-01,1124447498,A013010,갈치,제주 은갈치(특대) 8마리(1마리당450g내외 선물포장),344300,333980,-10320
2018-06-01,989138380,A013070,굴,RF)생새우살200G,7990,5990,-2000
2018-06-01,1309095648,A011020,현미,국산 찹쌀 현미 모음 10kg / 현미찹쌀 /현미 / 오색미,25100,25100,0
2018-06-01,1207421673,L021010,손목시계,회중시계 엔틱 목걸이 시계 악세서리 팬던트 패션시계,16800,16800,0
2018-06-01,1115007383,E061010,세탁세제,넬리천연세제 친환경세제 산소표백제 식기세척기세제,14630,14630,0
2018-06-01,980879505,A017040,양배추,[오창농협] 무농약 열무 400g,9400,8020,-1380
2018-06-01,1954296779,C013040,청바지,여름신상/반바지/7부청바지/남자반바지/면/빅사이즈,12800,12800,0
2018-06-01,222133615,C012060,여자내의,RT5 PBM8060 쎄무롱플레어스커트,22300,21860,-440
2018-06-01,203852158,C013040,청바지,빅사이즈 중년청바지 청바지 남성 밴딩 스판 바지 봄,26800,26800,0
2018-06-01,508462573,C012060,여자내의,[오빵스타일]밑단컷팅팬츠9부데님팬츠포포 일자핏 데님팬츠,27000,25650,-1350
2018-06-01,1010346691,A017300,미역,일미 더맛있는김밥세트 520G,8790,7490,-1300
2018-06-01,1010405470,A017070,부추,초L프레시) 얼굴이보이는쌈모음(300G/봉),5000,3000,-2000
2018-06-01,539517740,A016120,바나나,에스트렐라 고당도 바나나(13kg 6발내외),36000,36000,0
2018-06-01,1010405473,A017070,부추,초L프레시)얼굴이보이는청상추(150G/봉),4000,2000,-2000
2018-06-01,1010405472,A017070,부추,초L프레시)얼굴이보이는청경채(120G/봉),2000,2000,0
2018-06-01,1533704982,C011030,남자학생복,여름셔츠 린넨/7부/반팔/긴팔/오버핏/헨리넥/체크남방,9800,9800,0
2018-06-01,1273248814,C014010,아동복,한국 체크 원피스 유아정장3종 세트(3-24개월)203456,64230,57810,-6420
2018-06-01,1597180298,F011130,홍삼,정관장 원앙세트(70ML*30입),165000,165000,0
2018-06-01,1010405474,A017070,부추,초L프레시)얼굴이보이는적상추(150G/봉),4000,2000,-2000
2018-06-01,1290452779,L012090,기초화장품,IOU 수퍼아쿠아 스킨+로션 600ml/ 수분 대용량두배,15400,14900,-500
2018-06-01,578940624,C014010,아동복,남아 여아 상하 트레이닝 어린이집 유치원 아동복 옷,11900,11900,0
2018-06-01,1597062906,F011130,홍삼,정관장 14 아이패스M(50ML*30),140000,140000,0
2018-06-01,989138383,A013100,마른멸치,RF)통골뱅이300G,9990,9990,0
2018-06-01,133346104,C011050,남자내의,남자의품격 딱 떨어지는 슬랙스/면/카고팬츠 무료배송,28000,28000,0
2018-06-01,123496030,A013020,명태,광림 대구포450g 2개,62550,62550,0
2018-06-01,508462579,C012060,여자내의,[오빵스타일]블랙면스키니바지[데빌팬츠]면스키니9부바지 블랙,23500,22330,-1170
2018-06-01,982435536,A019120,혼합조미료,백설 다시다 명품골드 96G,3750,3750,0
2018-06-01,445478736,I031040,생화,콩맨 초경량 알루미늄 롤테이블/야외/캠핑/사이드,17300,15490,-1810
2018-06-01,1645116063,C013050,운동복,믹스후드트레이닝세트/운동복세트/밴딩반바지/후드티,21900,21900,0
2018-06-01,990093554,A019180,즉석식품,[오뚜기]오뚜기 돼지고기김치찌개 480G,3980,3980,0
2018-06-01,1816848002,C013050,운동복,상하세트 유아상하세트 핑크상하세트 상하복세트 맨투,33760,32750,-1010
2018-06-01,922710809,D031010,주택수선재료,FRP수지 3KG세트(유리섬유1M포함)/호마이카/에프알피,22000,22000,0
2018-06-01,1212172490,C013040,청바지,토들러 남아 샤크 데님 쇼츠 반바지 5228232101053/ 갭 키즈,35000,29750,-5250
2018-06-01,1010405466,A017070,부추,초L프레시)얼굴이보이는쌈모음(120G/봉),4000,2000,-2000
2018-06-01,1156767120,C012040,여자학생복,[LAP][LAP] AF2CT689. 장미 패턴 티셔츠,22410,21290,-1120
2018-06-01,1002678804,E011050,책상,[디자인블레스] 더블데스크/서울대학교 학생평가단 추천! 기능성책상!,145000,145000,0
2018-06-01,1010405469,A017070,부추,초L프레시)얼굴이보이는쌈케일(100G/봉),2000,2000,0
2018-06-01,1602054284,C013020,티셔츠,프린트티셔츠/맨투맨/이글/스팽글/큐빅/루즈핏/커프스,26800,26800,0
2018-06-01,1052590389,C014010,아동복,[MLB 키즈] 흘리미 로고 반팔 티셔츠 71TSD4831-07W,29000,24650,-4350
2018-06-01,1346563472,L012030,칫솔,(사은품)유아칫솔25개+치약 어린이 아기 치약,5900,5900,0
2018-06-01,578171605,C013020,티셔츠,[팡팡샵]신상 티셔츠/롱티/루즈핏/남방/빅사이즈,12900,12900,0
2018-06-01,552167831,C013010,점퍼,[모다아울렛][토토헤로스]모다오산동탄 마운틴롤업점퍼,25000,25000,0
2018-06-01,41740265,A012030,돼지고기,(고기천국)대용량 돼지고기 2.5kg/목살/삼겹살/도매가,14900,14900,0
2018-06-01,632065461,C011030,남자학생복,패딩점퍼 빅사이즈 JK755W 빅사이즈,87990,85360,-2630
2018-06-01,158435520,E041010,식기,모던 도자기 면기 라면그릇 우동그릇 라면기 냉면기,2000,1750,-250
2018-06-01,1948183603,A017110,감자,유기농 제주산 흙 당근 10kg,17900,17900,0
2018-06-01,1630567703,C013060,등산복,[빈폴아웃도어]아이보리 여성 BREEZE 롱 MA-1 재킷 (BO8339C020),111300,87930,-23370
2018-06-01,1377080783,C013010,점퍼,아동후드집업 키즈바람막이 가디건 번아웃점퍼 주니어,9800,9800,0
2018-06-01,1970425654,C013020,티셔츠,포켓맘 포켓수유티 캥거루티,29170,29170,0
2018-06-01,1888596286,A013030,조기,부세조기 1박스 12마리 내외 부세 조기 참조기 굴비,29500,29500,0
2018-06-01,2133944006,L021030,가방,[캉골] 에코 프랜들리 백 코니 0021 블랙 (가방/에코백/크로스백),43000,38700,-4300
2018-06-01,1440652661,C013010,점퍼,[리스트] (백화점브랜드/무료배송) 쿨링 썸머스페셜 경쾌한 테일러드 카라 자켓,34800,31320,-3480
2018-06-01,367051784,C021040,실내화,유아샌들/영유아/아동/스펀지/보행기/여아/삑삑이/크록스/아쿠아/키즈/신발/샌들/운동,10000,9700,-300
2018-06-01,1488669194,A012010,국산쇠고기,[무항생제] 사골 1kg 1+등급,21200,21200,0
2018-06-01,706731913,I031040,생화,센서작동/8종/헤드랜턴/5400루멘 /3발 /5발/,17800,15800,-2000
2018-06-01,1395462417,C012030,여자상의,스테라 청롱원피스 예쁜 스커트 DM-5737,42600,40470,-2130
2018-06-01,344732461,C012040,여자학생복,[대구백화점 II관] [ab.f.z]어깨프릴라인꽃블라우스(AFS2GB59E),69000,60720,-8280
2018-06-01,1192095341,A019080,고추장,해물볶음고추장450Gx2EA 비벼먹고 반찬으로 바로 먹는,9000,9000,0
2018-06-01,1597890390,E031050,냉장고,인증점M 삼성 김치냉장고 NEW M9000 RQ51N92D0X2,1873950,1799000,-74950
2018-06-01,1111822067,C013050,운동복,DDK00218 트레이닝 져지 803,57750,51400,-6350
2018-06-01,239650824,C011030,남자학생복,MCD-902 스트라이프 페어아일패턴 브이넥 가디건,17000,17000,0
2018-06-01,1282505785,I011030,사진기,소니 A7III 본체 + 28-70mm 정품 명품,3941990,3941990,0
2018-06-01,1013901776,C021040,실내화,리복 제트스트라이크 런 V68309,48900,42550,-6350
2018-06-01,1414875539,C013010,점퍼,아스널 컵 롱 벤치 자켓 운동점퍼 남성용자켓 운동자,207460,207460,0
2018-06-01,514489248,C013050,운동복,[툴앤툴]광택패드 6p 세트/전기/충전드릴/전동드릴,20000,16470,-3530
2018-06-01,774159214,C013050,운동복,에어로 스마트키케이스/그랜져IG/싼타페TM/올뉴쏘렌토,27000,23600,-3400
2018-06-01,1560170644,F012020,생리대,NEW 에리에르 엘리스 생리대 2팩 골라담기,10900,10900,0
2018-06-01,37052165,E031070,에어컨,파세코 DC타워선풍기 PTF-MP7500AW 날개없는선풍기,68900,68900,0
2018-06-01,1156767032,C012060,여자내의,[LAP][LAP] AF2DS662. 야자수 자수 솔리드 스커트,22410,21290,-1120
2018-06-01,234971817,C013060,등산복,[웨스트우드] 냉감티 외 여름 특가전,4900,4900,0
2018-06-01,751038864,A018100,꿀,트라피스트수녀원 유기농 포도잼 410g 포도쨈 과일잼 빵 식빵 토스트 포도잼 과일잼 빵,13300,12910,-390
2018-06-01,606024573,E061020,섬유유연제,인퓨전 앰버블라썸 드라이시트 105매/빨래건조기,9900,9900,0
2018-06-01,315244280,I031010,장난감,[마이리틀타이거]타이거 물놀이 테이블 NEW +손잡이컵플라밍고증정(마산점),39900,36780,-3120
2018-06-01,2133177716,A013120,낙지,못생겨도 맛만 좋다. 파품오징어 500g,12950,12950,0
2018-06-01,1947806547,F012020,생리대,[예지미인]그날엔순면 중형3팩+팩3매+2P 생리대,8000,7900,-100
2018-06-01,1173851369,C011050,남자내의,F776 KP506 작업바지 건빵바지 작업복 카고바지 바지,16000,15800,-200
2018-06-01,2111403700,A022030,생수,제주삼다수 2L x 12병/화산암반수/생수,13000,11500,-1500
2018-06-01,509353175,C012040,여자학생복,[바비앤펌킨]파스텔솜사탕 블라우스,57000,51300,-5700
2018-06-01,1926815264,C013010,점퍼,알파카야상패딩점퍼 방한안감패딩,167900,167900,0
2018-06-01,457304592,F012010,종이기저귀,[VIP 5%쿠폰]팸퍼스 베이비드라이 파우더향 기저귀,62900,62900,0
2018-06-01,1534381539,E061030,전구,일광 에디슨 전구 모음 - 볼램프 볼전구 인테리어,5700,5700,0
2018-06-01,2068275497,C012020,원피스,빅사이즈/지브라/롱/가디건 / 참고 지브라롱가디건 빅,45600,38760,-6840
2018-06-01,1681565928,I031040,생화,휴대용/접이식/낚시/캠핑/의자/등산/레져/캠핑용품/,2000,1900,-100
2018-06-01,753626099,C013020,티셔츠,빅사이즈민짱/무료배송/넘나예쁜 맨투맨모음/후드,19900,19900,0
2018-06-01,689993960,A022050,탄산음료,미닛메이드 스파클링 청포도 185ml x 30캔 / 커피몰,6600,6600,0
2018-06-01,427668039,E031120,믹서,[매직쉐프] 미니믹서기 MEB-J201Y(N) (본사),32300,32300,0
2018-06-01,691082992,A012040,닭고기,[허닭] 15팩특가+핫바4팩 닭가슴살 소시지/스테이크,26900,26900,0
2018-06-01,960325714,A019120,혼합조미료,[샘표]샘표 요리 에센스 연두 순(320G),6490,6490,0
2018-06-01,960325713,A019120,혼합조미료,[샘표]샘표 요리 에센스 연두(320G),6490,6490,0
2018-06-01,1615529013,F012010,종이기저귀,리베로 기저귀/밴드형2단계 88매x3팩,64500,64500,0
2018-06-01,1430333560,E061010,세탁세제,(초특가)퍼실 1.8x2개 2.7x2개 액체세제 세탁세제,20000,16900,-3100
2018-06-01,1985110662,E041010,식기,리퍼 스크레치 주전자 냄비 스텐냄비 밥공기 티포트,4500,4500,0
2018-06-01,1346020188,C012060,여자내의,솔리드 세미 부츠컷 데님 팬츠 (GI5N0SL50 GI3N0SL30)[예약상품 2018.06.01 부터 발송,29500,24490,-5010
2018-06-01,2049070472,D031010,주택수선재료,접착식 단열벽지 2.5M/폼블럭벽지 단열재 결로 곰팡이,15900,14160,-1740
2018-06-01,1778941178,C012040,여자학생복,여름신상~ 시원한셔츠 체크/롱/박시핏/무지/오버핏,14900,14900,0
2018-06-01,1999047756,A011090,국수,오뚜기 진라면소컵 18개/컵누들/육개장사발면/신라면,11890,11890,0
2018-06-01,1722653481,A017050,미나리,무농약 양배추 3kg,11700,9360,-2340
2018-06-01,1790601440,A019050,간장,일본간장/사시미간장/다시마간장/와사비/기꼬만혼쯔유,5700,5700,0
2018-06-01,1421196818,C011050,남자내의,남성 M~4XL 린넨 면 반바지 7부5부 트레이닝 팬츠,11900,11900,0
2018-06-01,1061994831,L021010,손목시계,TIMEX 타이맥스 TW2P81100 여성 나토밴드 패션시계,66000,66000,0
2018-06-01,1094677576,A013080,조개,국내산 새꼬막 1.5kg (상) 새벽조업후 발송 산지,32970,32970,0
2018-06-01,1261553620,E061050,청소용세제,깔끄미/곰팡이/욕실/주방/유리세정제/4가지중/1개,3000,3000,0
2018-06-01,585273851,E011070,식탁,#NAME?,159900,139900,-20000
2018-06-01,1061994828,L021010,손목시계,TIMEX 타이맥스 TW2P90200 여성 나토밴드 패션시계,72000,72000,0
2018-06-01,1061994829,L021010,손목시계,TIMEX 타이맥스 TW2P81000 여성 나토밴드 패션시계,66000,66000,0
2018-06-01,1120891733,C015020,모자,야구모자 군모 여름 봄 캡모자 볼캡 여성 남자 모자,9900,6900,-3000
2018-06-01,1061994824,L021010,손목시계,TIMEX 타이맥스 TW2P91900 여성 나토밴드 패션시계,84000,84000,0
2018-06-01,1061994825,L021010,손목시계,TIMEX 타이맥스 TW2P98100 여성 나토밴드 패션시계,84000,84000,0
2018-06-01,484225377,A019110,드레싱,소스모음전)키위/요거트/스파게티/아일랜드/케이준 외,4200,4200,0
2018-06-01,1061994826,L021010,손목시계,TIMEX 타이맥스 TW2P65300 여성 나토밴드 패션시계,71000,71000,0
2018-06-01,1890069627,C015020,모자,[포스케]끝장패션 심플 코디 무지 볼캡 야구모자,16900,16900,0
2018-06-01,1061994827,L021010,손목시계,TIMEX 타이맥스 T2P370 여성 나토밴드 패션시계,71000,71000,0
2018-06-01,347347061,L021050,우산,네파 제비표 우의 우비 레인코트 방수 판초 레저우의,53000,53000,0
2018-06-01,587608573,A013070,굴,킹왕짱대게4L급 2.0kg내외 스노우크랩,74900,74900,0
2018-06-01,303154700,C011030,남자학생복,투앤영/한정수량 초특가/준슬림 남자 긴팔 반팔셔츠,10000,9900,-100
2018-06-01,601753298,E031020,가스레인지,/동우환풍기 100mm/ 가정용환풍기 일반환풍기 화장실,12900,11700,-1200
2018-06-01,1912446269,E011070,식탁,베스트리빙 딜)캘빈젠 4인식탁세트/원목식탁/대리석식,109000,98100,-10900
2018-06-01,1297454369,E011020,침대,엉클베드 피콜로 멀티 수납 서랍침대 + 매트리스 포함,149000,149000,0
2018-06-01,1061994822,L021010,손목시계,TIMEX 타이맥스 TW2P74200 여성 나토밴드 패션시계,66000,66000,0
2018-06-01,767335330,E051020,건전지,CR2412 CR2477 CR2330 CR1216 CR1025 CR2012 CR2032,1510,1510,0
2018-06-01,490506602,A013100,마른멸치,[새우몰] 전복소스 500g 전복죽 볶음밥 찌개 엄지척 만능소스,15800,15800,0
2018-06-01,1061994823,L021010,손목시계,TIMEX 타이맥스 TW2P74100 여성 나토밴드 패션시계,66000,66000,0
2018-06-01,1159626868,C012060,여자내의,[클라이드n]여성 워싱 데님 스커트(CIBSK702F)(인천점),49800,43480,-6320
2018-06-01,933862983,C021040,실내화,푸마 키즈 미니언즈 스웨드 365528/365529,59000,52510,-6490
2018-06-01,1439698330,C014020,유아복,RT8 한국생산 원숭이 친구들 수면바지(5-11호) 202352,20150,19750,-400
2018-06-01,564497078,E011030,거실장,스틸 화이트 철제거실장 TV다이 스텐드 받침대 티비장,64000,60800,-3200
2018-06-01,294769752,E011040,소파,동서가구 기간한정 프리미엄 천연가죽 소파 특별기획,419000,419000,0
2018-06-01,1854683501,A013090,전복,신일수산 서해안 섬 바지락 2kg /조개/시원한 칼국수,13000,13000,0
2018-06-01,1719169085,A017180,호박,고추모음전 500g/1kg 청량  오이고추 풋고추 꽈리,3900,3900,0
2018-06-01,1246459830,I031040,생화,[판매1위 특가]접이식 낚시의자 1+1 /캠핑의자/접이식,19800,18220,-1580
2018-06-01,1147281142,C013010,점퍼,보니알렉스 롤업바람막이점퍼 BBUA501,34560,34560,0
2018-06-01,1499220453,E061040,부엌용세제,친환경 마크 인증 1종/세제/주방세제 750mL + 1.2L x3,11500,11500,0
2018-06-01,465971333,C013050,운동복,아스토레 JSG-JKW30002 골프 캐주얼 우븐자켓(ORG) 트,175530,175530,0
2018-06-01,62236150,A018110,물엿,[두레촌] 식품 명인 전통 도라지 조청 (500g) 쌀 생강 물엿 꿀,15000,15000,0
2018-06-01,475485447,A022010,주스,코카콜라 미닛메이드 홈스타일 자몽 1.2L 12개 주스,36800,35700,-1100
2018-06-01,1292885608,C013020,티셔츠,[JEEP(지프)]양 소매 와펜 V넥 반팔티(GJ2TSU403)(경기점),59000,51510,-7490
2018-06-01,1076497405,C013020,티셔츠,[크루클린] 무지 후드티/집업/반지퍼/맨투맨/기모,19800,13800,-6000
2018-06-01,1231868310,A016090,참외,달콤한 성주 꿀 참외2kg,6900,6900,0
2018-06-01,1171478678,C012060,여자내의,SK1403 뒷트임 슬림 데님 스커트 여자롱치마 롱스커트,38200,38200,0
2018-06-01,536168918,C012040,여자학생복,[쉬즈미스]2018 SSKPOI21020 투톤민소매니트,39000,33150,-5850
2018-06-01,1695488629,I031010,장난감,PC/PS3 EX3 ALPS 프리미엄 듀얼컨트롤러 / 무배,27400,27400,0
2018-06-01,494294669,A021010,커피,[커피/국산차 100여종] 인기 커피믹스 국산차 총모음/커피/수프리모/아이스커피/자판기,3350,3350,0
2018-06-01,850623809,E041060,수저,수저세트 스푼 포크 유아 어린이 티스푼 양식기 티포,2000,2000,0
2018-06-01,440944884,C012040,여자학생복,[LAP] AF2CT689. 장미 패턴 티셔츠,22410,21020,-1390
2018-06-01,1999936684,A012050,소시지,천연도장 수제소세지 케이크소시지 캠핑 바베큐 안주,10900,10900,0
2018-06-01,219262162,F012010,종이기저귀,국내/빠른배송) 미국산 팸퍼스 스와들러 2단계 기저귀,77800,77800,0
2018-06-01,296420431,C013040,청바지,남자청바지/슬림일자/스판/스키니진/찢청진/빅사이즈,15900,15900,0
2018-06-01,108726111,A013090,전복,국내산 새꼬막 1.5kg (상) 새벽조업후 발송 산지,32980,32980,0
2018-06-01,1859215311,E011020,침대,특가세일/라텍스2cm기본내장/매트리스/단면매트리스,70000,68900,-1100
2018-06-01,1317977516,C021020,구두,8628 망사 3.5cm 남성로퍼 3.5cm 로퍼 남성구두 망사,38520,38520,0
2018-06-01,927268867,D031010,주택수선재료,KCC 논슬립파우더/논스키드파우더/3-4KG/미끄럼방지,13000,13000,0
2018-06-01,14445011,C013030,스웨터,미노갤러리/9900원/쟈니 핸섬 빅사이즈/2장무료배송,9900,9900,0
2018-06-01,2039521975,A014040,발효유,풀무원다논 떠먹는요거트 액티비아 플레인80g*24개,13300,13300,0
2018-06-01,436447551,C012040,여자학생복,고급스러움을 추구하는 롱롱베스트 TUVAE2704/ 비키,249000,224100,-24900
2018-06-01,984521737,A012060,햄및베이컨,CJ 더건강한 후랑크 150G,2000,2000,0
2018-06-01,467875107,C013050,운동복,K-345 스타렉스 2004후사경 후사경 차량안전용후사경,25290,23040,-2250
2018-06-01,1084080000,E011030,거실장,무료배송 거실장 TV 다이 장 수납장 서랍장 정리함,44900,44900,0
2018-06-01,1107366934,A017160,오이,특가 꽃송이버섯 균사체 분말 400g/가루/베타글루칸,130000,130000,0
2018-06-01,240567980,C021040,실내화,[푸마] (SIZE : 280) 플레어 2(18951703) 신발 러닝,85190,85190,0
2018-06-01,1699753111,E041020,컵,티포원(B형) 1인조(BG)/ 포트메리온,30900,26270,-4630
2018-06-01,659912928,E011050,책상,[마미]삼나무책상/삼나무H형책상/어린이책상/책상,187000,187000,0
2018-06-01,396887623,C012040,여자학생복,[ab.f.z]셔링라인패턴블라우스(AFS2GB70E),49000,39690,-9310
2018-06-01,826197161,A012010,국산쇠고기,[무항생제 한우선물세트] 한우 명절 3호 2.5kg,174800,174800,0
2018-06-01,1982539212,C014020,유아복,[밍크뮤](NY)스페셜체크상하복(38311-610-01)[갤러리아],118000,93220,-24780
2018-06-01,217334600,E021020,커튼,암막커튼 커텐 거실 창문 안방 작은창 방풍 가리개,10000,9110,-890
2018-06-01,1296154404,C012060,여자내의,[밸리걸] 브이넥 슬리브리스 점프수트 973630,29900,25420,-4480
2018-06-01,1067491453,A019180,즉석식품,농다원 포두부 100%국산콩 건두부 쌈두부1kg (250g*2),28800,28800,0
2018-06-01,2058629807,I031040,생화,날진-트라이탄 루프통 (1.0L)/1리터물통/등산물통/날진물통/등산물병/날진물병/물병/물,14700,12900,-1800
2018-06-01,871335511,A021010,커피,알콩달콩 원두커피 500g+500 총1kg 사은품,9400,9400,0
2018-06-01,439966742,C013050,운동복,아스토레 쉘 4 우븐자켓(LM)-레인자켓 트레이닝운동복,61140,61140,0
2018-06-01,450192368,C021020,구두,산드라 샌들 LKR2732 여자샌들 여성샌들(YA02004),59180,59180,0
2018-06-01,1127305704,C021010,아동화,[해피키즈]운동화 캔버스 아동화 유아 스니커즈 우븐,15900,15900,0
2018-06-01,397418958,E061020,섬유유연제,샤프란 NEW 섬유유연제 2.1L x 6개,10900,10900,0
2018-06-01,664699473,C013020,티셔츠,전품목세일/무지라운드티/린넨/브이넥/여성,7900,7900,0
2018-06-01,1001109096,A019180,즉석식품,[최부자] 얼큰 시원 깔끔 최부자 즉석탕  즉석국 특가,1950,1950,0
2018-06-01,798922994,E031130,보온매트,[한일의료기] 분리 거실 매트(특대) HM-101DW (2700x1830) /매트/선물/,155700,155700,0
2018-06-01,1195086688,C013050,운동복,현대/기아/삼성/쉐보레/삼성/스마트키 가죽 케이스,29800,29800,0
2018-06-01,185094739,I031040,생화,NS엔에스 서프/슈퍼캐스터 원투낚시대/릴/선택1개,48000,48000,0
2018-06-01,654848626,F012020,생리대,예지미인 롱 라이너 20개입 x 60,139520,139520,0
2018-06-01,1764043439,A017250,고사리,산지애 유기농 양배추 브로콜리 진액 60팩 (100ml×30팩×2box) - 유기농 양배추&브로,44800,38190,-6610
2018-06-01,216058997,A011010,쌀,농협 강화섬 고시히카리10kg,34900,34900,0
2018-06-01,1574357383,E031010,전기밥솥,쿠첸 정품 패킹/ 밥솥패킹/ IH패킹/ 압력밥솥/SY,8500,8400,-100
2018-06-01,988030480,E041070,밀폐용기,초L) 스마트락 직사각 1.3L,2900,2900,0
2018-06-01,324586226,C013040,청바지,MDD5063 무릎데미지일자블랙스판남성청바지(~38) 빅사,43790,43790,0
2018-06-01,294167571,C012020,원피스,UNE[윈] [77까지]윙포인트절개라인린넨터치자켓,118000,112000,-6000
2018-06-01,798922992,E031130,보온매트,[한일의료기] 분리 거실 매트(대) HM-101DW (2300x1830) /매트/선물/,142200,142200,0
2018-06-01,987053139,E061050,청소용세제,아스토니쉬 박테리아 클리너_750ML,5900,3990,-1910
2018-06-01,1286736717,C013040,청바지,DDO1567 이너밴 일자 데님 803 와이드청바지 남자청바,56210,56210,0
2018-06-01,479091528,C013050,운동복,[신상추가]만원이상무료/트레이닝바지/반바지/밴딩42A,6900,6900,0
2018-06-01,2069972470,C012040,여자학생복,빅사이즈/소매/셔링/블라우스 / 참고 미시옷 임부복,63900,56240,-7660
2018-06-01,1530558666,C012020,원피스,MELODY F3/코트/여자코트/겨울코디/겨울코트/자켓/점퍼 미국 여성토탈브랜드 멜로디 어,54700,54700,0
2018-06-01,327000511,A013080,조개,두레생협 대구전부침용(400g/러시아산) 대구전부침용,22220,22220,0
2018-06-01,999832850,E061010,세탁세제,수퍼타이/하이타이/세탁세제/빨래/가루비누/테크/표백/살균/찌든때/얼룩제거/비트/스파,17000,17000,0
2018-06-01,1158975816,E041020,컵,leah 인기 커피잔세트(선택) 머그컵 커피잔 찻잔세트,28520,28520,0
2018-06-01,511333973,C013010,점퍼,[어스앤뎀]어스앤뎀 남성 절개 디테일 린넨 점퍼TBUA600[갤러리아],30000,23100,-6900
2018-06-01,1934438873,C015040,장갑,핑거 스노우 벙어리 장갑 겨울장갑 따뜻한장갑 혼방벙,10920,10920,0
2018-06-01,954848049,A011130,시리얼,[청정원]청정원 우리밀 튀김가루 (450g),2850,2850,0
2018-06-01,954848048,A011130,시리얼,[청정원]청정원 우리 밀 부침가루(450G),2900,2900,0
2018-06-01,1011156999,A018040,아이스크림,투게더 쿠앤크 4개,18000,17460,-540
2018-06-01,984545796,A013170,생선통조림,동원 살코기 마일드참치(150G*3+2기획),9980,8490,-1490
2018-06-01,1752325702,A011010,쌀,2017년 햅쌀 참살이 고시히카리 10kg,33800,33800,0
2018-06-01,61382678,D031010,주택수선재료,파워자임/친환경타일침투방수제/4kg,30400,30400,0
2018-06-01,1258995377,E031130,보온매트,작은별네이비 싱글 100x180 전기요 전기장판 전기담,49080,49080,0
2018-06-01,1870584170,A011090,국수,컵라면(한박스)x24개 육개장사발면 신라면 왕뚜껑,16800,16800,0
2018-06-01,1308731878,C013050,운동복,콜라보배색집업 MS1710 운동집업 편한운동집업 트레이,51110,51110,0
2018-06-01,19138834,I053020,스케치북,스케치북/크로키북/블랙스케치북/2절/3절/4절스케치북,1200,1200,0
2018-06-01,388869534,F011150,건강기능식품,의성식품 20곡 미숫가루 1kgx3봉(3kg)/선식/식사대용,9700,9700,0
2018-06-01,631196002,A017120,고구마,하루한끼 맥반석으로 구운 아이스 군고구마 450g(3-4,55900,49200,-6700
2018-06-01,440294494,A015020,식용유,(무)해표 카놀라유500mlx20개(box)식용유 올리브유 카,72200,63540,-8660
2018-06-01,1253112114,C012060,여자내의,빅사이즈/그란데/망사/스커트 그란데망사스커트 빅사,45900,45900,0
2018-06-01,1310429008,C012030,여자상의,oo01 7부소매 스트랩 단가라 ops - 오렌지 원피스 여,19460,19460,0
2018-06-01,1914305744,A013120,낙지,무료배송) 꽃보다오징어 300g 숏다리 안주 간식,17900,17900,0
2018-06-01,1380032416,E031050,냉장고,삼성공식 김치냉장고 RQ33M70227F 전국무료HS,1248000,1198080,-49920
2018-06-01,136362483,A012030,돼지고기,정성온 뚝불고기 410g 2개,15000,14550,-450
2018-06-01,685436636,A019040,소금,개암죽염 9회죽염 양치용자핵죽염 50g/ 부안 개암사 /,18000,18000,0
2018-06-01,1841998019,A018010,초콜릿,커클랜드 소프트앤츄이 그래놀라바 60개입 믹스바,14750,14750,0
2018-06-01,2030286435,A017220,양파,흙쪽파 1단(대) / 국내산,16810,16810,0
2018-06-01,1901092130,C012040,여자학생복,빅사이즈 55~99 조끼 니트조끼정장조끼 롱조끼 베스트,17900,17900,0
2018-06-01,982700836,A018070,파이,동서 오레오 초코크림(100G),1290,990,-300
2018-06-01,476883895,C013050,운동복,DYT 오픈져지(GLS-624) 트레이닝복상의 츄리닝 남성의,85720,85720,0
2018-06-01,2047068273,C015040,장갑,아놀드파마_APGW-BY1221(가죽장갑_여성용) 양털장갑,27150,27150,0
2018-06-01,1005702399,A021010,커피,[커피디씨마트] 맥스웰하우스 오리지날180T/마일드,11380,10700,-680
2018-06-01,921442005,A011180,파스타면,오뚜기 스파게티면 100gx5개/일반 가정용/스파게티,950,950,0
2018-06-01,799453357,C011050,남자내의,봄 청바지 밴딩바지 카고바지 배기 남자 남성 면바지,17800,17800,0
2018-06-01,1356977403,C011030,남자학생복,여름신상/와이셔츠/드레스/린넨/헨리넥/남자/남성,14900,14900,0
2018-06-01,535008188,C012040,여자학생복,[루코루코]8095 가디건 2color(RSC4CD008),24000,22800,-1200
2018-06-01,1687988734,A021020,차,[커피하우스]대호크리미 1kg 원두전용크리머,4600,4600,0
2018-06-01,1234620884,C012060,여자내의,[세여자몰][세여자몰]보미하이웨스트스커트[TW81SK043],27390,26300,-1090
2018-06-01,1327635992,E031080,선풍기,건강온열난방기 근적외선루비 HV-1720/3.2K난로 한빛,449700,449700,0
2018-06-01,1844663211,A013130,오징어채,국내가공 진미채 1Kg / 버터구이 땅콩버터 오징어채,23000,21900,-1100
2018-06-01,488950487,E041070,밀폐용기,국산 포스코 27종 스텐 밀폐용기/반찬통/김치통,6900,6900,0
2018-06-01,739004426,E061040,부엌용세제,참그린 [모과] 식초설거지 리필 900mlx3개 주방 세제,8900,8900,0
2018-06-01,2053879903,A013170,생선통조림,(오늘출발) 고추참치 150g x 12개/마일드 살코기 야채,18900,18900,0
2018-06-01,1033323153,A019130,스프,[동원] 스프 30개 (콘스프 양송이 누룽지크림 선택),20500,20500,0
2018-06-01,299998168,E011030,거실장,철레일 거실장/서랍장/tv다이/티비다이/3단서랍장/거실장/수납장/협탁/미니서랍장/티비,64900,61900,-3000
2018-06-01,280866038,A013040,고등어,제주 간고등어 14마리小中大 자반고등어 순살고등어,9900,9900,0
2018-06-01,1938956147,C011030,남자학생복,[TI FOR MEN] 티아이포맨 패턴 베스트 M144MVT271M1GY,15300,13470,-1830
2018-06-01,437529130,C011050,남자내의,슬림핏 카고팬츠 일자면팬츠 남자세미 위장지 절개 카르고 카고면바지 국산스판 얼룩,24700,24700,0
2018-06-01,928882775,F012020,생리대,(공식대리점)화이트 탐폰/레귤러/8p/16p/생리대/템포,10100,10100,0
2018-06-01,605408724,C012040,여자학생복,프라하블라우스(PWP2M2BL03)/ 파슨스,79000,71100,-7900
2018-06-01,2055804016,C012060,여자내의,[제시뉴욕] 펀칭민소매점프수트 (J73OP159S),79200,73660,-5540
2018-06-01,954873062,A013140,북어채,[무료배송][정화식품]해오징어 버터구이 35gx5봉,16900,13900,-3000
2018-06-01,665217439,I031010,장난감,PSVR 본체 신형+카메라+무브컨트롤러2개+아크파크VR,397890,378000,-19890
2018-06-01,627337273,C013050,운동복,차선유도봉/규제봉/차단봉/주차용품/탄력봉/볼라드,8900,8900,0
2018-06-01,550261398,A017020,상추,믿을 수 있는 우리 농산물 양상추 1통,6010,6010,0
2018-06-01,1134753059,A011160,빵,無우유 無계란 통밀옥수수모닝빵280g 2입,19300,17180,-2120
2018-06-01,811095908,A014020,분유,베비언스 킨더밀쉬 200ml 24입 영양밸런스UP,37900,37900,0
2018-06-01,656838941,C013020,티셔츠,[체스][체스골프]리본 귀걸이 이너,29000,27550,-1450
2018-06-01,1676477896,C011050,남자내의,신상카고바지/작업복/남자/남성면바지/슬림핏빅사이즈,23800,23800,0
2018-06-01,19860923,E031070,에어컨,한일선풍기 리모컨형 벽걸이선풍기 FW-604R,49000,46550,-2450
2018-06-01,1723668973,E011060,의자,[티움퍼니쳐] TF-MN시리즈 학생 책상의자,90500,85070,-5430
2018-06-01,1111667342,C011050,남자내의,T25H F TRACK SHORTS PURPLE,33000,33000,0
2018-06-01,398478496,C012040,여자학생복,수지네 일본 빈티지 레드 패딩조끼 여성 M 18-16,17130,17130,0
2018-06-01,329578628,E041020,컵,국산포토 머그컵 생일 커플 부모님 선생님 어린이날,9900,9900,0
2018-06-01,162871410,C014020,유아복,우리뚱/s예쁜여름신상/원피스/나시/반팔/유아복/아동,12900,12900,0
2018-06-01,559074632,C013010,점퍼,밀란시아 빅사이즈 보카시점퍼 ii9-2 빅사이즈 남성자,102120,102120,0
2018-06-01,898664139,A012060,햄및베이컨,[롯데]롯데 런천미트 340G,4300,1990,-2310
2018-06-01,1725486055,E041070,밀폐용기,보르미올리 피도 유리밀폐용기/유리병/피클병/담금주,3480,3210,-270
2018-06-01,1698632198,I031010,장난감,[브랜드B] 춤추는고래분수대 / 스프링클러 목욕놀이,39000,39000,0
2018-06-01,321356177,A013050,오징어,파인애플캔(슬 돌 3.06k) 업소용 식자재용 통조림 깡,16090,16090,0
2018-06-01,1336691861,A022040,기능성음료,포카리스웨트 340ml 20페트 페트음료 이온음료 음료수,11480,10800,-680
2018-06-01,1933689475,C013010,점퍼,빅사이즈 DSM1044 빅 포인트 울 자켓 801 빅사이즈재,90590,90590,0
2018-06-01,1433225399,C012030,여자상의,이자벨스모크 원피스)펀칭/레이스/화이트/흰색/여름,31900,31900,0
2018-06-01,642132710,E011050,책상,TS퍼니처 철제 강화유리 사무용 컴퓨터 학생 공부책상,55000,49500,-5500
2018-06-01,854914969,C013020,티셔츠,꼬불꼬불세로줄티/골지티/반팔티/슬림티/셔링티...,6900,6900,0
2018-06-01,2122637262,G011070,자전거,베리벨로 프라임GS 26 18년형 21단 접이식자전거,94330,84900,-9430
2018-06-01,352197374,L012060,샴푸,미쟝센 펄샤이닝 샴푸780ml x 3개/린스/헤어팩/팬틴,10300,10300,0
2018-06-01,897905817,I031010,장난감,[토이트론]아쿠아비즈-스타터 세트,22800,22420,-380
2018-06-01,1774915756,F011130,홍삼,굿베이스 홍삼담은 자연헛개(50ML*30입),53100,53100,0
2018-06-01,1396005603,E051020,건전지,18650/삼성18650/LG18650/대용량 3500mAh/MJ1/35E/KC,9500,9240,-260
2018-06-01,1081066022,C014020,유아복,[대구백화점 I관] [치크]린넨세트프릴상의(CKSM18F1G),19900,18510,-1390
2018-06-01,988030444,A013070,굴,[통영앞바다]통영 돌문어 1kg/1~2마리,41900,34400,-7500
2018-06-01,484994181,A013100,마른멸치,[새우몰] 전복소라다이스 1kg 전복죽 볶음밥용 다진 전복살,27800,27800,0
2018-06-01,588272097,C011050,남자내의,여름신상 와이드팬츠/밴딩바지/슬랙스/마바지/8부남성,15700,15700,0
2018-06-01,1011156973,A018040,아이스크림,매그넘멀티 아몬드바8개+클래식바 8개 (총16개),34000,28030,-5970
2018-06-01,1478458025,C011030,남자학생복,앤듀 기본카라 CR 7부 절개셔츠 O182SH150P,28000,22960,-5040
2018-06-01,1011156974,A018040,아이스크림,쭈쭈바 세트(총 25개),25000,13090,-11910
2018-06-01,1011156975,A018040,아이스크림,콘 세트 (총 25개),32500,16300,-16200
2018-06-01,978227297,I031010,장난감,폴리롤링카/엠버/로이/헬리/붕붕카,29800,29800,0
2018-06-01,1503865785,C012020,원피스,[이사베이]라운드넥 펄 스티치 롱 자켓 (VQJAB2116)_Y1L5,49000,46550,-2450
2018-06-01,446358931,L012040,치약,누런이 하얗게 치아미백 프리미엄화이트닝겔 미백제,19800,19800,0
2018-06-01,743094768,C013050,운동복,반팔 반바지 루즈핏 박스핏 밴딩 트레이닝복 세트,9900,9900,0
2018-06-01,965016717,I011020,영상음향기기,미니 빔프로젝터1K루멘 캠핑 영화 미러링 삼각대 세트,109000,105730,-3270
2018-06-01,559049350,C011030,남자학생복,[지오다노]여 포플린셔츠 348505,29800,23840,-5960
2018-06-01,572611410,C014020,유아복,[트윈키즈]폴프랭크슬라브수박T (M7MC9T01),7900,5140,-2760
2018-06-01,654199292,A022010,주스,식자재 식당 양념 음료 차 레몬에이드 컨츄리타임 585,101560,101560,0
2018-06-01,47008053,C013010,점퍼,[모다아울렛][막스카라]막스카라17 하이넥 양가죽 점퍼 -M71TLJ703 - 그레이(행담도,299000,269100,-29900
2018-06-01,441065191,C013050,운동복,차량용 소화기 0.7kg (거치대포함),33360,30390,-2970
2018-06-01,913414559,A016030,복숭아,산초가루(맷돌 50g)X100개/산초,245650,230920,-14730
2018-06-01,1709260199,E031010,전기밥솥,CRP-G1030MP [쿠쿠] 10인용 압력밥솥/쾌속취사,102800,96450,-6350
2018-06-01,520854641,A016040,포도,아삭아삭 껍질째 먹는 적포도(크림슨) 1kg이내,13900,13900,0
2018-06-01,2096940115,E041010,식기,노노스베어 5 사각찬기 1박스 20개 찬기 사각찬기 반,44380,44380,0
2018-06-01,1701869995,C012030,여자상의,스타일리쉬 원피스/봄/하객/면접/L사이즈/오피스룩,39900,39900,0
2018-06-01,1011095440,A014020,분유,[일동후디스]트루맘 메디설사(300gx3캔),41700,41700,0
2018-06-01,1831643381,E021020,커튼,[리앤룸] 2장/4장세트/린넨룩암막거튼//아일렛형,34800,33800,-1000
2018-06-01,66541536,C013050,운동복,최저가/正品 불스원 에탄올 워셔액/발수코팅/레인OK,1900,1900,0
2018-06-01,1011095441,A014020,분유,[일동후디스]트루맘 메디소이(320gx1캔),11800,11800,0
2018-06-01,677840582,C012060,여자내의,발목 스타킹 10족 양말 발목스타킹 기모레깅스 레깅스 겨울스타킹 기모레깅스 스타킹,7080,6310,-770
2018-06-01,1320281227,C014010,아동복,로리앤콜린여름신상_상하세트복/맨투맨/원피스,8900,8900,0
2018-06-01,1286171066,C011050,남자내의,미넴옴므 가먼트워싱 치노 면팬츠 3종,59000,58000,-1000
2018-06-01,592839383,E041050,냄비,키친아트 세라믹코팅 통주물 아르떼냄비,12900,12900,0
2018-06-01,1139576370,E031140,비데,[3년무상A/S][본사직영점] 노비타비데 BD-N550A/탈취,309000,289000,-20000
2018-06-01,1919477868,A015020,식용유,에버코코 쿠킹 코코넛오일 485ml - 코코넛 오일 식용,13620,13620,0
2018-06-01,1308180834,C015030,넥타이,5+1실크넥타이 명품다모여 케릭터500종 국내산고품질,24000,24000,0
2018-06-01,1686782295,L021060,유모차,(베렝구어)리틀큐티스 쌍둥이 유모차No.16982,81980,81980,0
2018-06-01,466923560,C015040,장갑,(3M스마트장갑여)베이직한 컬러감 스마트폰 사용가능,13680,13680,0
2018-06-01,1011095439,A014020,분유,[일동후디스]트루맘 메디설사(300gx1캔),13900,13900,0
2018-06-01,616453990,C013010,점퍼,엑스톤즈 시즈 N3B 파카 - 야상,210000,207900,-2100
2018-06-01,138543636,C012060,여자내의,[빅사이즈]청원피스/데님원피스/멜빵치마/뷔스티에,33900,33900,0
2018-06-01,1448274994,A013090,전복,국내산 새꼬막 1.5kg (상) 새벽조업후 발송 산지,30060,30060,0
2018-06-01,1706272685,L021030,가방,15.6인치 노트북가방/노트북백팩/서류가방/남성가방,23900,23900,0
2018-06-01,1010261136,A019070,양념소스,팔도 만능비빔장 40G*10입,4800,4800,0
2018-06-01,1036928956,C012030,여자상의,퓨리티 데님 롱원피스-M1062,31360,31360,0
2018-06-01,926483467,C012030,여자상의,엠짱_가격인하/빅사이즈 원피스/행사복/데일리룩,19800,19800,0
2018-06-01,1861349117,A012030,돼지고기,지리산 흑돈 버크셔K 앞다리살 1kg 외 구이 수육 부위,23000,19900,-3100
2018-06-01,1011156945,A018040,아이스크림,와일드바디 40개,24000,16290,-7710
2018-06-01,1011095463,A014020,분유,[일동후디스]트루맘 메디소이(320gx3캔),35400,35400,0
2018-06-01,531982674,C013040,청바지,여름신상 너무 예쁜핏 일자 진 / 청바지 스키니,29800,29800,0
2018-06-01,2063812705,E021010,침구,겨울왕국 면기모 패드 - 뷰티선샤인 (064187) 패드 까,64090,58380,-5710
2018-06-01,79140312,E061050,청소용세제,TV정품-더쎈 매직크리너 세정제/곰팡이/배수구/크리너,29800,29800,0
2018-06-01,596721046,A012010,국산쇠고기,[명절선물 Best][한우족 보신세트 2호]1등급 한우/한,215000,212850,-2150
2018-06-01,2053987758,C012020,원피스,[플라스틱아일랜드]쟈스민 원피스(PJBTX017)(강남점),59000,52660,-6340
2018-06-01,231304124,C012060,여자내의,빅사이즈/엔젤/쉬폰/스커트 엔젤쉬폰스커트 빅사이즈,38520,38520,0
2018-06-01,380537053,E061010,세탁세제,찌든때제거제 바르는테크 220ml 부분제거제 얼룩제거,8970,8970,0
2018-06-01,930219256,L021060,유모차,[치코] 휴대용유모차 스내피(SNAPPY),55000,55000,0
2018-06-01,608374416,C014010,아동복,터닝메카드W히어로즈3종세트 아동팬티 어린이팬티,12180,12180,0
2018-06-01,1332037503,F012050,의료측정기,컨투어 혈당기 세트+스트립100장.합100장+솜100+침200,30000,29000,-1000
2018-06-01,1480762403,A011090,국수,[농심]봉지라면x10봉+2/신라면/안성탕면/짜파게티/진,8000,7850,-150
2018-06-01,982435471,E061030,전구,GE PL 32W주광색2입,11900,11900,0
2018-06-01,2082994540,C012020,원피스,[올리비에스클로젯] 테잎배색 테니스 치마바지_[O1804PT031B],19800,18810,-990
2018-06-01,1637140998,A019130,스프,크루통 컵스프 24g x 15개 / 갈릭 콘 버섯 포테이토,11900,11900,0
2018-06-01,1525049427,A012010,국산쇠고기,한우갈비혼합세트 2호 2.8kg 소갈비선물세트 한우세트,350700,350700,0
2018-06-01,460354297,L021020,장신구,트윈 크로스 롱 목걸이 크로스목걸이 십자가네크리스,24080,24080,0
2018-06-01,198124427,A017220,양파,[흙살림] 친환경 대파 300g,1200,1100,-100
2018-06-01,1504565692,A013130,오징어채,참 꽃징어 200g / 건어물녀 / 꽃보다오징어 오징어,11900,11900,0
2018-06-01,2056242220,I053010,공책,GT 모닝 초등 3-6 알림장 좁은칸 남 여아알림장 알림,5230,5230,0
2018-06-01,1864614019,F011150,건강기능식품,26%할인 큐원 상쾌환 3gx10포x2개(20포)/최신제조상품,31600,31600,0
2018-06-01,30348246,A014030,치즈,동원 파티쉐 슬라이스치즈 50매/체다/업소용/카페용,6900,6900,0
2018-06-01,1769429370,A018040,아이스크림,업소용/아이스크림/라벨리/딜리셔스/카페,12000,12000,0
2018-06-01,1121542651,F012020,생리대,엘리스 생리대 메가미 오버나이트 11P x 2팩/ 엘리스,10500,9980,-520
2018-06-01,897303244,C013050,운동복,타이어 공기압 게이지/공기압측정기/타이어공기압측정,9900,9900,0
2018-06-01,638561423,A019030,생강,편강진저빈 (국산 250gX2통) 선물세트,32450,32450,0
2018-06-01,1237597531,A013170,생선통조림,고추참치캔(오뚜기 150g)X36 식자재 물참치캔 깡통 동,87700,87700,0
2018-06-01,320874809,C021010,아동화,월드컵 유아 여아 남아운동화 아동화 샌들 슬립온신발,10000,9900,-100
2018-06-01,253740162,C012040,여자학생복,러플5부블라우스 (J11NBL449)/ 매그제이(MAGJAY),39000,35100,-3900
2018-06-01,2134093251,L021010,손목시계,LED 패션시계/스포츠시계/밴드시계/커플시계/생활방수,1100,1100,0
2018-06-01,1239308633,A021020,차,[당일출고]동서 프리마 자판기용/가정용 1kg or 1.6kg,3700,3700,0
2018-06-01,2050226575,A012030,돼지고기,(왕목살 벌집삼겹살 오겹살 오돌뼈)돼지고기구이모듬,2900,2900,0
2018-06-01,2047526710,C013020,티셔츠,[NAMU][NamuGRim/나무그림] 에스페로T C18MNY6X344A5,24000,24000,0
2018-06-01,1083404490,E011020,침대,파로마 캐더린 퀸(Q) 수납침대(프레임만),349000,219000,-130000
2018-06-01,1654713695,F012010,종이기저귀,메리즈 기저귀 팬티형 남여공용 3~5단계,28900,26900,-2000
2018-06-01,1062765620,F012010,종이기저귀,마미포코 오버나이트 기저귀 굿밤팬티 코자요 3팩,39900,39900,0
2018-06-01,524894650,A011050,콩,[가온애]강정 땅콩강정 꽈베기 과자 주전부리 옛날과자 화과자 찹쌀과자 엿땅콩 옥수수,3900,3900,0
2018-06-01,715050234,L012060,샴푸,프리미엄 TS샴푸 티에스 500+30ml 사은품 /탈모샴푸,34700,34700,0
2018-06-01,1293033785,F012020,생리대,화이트 생리대/소형/중형/대형/오버나이트/라이너,7900,7900,0
2018-06-01,367878265,E021010,침구,굿몽 시어서커 여름이불 이불세트 이불패드 패드 토퍼,22800,22800,0
2018-06-01,352857420,A021010,커피,아이수 페루산 카카오닙스500g,16530,16530,0
2018-06-01,997097390,C012060,여자내의,[포에버21]프레이드 청반바지/FOREVER21/바지/팬츠/핫팬츠,28900,11560,-17340
2018-06-01,519866644,L021010,손목시계,Paop-u_스포츠시계 스포츠용품 방수시계 스포츠시계,12260,12260,0
2018-06-01,171612668,A022050,탄산음료,미린다 오렌지 355ml x24캔 파인애플 탄산음료 음료수,11200,11200,0
2018-06-01,1228867430,A019070,양념소스,청우 양념치킨소스순한맛10kg/꼬치소스매운맛10kg외,24500,24500,0
2018-06-01,1717397035,E031120,믹서,풍년 PQMC-150 다지기/믹서기/야채다지기/분쇄기/,18900,18900,0
2018-06-01,844208151,A019110,드레싱,코리원/CJ 타르타르 드레싱 2kg/생선까스/돈까스,8400,8300,-100
2018-06-01,1354365736,C013020,티셔츠,심플 후드집업 LTT004 여성후드집업 트레이닝복,30210,29610,-600
2018-06-01,30843727,C011030,남자학생복,[지오다노]여 코튼 린넨 셔츠 348510(대구신세계),39800,32820,-6980
2018-06-01,533610549,E031070,에어컨,14인치 박스팬 선풍기MF35-14T 미니선풍기 현진포커스,29800,29800,0
2018-06-01,1261264707,A015020,식용유,(맛있는 CJ)올리고당 700g x 4개 A13096 - 단맛 찜닭,24020,21380,-2640
2018-06-01,392788777,A019060,된장,된장(재래식 육미14K) 된장 재래식된장 식자재 업소용,49650,44690,-4960
2018-06-01,100348177,L021050,우산,고급형 투명우산 비닐우산 파스텔우산 자동우산,1300,1300,0
2018-06-01,1777775963,C013050,운동복,단체복전문/트레이닝 헬스반바지 쿨론기능성티셔츠,6000,5900,-100
2018-06-01,1885834554,L021020,장신구,실버)샤인 루돌프 목걸이(RG)주얼리 악세사리 기념일,15690,15690,0
2018-06-01,529644874,C012060,여자내의,허리조절 기모 스판 교복치마 그레이 교복 예쁜교복,49840,48350,-1490
2018-06-01,1085308250,A017050,미나리,방울양배추 1kg 신선농장 미니양배추 품절,20000,20000,0
2018-06-01,1234835700,C013010,점퍼,봄 신상품 남성 등산 자켓점퍼 바람막이 단체 작업복,15800,15800,0
2018-06-01,1429043321,C011020,남자상의,패딩 코트 레이어드 PD05 WS 패딩코트 코트 남자코트,167360,148960,-18400
2018-06-01,905781060,F012050,의료측정기,케어센스2 혈당계+시험지110+멸균침110개+솜100+수첩,34000,34000,0
2018-06-01,1309225363,A014030,치즈,프리미엄 파마산 1kg 아담스 치즈 치즈가루,9470,9470,0
2018-06-01,1411920085,F012020,생리대,[중형20p+입오버2p+립밤] 라이너 유기농순면 일반 40x3/ 좋은느낌,10900,10900,0
2018-06-01,440294467,A013170,생선통조림,유동자연산골뱅이 400gX24개식품 유동자연산 골뱅이,319200,271320,-47880
2018-06-01,190457814,E031020,가스레인지,[하이원 가스타이머 K-300] 원터치 스위치방식 디지털(전자식) 가스타이머/획기적인 가,58220,58220,0
2018-06-01,843533195,E061100,습기제거제,[강력제습+NEW]*피죤 제습제 옷장형/용기형 습기제로,11900,11900,0
2018-06-01,624539288,C015020,모자,뉴에라 [940]NYC 핸드드로잉 볼캡 블랙 11543736.,35000,30800,-4200
2018-06-01,440294463,A015020,식용유,(무)해표 카놀라유900mlx12개(box)포도씨유 식용유 카,76500,67320,-9180
2018-06-01,516323623,I012010,컴퓨터,APPLE Mac MINI MGEM2KH/A / SG / 정품 / 2015년형 맥미니/ 빠른발송,655880,655880,0
2018-06-01,1980947103,C013020,티셔츠,[올젠]투톤 포인트 카라 티셔츠 ZAX2TT1102_LI,35000,28000,-7000
2018-06-01,1354341772,C013020,티셔츠,양털 안감 후드집업 LDZ2214 후드집업 집업,35780,35070,-710
2018-06-01,1010261103,E041070,밀폐용기,[락앤락]락앤락)페더라이트링텀블러450ml블랙,24800,12900,-11900
2018-06-01,1439760853,C013050,운동복,R로고 자동차 도어가드/문콕방지가드 차량용도어가드,8450,8200,-250
2018-06-01,244786868,C011030,남자학생복,ACC(필골드)DB002 청스판 절개라인셔츠 청셔츠 청남방,37820,37820,0
2018-06-01,2063562990,C013020,티셔츠,반팔 후드 단체티 빅사이즈,9320,9320,0
2018-06-01,497666320,A017280,김,(무)대원치자단무지2.7kgX4개치자 단무지 식자재 대원,25800,22710,-3090
2018-06-01,672644647,L012060,샴푸,궁중어책/어성초샴푸 1000ml 2통/두피 약산성,30000,24900,-5100
2018-06-01,591794871,I031040,생화,스포츠물병 물통 휴대용물병 등산물병 보틀 물병 수통,3000,2760,-240
2018-06-01,1221060947,C012040,여자학생복,DWW1318 큐티 캉캉 뷔스티에 802S 캉캉끈뷔스티에 캉,38350,38350,0
2018-06-01,1010261199,E061070,가정용비닐용품,지퍼락)더블지퍼백냉장(대)2+1,6700,6700,0
2018-06-01,2113655294,I031010,장난감,아이폴리스 유아 전동 경찰오토바이/듀얼모터 바이크,178000,160200,-17800
2018-06-01,985473282,A016060,감,냉동 딸기 800G(국산/봉),19900,4990,-14910
2018-06-01,1852587839,C013010,점퍼,[네파키즈] (KDD0605) 에스티보 라이트 윈드 자켓,42500,40380,-2120
2018-06-01,735953542,A011050,콩,볶음땅콩 3.75kg,12900,12900,0
2018-06-01,58234441,C013050,운동복,상하세트 유아상하세트 핑크상하세트,40710,39900,-810
2018-06-01,985473285,A016100,수박,애플수박,6990,6990,0
2018-06-01,985473284,A022050,탄산음료,코카 닥터페퍼 355ML,750,600,-150
2018-06-01,999854195,I011020,영상음향기기,20만원 램프추가증정 PJM-3600X / 4000X 빔프로젝터,599000,554000,-45000
2018-06-01,1451515744,A013020,명태,[유진수산] 꽁치 / 특대사이즈,4460,4460,0
2018-06-01,699386970,A014030,치즈,옥산 리얼 그레이티드 파마산치즈 227g,6400,6400,0
2018-06-01,987317478,A016150,아몬드,아몬드 슬라이스 220G,4990,4990,0
2018-06-01,987317479,A016150,아몬드,구운 피스타치오 350G,8990,8990,0
2018-06-01,28721858,E011020,침대,아씨방 한정특가 LED조명침대/수납침대/슈퍼싱글침대,199000,199000,0
2018-06-01,987317480,A016150,아몬드,구운 아몬드 350G,7990,7990,0
2018-06-01,1269723219,L012090,기초화장품,참존nc1/대용량 310ml 퓨플 에센셜 스킨(스킨+에센스),18900,18900,0
2018-06-01,571007262,E031110,청소기,공식파트너)삼성 핸디 진공청소기 VC-H20 무료배송,28260,28260,0
2018-06-01,256144886,C013020,티셔츠,포켓맘 포켓수유티,28990,28130,-860
2018-06-01,644852060,A018090,잼,코리원/오뚜기 일회용 딸기쨈 디스펜팩 12gx480개/쨈,30500,30500,0
2018-06-01,1558299664,F012020,생리대,NEW 에리에르 엘리스 생리대 오버나이트 2팩,12900,12900,0
2018-06-01,898508395,A018040,아이스크림,설레임 밀크 (10개),12000,7000,-5000
2018-06-01,451024538,A013150,어묵,부산가덕도 꼬치어묵2 800g2개 어묵 꼬치어묵 냉동식,21380,19250,-2130
2018-06-01,969067959,D031010,주택수선재료,멀티멜 3.78L 반광 KCC페인트 숲으로 다용도 목재방문,30300,30300,0
2018-06-01,1681239987,C013020,티셔츠,[트래비스골프]여성용 기능성 쿨링 이너 긴팔티셔츠_NAVY(TAHMTL62F_NV),15600,14820,-780
2018-06-01,901695146,C014020,유아복,등레이스쉬폰ops/행사복/레이스나시/진주나시형원피스,9900,9900,0
2018-06-01,1991788498,C015040,장갑,남녀공용 패션 프리미엄 털장갑 AG1716019 겨울장갑,19020,19020,0
2018-06-01,2018772877,A013080,조개,두레생협 논우렁살(200g/마산푸드) 논우렁살 우렁살,14850,14560,-290
2018-06-01,1233161433,A013050,오징어,밀감캔(소교 3k)X6 식당용 통조림 식자재 밀감통조림,52110,52110,0
2018-06-01,152157850,A013090,전복,영신 냉동명태포슬라이스 7kg(700gx10),73820,73820,0
2018-06-01,1179061294,I011030,사진기,소니 DSC-RX100M4 정품 명품마을,780790,780790,0
2018-06-01,458508336,E061060,살충제,컴뱃파워 작은 바퀴막멸 전문베이트 12입 해충 컴배트,15610,15610,0
2018-06-01,1916016333,C012040,여자학생복,마르ni 민소매 롱원피스 KD,40300,40300,0
2018-06-01,312459549,C013050,운동복,여름 반팔티세트/운동복/트레이닝복/트레이닝세트,19900,19900,0
2018-06-01,1649300265,C012040,여자학생복,[포에버21]드롭 슬리브 골지 후드 니트/FOREVER21/니트/스웨터/후드니트,33900,13560,-20340
2018-06-01,1124472359,A013010,갈치,제주 옥돔(대) 3kg(마리당250g내외 선물포장) 탐라의,201200,195170,-6030
2018-06-01,1353506442,F012050,의료측정기,VT 케어센스N 혈당시험지 50매/당뇨검사지/측정지,17580,16000,-1580
2018-06-01,2112017341,C012060,여자내의,[블루종]린넨 플레어 뒷밴딩 스커트_[B1805SK063B],32800,31490,-1310
2018-06-01,1802036597,C012060,여자내의,[데일리워너비]줄리아 배색 니트 스커트,25000,23750,-1250
2018-06-01,187576792,C013020,티셔츠,여름신상 롱티/원피스/반팔티/박스티/빅사이즈/쁘니걸,19800,17800,-2000
2018-06-01,368843500,C021020,구두,남성구두 MA83 신사화 천연가죽 3.3cm 정장슈즈 정장,53390,53390,0
2018-06-01,116901400,E031090,공기청정기,파트너M 삼성 공기청정기 AX40M3030WMD 당일발송,250000,235000,-15000
2018-06-01,984281462,E041080,부엌용용구,껍질제거 매직 장갑,6900,6900,0
2018-06-01,949474623,A012050,소시지,천하장사 더블링 400g 1+1콰트로치즈 참치마요 소세지,14900,14900,0
2018-06-01,1169812300,C013050,운동복,BH 빅사이즈 GOOD 여름 트레이닝복 세트 단품구성,29900,29900,0
2018-06-01,950176733,E011020,침대,느웰베드 15cm 천연라텍스 원목/가죽/LED/수납형 침대,759000,759000,0
2018-06-01,1244494676,A021010,커피,카너스 네스프레소호환 싱글오리진 캡슐커피 10개입,3800,3800,0
2018-06-01,467851081,L021010,손목시계,쥬얼리 스포츠 컬로리 손목시계 손목시계 시계 손목시,6910,6910,0
2018-06-01,1512859793,C013010,점퍼,bb99 숨김 원버튼 fur 도톰 자켓 크림 퍼자켓 여성자,47760,46330,-1430
2018-06-01,1908696162,A013050,오징어,동원 꽁치캔 (400g) x24,65170,65170,0
2018-06-01,1216488710,C015030,넥타이,(공연이벤트나비넥타이모음)넥타이 삐에로 리본타이,1000,970,-30
2018-06-01,391148253,C013050,운동복,아디다스 에이스 플리스 니트수트(AA6863) 운동복 운,141770,141770,0
2018-06-01,440942156,C012040,여자학생복,[LAP] AF2WB571. 아일렛 주름 블라우스,31860,29890,-1970
2018-06-01,1054407022,C021010,아동화,바자르 플레이 양스판 아동슬립온 어린이슬립온 어린,46060,46060,0
2018-06-01,1296274530,C012020,원피스,노카라 포켓 바바리 (LI5BY603)/ 르샵,129000,109650,-19350
2018-06-01,1147643864,A017010,배추,[강원도 정선] 건곤드레500g/냉동곤드레/곤드레 나물,25000,24750,-250
2018-06-01,25070668,L021020,장신구,원석sale/루틸라이트쿼츠/quartz/10.45ct,80000,80000,0
2018-06-01,340490428,C012060,여자내의,스판포켓 기모 밴드팬츠 여성 레깅스 팬츠,31000,30690,-310
2018-06-01,493761623,C012060,여자내의,(JJ지고트) 체크 울 혼방 H라인 스커트 GI4A0SK32/ 제이제이지고트,139000,125100,-13900
2018-06-01,493761624,C012060,여자내의,(JJ지고트) 사선 핀턱 스커트 GI4A0SK30/ 제이제이지고트,77400,69660,-7740
2018-06-01,164644788,F011150,건강기능식품,속편한에센셜6병 위건강 속쓰림 역류개선 글라브리딘,203700,203700,0
2018-06-01,920168645,D031010,주택수선재료,안새내/워터크로즈-뿌리는고무방수제/스프레이/욕실,8800,8800,0
2018-06-01,1825593635,A011120,두부,콘푸로스트 컵 시리얼 30gX24개/첵스초코/씨리얼,18900,18900,0
2018-06-01,381395006,I031070,애완동물관리비,바볼랏 RPM 블라스트릴- 117771 탁구채소품 배드민턴,228650,228650,0
2018-06-01,209363244,C013040,청바지,뿌찌 남아 여아 주니어 청바지 면바지 자켓 바지 의류,22400,22400,0
2018-06-01,1010285128,A012060,햄및베이컨,롯데 런천미트 120G,1690,1690,0
2018-06-01,1010405350,E031070,에어컨,마이)초마풍좌석용선풍기,89900,29900,-60000
2018-06-01,122989324,A014030,치즈,무배 미국 메세나 파마산 치즈 분말 파우더 227g 20개,170300,170300,0
2018-06-01,2002797459,A019020,참깨,검정깨가루 (한1K) X10,195220,173750,-21470
2018-06-01,1138144568,E061060,살충제,향균 탈취 살균 소독 악취제거 연막소독기 냄새제거,98000,98000,0
2018-06-01,510861895,E031040,전기레인지,차량 휴대용 냉온장고 175x320x315 7.5L 차량용냉온장,74760,74760,0
2018-06-01,780094610,E031050,냉장고,[대유위니아] 공식판매1 딤채 스탠드김치냉장고 WDT33BLMTST (330L),1135410,1090000,-45410
2018-06-01,1056808926,C014020,유아복,아둘 유아 여름 미키 랍빠 핫팬츠 반팔티 상하세트 11,19100,19100,0
2018-06-01,1883089791,A021010,커피,[당일출고/무료배송]카누라떼/더블샷 100T+보온병or6T,33900,33900,0
2018-06-01,754051419,A022010,주스,버블티재료모음 1kg/버블티파우더 타피오카펄 요거트,12900,12900,0
2018-06-01,987317440,A021010,커피,이디야 블렌딩 원두 다크블루 200G,14000,14000,0
2018-06-01,1121493266,A012050,소시지,천하장사 소시지 600g x 2개 천하장사Q 프리미엄/ 간,10900,10900,0
2018-06-01,982435410,E061030,전구,GE삼성) T514W 직관,8490,8490,0
2018-06-01,1238199118,F012020,생리대,좋은느낌 유기농순면 슬림 날개 소형 18x3,15700,14910,-790
2018-06-01,203181605,A016110,딸기,[당일수확]2017년 산청 햇 딸기 1kg 2kg 무료배송,13900,13900,0
2018-06-01,987317445,A021010,커피,이디야 비니스트 마일드 아메리카노 100T + 30T,19900,19900,0
2018-06-01,895712758,A011010,쌀,[2017년산] 이천쌀 10KG/포,35900,31900,-4000
2018-06-01,987317446,A021010,커피,이디야 비니스트 아메리카노 오리지날 100T +30T,19900,19900,0
2018-06-01,163199540,L012010,면도기,도매 일회용면도기 도루코면도기 페이스4 페이스6,13500,13500,0
2018-06-01,539902566,C012060,여자내의,[대구백화점 II관] [NII]여 폴리카치온 밴딩 슬랙스팬츠(NNYDLUM2511),39920,33940,-5980
2018-06-01,1261949714,C015040,장갑,스마트터치 모직 리본 여성장갑 캐주얼장갑 패션장갑,20590,20590,0
2018-06-01,1291042224,C012030,여자상의,nn66 스트랩 베이직 린넨원피스 - 네이비 원피스 여성,33640,33640,0
2018-06-01,1966829349,A012030,돼지고기,정직한 벌집삼겹살 500g 진짜 다이아몬드 칼집,5500,5500,0
2018-06-01,1701025105,A019140,이유식,엘빈즈 클래식 유아식 아기국(만 12개월이상)/ 엘빈즈,3480,3170,-310
2018-06-01,1476013360,E011070,식탁,기본형 대리석 네이비 홈바 아일랜드식탁 조리대 주방,220000,220000,0
2018-06-01,984425608,A013140,북어채,동해안 건오징어(마리) 70G,6990,6990,0
2018-06-01,2104239127,C013030,스웨터,민자 목폴라 니트 MRO반폴라니트 목폴라목폴라폴라티,48660,48660,0
2018-06-01,989907278,A017300,미역,광천 돌자반볶음 50G*2,4990,3990,-1000
2018-06-01,752050153,A018010,초콜릿,커피레인]선인 퐁듀타임 초콜릿2kg/초코퐁듀/초콜렛/초콜릿분수대/홈베이킹재료/빵/가,15900,15900,0
2018-06-01,1444474430,L012060,샴푸,[천연 샴푸&린스]유아+비듬+탈모+화장품+두피케어,20000,13800,-6200
2018-06-01,1146318895,A018060,스낵과자,우마이봉 15개 /치즈맛 콘포타지맛 멘타이맛 초코맛,3000,3000,0
2018-06-01,349580747,C012030,여자상의,[무료배송]DRM1264 미들 단 롱 니트 802 롱니트 여성,41790,41790,0
2018-06-01,989138482,A019110,드레싱,풀무원 오리엔탈드레싱 240G,3980,3980,0
2018-06-01,38041589,A017220,양파,무배 베트남 갈린 냉동 카사바 그라인디드 분쇄 500g,10990,10990,0
2018-06-01,1233631904,C013030,스웨터,폴라티 반팔 MJ7006_7007 마르잔 반팔 폴로티,29370,28790,-580
2018-06-01,271225681,I031010,장난감,(스플래쉬대셔) 오징어 가정용물놀이완구 물놀이장난,24130,24130,0
2018-06-01,1884833298,I031040,생화,초대형 2층8각 꺽임 파라솔 + 받침대세트 이중송풍구,26700,22910,-3790
2018-06-01,1426882063,I031010,장난감,Step2 멜로디 지붕차 유아용완구 자동차완구 타는자동,229070,224490,-4580
2018-06-01,565956836,C013040,청바지,[블라키] 아이스데님 여자 2종,39000,39000,0
2018-06-01,443574832,A011180,파스타면,스파게티(8번 디벨라 500g)X24,52150,52150,0
2018-06-01,1600560784,C011030,남자학생복,[더셔츠스튜디오]더셔츠스튜디오 봄신상 남성 긴팔셔츠 슬림라인 12종 택1 TD54S55015,19000,18620,-380
2018-06-01,1458461879,A021020,차,대상 카페시럽 1.5L x2 + 시럽펌프 x2,9890,9300,-590
2018-06-01,1010261191,A014030,치즈,매일 슈레드치즈(체다&모짜) 210G,5990,4890,-1100
2018-06-01,478763616,C021040,실내화,[아디다스 퍼포먼스][UNISEX ORIGINALS]스탠스미스 컴포트 CQ2632,71400,60690,-10710
2018-06-01,1281012514,A019090,카레,청정원카레여왕 토마토&치킨 (160g x 10개),20000,20000,0
2018-06-01,635500970,C011050,남자내의,밀리터리반바지/카고/군인/미군/아웃도어/해변/캠핑,26900,26900,0
2018-06-01,989163428,A011170,떡,[풀무원]풀무원 말랑밀 국물떡볶이 423.5G,4700,4700,0
2018-06-01,956669013,A018060,스낵과자,[롯데]롯데 오잉 (75G),1250,990,-260
2018-06-01,977482731,E031070,에어컨,미룸 벽걸이선풍기 MF-16WHD 업소용 가정용 선풍기,30000,28310,-1690
2018-06-01,1182617994,L021020,장신구,바하 반지 - 라피스 GP-RG-BJLG-LAP/ 모니카비나더(주얼리),218000,196200,-21800
2018-06-01,2060139958,L012090,기초화장품,비비프로그램/프림로즈/메타그린/ 멀티팩 멀티비타민,31000,31000,0
2018-06-01,1308358909,E011040,소파,[보니애가구]타미 패브릭 3인용 오토만 소파,212570,203730,-8840
2018-06-01,506868595,A013140,북어채,손으로 찢어 간편한손질먹태 먹태채 3900원부터,3300,3300,0
2018-06-01,2144520310,C011030,남자학생복,[탑보이] 심플 린넨 헨리넥 루즈핏 반팔셔츠 (TR675),15800,15800,0
2018-06-01,317031702,C014010,아동복,[탑텐키즈]남아 코튼 린넨체크셔츠(MKX2WC5102)(하남점),14900,13300,-1600
2018-06-01,1718195401,E061020,섬유유연제,(FC 베이비전용 섬유유연제 bottle)베이비전용 아기세,20380,19980,-400
2018-06-01,1000829149,A019180,즉석식품,(신송/즉석국/된장국)5개입x2박스 총10인분/컵국,5000,4900,-100
2018-06-01,1590598613,E011060,의자,[룸앤홈] 식탁의자 12종/원목의자 원목식탁의자 식탁,29900,26900,-3000
2018-06-01,1991019898,A018080,설탕,(무배/박스포장)큐원 백설 하얀설탕 15kg 갈색설탕,16500,16500,0
2018-06-01,1541398645,C013010,점퍼,[웰메이드]웰메이드[인디안모드] 18여름 캐주얼점퍼 집업점퍼 바람막이점퍼 [MIGCLTM3,140000,116200,-23800
2018-06-01,1604599762,C012040,여자학생복,[부루앤쥬디]자수 가디건(WOKE3CD001),19900,19670,-230
2018-06-01,1834067269,C013010,점퍼,[빅브라더]빅사이즈야상/패딩/다운/바람막이/라이더,76670,76670,0
2018-06-01,29215337,F012020,생리대,[엘리스]생리대 5팩 순수감촉 라이너 오버나이트,9700,9700,0
2018-06-01,366434870,A015020,식용유,코코엘 오가닉 엑스트라버진 코코넛오일 (500ml*4병),39000,39000,0
2018-06-01,1994523377,A019130,스프,일본 미소라면소스 (유타카 1.8L) X6,190270,169350,-20920
2018-06-01,135133519,A011160,빵,[삼립/샤니] 빵 종류별 10개/간식/단팥/크림/슈크림,9000,9000,0
2018-06-01,1667202040,E011040,소파,베로 원목 가죽 4인용 소파/쇼파,489000,489000,0
2018-06-01,2068309251,C012060,여자내의,빅사이즈/밴딩/망사/롱/스커트 / 참고 밴딩망사롱스커,44300,38990,-5310
2018-06-01,1764069793,I011030,사진기,캐논 정품 EOS 80D + 18-135mm IS STM+가이드북 명품,1500570,1380440,-120130
2018-06-01,2006306462,C012020,원피스,[모다아울렛][제이제이지고트]오버체크코트2gi3a0jkj1,271200,244080,-27120
2018-06-01,896542187,A022020,두유,파스퇴르 검은콩 검은참깨 칼슘두유 (190ML*16입),16800,8990,-7810
2018-06-01,1798558361,A019060,된장,[윈지마켓]s105949_001 된장지함 재래식 신송 14Kg X 1 된장찌개 식재료 소스 된장 장,42990,38700,-4290
2018-06-01,1774915850,F011130,홍삼,굿베이스 홍삼담은 자연석류(50ML*30입),47700,47700,0
2018-06-01,2019168007,E061080,키친타월,크린랩 빨아쓰는행주20매x3개 무료배송 키친타올,10900,10900,0
2018-06-01,958658283,F012020,생리대,[유한킴벌리]유한킴벌리 좋은느낌 오가닉 코튼커버 소형 날개형(18P),6500,6500,0
2018-06-01,353808493,E011050,책상,(미니 칼라 포밍테이블) 공부/학원/사무용 책상/식탁,35000,34300,-700
2018-06-01,276826206,C011050,남자내의,GNN871 총알스판남자스키니청바지 남성스키니진 남자,48670,48670,0
2018-06-01,1779604461,E011030,거실장,[채우리] 펜디 패브릭 3인용 소파,1190000,1190000,0
2018-06-01,1779604462,E011030,거실장,[채우리] 디오 3인 소파베드,200000,200000,0
2018-06-01,1779604463,E011030,거실장,[채우리] 로렌 패브릭 3인 소파베드,300000,300000,0
2018-06-01,279060252,L021020,장신구,3+1 써지컬스틸 귀걸이 귀찌 피어싱/패션 남자 여자,5000,4900,-100
2018-06-01,985294380,A017180,호박,(유기농)가지(봉),3490,3490,0
2018-06-01,169646524,F012010,종이기저귀,킨도 독일 프리미엄 기저귀 밴드/팬티/슬림,39900,39900,0
2018-06-01,1609298177,C015020,모자,메쉬모자/야구모자/매쉬 캡/낚시모자/등산모자/여름,3600,3600,0
2018-06-01,1525410402,A015010,참기름,[ 간장/참기름] 참깨/참기름 1.8L 모음/네슬레 매기,7000,7000,0
2018-06-01,971655235,A016090,참외,[농협]산지직송 아삭달콤 성주참외 꿀참외 2kg-10kg,10900,10900,0
2018-06-01,1233014092,F012020,생리대,예지미인 울트라슬림 날개 대형 16개입 x 40,179040,159350,-19690
2018-06-01,1084633544,C011020,남자상의,봄신상 S~3XL 9부/10부/밴딩/기능성 슬랙스 기획전,15900,15900,0
2018-06-01,2056555247,C011020,남자상의,체크 밍크털 코트 남성코트 퍼코트 털코트 캐쥬얼코트,111770,111770,0
2018-06-01,1092976311,A017110,감자,쥬스용 제주당근 햇당근 못난이(최상품),13900,13900,0
2018-06-01,1681020156,E041070,밀폐용기,캠핑양념통 캠핑컵 바베큐꼬치 소주잔캠핑물컵 스텐컵,4900,4510,-390
2018-06-01,897991916,C013050,운동복,[클릭앤미]세상 편해~여름신상 트레이닝세트/,5900,5900,0
2018-06-01,480114138,I011010,TV,[아남TV]COS49U/49인치/UHD LED TV/삼성 정품 패널,399000,399000,0
2018-06-01,1020675134,F011150,건강기능식품,종근당 프리바이오틱스 프락토올리고당(30포),14900,14900,0
2018-06-01,1385852194,A011160,빵,안흥찐빵마을 수제 초코블랙찐빵 500g(10입) 3봉 주전,33660,33660,0
2018-06-01,1015348234,C013010,점퍼,[화이트폭스][화이트폭스]데일리오버핏라이더자켓,45000,40950,-4050
2018-06-01,1426164913,A019170,냉동식품,동원 개성왕만두 3종 감자/왕/김치 3.8kg(2봉),18800,18800,0
2018-06-01,296889578,L021050,우산,스타일이 살아있는 성인우비 판초우의 비옷 판쵸 등산,49900,49900,0
2018-06-01,372534378,C021020,구두,프라다 남성 드라이빙슈즈/로퍼 2DD131 MGV 모음전,524000,457040,-66960
2018-06-01,1179469333,E061010,세탁세제,EM-1 원액(발효원액)500ml-이엠 다목적 친환경 세제,5050,4950,-100
2018-06-01,427176039,L021010,손목시계,40%OFF 보이런던/정품/손목시계/명품시계/패션시계,39900,39900,0
2018-06-01,898508339,E061050,청소용세제,[LG]홈스타 착붙는 락스 스프레이(480ML),4380,3000,-1380
2018-06-01,1720521632,F011150,건강기능식품,동화약품 부채표 까스 활 액 75ml 20병 소화제,16450,16450,0
2018-06-01,174495323,E021010,침구,[슈에뜨룸]사계절 이불토퍼세트/요세트/차렵이불세트,53800,49900,-3900
2018-06-01,395695637,E061020,섬유유연제,샤프란 섬유유연제 시트 50매 x 3개,13900,13900,0
2018-06-01,1109785324,C014010,아동복,아둘 가족티 쥬니어 커플룩 단가라 스누피 티셔츠 28,11100,11100,0
2018-06-01,1881325179,C021040,실내화,[호보켄]여름필수템 모음!호보켄 우븐/EVA샌들/아쿠아,19000,19000,0
2018-06-01,1080081719,C013040,청바지,[뱅뱅]여성 스키니핏 청반바지 LQE507,19900,18310,-1590
2018-06-01,1928827004,L021060,유모차,타이니러브 메도우데이즈 써니스트롤,24410,24410,0
2018-06-01,267352165,A012050,소시지,[캠핑필수템]쟌슨빌 소시지 2종/1810g(약 27개입),27900,27900,0
2018-06-01,127693797,C012060,여자내의,허리 버튼 랩스타일 와이드 팬츠 (BMPAC2241)/ 베스띠벨리,35900,35900,0
2018-06-01,1239139486,C013010,점퍼,여성 후드 롱자켓 KK 버켄훌 CT 여성롱자켓 여자후드,83830,83830,0
2018-06-01,594684178,A014030,치즈,(한정특가) 썬리취 피자치즈 1kg (소스공짜)/모짜렐라,12000,10800,-1200
2018-06-01,83418286,A017230,마늘,빛고을장터 2018년 무안 자색양파 3/5/10kg 내외,6190,6190,0
2018-06-01,341718903,C012040,여자학생복,[모다아울렛][비키]브이넥 프릴 플라워 블라우스_TUBAE9439-옐로우,97300,86600,-10700
2018-06-01,1898194090,L021030,가방,[비비안/피에르가르뎅] 80데니아 팬티스타킹(타이즈) 5족//레깅스 5족 [국산][발목/카,20300,19800,-500
2018-06-01,481451203,C012040,여자학생복,W 기비키이스 주리 gbm97f7,129000,129000,0
2018-06-01,988149455,A021010,커피,[동서]동서 카누미니 다크로스트 아메리카노 150T,26980,24990,-1990
2018-06-01,988149456,A021010,커피,[동서]동서 카누미니 마일드로스트 아메리카노 150T,26980,24990,-1990
2018-06-01,534406552,E061040,부엌용세제,[무궁화] 오클린 주방세제 1.2L(리필)x4개,10900,10900,0
2018-06-01,433182866,C013050,운동복,자동차파워핸들 파워봉 핸들손잡이 차량 보조핸들봉,6480,5970,-510
2018-06-01,817444181,C012030,여자상의,썬샤인 전상품할인_원피스/롱원피스/여름/신상/사계절,10900,10900,0
2018-06-01,1496917875,F011150,건강기능식품,옛날미숫가루 3kg(1kgx3팩)43곡/까망콩/간편간식/선식,8900,8900,0
2018-06-01,539170834,C011020,남자상의,[무료배송]아이보리 체크 밍크털 코트 코트 캐쥬얼코,103720,103720,0
2018-06-01,828645664,A021010,커피,까페리얼 1.5Lx12병/헤이즐넛/아메리카노/아이스커피,25900,25900,0
2018-06-01,303490133,A017020,상추,모듬 쌈채소 1kg 골라담기,11200,11200,0
2018-06-01,152155190,A013090,전복,인풍 (겉)홍합 1kg2개,23850,23850,0
2018-06-01,717846716,C013010,점퍼,[모다아울렛][비지트인뉴욕][비지트인뉴욕][순천모다]옆트임 항공점퍼[VU3JP11],143100,135950,-7150
2018-06-01,2018772437,F012010,종이기저귀,하기스 네이처메이드 팬티 기저귀 3∼6단계 x2팩,51900,51900,0
2018-06-01,1659093863,C013020,티셔츠,정품 언더아머 풋조이 골프웨어/빅사이즈/pk티셔츠,42900,38190,-4710
2018-06-01,1760664044,C013020,티셔츠,빅사이즈 2XL.4XL후라이스(골지) 기본 라운드/프린트,7900,7900,0
2018-06-01,1416539740,E061060,살충제,최저가판매/바퀴벌레약/맥스포스셀렉트겔/개미약 퀀텀,12500,2500,-10000
2018-06-01,838661197,E061020,섬유유연제,(FC 베이비전용 섬유유연제 bottle) 유아유연제 아기,21190,21190,0
2018-06-01,582391455,C013020,티셔츠,플라워자수크롭티/레이어드/망사티/레이스티/시스루티,7900,7900,0
2018-06-01,306625962,C011020,남자상의,여름/국내생산/95~110사이즈/정장자켓/콤비자켓,59000,59000,0
2018-06-01,1094207821,A019110,드레싱,오타후쿠 오꼬노미 소스 300g,4800,4800,0
2018-06-01,1094207827,A019060,된장,아와세 미소 된장(봉지) 1kg,5400,5400,0
2018-06-01,1094207826,A019060,된장,아와세 컵미소 된장 1kg,8000,8000,0
2018-06-01,1094207825,A019060,된장,마루산 고시고우지 미소된장 1kg,5400,5400,0
2018-06-01,1779604464,E011030,거실장,[채우리] 레오나 PU가죽 3인용 소파,380000,380000,0
2018-06-01,1779604465,E011030,거실장,[채우리] 크라운 PU가죽 3인용 소파,490000,490000,0
2018-06-01,391246805,C013020,티셔츠,유유존-브이넥/프린트-티셔츠모음/클럽섹시타이트,16800,16800,0
2018-06-01,1779604466,E011030,거실장,[채우리] 알렉스 패브릭 3인용 소파,1740000,1740000,0
2018-06-01,1779604467,E011030,거실장,[채우리] 폰테 패브릭 3인용 소파 + 스툴,440000,440000,0
2018-06-01,1711071925,I031040,생화,(NEW)캠핑 도끼 손도끼 우레탄도끼 망치 장작 톱,11900,11900,0
2018-06-01,1779604468,E011030,거실장,[채우리] 베로 패브릭 3인용 소파 + 스툴,2120000,2120000,0
2018-06-01,1944470583,C015030,넥타이,넥타이 커프스 넥타이핀 선물세트 남성 정장 자동타이,8200,8200,0
2018-06-01,485035690,C013050,운동복,프론트 리어 범퍼 가드 보호대 몰딩 화이트 범퍼 범퍼,21850,19910,-1940
2018-06-01,1255907602,C012040,여자학생복,[ab.f.z][18S/S]롱여름가디건AFS2GY21[갤러리아],29000,24650,-4350
2018-06-01,1192370192,E021010,침구,26900원~국내산 고급 시어서커 여름이불/베게침구세트,53800,53800,0
2018-06-01,1650976335,F012050,의료측정기,맥시마 혈당계+채혈기+시험지10매+멸균침10개,5000,1000,-4000
2018-06-01,142607990,A017280,김,무맛나쌈무(와사비맛)4kg/민속,7680,7680,0
2018-06-01,1842733209,E011030,거실장,클래식거실장/TV다이/티비다이/tv장/tv받침대,60000,59000,-1000
2018-06-01,1775038702,F011130,홍삼,정관장 홍삼타브렛(90G),42000,42000,0
2018-06-01,2095520650,I031040,생화,Kershaw 커쇼 나이프 공식수입 Jens 카라비너 Blue,15000,13430,-1570
2018-06-01,1253234321,A012010,국산쇠고기,[주인의 食] 드라이에이징 한우 등심/채끝 200g,21900,21900,0
2018-06-01,66144432,C013040,청바지,[키키제제]여아 청바지/7.5부/스키니/면바지/반바지,10900,10900,0
2018-06-01,816178226,E031030,전자레인지,[SK매직] 모던 클래식 전자레인지 MWO-17M1,63720,59900,-3820
2018-06-01,722908543,I012060,저장장치,ABKO HACKER K640T (청축/갈축/적축) 축교환 텐키리스,36060,33900,-2160
2018-06-01,78644752,A019160,밑반찬,코다노 자연산99 모짜렐라치즈 2.5kg /피자치즈/연성/,24200,23000,-1200
2018-06-01,1541398678,C013010,점퍼,[웰메이드]웰메이드[인디안모드] 17여름 캐주얼점퍼 집업점퍼 바람막이점퍼 [MIGCLTM3,99500,82590,-16910
2018-06-01,191349413,A012050,소시지,천하장사 더블링 16개 x 1통 소세지,15900,15900,0
2018-06-01,1208659122,C013050,운동복,모비스 크루저 루프백 모비스 자동차용품 내장 외장,236240,213000,-23240
2018-06-01,1531570452,A022050,탄산음료,사이다 190mlx30캔 코카콜라 팹시 맥콜 캔커피 음료수,10900,10900,0
2018-06-01,391246810,C012020,원피스,유유존-미니원피스/클럽의상/섹시홀복/쉬폰/나시/탑롱,15800,15800,0
2018-06-01,136927747,C014010,아동복,아동셔츠/ 아동남방/ 아동 스트라이프 셔츠/ 아동 스트라이프 남방/ 줄무늬 셔츠/줄무,21800,21800,0
2018-06-01,1259697854,L021060,유모차,신상품 엘레니어 윙스S 에스 포시즌 4시즌 양대면,224000,224000,0
2018-06-01,1614928513,E031120,믹서,명절음식준비 대용량 야채다지기 고기다지기 마늘박피,78000,58000,-20000
2018-06-01,1094207829,A019110,드레싱,불독 돈까스 소스 300ml,3900,3900,0
2018-06-01,2015707099,A018030,껌,벨라민츠 스피아민트 무설탕 껌 40g x 8개 /코스트코,15770,15770,0
2018-06-01,433613320,E041020,컵,보르미올리 정품 이태리 직수입/커피잔/카푸치노잔/에스프레소잔/머그잔/찻잔/물잔/컵,3600,3500,-100
2018-06-01,895805228,L012030,칫솔,애경 2080센서티브 2단 미세모 3+3입,6990,6990,0
2018-06-01,1572463242,C012040,여자학생복,프린트쉬폰블라우스(715-84571)/ 오조크,45000,38250,-6750
2018-06-01,743777032,C011050,남자내의,여름신상 남성 면바지 슬랙스 일자 사방스판 허리밴딩,17800,17800,0
2018-06-01,1242841535,A019140,이유식,맘마밀안심이유식6개월/9개월/12개월(100gX1팩)11종류,1790,1790,0
2018-06-01,342634560,F012020,생리대,[쏘피] 안심숙면팬티 L 5P×2팩+사은품(한결중형10P×1팩)/ 바디피트,16900,16900,0
2018-06-01,745537427,C012020,원피스,빅사이즈/루즈/니트/롱/베스트 빅사이즈,46530,44670,-1860
2018-06-01,990030100,L012080,화장지,Onlyprice)천연펄프미용티슈240매*3입,3000,3000,0
2018-06-01,990030101,E061080,키친타월,Onlyprice)천연펄프키친타올180매*4롤,3000,3000,0
2018-06-01,895771371,A019080,고추장,[대상]청정원 순창 태양초 매운 고추장(500g),9600,8990,-610
2018-06-01,628325087,I031040,생화,야전침대 특대형 접이식 간이침대 캠핑 낚시 침대의자,23900,21280,-2620
2018-06-01,475988305,C013010,점퍼,[무료배송]오버사이즈 롱 야상 YSM03 WS 야상점퍼 야,133010,133010,0
2018-06-01,1576469941,F012010,종이기저귀,팸퍼스 스와들러 신생아 기저귀 N단계  1단계 20P,10300,10300,0
2018-06-01,1081127499,C013050,운동복,[어반비]여성요가복 필라테스 트레이닝운동복,20800,16900,-3900
2018-06-01,900131560,A019080,고추장,청정원 태양초 고추장(500G),5980,5980,0
2018-06-01,451120698,A019100,식초,오뚜기 식당용케찹(뚜껑팩)3.3kg2개 케찹 식당용케찹,18710,16840,-1870
2018-06-01,991180893,I031040,생화,초경량 듀랄루민 미니 테이블/캠핑/등산/접이식/소형,19000,17310,-1690
2018-06-01,1597145644,F011130,홍삼,굿베이스 홍삼선물세트 감사(SET),43200,43200,0
2018-06-01,1395403763,C013030,스웨터,다이아 롱니트 여성티셔츠DM-5243,49800,47310,-2490
2018-06-01,878868536,A019060,된장,ⓒ 해찬들 그대로 끓여먹는 찌개된장(450G),5750,5750,0
2018-06-01,1746873505,L021060,유모차,맘네스트 싸이벡스 프리암 전용 유모차 4계절 커버,55660,55660,0
2018-06-01,1011152042,L012110,색조화장품,참존화장품 알바트로스 파우더선 뽀송한 선크림 70ml,35000,14000,-21000
2018-06-01,566656999,A018020,사탕,[인기사탕100가지]사탕초콜릿/키티사탕롤앤롤/쥬얼리손바닥사탕/막대사탕허쉬키세스마,3000,3000,0
2018-06-01,674307696,A019180,즉석식품,빅마마 이혜정 특제소스 스테이크 폭립 LA갈비 소갈비,19000,19000,0
2018-06-01,1981107812,I031070,애완동물관리비,이갈이 스포츠 형상기억 마우스피스 마우스가드 1+1,11400,11400,0
2018-06-01,603876393,F012010,종이기저귀,[마미포코] 마미포코 쿨썸머그린 팬티기저귀 대형 남아 34매x3팩,36900,36900,0
2018-06-01,932559718,C013020,티셔츠,데일리걸 봄신상 무지티 레이스 입술넥 단추 오프숄더,12900,12900,0
2018-06-01,1500972465,L012030,칫솔,래디어스토츠/토츠플러스/퓨어베이비6종 랜덤,20500,20500,0
2018-06-01,1701870571,F012020,생리대,템포 30P~80P/레귤러 슈퍼 체내형 생리대 /2018신형,11500,11500,0
2018-06-01,1423519692,C013030,스웨터,여름신상 니트 남자 남성 브이넥 V넥 집업 무지 커플,15800,15800,0
2018-06-01,772904799,A013030,조기,[해울림] 영광 굴비 세트/법성포 참 조기/선물 셋트/명절 명품/,349900,349900,0
2018-06-01,521132359,L012110,색조화장품,싸이닉 [1+1] 엔조이 워터프루프 썬크림 SPF50+ PA++++ /,30000,15000,-15000
2018-06-01,1491471857,C013040,청바지,여름 주니어 아동 청바지 면바지 스키니진 칠부바지,19800,19800,0
2018-06-01,1820156388,C012040,여자학생복,총110종 반팔 긴팔 롱 배색 유니폼 기본셔츠 롱블라우스 스트라이프 교복셔츠 여자셔츠,12800,12800,0
2018-06-01,1437528262,A011140,부침가루,백설 컵케익 (쵸코) 55g x 12,19520,19520,0
2018-06-01,393057917,A019040,소금,돈까스소스(에스비 1.8K)X10 돈까스 돈까스소스 식자,61650,55490,-6160
2018-06-01,1619029815,C013010,점퍼,무스탕 라이더 가죽자켓 WS_PU_08 무스탕 패딩자켓 가죽 가죽자켓 무스탕 라이더자켓,227190,202200,-24990
2018-06-01,895830216,F012020,생리대,[LG]LG 쏘피 바디피트 울 (날개형/대/32P),11500,11500,0
2018-06-01,44766128,C011030,남자학생복,[헤리토리][헤리토리(HERITORY)](남성)무지심플포켓베스트_HMAQCPM3311_56,17900,17010,-890
2018-06-01,2105326350,C011050,남자내의,28~40사이즈 신상특가 면반바지/카고/청반바지/남자,15800,15800,0
2018-06-01,323840520,C013040,청바지,JMM8850 블랙워싱남자슬림일자스판바지 빅사이즈청바,30770,30770,0
2018-06-01,1492538019,A012010,국산쇠고기,[무항생제] 안심 300g 2등급,30300,30300,0
2018-06-01,2000028906,C014020,유아복,아둘 가족티 유아 옐로우 페미니스트 반팔티 11,9600,9500,-100
2018-06-01,285425222,A011020,현미,혼합찹쌀가루 (초야 300g) X25,49420,43990,-5430
2018-06-01,630916616,L021030,가방,리바케이스 8365 (블랙)/17.3인치 노트북가방/백팩,89000,87220,-1780
2018-06-01,18339052,C011050,남자내의,시원한 여름 쿨 슬랙스/팬츠 특가전 28~40size까지,17900,17900,0
2018-06-01,1237081453,C013030,스웨터,7부단가라니트(RMD_1603) 빅사이즈 큰옷티셔츠 라운드,17990,17990,0
2018-06-01,1173958353,I011020,영상음향기기,인기만점 비비텍 DX281ST 밝기3000 단초점 빔프로젝터,749000,699000,-50000
2018-06-01,1088347601,I012060,저장장치,[앱코] 단독특가 ABKO K770 카일 광축 완전방수 기계식키보드,39900,39900,0
2018-06-01,395644039,A018030,껌,롯데 졸음올때 씹는 껌 5통 (250정)/졸음껌/자일리톨,14500,14500,0
2018-06-01,562209949,C013010,점퍼,남아  여아 아우터 모음 - 100여종 - 패딩.점퍼.다운.코트.밍크.조끼.......다양한 디,19900,19900,0
2018-06-01,687401532,E061100,습기제거제,[이연 야자활성탄1kg]천연가습기/공기정화/애완견냄새/새집증후군//곰팡이억제/제습제,10000,9900,-100
2018-06-01,622947142,C011050,남자내의,카고팬츠/반스키니/슬렉스/남자청바지/롤업팬츠,26000,26000,0
2018-06-01,1436035179,I031040,생화,코멕스 아이스박스30L/블루 레드/쿨러 아이스탱크,48000,48000,0
2018-06-01,2000028914,C014020,유아복,아둘 가족티 유아 옐로우 페미니스트 반팔티 12,9600,9500,-100
2018-06-01,1482039124,E061100,습기제거제,물먹는 제습제/3팩 6개/옷장용/참숯옷장/중 선택,19800,19800,0
2018-06-01,336030349,C012060,여자내의,데님팬츠 핫팬츠 PT1293-컷팅 절개 숏 팬츠 빈티지진,18490,18490,0
2018-06-01,1225059165,C011050,남자내의,여름트레이닝복 팬츠/반바지/7부바지/나시/빅사이즈,8900,8900,0
2018-06-01,1560769265,A019070,양념소스,중국정통 샤브샤브소스 샤브샤브육수 마라샹궈 마라탕,3000,3000,0
2018-06-01,548427443,C013010,점퍼,[홈런]바람막이점퍼/자켓/블루종/야상/등산/남성/남자,19800,19800,0
2018-06-01,1593718470,A011010,쌀,[김포금쌀] 온참 신김포농협_5000전통 김포쌀_쌀20kg/햅쌀,53900,53900,0
2018-06-01,1064887681,E031080,선풍기,유니맥스_2구 욕실 램프히터 UMH-6021B,41900,41900,0
2018-06-01,693790553,C011030,남자학생복,여름 7부 리넨 셔츠 남성 편안한 케쥬얼남방 40여종,16800,15800,-1000
2018-06-01,1064887683,E031080,선풍기,유니맥스_3구 욕실 램프히터 UMH-6031B,54900,54900,0
2018-06-01,1064887682,E031080,선풍기,유니맥스_2구 욕실 램프히터 UMH-6022BS (시력보호형),45900,45900,0
2018-06-01,1200139657,C012040,여자학생복,[나인스텝](18 S/S) 린넨마블소매프릴 불라우스 A18SH8222[갤러리아],29000,24940,-4060
2018-06-01,993336943,C014010,아동복,[푸마 윌슨]반팔 반바지 트레이닝 상하세트 후드짚업,13800,13800,0
2018-06-01,959405071,F012010,종이기저귀,하기스 매직팬티 6단계 여아용 (28P),23650,13900,-9750
2018-06-01,1011127058,L021050,우산,Kakao슬림텀블러(KASLIM-R),19800,19800,0
2018-06-01,1064887684,E031080,선풍기,유니맥스_3구 욕실 램프히터 UMH-6032BS (시력보호형),60100,60100,0
2018-06-01,113493697,E031010,전기밥솥,CRP-FA0621MR/쿠쿠/6인용/압력/LED/GH,99000,90350,-8650
2018-06-01,1195263150,C013010,점퍼,[펠틱스][펠틱스] 퍼 점퍼 FEPDMJP02_BK_1,20900,19860,-1040
2018-06-01,501972014,C011020,남자상의,투앤영/한정수량 초특가 무료배송/노턱 정장바지 팬츠,29800,19800,-10000
2018-06-01,985870562,F012010,종이기저귀,[Genki]프리미엄 소프트 겐키 기저귀 팬티/테입 2+1,29500,29500,0
2018-06-01,1141096098,F011150,건강기능식품,[BYO] CJ(냉장) BYO 피부유산균 2.5g X 30포 1개월(30일)분,21600,21600,0
2018-06-01,1350697373,E011020,침대,아리아퍼니쳐 메탈/철제 퀸 침대/침대프레임 BEST,133900,133900,0
2018-06-01,338029403,A017200,토마토,싱싱한 가지5kg(1박스) 알뜰쇼핑가격,22500,22500,0
2018-06-01,98083938,E031110,청소기,[고급형!!]-휘넥스 핸디형 스팀청소기 FX-7100 NEW,19800,19800,0
2018-06-01,469720199,E041010,식기,황금/풍수/지리/인테리어/소품/닭/부부금실/금전대박,165000,161700,-3300
2018-06-01,1998923204,A016150,아몬드,팜앤팜 믹스너트 블루 지퍼형 2kg 간식 견과류,12900,12900,0
2018-06-01,463618255,C011020,남자상의,블랙 체크 밍크털 코트 캐쥬얼코트 남자코트 남성털코,111770,111770,0
2018-06-01,2068334238,C013010,점퍼,(SR)MHA331 빅사이즈이중카라시보리점퍼 / 참고 점퍼,86500,76120,-10380
2018-06-01,895805285,A011070,혼식곡,CJ 백설 밀가루 2.5kg (중력1등급),3750,3750,0
2018-06-01,895805286,A011070,혼식곡,[CJ]CJ 찰밀가루 1KG,2150,2150,0
2018-06-01,836551006,E031010,전기밥솥,CRP-HQXB0310FP/쿠쿠/IH압력/3인용/음성/GH,184800,169930,-14870
2018-06-01,895805289,A011070,혼식곡,[CJ]CJ 찰밀가루 2.5KG,4650,4650,0
2018-06-01,895746388,A013170,생선통조림,[동원]동원 김치찌개참치 250g,3650,3650,0
2018-06-01,895805287,A011070,혼식곡,[CJ]CJ 백설 과자용 밀가루 1kg,1690,1690,0
2018-06-01,895746387,A013170,생선통조림,[동원]동원 자연산 골뱅이 400g,8990,6990,-2000
2018-06-01,895805288,A011070,혼식곡,[CJ]CJ 백설 밀가루 1kg (중력1등급),1680,1680,0
2018-06-01,777029201,A013060,게,손질 오징어 4kg내외 국산 냉동,52000,52000,0
2018-06-01,955888656,A018040,아이스크림,찰떡 국화빵 (10개),12000,7000,-5000
2018-06-01,955888657,A018040,아이스크림,깐도리 바 (10개),12000,4500,-7500
2018-06-01,895746385,A013170,생선통조림,[동원]동원 고추참치 100g*3입,6150,6150,0
2018-06-01,990029138,A022020,두유,정식품 뼈에좋은칼슘검은콩(파) 190ML*20입,19800,11200,-8600
2018-06-01,921422979,A011090,국수,농심 안성탕면 40봉/너구리/물냉면/육개장사발면,22760,22760,0
2018-06-01,1833305007,C012040,여자학생복,조이너스(JOINUS) 썸머 쉬폰 베스트 + 이지핏 팬츠(총2종),59900,56910,-2990
2018-06-01,1147079713,I031040,생화,미르랜턴/충전식LED랜턴 손전등 후레쉬 자전거라이트,16800,15460,-1340
2018-06-01,895746390,A013170,생선통조림,[동원]동원 꽁치 (400g),3290,3290,0
2018-06-01,1303222665,C013030,스웨터,민자 목폴라 니트 MRO반폴라니트 목폴라목폴라폴라티,48660,48660,0
2018-06-01,124353468,C012060,여자내의,[TEZUKA] 아톰 데님 미니 스커트,31900,16900,-15000
2018-06-01,415902868,C015020,모자,볼캡 스냅백 야구모자 라인볼캡 모자 모자 패션모자,15450,15150,-300
2018-06-01,713880473,A014050,달걀,금강초계 청란)청계알/청계란/유정란/푸른달걀/청계,31900,31900,0
2018-06-01,1049704111,C012030,여자상의,KD 아그네 투피스 SET 투피스,86150,84430,-1720
2018-06-01,300573565,C012040,여자학생복,[카라]KARRA 버티컬린넨로브가디건_KBI6CD201A,50800,48260,-2540
2018-06-01,536433834,C013020,티셔츠,[예쎄] 여름을 위한 코디 신상 BEST 블라우스/티셔츠,9900,9900,0
2018-06-01,1395403700,C013010,점퍼,엘리자 테일러드 롱자켓 여성쟈켓 DM-5082,92000,87400,-4600
2018-06-01,2015406316,A019070,양념소스,국산 만능양념장 구이 두루치기 조림 찌개 전골 양념,16500,16500,0
2018-06-01,1171547060,E021020,커튼,/벌집블라인드 그레이 호프발스 120x155 cm/ 롤스크린,63870,56850,-7020
2018-06-01,1635173753,I011020,영상음향기기,비비텍 DX56A 밝기4500 흑판모드 빔프로젝터 프로젝트,750000,630000,-120000
2018-06-01,117890418,A013050,오징어,꽁치캔(펭귄400g)X24/꽁치 통조림 간식 가공식품 식당,60510,60510,0
2018-06-01,1011127086,G022010,자동차용품,Kakao고무키링(KAKR-A2),5000,5000,0
2018-06-01,266615213,A017300,미역,[광천김본사 직송] 달인 삼각김밥김 100매(50매X2봉),14900,14900,0
2018-06-01,1733600718,C013050,운동복,차량용 사이드컵홀더/사이드포켓/트렁크정리함/테이블,2400,2210,-190
2018-06-01,1755891441,E021010,침구,[슈에뜨룸]리플침구세트/인견/시어서커/여름이불세트,28900,25900,-3000
2018-06-01,1179651238,E061040,부엌용세제,대용량울트라 조이 고농축주방세제레몬향2.66L /퐁퐁,10490,10490,0
2018-06-01,2051062841,C011030,남자학생복,[예작셔츠]남성 반소매 셔츠 YJ8MBS204 26종 택1,30000,23700,-6300
2018-06-01,539324557,C012040,여자학생복,세련된 스트라이프 셔츠 블라우스(GI6N0BL79 GI4N0BL56)[예약상품 2018.06.01 부터 발,25000,20750,-4250
2018-06-01,1258199061,L021010,손목시계,라마데스 손목시계 남성시계 메탈시계 남자시계,27900,27900,0
2018-06-01,451083153,A015020,식용유,오뚜기 식용유(대두유)1.8L2개 식용유 오뚜기식용유,23300,20970,-2330
2018-06-01,806199793,E061050,청소용세제,[한정특가] 곰팡이 제거제 젤타입 대용량 220ml 1+1,9360,8900,-460
2018-06-01,257157881,C012020,원피스,[드넬]보이프랜여름자켓DJ81034A,16900,15210,-1690
2018-06-01,1657981467,A019110,드레싱,코리원/유경빈 모밀쯔유/가쓰오풍쯔유 1.8L/간장/메밀,10900,10900,0
2018-06-01,1750048752,E011030,거실장,코지3인소파,439000,439000,0
2018-06-01,2046356181,A016150,아몬드,[기다리던 햇수확]구운아몬드800g /최근직수입/견과류,8900,8900,0
2018-06-01,158090765,A018080,설탕,CJ백설 하얀설탕15kg 백설탕15kg 흰설탕15kg,12500,12500,0
2018-06-01,2139325602,E041010,식기,글라스락 계란찜기 뽀글이/유리용기 전자렌지용기,8900,8190,-710
2018-06-01,444654010,C012020,원피스,투버튼 루즈핏 체크배색 코트(Z174MSG008)/ 쥬크,189000,160650,-28350
2018-06-01,959405047,F012010,종이기저귀,하기스 매직팬티 5단계 남아용 (33P),23650,11900,-11750
2018-06-01,959405046,F012010,종이기저귀,하기스 매직팬티 4단계 여아용 (40P),23650,11900,-11750
2018-06-01,959405045,F012010,종이기저귀,하기스 매직팬티 4단계 남아용 (40P),23650,11900,-11750
2018-06-01,788433564,E011050,책상,삼나무 원목 책상세트/컴퓨터책상/학생책상/서랍 책장,147000,147000,0
2018-06-01,244784140,C011030,남자학생복,ACC(필골드)DB912 데님 스트라이프 면 버튼다운셔츠,37820,37820,0
2018-06-01,375980242,C013040,청바지,[게스진] YI2D4061 여성용 화이트 구제 스키니 팬츠 바지,117600,95260,-22340
2018-06-01,360071814,E061010,세탁세제,무료배송 대용량 수퍼타이 액체세제 14L 세탁 세제,17700,17700,0
2018-06-01,1977861205,E031070,에어컨,듀플렉스 벽걸이선풍기/리모콘형 JY-40WFB/DP-W16RF,18000,18000,0
2018-06-01,959405049,F012010,종이기저귀,하기스 매직팬티 6단계 남아용 (28P),23650,13900,-9750
2018-06-01,768804127,C012040,여자학생복,심플이너프티셔츠 (J11PTT038)/ 매그제이(MAGJAY),19000,17100,-1900
2018-06-01,959405048,F012010,종이기저귀,하기스 매직팬티 5단계 여아용 (33P),23650,11900,-11750
2018-06-01,1792506955,A018070,파이,무료배송/반박스/인기간식/초코파이/카스타드/몽쉘,13900,13900,0
2018-06-01,1220909870,C015020,모자,[오시오] yi 메쉬 군모 야구 모자 종류 선물 볼캡 남자 여성 캡,4900,4900,0
2018-06-01,1212975032,A013130,오징어채,오징어 실채 200g+200g / 오징어채 진미채,14900,14900,0
2018-06-01,1331178026,A019140,이유식,맘마밀 안심이유식 (100gx10EA) 아기죽 미음 아기 밥,18900,18900,0
2018-06-01,1946362896,E061030,전구,금호 번개표 LED형광등/LED등/형광등/LED방등/등기구,17300,17300,0
2018-06-01,862413215,A022010,주스,식자재 양념 음료 차 음료 파낙스 매실 1.5L 양념 파,12970,12970,0
2018-06-01,432362577,C012040,여자학생복,LAP 레이스 브이 블라우스 AJ2WB424,46550,46550,0
2018-06-01,530596116,A018080,설탕,핀란드산 자일리톨 가루 분말 크리스탈 500g 1kg,8900,8900,0
2018-06-01,628517531,C012060,여자내의,압축 기모 레깅스 방한레깅스 남성레깅스 레깅스 기모,13200,13200,0
2018-06-01,529678325,C012060,여자내의,허리조절 스판 베이지 교복치마 교복 예쁜교복 교복쇼,43580,42280,-1300
2018-06-01,1103422830,C013010,점퍼,아디다스 유소년 콘디보16 스타디움자켓 (AB3152 ),151870,135170,-16700
2018-06-01,1738902442,A019170,냉동식품,사조 포자찐만두 180g 6개입 전자레인지용 포자만두,750,750,0
2018-06-01,1125449870,A011180,파스타면,자로티 봉골레 130g 레스토랑봉골레 스파게티재료 요,10760,10760,0
2018-06-01,271046811,A017080,무,톡쏘는 단맛! 생와사비 뿌리 1개/2개 25g,4900,4900,0
2018-06-01,716580479,A017020,상추,반찬단지 간장깻잎 4kg 2개,61470,60250,-1220
2018-06-01,1010346815,A016130,키위,[1+1]명절단독특가]나주햇살품은 신고배세트5kg (10-11과),59000,42000,-17000
2018-06-01,1010346814,A016130,키위,[1+1]명절단독특가]나주햇살품은 신고배세트5kg (8-9과),62000,44000,-18000
2018-06-01,989043399,A014030,치즈,매일 리코타치즈 200G,5500,5500,0
2018-06-01,2096940263,E041010,식기,노노스베어 6 사각찬기 1박스 10개 반찬그릇 업소용찬,30360,30360,0
2018-06-01,1010346817,A016130,키위,명절단독특가]나주햇살품은 신고배세트5kg (6-7과),43000,31000,-12000
2018-06-01,1239017002,C011050,남자내의,[베스티스]베스티스 아이스 쿨링 레터링 팬츠,69000,65550,-3450
2018-06-01,989043396,L012040,치약,[애경]애경) 2080 퓨어 베이킹소다 (레몬라임) 120G*3,7900,7900,0
2018-06-01,1010346813,A016130,키위,[1+1]명절단독특가]나주햇살품은 신고배세트5kg (6-7과),81000,58000,-23000
2018-06-01,438689891,C015040,장갑,카르닉 등산 장갑 반장갑 여름 손가락 글로브 아웃도어 MTB 스포츠 자전거 헬스 조깅,6900,6900,0
2018-06-01,2104181249,C013010,점퍼,야상 YSM01 WS야상바람막이점퍼남자 바람막이남성 바,109520,109520,0
2018-06-01,1175417065,A011010,쌀,[17년산 햅쌀]슈퍼오닝 고시히카리쌀10kg/당일도정,34500,34500,0
2018-06-01,1297118543,A014050,달걀,두레생협 올레길깐볼(250g/제주),14000,13580,-420
2018-06-01,1750048724,E011030,거실장,엘리제거실장SET,369000,369000,0
2018-06-01,1750048723,E011030,거실장,조이거실장SET,457000,457000,0
2018-06-01,989018379,A012010,국산쇠고기,홍성한우 채끝등심 300g 1등급,37000,35300,-1700
2018-06-01,1376367608,I053010,공책,모닝)초등 1-2 무제노트(남)-팩(10권입) 남아노트 무,11650,11650,0
2018-06-01,172395067,E031090,공기청정기,인증점 삼성 공기청정기 큐브 AX80N9080WWD 무료배송,1000000,733200,-266800
2018-06-01,504593619,L021010,손목시계,BELCARINO 모던니즘 손목시계 남성시계 MV207102S 패,51280,51280,0
2018-06-01,451484939,C021040,실내화,나이키 오디세이 리액트 AO9819-001,113000,113000,0
2018-06-01,894497733,C013010,점퍼,간절기[네오프렌 항공점퍼/블루종]멋쟁이들의 필수아,27700,27700,0
2018-06-01,988211891,A016160,과일가공품,DOLE 후룻볼 슬라이스(파인애플) 198G,3990,1990,-2000
2018-06-01,1010346848,A016090,참외,GAP인증 청송주왕산사과8kg(46-52개),63000,45000,-18000
2018-06-01,1010346849,A016090,참외,GAP인증 청송주왕산사과8kg(42-44개),52000,37000,-15000
2018-06-01,469720103,E041010,식기,델키 피라미드 과일바구니/스테인레스/과일쟁반/스텐,185200,181500,-3700
2018-06-01,10721508,I011010,TV,LG 울트라 HD TV 60UJ6620 151cm IPS패널,1300000,1248000,-52000
2018-06-01,115938814,A011170,떡,(맛나)장푸드햇살떡국4kg/궁전방,10100,9090,-1010
2018-06-01,99755764,C013050,운동복,남여트레이닝세트/츄리닝세트/후드세트/빅사이즈 반팔,23900,23900,0
2018-06-01,1010346853,A016050,밤,[9회죽염수로 만든]인산가죽염곶감 (45g*30),88000,63000,-25000
2018-06-01,1346139166,A014010,우유,엿기름(뚜레반 1K)X10개/엿기름가루 티백,54590,51870,-2720
2018-06-01,213644991,E011070,식탁,스테이 테이블 의자set/ 식탁 컴퓨터책상/ 거실 벤치,108810,108810,0
2018-06-01,1556236382,A013130,오징어채,정화 진미오징어 전기 50gx5.,21070,21070,0
2018-06-01,1410801585,A014010,우유,[매일유업]멸균우유 흰우유/저지방/초코/딸기/피크닉,14900,14900,0
2018-06-01,19786121,E011050,책상,해피클래스 1인용책상 2인용책상 H형책상/서랍장/수납,98900,98900,0
2018-06-01,1177107182,C013040,청바지,주니어반바지/쿨바지/데님/3부/5부/초등학생,25900,15900,-10000
2018-06-01,288622975,C013040,청바지,[에잇컨셉]뱅가드 슬림일자핏 청바지(C8E1FPT006),33900,32890,-1010
2018-06-01,856964698,C011030,남자학생복,4XL 스트라이프 셔츠 남방 청남방 남자 남성 빅사이즈,13800,13800,0
2018-06-01,2001571933,A016160,과일가공품,블루베리안주 (소울 350g),26940,23980,-2960
2018-06-01,2005149607,C011020,남자상의,(무료배송) AG 체크자켓 남성자켓 OP터틀 모직JK 체,237720,209200,-28520
2018-06-01,1384576917,C013020,티셔츠,남성/여성/반팔티/티셔츠/빅사이즈/남여공용/90~120,10000,9900,-100
2018-06-01,5623902,A022010,주스,킹아일랜드 코코넛워터 250ml 36팩,29500,29500,0
2018-06-01,990093710,A017300,미역,초L프레시)들기름으로구운재래김4G*8봉,2490,2190,-300
2018-06-01,1943768333,A022050,탄산음료,코카콜라/사이다/레쓰비/캔음료/미니캔모음/환타,12800,12800,0
2018-06-01,82348939,L021030,가방,루피노 노트북 파우치 가방 케이스 11인치~15.6인치,15900,15900,0
2018-06-01,71831370,E031110,청소기,[명품 카처]미세먼지 잡는 헤파필터진공청소기VC3 ERP,149000,149000,0
2018-06-01,1054530246,C013010,점퍼,아디다스 니트 AK 3S 트랙탑(AJ3645) 트레이닝복 체육,68530,66480,-2050
2018-06-01,1292018607,C013060,등산복,기능성 쿨티셔츠 긴팔티 반팔티 아이스티 남자 라운드,5800,5800,0
2018-06-01,878734093,C011050,남자내의,봄신상 프리미엄 청바지 면바지 슬랙스 남자청바지,18800,17800,-1000
2018-06-01,69216199,I031040,생화,접이식 스테인레스 등산컵(100ml)/등산컵/스탠컵,2800,2510,-290
2018-06-01,1032816479,I053040,기타문구,[3M] [오피스미]683-9KP 일반플래그-1개/3M정품 포스트잇 슈퍼노트 77 75 전국도매업체,1990,1990,0
2018-06-01,1726137350,A011010,쌀,17년 햅쌀 오뚜기쌀 씻어나온골드 쌀20kg/이중박스포,51900,51900,0
2018-06-01,982435380,L012110,색조화장품,세타필 모이스춰라이징 크림 566G,24500,20900,-3600
2018-06-01,428621191,A011140,부침가루,[삼립] 삼립 초코 티라미스 60g 3개 케이크 조각케익,6840,6840,0
2018-06-01,1412021418,C013050,운동복,맥스포츠 L~5XL 빅사이즈 트레이닝복 특양면 반바지,19900,19900,0
2018-06-01,711358045,I012010,컴퓨터,2017년 아이맥iMAC/삼성/SK/마이크론/8GB/PC4-2133MHZ,109800,109800,0
2018-06-01,974263435,F011130,홍삼,보령 홍삼녹용진액 80ml×60포 1박스,99000,99000,0
2018-06-01,1395545006,C012030,여자상의,튤람 어깨망사 청원피스 예쁜 스커트 STLD-6347,35400,33630,-1770
2018-06-01,1010346875,A016050,밤,[9회죽염수로 만든]인산가죽염곶감 명품형( 55g*28),170000,121600,-48400
2018-06-01,503229256,L021020,장신구,써지컬스틸 피어싱 세그먼트링 체인 드롭 자석 귀걸이,800,800,0
2018-06-01,1314096216,A012010,국산쇠고기,정남진 장흥한牛 장흥한우 국거리용 500g 소고기국거,53030,53030,0
2018-06-01,1857470590,A015020,식용유,시아스 화유 불맛기름 500ml/식용유/향미유/스모크향,7500,7500,0
2018-06-01,1890814390,C012060,여자내의,밴딩팬츠/뽄뜨와이드 팬츠/데님와이드팬츠,11000,9790,-1210
2018-06-01,2106181011,L021050,우산,5단 3단 완전자동 예쁜 일러스트 패션 우산 모음,13800,13800,0
2018-06-01,155292615,E041070,밀폐용기,[락앤락] 항균 비스프리 기획세트 밀폐용기 반찬통,9900,9900,0
2018-06-01,1838549004,A019160,밑반찬,[엘빈즈]유기농 어린이 김자반,3400,3400,0
2018-06-01,54086118,A017220,양파,[맘스허브]국산 대파3단 : 알뜰구매찬스,8590,8590,0
2018-06-01,786301988,A011040,보리쌀,수입 흰강낭콩 완두콩 매화콩 울타리콩 동부콩,1800,1800,0
2018-06-01,582535891,A017170,풋고추,[오병이어농산]오이/특품/2kg/취청오이,14900,14900,0
2018-06-01,1062246520,I031040,생화,구조용품 GERBER / 미국명품 거버 서바이벌 BASIC KIT 비상시 사용 필수품,54950,50550,-4400
2018-06-01,2105341918,C013010,점퍼,[SWIB] 역시즌찬스 스위브 인터라켄 N3B 구스다운점퍼_WD4D19021,99800,79840,-19960
2018-06-01,1573092374,A019040,소금,인산가 인산죽염(9회죽염) 분말1kg /고체/회백색,208550,208550,0
2018-06-01,260099687,C013010,점퍼,[톰키드]스노우 다운점퍼(9217414102001)(의정부점),49000,45160,-3840
2018-06-01,616715838,C011030,남자학생복,신사의품격 레귤러핏 긴팔 & 반팔 남방겸셔츠DKES2CSS110E1외18종(선물포장가능/ 닥스,60000,50400,-9600
2018-06-01,1216702649,A016060,감,달콤샤르르 자연그대로 만든 아이스 홍시 30개(컵)/개,36640,32980,-3660
2018-06-01,1066587480,E031130,보온매트,03 한일전기 난열열선 지브라 전기매트 더블 140*183,44000,44000,0
2018-06-01,233345587,A022050,탄산음료,나랑드사이다 1.5L x 12병/사이다,11590,11590,0
2018-06-01,263723182,C014020,유아복,상하세트 유아상하세트 핑크상하세트 유아상하세트 유,42200,40940,-1260
2018-06-01,2016662351,C013040,청바지,[위스진]청바지/블랙진/남자/찢어진/스키니/스판바지,21800,17800,-4000
2018-06-01,1176770285,C011030,남자학생복,남성 간절기 롱가디건 브이넥 후드 롱조끼 베스트 봄,54500,54500,0
2018-06-01,2069455130,I012010,컴퓨터,할인가 97만원대+가방) 노트북5 Metal NT550XAA-K54A,1119000,1049000,-70000
2018-06-01,1390978950,E011040,소파,[필우드가구]인조가죽 소파/2인용/3인용/원목 쇼파,109000,109000,0
2018-06-01,1356245491,C013020,티셔츠,V트임 티셔츠 BTT026 남자티셔츠 남자긴팔티 / 참고,35100,30890,-4210
2018-06-01,1372817219,C013010,점퍼,아이스 쿨링자켓 여름 선풍기 작업복 점퍼 긴팔 반팔,172000,154800,-17200
2018-06-01,26046867,C013050,운동복,[마끼다] 마끼다 폴리셔 PV7000C 광택기 폴리싱 흠집제거,602890,602890,0
2018-06-01,1302414899,C013020,티셔츠,20%쿠폰! 컨셉원 슬랙스/린넨팬츠외 썸머 인기 SALE,10000,10000,0
2018-06-01,900357391,A013110,마른오징어,초이스L 금오도 국물용 멸치 (200G),5990,5990,0
2018-06-01,1010346877,A016050,밤,명절단독특가][9회죽염수로 만든]무유황죽염곶감 (35g 20),52000,37000,-15000
2018-06-01,1010346876,A016050,밤,명절단독특가][9회죽염수로 만든]인산가죽염곶감 (35g*30),67000,48000,-19000
2018-06-01,1010346878,A013050,오징어,[속초반건조생선]명절 선물세트4호(3종 1.4KG),66000,47000,-19000
2018-06-01,253656430,F012020,생리대,+2P증정/좋은느낌 오버나이트 유기농 팬티형 매직쿠션,16800,16800,0
2018-06-01,37941304,C012030,여자상의,공구우먼 프로밍 레이스 원피스 25346 빅사이즈여성,35000,35000,0
2018-06-01,279816414,I012010,컴퓨터,애플정품 16년형 21.5형 New iMac MK442KH/A 아이맥신형/SG,1702770,1702770,0
2018-06-01,2059905910,C011030,남자학생복,남자 봄여름셔츠/린넨셔츠/스트라이프/오픈카라/남방,18500,18500,0
2018-06-01,1647047696,C011050,남자내의,남여 9부 아이스 쿨바지 팬츠 냉장고바지 여름바지,6200,6200,0
2018-06-01,988150479,A018070,파이,롯데 마가렛트 오리지널 396G,5280,3990,-1290
2018-06-01,1266638292,C013030,스웨터,MRO 부클사 폴라 니트 세터 남성니트폴라티 남성폴라,63660,63660,0
2018-06-01,1005812689,I031040,생화,2층 팔각 야외용 고급 파라솔/대형파라솔/2단 꺾임,22800,20890,-1910
2018-06-01,1862363105,A015010,참기름,국내산/ 참기름/ 들기름/ 350ml/ 당일착유 / 무료배송,17900,17900,0
2018-06-01,1713416125,C013020,티셔츠,세인트제임스 여성 티셔츠 밍콰이어 레반트 마린룩,75900,75900,0
2018-06-01,1838684628,L021030,가방,늘푸른백화점 제노바 jyc998 소가죽 노트북 서류가방,96830,96830,0
2018-06-01,83658371,A011170,떡,코리원/아하 맛있는 치즈떡(1kg+1kg)/떡볶이/바우네,10600,10600,0
2018-06-01,1209433667,C013040,청바지,[Blouson]쿨 정글나염 와이드 밴딩팬츠_[B1806PT062B],29000,25780,-3220
2018-06-01,1167874954,C013020,티셔츠,[VOV_의류]프리덤 라운드 티셔츠 (7117340301),48000,37440,-10560
2018-06-01,1578202524,I011010,TV,(전국무료배송) LG전자 HD LED TV 32LJ562B 80cm,332290,319000,-13290
2018-06-01,1855718649,F012020,생리대,시크릿데이 센스/러브레시피/러브코튼 외,10900,10900,0
2018-06-01,954851916,A018030,껌,[롯데]롯데 자일리톨 오리지날 (18g),900,900,0
2018-06-01,875699643,E041050,냄비,전골냄비 경질 샤브샤브 냄비,17000,17000,0
2018-06-01,1230965433,A019020,참깨,참깨 (이츠웰 1k) X10,124000,110360,-13640
2018-06-01,289427693,A017180,호박,가을 특 고운 고추가루 2.5kg,46600,45210,-1390
2018-06-01,2138769657,E031130,보온매트,한일꽃잠 카페트매트 7인용 183x270.좌우분리난방.국,215040,215040,0
2018-06-01,561882460,C012060,여자내의,[모다아울렛][반에이크]반에이크 디지털플라워점프수트VA87OPM209Z,59800,54420,-5380
2018-06-01,1220079245,A018010,초콜릿,[롯데제과]6000 ABC초콜릿 200GX 4봉/6봉/간식/사탕,12900,12900,0
2018-06-01,653345854,E041030,솥,풍년압력밥솥패킹/풍년패킹/고무패킹/스테인레스/알루미늄/4~10인용/20/30/50/가정용/,5000,5000,0
2018-06-01,490829179,C012060,여자내의,리스트 여름 레이스 포인트 플레어 스커트_TWSKG21220_BK/ 리스트,39000,34710,-4290
2018-06-01,537973619,C012040,여자학생복,니트박시뷔스티에,19700,19700,0
2018-06-01,75391248,C013040,청바지,진우드 빅사이즈청바지 남자청바지 봄신상 남자바지,10800,10800,0
2018-06-01,1200658664,C013020,티셔츠,린넨 브이넥 반팔 티셔츠,11000,11000,0
2018-06-01,346432405,C012060,여자내의,기모 퀄트스타일 팬츠 여성 캐주얼 기모팬츠 레깅스,19510,19510,0
2018-06-01,1318582587,C021040,실내화,[아디다스] 특가 /스니커즈/런닝화/크록스/당일출고,38000,38000,0
2018-06-01,59245201,A012010,국산쇠고기,호두기름 견과세트 10호(고품격 웰빙 선물세트)사은품,128710,128710,0
2018-06-01,957732846,A013020,명태,고등어 자반 (2마리/1손),2390,2390,0
2018-06-01,1537548477,C012030,여자상의,지나블리스 스트라이프 벨티드 롱 원피스 7299,19800,19800,0
2018-06-01,1425268493,A019170,냉동식품,동원 개성 왕새우만두315gx4봉(총1.26kg),12600,12600,0
2018-06-01,263747117,C013050,운동복,AS 레볼루션 니트 트랙 수트(693489452) 남성트레이닝,172300,172300,0
2018-06-01,8373547,A017160,오이,노루궁댕이버섯 노루궁뎅이버섯,31000,31000,0
2018-06-01,412815517,C013020,티셔츠,체리온 여름신상 롱티/전사나염/반팔티,9900,9900,0
2018-06-01,352689078,A012010,국산쇠고기,대관령한우 프리미엄 3호,457740,457740,0
2018-06-01,289799109,F012020,생리대,화이트 중형 보너스팩 총 48매! 견본 증정!,9200,9200,0
2018-06-01,341848168,L021030,가방,[대구백화점 I관] [랩]스트링 오픈포켓 숄더백(AJ2ABS86),62100,57140,-4960
2018-06-01,482731847,E011050,책상,LFM 미니테이블 아이탭 공부상 독서테이블 좌식책상,29000,28710,-290
2018-06-01,2133633735,A019060,된장,보따리몰/일본 아와세미소1kg/미소된장/일본된장/시로,3950,3950,0
2018-06-01,266260893,C012020,원피스,[쉬즈미스] 썸머신상 블루라벨 슬림핏 크롭 팬츠_SWWSLI22020,59000,57820,-1180
2018-06-01,1094281780,C012040,여자학생복,쉬폰주름스커트 (J11PSK082)/ 매그제이(MAGJAY),39000,35100,-3900
2018-06-01,1687434235,A012050,소시지,아임닭 닭가슴살 소시지 18종 골라담기,2250,2250,0
2018-06-01,2082465563,F012020,생리대,위스퍼 보송보송 울트라날개 대형16pX5개(총80개)-생,25400,25400,0
2018-06-01,998196984,A019130,스프,컵스프8개/비닐스프12개/선택1+선택2/보노스프/스프,11900,11900,0
2018-06-01,1749082584,C013050,운동복,(2+1 EVENT) 16ss 첨이첨이 열대정글나시세트 듀퐁 유아동의류 아동의류 공용 상하복,17730,17730,0
2018-06-01,472216013,A013140,북어채,중국산을 섞지않은 정직한 용대리100%/최용식황태덕장,36000,36000,0
2018-06-01,1599579667,C013040,청바지,테스트-단일옵션/그룹추가 比,3000,3000,0
2018-06-01,1724618978,A013070,굴,[새우몰] 골든크랩 5kg 왕대게 5kg 대게 스노우크랩,154000,154000,0
2018-06-01,1693343522,C012060,여자내의,플라워 핸드 프린팅 심플 스커트(GGFI300318)[예약상품 2018.06.01 부터 발송]/ 제이제,20000,16000,-4000
2018-06-01,539169814,C011020,남자상의,[무료배송]레드 체크 밍크털 코트 코트 남성용코트 남,103720,103720,0
2018-06-01,2130317014,A022010,주스,무료배송/ V8 야채주스/ 6개x4팩/24캔x163ml/토마토,18900,18900,0
2018-06-01,1034133866,A011170,떡,정남농협 디딜향 우리떡 선물세트,29900,29900,0
2018-06-01,61573457,A021010,커피,네스카페 마일드 커피믹스 900g x 10봉 자판기용,41380,38900,-2480
2018-06-01,1013587020,A019070,양념소스,[초담원]모밀소스(1.8L×8병/1박스/무료배송),76000,76000,0
2018-06-01,896542155,A013130,오징어채,[샘표]샘표 질러 부드러운육포기획 (30G*3입),7700,6900,-800
2018-06-01,957732870,A013020,명태,명태 코다리 (대/4마리),7990,4990,-3000
2018-06-01,330458512,I031040,생화,2.7M 발리 대형 파라솔/고급형 굵기36mm 카페 야외,49500,43870,-5630
2018-06-01,320308687,C012060,여자내의,(해외직배송) 여성 브이넥 랩 와이드 통 팬츠 리본 허,77220,67960,-9260
2018-06-01,486469741,A022010,주스,세부 망고퓨레 1kg/깔라만시퓨레 1kg 원액 주스 쥬스,8500,8500,0
2018-06-01,346035511,I031040,생화,[BUCK703]캠핑용야전침대/간이침대/접이식침대/군용침,36900,36900,0
2018-06-01,1030178568,A017200,토마토,이용기님의 무농약 가지 3kg,23000,21900,-1100
2018-06-01,636298844,F012010,종이기저귀,하기스 매직기저귀 밴드 1단계/2/3/4단계/5단계(3팩),42500,42500,0
2018-06-01,38907892,F011150,건강기능식품,종합비타민15 멀티비타민 4박스 12개월,29900,29900,0
2018-06-01,8057027,F012020,생리대,화이트 클린 울트라 날개 중형 4팩 대형 4팩 구성,11300,11300,0
2018-06-01,677840802,C012060,여자내의,페이크삭스 10족 양말 스타킹 발목스타킹 기모레깅스 스타킹 덧신 겨울스타킹 기모레깅,11590,10320,-1270
2018-06-01,783757760,C013050,운동복,툴툴 광택패드세트5인치 3종세트 전동공구용 광택기,8900,8900,0
2018-06-01,293780607,A015020,식용유,[사조해표] [기획] 포도씨유+카놀라유 900ml 각각 2개씩 총4개,11900,11900,0
2018-06-01,100530436,A017300,미역,2018년햇김/생산자 직판/파래김/재래김/돌김/곱창돌김,6000,6000,0
2018-06-01,440679979,E021020,커튼,통풍루버/블라인드/창문가리개/문발/대나무발/방충망,8000,7900,-100
2018-06-01,1340079988,C015040,장갑,고급 포인트라인 가죽장갑(여성) 숙녀용장갑 여성용겨,28860,28860,0
2018-06-01,304008680,L012090,기초화장품,일리윤 신제품 프로바이오틱스 & 베스트 모음전,11900,11900,0
2018-06-01,1300929866,F012050,의료측정기,브라운 써모스캔 귀체온계 IRT-6520 (총 필터 21개),80000,80000,0
2018-06-01,825498268,C011050,남자내의,[지오다노] 407505 여성 테리 핫숏/ 지오다노,7500,6080,-1420
2018-06-01,954851952,A011090,국수,[삼양]삼양 큰컵 불닭 볶음면(105G),1300,1300,0
2018-06-01,921300869,F012020,생리대,시크릿데이 생리대 입는 오버나이트 2p,2500,2240,-260
2018-06-01,1722533341,E021020,커튼,까르데코 호텔식 린넨룩 암막커튼2장/4장/6장세트,29900,29900,0
2018-06-01,451119614,A019020,참깨,해정원 볶음들깨(거친) 1kg2개 깨 들깨 볶음들깨 해정,27150,24440,-2710
2018-06-01,477377520,F012010,종이기저귀,리베로기저귀 밴드형/팬티형 3팩구성,46900,46900,0
2018-06-01,451120607,A019010,고춧가루,가을 특 고운 고추가루 2.5kg2개 고추 고추가루 가을,93490,84150,-9340
2018-06-01,297707332,C013050,운동복,카텍크 초극세사 9인치패드전용 광택기융 세트(광택용1매/왁스용1매) AHT2001광택기전,7000,6440,-560
2018-06-01,184367257,A013170,생선통조림,[사조] 살코기 참치 250g 10묶음 안심따개 참치캔 통조림,26000,26000,0
2018-06-01,1784190250,A019090,카레,청정원 카레여왕 비프카레 160g/카레여왕 비프/치킨/스위트카레/구운마늘양파,1800,1800,0
2018-06-01,549573965,C012020,원피스,[크로커다일레이디스]클래식 배색 광택 코트_Y5V1,37900,36010,-1890
2018-06-01,1213952180,L012090,기초화장품,명작수/예진생 진생베리 명작수,128700,128700,0
2018-06-01,896542162,A013160,맛살,[한성]한성 유부초밥 박사 (160G*2입),3590,3290,-300
2018-06-01,546857221,A018060,스낵과자,인기 콘스낵 모음전 9종 콘초/꼬깔콘/카라멜콘과땅콩,780,780,0
2018-06-01,1296695756,C012060,여자내의,[파프리카]반밴딩 마 반바지_N82SLF05(센텀시티점),29000,23500,-5500
2018-06-01,342695432,F012030,안경,위블앤 42종 안경테1+1사은품(패션선글라스)안경/뿔테,19900,19900,0
2018-06-01,333979861,A013140,북어채,개코먹태10마리/대관령짝태/황태버터구이(맛태)10마리,31000,31000,0
2018-06-01,511546405,L021030,가방,SL 744 서류가방 남성가방 비즈니스백,61800,59950,-1850
2018-06-01,716196261,E011060,의자,[비애노] 게이밍 컴퓨터 의자 / 레이싱체어,75400,67860,-7540
2018-06-01,475579408,E011040,소파,보니타빈백 CV01 북유럽스타일/명품빈백,145000,145000,0
2018-06-01,199534675,A019080,고추장,★제수용품★ 명절에 꼭 필요한 소스만 모았다!,2450,2450,0
2018-06-01,985380910,F012020,생리대,좋은 순면 참숯라이너 일반_40P,4700,4700,0
2018-06-01,1580015988,A019030,생강,리얼편강 (국산 200gX2통) 선물세트,32450,32450,0
2018-06-01,1331516376,E011020,침대,[파로마] 루이스LED 저상형 패밀리 침대,269100,269100,0
2018-06-01,1013587078,A019070,양념소스,[초담원]불닭소스 매운맛(2kg×8병/1박스/무료배송),80000,80000,0
2018-06-01,989883067,E061030,전구,GE2관36W 주광색 4입,12900,12900,0
2018-06-01,986677232,A017220,양파,국내산 홍화씨 150g,6500,6500,0
2018-06-01,2108414874,A011160,빵,천연발효종 먹물치아바타(110gX4개)/샌드위치/빵,5900,5900,0
2018-06-01,348255512,C013050,운동복,이지 비상용소화기 차량용 캠핑용 가정용 119 긴급,14000,12790,-1210
2018-06-01,1997348819,E031130,보온매트,일월 워셔블 온열매트 M2 싱글 더블 전기요 매트 장판,89400,86500,-2900
2018-06-01,1001410145,A017280,김,초생강(백색 참존 1.2k)X10,33120,33120,0
2018-06-01,937995454,L012090,기초화장품,(헤라)지일비누 60g X 54개 롤리타렘피카비누/궁중,44000,44000,0
2018-06-01,540124919,C011050,남자내의,[지오다노] 408503 여 린넨 백밴드 쇼츠/ 지오다노,26820,21730,-5090
2018-06-01,1967857696,E011050,책상,비젼카운터/안내데스크/인포메이션/PC방/주문제작가능,430000,417100,-12900
2018-06-01,1233102835,C011050,남자내의,[바이더알]ByTheR 비비드 밴딩 와이드 팬츠,29380,27920,-1460
2018-06-01,540124918,C011050,남자내의,[지오다노] 408502 여 린넨 쇼츠/ 지오다노,29800,24140,-5660
2018-06-01,820854171,A021010,커피,[당일출고]맥스웰하우스 자판기용 커피믹스 900g,3500,3500,0
2018-06-01,1440652696,C012020,원피스,[어퍼스트로피] (TV홈쇼핑방송/무료배송) 스윗 루즈 9부 팬츠-사이즈 44∼77다양,6900,6350,-550
2018-06-01,1256417682,C011030,남자학생복,[커스텀멜로우] 하운드 투스 베스트 CWUAM17351GYX,89000,72980,-16020
2018-06-01,2080704883,C012030,여자상의,퍼플스완 우리 서로 편한 트임 린넨원피스,35800,35800,0
2018-06-01,898486327,A018040,아이스크림,뽕따 (소다맛/10개),7000,4500,-2500
2018-06-01,488086670,E041010,식기,문창탑/문창붓/풍수지리/인테리어/소품/합격기원/선물,54400,53320,-1080
2018-06-01,2052940881,C013020,티셔츠,오프숄더레이스끈티/라운드티/딥브이넥/입술넥/시스.,7900,7900,0
2018-06-01,1982483591,C012020,원피스,모직자켓 겨울자켓 자켓 JK08 WS 남자자켓 모직자켓 정장자켓 겨울자켓 자켓,173930,154800,-19130
2018-06-01,991767986,A011100,라면,초특가 옛날 당면 100g 250g 300g 400g 500g 모음전,2790,2790,0
2018-06-01,69412987,E021010,침구,순면 피그먼트 워싱 차렵이불/순면이불/봄이불,46000,42140,-3860
2018-06-01,961615895,A012050,소시지,크라제버거 비프 스테이크 170g x 10팩 ＋ 3팩증정,27900,27900,0
2018-06-01,451120516,A019020,참깨,은진 볶음들깨(고은) 1kg2개 깨 들깨 볶음들깨 은진들,27150,24440,-2710
2018-06-01,1118465193,C013050,운동복,[모비스] 모비스 크루저 루프백 캠핑루프백 차량용루프백 자동,257390,234440,-22950
2018-06-01,98249775,C012040,여자학생복,레노마 집업 니트 가디건/여성 M/스웨터/중고/구제,17900,17900,0
2018-06-01,895474895,E031020,가스레인지,/렌지후드용 교환필터 1매입 10SET/ 렌지후드필터 레,17000,15800,-1200
2018-06-01,647376841,C011030,남자학생복,폴로긴팔 남성 여성 셔츠 드레스 남방 면바지 원피스,49900,49900,0
2018-06-01,412205970,E021020,커튼,커텐클럽실커튼 쫀쫀한1등급 무지 스팽글 하트 무지개,5500,5500,0
2018-06-01,540124921,C011050,남자내의,[지오다노] 108504 린넨/코튼 이지숏/ 지오다노,26820,21730,-5090
2018-06-01,1277129357,C013050,운동복,중외 에탄올 워셔액/워셔액/워서액/1.8리터,2100,1840,-260
2018-06-01,1153838865,E041050,냄비,맥반석고리전골 쭈꾸미팬 볶음요리팬 철판 무쇠팬,24000,24000,0
2018-06-01,2134247322,A022010,주스,Tipco 팁코 오렌지쥬스 1000ml 12개 오렌지쥬스 오렌,73290,71830,-1460
2018-06-01,1765620132,C012040,여자학생복,[포에버21]드로우 스트링 후드 니트/FOREVER21/니트/스웨터/후드니트,26900,8070,-18830
2018-06-01,1215605176,E011060,의자,페라리 엔초 체어/pc방 사무용 컴퓨터 책상 게임방,133000,129000,-4000
2018-06-01,1158542842,E021010,침구,[국내제품] 순면100% 이불세트/요커버세트/차렵이불,29900,29900,0
2018-06-01,1221776079,C013010,점퍼,[이사베이]모혼방 숏 점퍼 (VQMAB2108)_I5H9,59000,56050,-2950
2018-06-01,1859168687,C012060,여자내의,(무료배송) (해외직배송)블랙 캐쥬얼 블라우스 스커트,72920,64170,-8750
2018-06-01,985380909,F012020,생리대,좋은느낌 좋은순면 롱 팬티라이너_36P,4500,4500,0
2018-06-01,985380908,F012020,생리대,좋은느낌 좋은순면 일반 팬티라이너_40P,4500,4500,0
2018-06-01,546870216,C012060,여자내의,[플러스에스큐] 4017일자 데님팬츠(LU4DP8I),49000,47250,-1750
2018-06-01,82192888,C013010,점퍼,[DUCLY] 신상 맨투맨/후드티/후드집업/기모/빅사이즈,27900,27900,0
2018-06-01,1989654791,A017230,마늘,[2018년햇양파]직접 재배 생산한 무안황토양파,5900,5900,0
2018-06-01,1708823163,A014020,분유,[아이배냇] 순 산양분유 1단계~4단계(800gX3캔),88800,88800,0
2018-06-01,321958785,C013030,스웨터,MNTS18008 데일리 심플 골지 니트 기본니트 니트 남성,19540,19540,0
2018-06-01,1830426398,C011050,남자내의,블루빈 남자 청반바지 면반바지 밴딩 5부슬랙스,14900,14900,0
2018-06-01,1039774651,F011130,홍삼,[정원삼] 6년근 고려홍삼정 365스틱 키즈 (10ml x 30포) 어린이홍삼,25900,25900,0
2018-06-01,918908046,A012060,햄및베이컨,CJ 스팸 340g*6캔or200g*8캔 클래식/마일드,21800,20800,-1000
2018-06-01,223976522,E021010,침구,일본수출/60수아사면100%/사계절용 차렵이불/마이크로,55000,48400,-6600
2018-06-01,331314486,I031010,장난감,레고호환블럭 대형 초대형 어린이날선물,10900,10900,0
2018-06-01,1599999919,A022040,기능성음료,포카리스웨트 340ml x 20펫/코카콜라/펩시콜라/음료수,12230,11500,-730
2018-06-01,451119548,A019010,고춧가루,청양 김치 고추가루 1Kg2개 가루 고추가루 김치고추가,41520,37370,-4150
2018-06-01,435554660,C013020,티셔츠,테잎브이넥티(BRD_1602) 여성브이넥 빅사이즈티셔츠,18820,18820,0
2018-06-01,1730308565,C011020,남자상의,봄신상 코트 더플/남자옷/자켓 하프 쟈켓 울 트렌치,29800,29800,0
2018-06-01,451144508,A015010,참기름,해정원 참맛기름 1.8L2개 기름 참맛기름 해정원맛기름,32780,29510,-3270
2018-06-01,1486618270,A022010,주스,포모나스무디/세미/과일원액/딸기/블루베리/망고/키위,8600,8600,0
2018-06-01,1891396526,C012040,여자학생복,모자이크 라운드 넥 반팔 니트 티 티셔츠 여성 스웨터,8020,7920,-100
2018-06-01,61022728,A011160,빵,유스마일 통밀빵 호밀빵 견과류빵,600,600,0
2018-06-01,1281974620,A012010,국산쇠고기,실속형 한우선물세트 6호x2.4kg 1+등급 한우 한우세트,270000,267300,-2700
2018-06-01,1733360610,F012020,생리대,[릴리안] 릴리안 향라이너 20p x 6팩,10900,10900,0
2018-06-01,451144502,A019010,고춧가루,B김치 고추가루 1kg2개 가루 고추가루 김치고추가루,37220,33500,-3720
2018-06-01,1317243763,L021020,장신구,Crystal Ver 캔디 문 스타 목걸이 문스타세트 큐빅목,19430,19430,0
2018-06-01,356381426,C012030,여자상의,[이란지]섹시美!남친심쿵룩!원피스/블라우스/티셔츠,6800,6800,0
2018-06-01,48891475,C013010,점퍼,(도도한걸)정장자켓/7부자켓/정장세트/데님자켓,14900,14900,0
2018-06-01,1232304407,C013020,티셔츠,[헤지스]남성 HZTS8B908BK [PHIZ] 퍼피패치 면 반팔티셔츠,41300,34700,-6600
2018-06-01,488060050,E061040,부엌용세제,제빙기세척제 어넥스프리즈 - 제빙기세정제 제빙기클,47210,42020,-5190
2018-06-01,795584342,C011030,남자학생복,레디핏_ 남성 긴팔 와이셔츠 4종 균일가전,19900,9900,-10000
2018-06-01,877135754,C013020,티셔츠,로로텐 롱/루즈핏/라운드/티셔츠 빅사이즈 여성의류,15900,15900,0
2018-06-01,1234896517,F012050,의료측정기,브라운 체온계 IRT-6520/IRT-6030/굿,78800,72500,-6300
2018-06-01,285319967,F011150,건강기능식품,[특가] 사랑이 멋진 생생 유산균 30포/온가족 유산균,6400,6400,0
2018-06-01,1261061940,C012040,여자학생복,빅사이즈 커버 루즈 훌 가디건,38020,38020,0
2018-06-01,109862945,A018030,껌,초특가 롤리팝아이스츄잉 63g x 10봉 롤리팝아이스,12500,12500,0
2018-06-01,604623102,A022020,두유,매일 뼈로가는칼슘두유950ml 10팩2018년(10월30일),10900,10900,0
2018-06-01,105666252,A017160,오이,대용량 1kg 건표고버섯슬라이스 / 표고버섯원형,17000,17000,0
2018-06-01,1418205696,C012060,여자내의,핏이 예쁜 체크 니트 플레어 스커트/치마 KG620-628,14700,14700,0
2018-06-01,617439877,C013040,청바지,[나나진]신상스키니진/스판/컷팅/연청/중청/진청/구제,15900,12900,-3000
2018-06-01,1857193732,E011060,의자,[위드퍼니처]식탁의자 베스트13종모음(2개 한세트)-식탁의자/목재의자/식당의자/원목의,39800,35820,-3980
2018-06-01,315508238,C014010,아동복,[플레이몰]아동 냉장고바지 레깅스5900원균일가 기획전,5900,5610,-290
2018-06-01,2118454341,C013010,점퍼,[푸마]간절기 경량 패딩자켓 트레이닝자켓 패딩점퍼,39800,39800,0
2018-06-01,1164570384,C013040,청바지,[까르뜨블랑슈]17년 여름 솔리드 스판 팬츠 CMM7WP87,69000,56580,-12420
2018-06-01,1893649926,C013010,점퍼,로로샤 가디건/여아/바람막이/점퍼/집업/아우터/남아,26600,26600,0
2018-06-01,2040365839,C013020,티셔츠,[폴햄 (POLHAM)](공용)무지 브이넥 베이직 반팔티셔츠(PHY2TR1840)[갤러리아],9900,7920,-1980
2018-06-01,1338258801,C021040,실내화,테바 남성 샌들 SVTM1814010-BLK 오리지널 유니버셜,39200,39200,0
2018-06-01,1798353124,A016160,과일가공품,블루베리(건조 한끼 350g)X6,110760,110760,0
2018-06-01,989883094,A012010,국산쇠고기,한우차돌박이_500G팩(냉동),79900,39900,-40000
2018-06-01,371618803,E061060,살충제,악취의 원인 세균 제거 바이오솔루션 피톤치드 1L 살,15610,15610,0
2018-06-01,599617896,A021010,커피,아이수 페루산 카카오닙스200g,9000,8730,-270
2018-06-01,2041222917,E011010,장롱,오플로어 2.2~3.2m 장롱 옷장 세트 46종 시리즈,400000,400000,0
2018-06-01,1735048597,C011050,남자내의,(평화)(여체크9부)특면 순면 체크무늬 여성파자마,10950,9750,-1200
2018-06-01,1279526061,C021040,실내화,나이키 코르테즈 흰빨파/검흰,73000,73000,0
2018-06-01,349327996,C013020,티셔츠,슈퍼렉스 남자 헬스복 운동복 트레이닝복 티셔츠 바지,9600,9500,-100
2018-06-01,985380938,F012020,생리대,바디피트 내몸에 순한면 대형_16P,6400,3400,-3000
2018-06-01,1988868540,I031040,생화,스테인레스 등산컵/일반형 뚜껑형 연결고리포함/물컵/머그컵/물병/스테인레스컵/스텐컵,2300,2030,-270
2018-06-01,985380937,F012020,생리대,바디피트 내몸에 순한면 중형_18P,6400,3400,-3000
2018-06-01,898486352,A018040,아이스크림,탱크보이 (10개),7000,4500,-2500
2018-06-01,1574561424,L021030,가방,[오늘출발] 신상 데일리 에코백/숄더백/여성가방/,7900,6900,-1000
2018-06-01,985380932,F012020,생리대,좋은느낌 좋은순면 참숯 롱 팬티라이너,4700,4700,0
2018-06-01,898486355,A018040,아이스크림,더블팅(10개),7000,4500,-2500
2018-06-01,898486356,A018040,아이스크림,왕포도알 (10개),7000,4500,-2500
2018-06-01,985380936,F012020,생리대,좋은느낌 오가닉 순면 울트라 날개 대형16P,6900,6900,0
2018-06-01,1129486614,F011150,건강기능식품,본사공식/드시모네키즈 블루베리&쿠키크림향 추가증정,58000,58000,0
2018-06-01,985380934,F012020,생리대,좋은느낌 오가닉 순면울날 소 18P,6400,6400,0
2018-06-01,813924631,E011070,식탁,로뎀나무 아카시아 원목식탁/원목테이블/식탁/책상,129000,129000,0
2018-06-01,519010481,E021020,커튼,/벌집블라인드 화이트 호프발스 140x155 cm/ 롤스크린,71460,63600,-7860
2018-06-01,59859250,A011070,혼식곡,곰표 밀가루 (다목적용)(2 500G),3080,3080,0
2018-06-01,488086642,E041010,식기,풍수지리/팔괘/주산/주판/인테리어/소품용품/개업선물,110200,108000,-2200
2018-06-01,379729625,C013060,등산복,기능성 쿨티셔츠 긴팔티 반팔티 아이스티 남자 라운드,5800,5280,-520
2018-06-01,631326218,E011010,장롱,리버스 소나무 원목 장롱 옷장 장농 이불장 드레스룸,329860,329860,0
2018-06-01,1637198171,C013050,운동복,[불스원] 레인OK 프리미엄 에탄올 발수코팅 워셔액,8500,7480,-1020
2018-06-01,674200220,A013090,전복,가리비관자1Kg/관자버터구이/관자스테이크/캠핑요리,41000,41000,0
2018-06-01,1437494467,C012060,여자내의,편안하고 시원한 고품질 냉감통바지 SD-5668,8040,8040,0
2018-06-01,1045967260,A021010,커피,[사이버마트]맥스웰마일드1Kg/카페마고/헤이즐넛/핫초,2900,2900,0
2018-06-01,956698995,A018010,초콜릿,롯데 크런키볼 76G,2200,2200,0
2018-06-01,624899141,L012060,샴푸,라온 블랙 비누풀 샴푸/트리트먼트 2000ml 대용량,14900,14900,0
2018-06-01,444536858,C011030,남자학생복,압구정클럽 남녀공용 프리사이즈 하찌후드니트숄가디,74600,74600,0
2018-06-01,448598244,C012060,여자내의,[파파야] 데일리룩 밴딩 리본 A라인 스커트 (CNIRSK017B),20000,18000,-2000
2018-06-01,1240804788,C013020,티셔츠,에스닉시스루티/라운드티셔츠/그물티/시스루니트,9900,9900,0
2018-06-01,356067441,A018040,아이스크림,돌핀 폴라레티 아이스바 후르츠 30개+트로피칼 30개,13990,13990,0
2018-06-01,1899616876,C013020,티셔츠,[필골드] DB004 스판 단가라 목폴라 티셔츠,25800,25800,0
2018-06-01,2069986869,A011180,파스타면,보가사리 91호 펜네지티리가티 파스타 500g,1200,1200,0
2018-06-01,716389588,A019040,소금,신안소금 신안천일염 국산천일염 20kg 굵은소금,14800,14800,0
2018-06-01,1360798025,A016090,참외,2018 성주 햇 참외 2kg (에어백안전포장),9900,9900,0
2018-06-01,1815058912,A013070,굴,☞TV홈쇼핑정품!!조선대가 전통 간장 꽃게장 2.4Kg 간장게장/ 암게/반찬/게장/,49310,49310,0
2018-06-01,1000746159,E031070,에어컨,NEW 신일 SIF-16CSR 천장형 선풍기 천장용 선풍기,59400,59400,0
2018-06-01,1775063652,F011130,홍삼,정관장 무설탕홍삼캔디수(180G),12000,12000,0
2018-06-01,901249229,A018020,사탕,[오리온]오리온 통아몬드,1650,1650,0
2018-06-01,250065066,E031070,에어컨,SIF-TH60B 신일산업 타워팬 선풍기,60000,60000,0
2018-06-01,1319821585,C011030,남자학생복,밀란시아 메쉬 라운드 조끼 601-045 남성캐쥬얼 캐쥬,26110,25590,-520
2018-06-01,1752264238,C013020,티셔츠,[쁘띠뮤] 래쉬가드 미리준비하세요!,12900,12900,0
2018-06-01,1489649920,E041020,컵,el 머그컵 5p(선택) 커피잔 머그잔 그릇 찻잔,16900,16900,0
2018-06-01,1228975395,A014050,달걀,[홈플러스][행사상품]풀무원_동물복지목초란_15구 대란,6990,6650,-340
2018-06-01,1266158801,E021020,커튼,/롤러블라인드 그레이 스콕스클뢰베르 120x195 cm/ 블,63870,56850,-7020
2018-06-01,2056986192,E011020,침대,리퍼브 한샘 슈퍼싱글 침대/샘베딩 옷장/협탁/테이블,129000,129000,0
2018-06-01,72460633,A018050,비스킷,커피죠이 810g(45g x 18ea)/커피조이/비스킷/수입과자,6250,6250,0
2018-06-01,1745837566,E061010,세탁세제,퍼실 컴플리트솔루션 밀리언파워젤 라벤더2.7L x 4,49900,49900,0
2018-06-01,1071698115,A014030,치즈,코리원/서울우유 슬라이스 치즈 100매/서울슬라이스,15800,15800,0
2018-06-01,1433661895,C011050,남자내의,1+1 슬랙스/팬츠/링클프리/스판/원플/바지/S~2XL,10900,10900,0
2018-06-01,63009629,A018110,물엿,[두레촌] 식품 명인 전통 생강 조청 (500g) 쌀 도라지 물엿 꿀,15000,15000,0
2018-06-01,1786513170,A016110,딸기,제이제이 냉동딸기 1kg 2개,19770,19770,0
2018-06-01,599916230,A012030,돼지고기,[홈플러스]돼지일품포크삼겹살_100 g,1590,1520,-70
2018-06-01,1385793382,A011160,빵,안흥찐빵마을 우리밀우리팥 수제 안흥찐빵 더블3종세,63120,63120,0
2018-06-01,1030286369,A013170,생선통조림,한성 골뱅이400g,4500,4500,0
2018-06-01,1807883948,C014010,아동복,[밍크뮤] 프릴레터링티셔츠 (37233-332-02),18200,14930,-3270
2018-06-01,1271666228,C012030,여자상의,DRM1264 미들 단 롱 니트 802 여자라운드니트 여자롱,45860,45860,0
2018-06-01,1112498053,A015020,식용유,코코라이프 유기농 코코넛오일 쿠킹오일 500ml,13900,6950,-6950
2018-06-01,810224720,L021030,가방,노트북가방 노트북파우치 삼성 LG HP 노트북케이스,29800,29000,-800
2018-06-01,1213039316,C012040,여자학생복,베니토 나이스 NB/3컬러/스트라이프/카라/데일리,29000,29000,0
2018-06-01,1807112553,A014040,발효유,수제 요거트 야베스요거 150ml/500ml/1 000ml,1700,1700,0
2018-06-01,1782235748,C012060,여자내의,PT1341-데일리 베이직 롤업 숏 팬츠 여자반바지 롤업,29890,24220,-5670
2018-06-01,745501364,E031020,가스레인지,(당일발송) SK매직 2구 가스렌지 GRA-C2080R,115000,115000,0
2018-06-01,519927928,A011160,빵,세상 가장 행복한 정직한 디저트 에그타르트 60개입 1box,14900,14900,0
2018-06-01,1443355762,A012060,햄및베이컨,[무배]그릭슈바인 200g*6개 정통 독일식 프리미엄 햄,10500,10500,0
2018-06-01,1305934602,C015040,장갑,화이트 북극곰 장갑 예쁜장갑 북극곰끈장갑 귀여운장,16390,16390,0
2018-06-01,501612119,A016040,포도,동원)황도 슬라이스 400g x 12개 사시사철 맛있는,41360,41360,0
2018-06-01,474975354,C012040,여자학생복,[헤레이스]트레비블라우스CHF18S765,98000,93100,-4900
2018-06-01,1939886894,C013050,운동복,두줄띠트레이닝set/공용체육복/생활복/체육복/아동복,19500,19500,0
2018-06-01,1407484193,A011180,파스타면,바릴라 스파게티1kg/스파게티면/파스타면/펜네/라폰테,2390,2390,0
2018-06-01,966894315,I031070,애완동물관리비,다용도 KS-201 초시계 1/100초 생활방수 스톱워치,9100,7620,-1480
2018-06-01,621177200,L012030,칫솔,죽염 칫솔 3입 x 2개 (택일),8900,8900,0
2018-06-01,292781590,A017120,고구마,포근포근하고 싱싱한 2018년 햇감자 / 햇양파,9900,8900,-1000
2018-06-01,2093557912,L021010,손목시계,버팔로 레저 아파치 전자시계/손목 학생 군인 시계,29000,29000,0
2018-06-01,1585064553,F012020,생리대,[릴리안]생리대 4팩 순수한면 팬티라이너 오버나이트,7900,7900,0
2018-06-01,747107717,A016110,딸기,제이제이 냉동딸기 1kg 2개,16850,16850,0
2018-06-01,504772214,C011030,남자학생복,FS-197 프루다 셔츠 블루 (가을에재생산예정) 긴팔셔,37520,37520,0
2018-06-01,570648846,C014020,유아복,[밀리밤]레이어드 끈 원피스 MLOM18F50,19800,19800,0
2018-06-01,822605685,C021010,아동화,[꼬꼬마슈]아동화/유아동운동화/슬립온/스니커즈 kd50,9800,9800,0
2018-06-01,1104218942,L012090,기초화장품,바닐라코 NEW 클린잇제로 클렌징밤 오리지널/대용량,15700,15700,0
2018-06-01,1187512781,E011040,소파,아리아퍼니쳐 패브릭패턴 가죽소파/리클라이너 쇼파,399000,179100,-219900
2018-06-01,989043430,A011040,보리쌀,[월드그린] 한드레 찰현미 4kg,13800,10540,-3260
2018-06-01,127825804,I011010,TV,LG 패널 자비오TV UHDTV 43인치TV 42인치TV 50인치TV,280310,269000,-11310
2018-06-01,648882857,L012030,칫솔,페리오 엑스트라 딥클린 칫솔 10입 x 2개 (택일),8900,8900,0
2018-06-01,675658642,E021010,침구,직접생산 자연섬유/피그먼트/침구세트/사계절이불,29900,29900,0
2018-06-01,848789123,C011030,남자학생복,by STCO 코디갤러리 18ss신상 셔츠/팬츠,10000,10000,0
2018-06-01,901225267,E061020,섬유유연제,[아토세이프] 섬유유연제2.5L*4개(핑크로즈향)+(증정)밀크코튼 50ml 2개,14900,7900,-7000
2018-06-01,989018413,A012010,국산쇠고기,홍성한우 안심스테이크 300g 1등급,40000,38300,-1700
2018-06-01,1242770959,G022020,자동차타이어,넥센타이어 SUV CP521 235/55R18 정품 무료배송,81700,69020,-12680
2018-06-01,989043429,A011040,보리쌀,[월드그린] 한드레 현미 4kg,12000,9400,-2600
2018-06-01,242600335,I053010,공책,유어 스페이스 저널(Your Space Journal) 제본공책 프,16800,16470,-330
2018-06-01,759429970,A013140,북어채,[서래푸드] 자연건조 황태채 300g/황태포/황태머리,8900,8900,0
2018-06-01,1163688287,C011030,남자학생복,AG 빅사이즈 바투스 청남방 BW 남성용데님셔츠 셔츠,68340,68340,0
2018-06-01,1397946836,A012010,국산쇠고기,두레생협 통오리(2kg/냉동/미소),51790,50760,-1030
2018-06-01,42789041,E011040,소파,아로미가구 티파니 소가죽 기능성 4인용쇼파,459000,459000,0
2018-06-01,1413695471,C013020,티셔츠,뒷면레이스망사나시티/민소매/섹시/무지/면/기본/망고,6900,6900,0
2018-06-01,938095229,A016020,배,자연농부 달콤시원 나주배 선물세트 6호 7.5kg(12과),68900,66840,-2060
2018-06-01,894759236,A018020,사탕,담라 어소티드 소프트캔디2kg/카라멜/투시팝/막대사탕,8300,8300,0
2018-06-01,465439092,L012090,기초화장품,라네즈 워터뱅크 아이젤 25ml 눈가케어 아이케어 보습,53670,51530,-2140
2018-06-01,895829129,F012020,생리대,[LG]LG 바디피트 울트라 날개기획 (32P+16P+12P),15990,11900,-4090
2018-06-01,921106658,F012020,생리대,바디피트 천연코튼 팬티라이너 40PX4팩/생리대/한결,9900,9900,0
2018-06-01,385566512,C011030,남자학생복,오투아이스_쿨링타올 대형2개,43650,41040,-2610
2018-06-01,1974510414,C012030,여자상의,[패션24시30%쿠폰][세인트마리] 여름 신상 정장원피스,51500,49900,-1600
2018-06-01,2058208587,E041010,식기,[라면기 나눔접시]메이슨자 머그컵세트 돌잔치답례품,2500,2300,-200
2018-06-01,398611406,C013050,운동복,고타고 종이화장실/양변기/휴대용/고타고/대형/변기,34300,33620,-680
2018-06-01,901225201,A013140,북어채,초이스L황태실채(팩) 100G,8990,8990,0
2018-06-01,901225202,A013140,북어채,초이스L 황태포 (1미/50G),5990,5990,0
2018-06-01,1628661690,E061080,키친타월,크리넥스 안심 키친타올 120매 4롤 3팩,10000,10000,0
2018-06-01,1562265183,E061010,세탁세제,비트 3kg x 2개/ 3개 세탁세제 스파크 슈퍼타이,13500,12700,-800
2018-06-01,1265828097,C013040,청바지,6부트랙데님팬츠(18329-411-02 03) 2종 중 택1/ 알로봇,69000,56580,-12420
2018-06-01,1840023027,C021040,실내화,나이키 아디다스 운동화/슈퍼스타/에어맥스/루나,39900,39900,0
2018-06-01,545844385,C013020,티셔츠,구름넥포켓면티/오프숄더/기본/심플/무지/라운드/.,5900,5900,0
2018-06-01,895805169,A019130,스프,[동원]동원 양반 쇠고기죽 285g,2490,2290,-200
2018-06-01,2002712795,A018100,꿀,잡화꿀 (다드림 2K),30350,27020,-3330
2018-06-01,2032937562,C012040,여자학생복,빅사이즈 남성 여성 탭스 라운드 반팔 티셔츠 티 셔츠,10700,10700,0
2018-06-01,1539252965,C011050,남자내의,남녀공용 냉장고바지/아이스바지/쿨바지/린넨바지,4900,4900,0
2018-06-01,774509761,C013020,티셔츠,데일리 민소매티셔츠/나시/끈나시/크롭나시/홀터넥,7000,6800,-200
2018-06-01,731469345,C013010,점퍼,[정상가 : 199 000] 히든여밍 핸드메이트 코트(AH4WTW01)/ 랩,69000,58650,-10350
2018-06-01,1498184273,A018050,비스킷,오리온 초코파이/카스타드/몽쉘/오예스/빅파이x4곽,7800,7800,0
2018-06-01,2086141052,E011040,소파,2인3인소파 베드모음/좌식소파/업소용소파/패브릭소파,185000,185000,0
2018-06-01,1629433703,A019040,소금,초미립자 천일염 양치 소금 120gx2개,10000,9900,-100
2018-06-01,508378608,C011030,남자학생복,신상 프리미엄 남성셔츠 특가/캐주얼/남방/정장셔츠,19500,19500,0
2018-06-01,957072878,C013040,청바지,여름 청바지 남자 남성 밴딩 스키니진 스판 찢어진,17800,17800,0
2018-06-01,1624068368,C011050,남자내의,봄신상 남자 팬츠모음/슬랙스/면바지/청바지,11900,11900,0
2018-06-01,150371322,A013070,굴,와이에스 냉동절단꽃게M 450gx12개,59250,59250,0
2018-06-01,246664348,E031110,청소기,삼성 싸이클론 진공청소기 VC33M4111LY / 오늘발송,175800,175800,0
2018-06-01,915875981,A013070,굴,★영덕대게500g A급 5마리(총2.5kg)★영덕산지선주직송/생생하게 살아있는 생물/해산물,139900,139900,0
2018-06-01,2111092463,A013060,게,싱싱 원양산 선동 포크오징어 한박스 20kg 냉동오징어,165900,165900,0
2018-06-01,1386601521,C012040,여자학생복,DAP1468 하찌 롱 심플 조끼 803 니트조끼 조끼 여성패,35730,35730,0
2018-06-01,326997786,A013080,조개,두레생협 냉동굴(400g) 냉동굴 굴 두레생협냉동굴 두,15290,15290,0
2018-06-01,1912302451,C011030,남자학생복,남자셔츠 차이나카라 포켓 반팔셔츠 J0417020,21420,21420,0
2018-06-01,833311768,C011030,남자학생복,[게스_VIP]남여공용 삼각 자수포인트 라운드 반팔티(NI2K6432),22400,22400,0
2018-06-01,983208688,L012030,칫솔,백선생 왕타칫솔 모음전,14800,14800,0
2018-06-01,1240838130,C013050,운동복,아스토레 쉘 4 우븐자켓(LM)-레인자켓 상의자켓 운동,58250,58250,0
2018-06-01,2037868812,A022010,주스,하늘내린 인제 오미좋아 오미자주스(110ml x 20봉),20000,19500,-500
2018-06-01,1306766422,C013050,운동복,DDM커스커즈 3D 루프백 차루프백 자동차루프박스 캠핑,189110,172250,-16860
2018-06-01,1782984905,I012060,저장장치,마이크로소프트 클래식 인텔리 마우스 NEW 익스3.0,46200,43430,-2770
2018-06-01,2005150576,C011020,남자상의,(무료배송) AG 남성자켓 마이 DB786 쥐색보카시 빅사,208920,183850,-25070
2018-06-01,1372450797,C012040,여자학생복,[엽페][엽페] collar frill knit_navy,60800,57760,-3040
2018-06-01,1664495927,A017280,김,초생강(백색 참존 1.2k)X10,33110,33110,0
2018-06-01,2017315824,I031040,생화,[09피싱]머모피 독거미/은성 해풍기플러스/바다릴대,90000,75600,-14400
2018-06-01,2109401811,C012040,여자학생복,[모다아울렛][멜로디가든]망사 레이스 로브 M8M4C17 아이보리,32000,30400,-1600
2018-06-01,717905557,F012010,종이기저귀,[11ST 단독특가] 보솜이 팬티기저귀 전라인 4팩,30900,30900,0
2018-06-01,376356120,E041010,식기,도자기그릇 /밥그릇 생선 접시세트 그릇세트 주방용품,5900,5430,-470
2018-06-01,1435229860,C011050,남자내의,팀 클럽 커프 팬츠(658679050) 트레이닝팬츠 운동복,58570,58570,0
2018-06-01,1368551058,E061010,세탁세제,미국산 암앤해머 베이킹소다 6.12kg /세척 위생 청소,11300,11300,0
2018-06-01,261241285,A019170,냉동식품,1+1 아하만두 꼬물이 물 왕 군 감자 메밀 곤드레 전병,15000,15000,0
2018-06-01,451144596,A019010,고춧가루,가을 특 고추가루 2.5kg2개 가루 고추가루 가을고추,93490,84150,-9340
2018-06-01,1775038674,F011130,홍삼,정관장 홍삼분(90G),40000,40000,0
2018-06-01,1458088963,L012010,면도기,쉬크/프로텍터3 면도날 8입+면도기 증정 미세 안전망,10500,10500,0
2018-06-01,1171373902,E031070,에어컨,천장용 리모컨형 FCR-65 회전/회전정지기능,62500,59380,-3120
2018-06-01,1250306955,C013050,운동복,코리아 울트라파워9인치광택기 12V전용/차량용 광택기,55900,54230,-1670
2018-06-01,50700850,A011020,현미,[거시기장터]2017년 햅쌀 쌀의1번지 찹쌀 10kg/20kg,30300,30300,0
2018-06-01,447514906,C013020,티셔츠,라이크 가방 쉬폰티셔츠 SD-4131 여성티 반팔티셔츠,6450,6450,0
2018-06-01,2147174788,A014020,분유,[LG생활건강]AK 단독 베비언스 액상분유 12-24개월(3단계) 32개입,51840,49240,-2600
2018-06-01,603140165,F012010,종이기저귀,[마미포코] 마미포코 쿨썸머그린 팬티기저귀 특대 여아 28매X3팩,36900,36900,0
2018-06-01,34387184,E021010,침구,피그먼트 간절기이불/봄이불/간절기이불/침대패드,23300,21440,-1860
2018-06-01,1923248322,C013020,티셔츠,골프/등산/레저용 이너웨어 스판 반폴라 티셔츠 A232,19000,18810,-190
2018-06-01,1320535504,E011020,침대,프리미엄 패밀리침대 Q+Q 오픈형 20T라텍스 매트리스,897400,870480,-26920
2018-06-01,363757417,C013050,운동복,봄신상트레이닝SET특가 트레이닝 체육복 운동 요가,19900,19900,0
2018-06-01,2144941716,C021020,구두,MBT 마사이워킹 보시 블랙/체스트넛,198000,178200,-19800
2018-06-01,1070156717,E041050,냄비,[홈쇼핑] 단독행사 컬링스톤 냄비/후라이팬,49900,49900,0
2018-06-01,946796273,A015010,참기름,국산 생들기름 국산 참기름 국산 들기름 볶은통참깨,15500,15500,0
2018-06-01,895805077,A022060,혼합음료,[광동]광동 비타500 100ML*20입,12000,12000,0
2018-06-01,265567337,I053010,공책,클래식 양장노트 유선 예쁜하드커버유선노트 예쁜유선,10500,10500,0
2018-06-01,411481616,C012040,여자학생복,컨택유 가벼운 글램 라인 5부 니트 #105649/ 컨택유,21800,16570,-5230
2018-06-01,1527915129,C021020,구두,[SODA] 남성화/캐주얼 기본 스타일모음 15종택1,74900,59920,-14980
2018-06-01,1574369078,C013020,티셔츠,토끼소녀긴팔티 /프릴치마포인트/퍼프소매여아티셔츠,28900,18900,-10000
2018-06-01,1073603794,E051020,건전지,라이칸 에어 L2 자전거 라이트 랜턴 손전등 전조등,38000,38000,0
2018-06-01,1404497807,C013050,운동복,모비스 크루저 루프백 차량루프백 캠핑루프백 차량용,259660,236510,-23150
2018-06-01,386423759,C021020,구두,로하 샌들 LKR2723 여자샌들 여성샌들(YA02004),58200,54710,-3490
2018-06-01,703487196,A014030,치즈,슬라이스치즈100매/50매/체다/카페용/업소용/대용량,12300,11900,-400
2018-06-01,1088347575,C021010,아동화,[수아봉봉] 아동화 아동운동화 여름운동화 아동샌들,18800,18800,0
2018-06-01,1766550281,A017090,열무,청정 자연건조 삶은 무우청 500gx3개 양구시래기 무청,34900,34900,0
2018-06-01,915378216,A014030,치즈,건국 자연치즈 99.5% 모짜렐라치즈 1kg 피자치즈 초특급할인가,9900,9900,0
2018-06-01,1025320817,A012060,햄및베이컨,사조 런천미트 1800g / 롯데 로스팜 1800g,12900,12900,0
2018-06-01,768804217,L021020,장신구,실버 귀걸이 B18SE2025/ 바쵸바치(주얼리),78000,70200,-7800
2018-06-01,827152576,A012010,국산쇠고기,[무항생제 한우선물세트]VIP 한우지애 2호 2kg/1+등급,212700,212700,0
2018-06-01,1546158099,A018080,설탕,유기농 비정제설탕 마스코바도10kg,52000,49000,-3000
2018-06-01,895829062,A014030,치즈,서울 슈레드 피자 치즈 멀티팩 (300G),6300,6300,0
2018-06-01,1672364171,E031010,전기밥솥,딤채쿡위니아 6인용 레트로 IH압력밥솥 EDCH-C0606DCV,269000,260000,-9000
2018-06-01,740247651,E041070,밀폐용기,글라스락 사이즈별로 골라잡아 밀폐용기 반찬통 양념통 이유식 대용량 김치통 초특가할,1900,1750,-150
2018-06-01,1179710073,C013010,점퍼,[메이드]레더자켓/가죽자켓/라이더자켓야상/남자/남성,39800,39800,0
2018-06-01,1812141799,L021060,유모차,진화된 미래형 유모차 기내반입 휴대용 세스토라이트T,210000,210000,0
2018-06-01,109703684,A011010,쌀,17년 햅쌀/김제 공덕농협 왕겨숯미20kg백미,47500,47500,0
2018-06-01,387460246,A017230,마늘,싱싱하게! 18년 햇 양파/자색양파 5kg/10kg,4900,4900,0
2018-06-01,796055541,L012010,면도기,특가/질레트 프로글라이드 파워 면도날 X 8개,35800,34800,-1000
2018-06-01,895893641,A013160,맛살,CJ 주부초밥왕기획 320G,4390,3790,-600
2018-06-01,1638207087,C012030,여자상의,여름 예쁜 롱원피스 린넨 랩 쉬폰 레이스 여성 빅사이,18900,17900,-1000
2018-06-01,409574242,C013010,점퍼,[ARMANI EXCHANGE(아르마니 익스체인지)]서클로고 시어서커 재킷(A418110013)(본점),208600,182110,-26490
2018-06-01,1914173265,F011120,인삼,(장생농산장수산삼 10년근 10주(10뿌리) 7년근 산삼,783970,760460,-23510
2018-06-01,899497423,A016060,감,SF)참외 (2KG/박스),19900,19900,0
2018-06-01,898569123,A019080,고추장,해찬들 우리쌀태양초고추장 2.5KG,28500,28500,0
2018-06-01,1610466021,C015020,모자,큰모자/빅사이즈모자/야구모자/대두볼캡/무지,14900,13900,-1000
2018-06-01,951476976,C012040,여자학생복,[유니클로] (중고 여44~55) UNIQLO 그레이 스트라이프 브이넥니트,17000,16500,-500
2018-06-01,129259049,A013170,생선통조림,유동 번데기캔 130g X 48EA_1BOX 번데기통조림 맛있는,58100,58100,0
2018-06-01,2005076095,E041060,수저,수저 포크 나이프 모음/커트러리 티스푼 양식기세트,500,480,-20
2018-06-01,855399558,A016150,아몬드,2017년산 햇 아몬드1kg(500gX2) 슬라이스 볶음/견과류,12900,12900,0
2018-06-01,394693378,C013050,운동복,미즈노 베이직 트랙 수트 세트(P2MC601014-P2MD601214,111030,111030,0
2018-06-01,407872088,C012030,여자상의,[대구제이제이]여름/빅사이즈/루즈핏/롱/원피스/티,27000,27000,0
2018-06-01,1385829869,C013010,점퍼,KJN-NW100R 남자레쉬가드요가복후드집업상의 후드집업,32510,32510,0
2018-06-01,831418523,C014010,아동복,[ASK주니어]JA2MTR354ML (화이트) 벌레 프린팅 티셔츠,10000,8500,-1500
2018-06-01,498606860,C012040,여자학생복,[오조크]다이아몬드 패턴니트(715-14138) (기존가:129000원),49000,43120,-5880
2018-06-01,345036579,C013050,운동복,나비날개 차량용 도어가드 4P차문보호/ 미니도어가드 카도어가드 자동차도어가드몰딩,5400,4300,-1100
2018-06-01,1751082160,C013050,운동복,트레이닝 팬츠 추리닝 긴 바지 일자 부츠컷,18000,16800,-1200
2018-06-01,957503315,E051020,건전지,[에너자이져]에너자이저 충전지 (AA/2입),11900,7990,-3910
2018-06-01,391895043,C013050,운동복,푸조 남여공용 니트 트레이닝 세트(FZ135-1) 트레이닝,76130,76130,0
2018-06-01,1964733042,E061030,전구,금호전기 LED등기구/형광등/LED일자등/거실등/주방등,23900,23900,0
2018-06-01,1295899281,A021010,커피,칸타타 분쇄 원두커피 900g/800g/600g/대용량/5종선택,14900,14900,0
2018-06-01,1492514141,A011090,국수,컵라면 소컵 6개/진라면/스낵면/삼양라면/불닭볶음면,2900,2900,0
2018-06-01,1005631429,F011130,홍삼,[농협홍삼/한삼인] 아이홍삼 2단계 25ml*30(750ml),100400,100400,0
2018-06-01,1249350211,F012020,생리대,[시크릿데이]산모패드 4팩/팬티라이너/생리대,6900,6900,0
2018-06-01,1036124887,C012040,여자학생복,레이스 넥카라 IX8MF001/ 코인코즈,37920,37920,0
2018-06-01,631918614,A016060,감,달콤샤르르 자연그대로 만든 아이스 홍시 18개(컵)/개,34300,30190,-4110
2018-06-01,901191481,A021010,커피,동서맥심 화이트골드믹스 100T*11.7G,15500,15500,0
2018-06-01,1436672065,F012020,생리대,시크릿데이 생리대 샬롯 울트라 날개 슈퍼롱 오버나이트 5PX8팩,12900,12900,0
2018-06-01,901191482,A021010,커피,동서 맥심 화이트골드믹스 20T*11.7G,3990,3990,0
2018-06-01,2021927445,L012090,기초화장품,뉴트로지나 딥클린 클렌징 크림285ml/매장용정품,5680,5680,0
2018-06-01,901191480,A021010,커피,[동서]동서 맥심화이트골드믹스 180T+ 20T증정,25900,21900,-4000
2018-06-01,1012501329,L021020,장신구,실버 체인 남자 여자 검지 중지 링 은반지 친구 선물,80000,80000,0
2018-06-01,876855214,E061030,전구,LED 다운라이트 매입등 15W 6인치 조명 전구 LG칩,4700,4700,0
2018-06-01,1246126,A012040,닭고기,[오쿡] 훈제 닭가슴살 3kg (200g*15팩),26900,26900,0
2018-06-01,1921477194,G011070,자전거,삼천리 하운드 아동용/어린이자전거 코코키즈16/18형,97000,87300,-9700
2018-06-01,813540883,C014010,아동복,끈댕기롱원피스/여아롱원피스/민소매롱/아동복/원피스,9900,9900,0
2018-06-01,1005631430,F011130,홍삼,[농협홍삼/한삼인] 아이홍삼 1단계 20ml*30(600ml),80300,80300,0
2018-06-01,1005631432,F011130,홍삼,[농협홍삼/한삼인] 안심홍삼순 50ml*30포*2상자,66300,66300,0
2018-06-01,1204445933,C013020,티셔츠,[마인드브릿지]CP쿨피케가로배색카라티셔츠MSTS3142NA,39900,31530,-8370
2018-06-01,135265203,A012010,국산쇠고기,신선 간장닭갈비 1kg3개,51790,50760,-1030
2018-06-01,628002774,C013010,점퍼,[시에로]꽃모티브 장식 다이마루 집업 자켓(SC3JPF044),104650,85820,-18830
2018-06-01,1005631433,F011130,홍삼,[농협홍삼/한삼인] 안심홍삼순 50ml*30포*3상자,99400,99400,0
2018-06-01,1208253236,C013020,티셔츠,웨건 여름 반팔 면 티셔츠 헨리넥 카라셔츠,8900,8900,0
2018-06-01,149668381,C012040,여자학생복,인기신상 셔츠 롱남방 쉬폰 여름블라우스 특가모음전,16900,16400,-500
2018-06-01,134888367,A011100,라면,오뚜기 옛날당면 1kg/오뚜기 옛날 자른당면 1kg/당면,6900,6900,0
2018-06-01,1573417653,E031070,에어컨,신일 천장선풍기 SIF-16CSH 천장형 천정형 선풍기,57800,57800,0
2018-06-01,320563861,A017230,마늘,해풍맞은 제주산 조생 햇 양파 5kg 10kg 단독 7일특가,16900,16900,0
2018-06-01,1311046446,E011050,책상,접이식 원목 테이블 좌식 책상 나무 독서대 책 받침대,14400,14400,0
2018-06-01,2127739893,C011050,남자내의,봄신상 면바지/일자 남자옷/슬랙스스키니/빅사이즈,15800,15800,0
2018-06-01,2112259671,C011030,남자학생복,남성 여름 히든셔츠/린넨셔츠/마/리넨/차이니/헨리넥,19000,19000,0
2018-06-01,656946816,E041030,솥,풍년압력솥모음전 압력밥솥 메가펄 뉴블랙펄 뉴비엔나,57900,57900,0
2018-06-01,861979488,A022030,생수,초정탄산수 1.5Lx12병/500mlx20병/트레비/씨그램,14360,14360,0
2018-06-01,1136106926,A019160,밑반찬,솔거절임 산고추 1kg-산노을/고추절임,5900,5900,0
2018-06-01,197267015,E041050,냄비,리빙아트 통3중 이유식냄비/밀크팬/스텐냄비/편수냄비,16900,15900,-1000
2018-06-01,2141386213,F012010,종이기저귀,[보솜이] 소프트슬림 3단계 중형 공용 밴드형 42매 4팩,30900,30900,0
2018-06-01,990093618,A013050,오징어,구울필요없는 구운고등어 110g*10팩,28900,27000,-1900
2018-06-01,895712906,A011110,당면,CJ 노릇하게잘구워지는부침두부300G,1490,1000,-490
2018-06-01,298458783,C012030,여자상의,[데이바이쏭]루즈핏 펀칭레이스 브이넥 반팔 원피스,28000,28000,0
2018-06-01,1005631401,F011130,홍삼,[농협홍삼/한삼인] 홍삼성분캅셀골드 180c,72300,72300,0
2018-06-01,1005631400,F011130,홍삼,[농협홍삼/한삼인] 뽀로로홍삼키젤 15g*56(840g),80300,80300,0
2018-06-01,990093621,A011120,두부,농심 켈로그 허쉬초코크런치 500G,8350,8350,0
2018-06-01,1914175895,F011120,인삼,(장생농산장수산삼 10년근 7주(7뿌리) 선물용 부모님,565220,548270,-16950
2018-06-01,1005631403,F011130,홍삼,[농협홍삼/한삼인] 1+1 홍삼녹용진액 60ml*30(1 800ml),158600,158600,0
2018-06-01,895712907,A011110,당면,[CJ]CJ 양념이 잘배는 찌개두부 300G,1490,1000,-490
2018-06-01,1126377298,E021020,커튼,롤러블라인드 그레이 스콕스클뢰베르 140x195 cm/ 블,78720,70070,-8650
2018-06-01,1005631406,F011130,홍삼,[농협홍삼/한삼인] 연홍선물세트(홍삼순액골드+봉밀절편홍삼+홍삼양갱),105400,105400,0
2018-06-01,1011058796,A018100,꿀,[백화농원] 한국양봉협회 인증 1등급 야생화벌꿀 1kg(튜브),25900,19700,-6200
2018-06-01,2122804043,I012010,컴퓨터,LG데스크탑 Z71EV-AX7506 코어i5 4G 1TB 윈도우없음,732970,689000,-43970
2018-06-01,1931244290,G011070,자전거,알톤 코렉스 HCR 24 / 시마노 원터치 24단/RCT 썸탈,239000,210800,-28200
2018-06-01,1011058797,A018100,꿀,[백화농원] 한국양봉협회 인증 1등급 아카시아벌꿀 1kg(튜브),29900,23000,-6900
2018-06-01,1517093465,E041030,솥,풍년 뉴 블랙펄 뉴하이클래드 IH하이브 압력밥솥 세원,72000,69840,-2160
2018-06-01,1238102481,C012040,여자학생복,[토마토팩토리][토마토팩토리] 후드 롱 비치가디건여름로브쿨,15900,15110,-790
2018-06-01,624194945,A021020,차,테이크아웃용 종이컵/투명컵 홀더 (골판지)1박스(1000개)/,25000,25000,0
2018-06-01,1011058794,A013100,마른멸치,[통영앞바다]싱싱함을 그대로 키조개 관자 200g,16900,11900,-5000
2018-06-01,1894203464,L021030,가방,천연가죽 서류가방/노트북가방/남성서류가방/남자가방,29900,29900,0
2018-06-01,1011058795,A018100,꿀,[백화농원] 스위트 허니 국내산 벌꿀 1kg,14900,9600,-5300
2018-06-01,1346140057,A014010,우유,엿기름(성진 1K)X10개/엿기름가루 식혜재료,54850,52110,-2740
2018-06-01,443574676,A011180,파스타면,스파게티(앙카라 면사랑 500g)X20,40570,40570,0
2018-06-01,2125292168,C012060,여자내의,꾸제꾸제/JIGOTT 청치마/허리 26/스커트/데님/진청/워싱/세일/브랜드/빈티지/구제/중고,18900,18900,0
2018-06-01,1079150139,A016120,바나나,아침 식사대용으로 굿~바나나 4.5kg(3~4다발),10900,10900,0
2018-06-01,1385830895,A011160,빵,안흥찐빵마을 수제 슈크림찐빵 500g(10입) 3봉 주전부,36920,36920,0
2018-06-01,308195973,E031070,에어컨,실링팬 날개형 52인치 우드 BIG THINK 천장,79000,79000,0
2018-06-01,1310143183,E031030,전자레인지,[LG전자] LG전자 MW23GD 23L 인버터 전자레인지 (주)대명,130000,130000,0
2018-06-01,2083826892,E011040,소파,1인소파 패브릭소파 스타일소파,98800,98800,0
2018-06-01,1115105480,C012040,여자학생복,루즈핏 롱 박시셔츠 남방 빅사이즈 체크 스트라이프,21800,21800,0
2018-06-01,1692789811,I031040,생화,버켄스탁&타푸코 쿨러백/보냉백 쿨링백 아이스박스,12800,11400,-1400
2018-06-01,1718254499,C013040,청바지,슬림9부/반스키니/남자청바지/카고팬츠/데미지진,26000,26000,0
2018-06-01,869885113,E051020,건전지,[정품/파나소닉에네루프/eneloop]파나소닉 에네루프 AA/AAA/건전지/충전지/배터리/충전,12900,12900,0
2018-06-01,559015729,A014030,치즈,DS042/고르곤졸라 피칸테치즈150g 가공식품 조미료 소,20120,20120,0
2018-06-01,1308948863,I031010,장난감,PSVITA 본체 신형+액정필름 증정/플레이스테이션 비타,229470,218000,-11470
2018-06-01,1043260545,A011160,빵,수제 쌀 찐빵 하얀봄빵X8개 외13종 아이간식 유아간식,12800,12800,0
2018-06-01,1172587572,C013010,점퍼,JK442 루즈핏 투버튼 버클 자켓 버튼자켓 여자자켓 여,59240,59240,0
2018-06-01,1074854391,E061060,살충제,애경 방충선언 향기방충 옷장용/서랍장용 6개월용,3500,3500,0
2018-06-01,1474876229,C012030,여자상의,여름원피스 프릴원피스 나시원피스 스판 미니원피스,9900,9900,0
2018-06-01,1837874166,D031010,주택수선재료,[10+1풀바른벽지]소폭합지(폭53cm)포인트/도배지,490,490,0
2018-06-01,954790416,A016100,수박,하우스 밀감 (700g/팩),14900,10900,-4000
2018-06-01,691021866,A017170,풋고추,(전남오픈마켓/남도농산)덖음여주50g×4개/덖음여주+여주티백차세트/여주/국내산/국내,25000,25000,0
2018-06-01,1068661792,A016150,아몬드,아몬드가루100%/아몬드분말/300g/500g/1kg/마카롱용,7500,7500,0
2018-06-01,1193985705,C013040,청바지,[쥬니블리]여름에도 러블리한 캐주얼세트 14종,16900,16900,0
2018-06-01,1306884367,L012090,기초화장품,1+1 비욘드 키즈 샴푸/폼/워시/ 샴푸60ml 사은품 증정,20900,20900,0
2018-06-01,1430081769,C014010,아동복,노스페이스키즈 히말라야 더블 다운 자켓 NJ1DI54T,748000,698000,-50000
2018-06-01,1449104715,C012040,여자학생복,[대구백화점 I관] [레코브]여운가디건(LZ3182KC503X),55800,53010,-2790
2018-06-01,147270032,C011030,남자학생복,다니엘크레뮤 17SS 스마트 쿨맥스 셔츠 3종,47200,47200,0
2018-06-01,1629663905,A019170,냉동식품,[동원]개성 왕새우만두 4봉+교자만두4봉 외 냉면/간식,17700,17000,-700
2018-06-01,896639437,A015020,식용유,[해표]해표 대두유 1.8L+500ml 증정기획,7500,7500,0
2018-06-01,358032834,C013010,점퍼,빅사이즈 804 라운드 마 벨트 자켓 DMS1898 빅사이즈,66770,64770,-2000
2018-06-01,23559524,A011010,쌀,2017년햅쌀 보성농협 보성다향미20kg/쌀20kg/백미현미,47900,47900,0
2018-06-01,300101260,A018060,스낵과자,미왕/쌀과자/10봉/고소한/바삭한/안주/미왕쌀과자,24400,24400,0
2018-06-01,1049790249,E031010,전기밥솥,CRP-CHS107FS/쿠쿠/IH압력/10인용/음성/GH,400000,371910,-28090
2018-06-01,255345402,C012040,여자학생복,[잇미샤] (ITI4ZPO970) 소매 레이스 프릴 풀오버,69300,62370,-6930
2018-06-01,157389906,A022050,탄산음료,음료수/캔음료/355ml24캔/뚱캔/사이다/트레비스파클링,12200,12200,0
2018-06-01,594926812,E011060,의자,하라체어 무가애E 학생 컴퓨터 사무실책상 사무용의자,59800,59800,0
2018-06-01,1844291392,E061020,섬유유연제,다우니 인퓨전 라벤더 드라이시트 105매/의류 건조기,12400,12400,0
2018-06-01,78620854,A011170,떡,[올찬농산] 제주탐나 팥 오메기떡 (50개입),35900,35900,0
2018-06-01,1010346789,A016130,키위,명절단독특가]나주햇살품은 신고배세트7.5kg (11-13과),49000,35000,-14000
2018-06-01,2013948854,C013050,운동복,KC인증 국산 에탄올 워셔액(1.8L)/6개/12개묶음,13900,13900,0
2018-06-01,1573358834,C013020,티셔츠,[와이드앵글] T_UP 메쉬소매 솔리드 티셔츠-WWM17242,52000,52000,0
2018-06-01,304584175,C013050,운동복,차량용컵홀더.트레이.자동차용품.음료테이블.차량용품,5800,5800,0
2018-06-01,335160079,C013050,운동복,GT 고급 안전 삼각대 반사리플렉터타입 차량안전삼각,12890,12890,0
2018-06-01,1885101692,F012020,생리대,바디피트 유기농순면 20Px2팩+gift키트/생리대/오가닉,9900,9900,0
2018-06-01,741102142,A017230,마늘,{햇 양파 특품 7900원} 18년산 햇 양파 3/5/10kg,4900,4900,0
2018-06-01,985294540,A021010,커피,[동서]동서 카누 디카페인 미니아메리카노 30T*0.9G,7490,7490,0
2018-06-01,1806064834,C012040,여자학생복,[끌레르뮤][끌레르뮤] 브루노 V넥 루즈핏 박시 니트,41800,34700,-7100
2018-06-01,1010346790,A016130,키위,명절단독특가]나주신고배세트7.5kg (9-10과),55000,39000,-16000
2018-06-01,1416073588,I012010,컴퓨터,[E]B70EV-AR73DR8/7세대/i3/8G/HDD500G/키보드+마우스,720000,684000,-36000
2018-06-01,1010346791,A016130,키위,명절단독특가]나주햇살품은 신고배세트7.5kg (7-8과),62000,44000,-18000
2018-06-01,501384132,A011030,찹쌀,민가네 2017년햅곡 국내산 늘보리쌀 1kg,3200,3200,0
2018-06-01,1199700476,C012040,여자학생복,[A+G]엣지 SUMMER18 썸머 보헤미안 블라우스 4종,78000,78000,0
2018-06-01,1135707815,C012060,여자내의,[나무그림]와이드핏(밴딩FREE)_린넨통바지/C18MIE0B067P5,29000,23780,-5220
2018-06-01,1076603305,C012060,여자내의,[미센스]컷팅 포인트 5부 데님 팬츠_M76SLM222Z,23700,20150,-3550
2018-06-01,324790024,C013010,점퍼,{17G2_18S0165}올오버집업/ 행텐주니어,5000,4700,-300
2018-06-01,790174892,C013050,운동복,에이몬 6726 휴대용 깜빡이 비상등,13400,13400,0
2018-06-01,822412518,A011070,혼식곡,백설 밀가루 (부침용)(1KG),1570,1570,0
2018-06-01,1656654631,E061060,살충제,마툴키/잡스/개미파워 바퀴벌레/강력한 바퀴 제거/한,13200,8850,-4350
2018-06-01,1185453930,L021020,장신구,슈팅스타 나이트 드롭 이어링/ 리타모니카,33000,29700,-3300
2018-06-01,1437687523,I031010,장난감,키성장완구 토이아띠/토이아띠/완구/승용완구/성장완,94900,94900,0
2018-06-01,1631433270,C013020,티셔츠,빅사이즈 박시트임맨투맨 WW1709 여성의류 임부복 빅,43390,43390,0
2018-06-01,1010346785,A016130,키위,명절단독특가]나주햇살품은 신고배세트5kg (10-11과 실속형),17000,12000,-5000
2018-06-01,1010346784,A022060,혼합음료,[CJ직배송] 한뿌리 흑삼정 로얄블랙 엑스(건기식  10g*30포),140000,140000,0
2018-06-01,1010346787,A016130,키위,명절단독특가]나주햇살품은 신고배세트5kg (6-7과 실속형),24000,17000,-7000
2018-06-01,1190180972,E011060,의자,(1+1)원목 식탁의자 2개세트/벤치/스툴/식당/업소/학원/카페/주방/등받이/커피숍/가구,43400,42400,-1000
2018-06-01,1010346783,A016130,키위,명절단독특가]나주햇살품은 신고배세트15kg (26-30과 실속형),36000,26000,-10000
2018-06-01,1126377267,E021020,커튼,롤러블라인드 그레이 스콕스클뢰베르 60x195 cm/ 블라,41100,36580,-4520
2018-06-01,445608406,I031040,생화,애완동물 자동차시트패드 애견패드,47250,43040,-4210
2018-06-01,149589903,E011030,거실장,[채우리] 코모레비 편백나무 원목 가습기 겸 수납박스,46000,46000,0
2018-06-01,1226086472,C012020,원피스,[리안뉴욕][AK분당점][리안뉴욕] 체크 포인트 오버핏 홑겹 자켓 RMEWLJ990,49000,46550,-2450
2018-06-01,1763247511,C011030,남자학생복,마크 후드 웰론 조끼밑단시보리 YKK 지퍼 패딩 착한 가격 좋은 의류 겨울 FW 패딩조끼,85350,85350,0
2018-06-01,2147174742,C012020,원피스,김발 겉대x20,20160,20160,0
2018-06-01,391246869,C012030,여자상의,유유존-미니원피스/클럽의상/섹시홀복/롱/나시,15800,15800,0
2018-06-01,1911832597,L012040,치약,브리오 천연 치약 / 임산부 어린이 유아용 16無 치약,15000,15000,0
2018-06-01,577216210,C013020,티셔츠,여성티셔츠 쉬폰 셔링 면 반팔 라운드 티 블라우스,7000,6900,-100
2018-06-01,1813208055,A013070,굴,★MD추천정품★조선대가 전통 간장 꽃게장 4.8Kg 간장게장/ 게장/꽃게/대게/킹크랩/밥,94000,93060,-940
2018-06-01,632895914,A011170,떡,전북고창 울어매 복분자송편 75개(25개 3팩) / 삼경복,66000,58080,-7920
2018-06-01,58209297,C012060,여자내의,T1765-지젤 나비 자수 티셔츠 브이넥티셔츠 자수티셔,63610,62340,-1270
2018-06-01,1311504587,C013040,청바지,[AND-Z by 지오지아] 여름 솔리드 멜란지네이비 정장바지 BZX2SP1102,50000,43500,-6500
2018-06-01,195506592,I031010,장난감,아이와 파워휠 전동오토바이(2모터장착),140000,128000,-12000
2018-06-01,1071385191,A013040,고등어,[여수고기]국내산 고등어/순살/한마리/반마리/3kg,19900,19900,0
2018-06-01,1011058734,E031070,에어컨,엠투)써큘레이터(M2-C2599),69900,39900,-30000
2018-06-01,610496078,E011040,소파,아로미가구 인조가죽 2인용소파 모음전,129000,129000,0
2018-06-01,1011058737,A013110,마른오징어,국물용멸치 기획 500G/봉,12900,12900,0
2018-06-01,1011058731,E031070,에어컨,마이)타워팬선풍기(MFTW-18M),89900,39900,-50000
2018-06-01,1011058732,E031070,에어컨,엠투)다오핸디형선풍기(M2G-200)(점포별 색상랜덤배송),9900,9900,0
2018-06-01,1444305945,C021020,구두,VA-130 남성 워킹화 등산화 효도신발 로퍼 남자신발,68570,61720,-6850
2018-06-01,404508387,A019160,밑반찬,체다슬라이스치즈 100매 모음/썬리치/동원/서울우유/,14900,14900,0
2018-06-01,1011058733,E031070,에어컨,엠투)좌석용선풍기(M2-3562),79900,29900,-50000
2018-06-01,1227541065,C013040,청바지,블루 밴딩 5부 일자 스판 청반바지 AP0527,23800,22800,-1000
2018-06-01,332401772,A011090,국수,삼양 까르보나라 불닭볶음면 10봉 까르보불닭,10500,10500,0
2018-06-01,114046499,C013020,티셔츠,빅사이즈 데일리룩후드티 WW01809 빅사이즈 미시옷 임,47470,47470,0
2018-06-01,2053228591,E061040,부엌용세제,세이프 주방세제 용기725ml+580x2 자연퐁 참그린 퐁퐁,10900,10900,0
2018-06-01,746236031,E031020,가스레인지,당일발송 SK매직 Eco버너 2구 가스렌지 GRA-C2080R,125000,114000,-11000
2018-06-01,537169918,C011030,남자학생복,오투웜발열자켓-프리미엄]발열조끼 등산,77600,77600,0
2018-06-01,1011058728,E031070,에어컨,마이)소형써큘레이터(MFSS-10MS),59900,29900,-30000
2018-06-01,1811273918,C021040,실내화,Shoeking 남여패션 운동화/ 런닝화/ 우븐슈즈 기획전,15800,7900,-7900
2018-06-01,1233905458,C012040,여자학생복,[공구우먼] 이지 오픈카라 린넨 반팔남방 29035 빅사이즈여성의류,29000,29000,0
2018-06-01,657395352,C011020,남자상의,균일가 봄 여름 정장바지 슬랙스 남자 남성 바지 정장,19800,19800,0
2018-06-01,1837563050,C012040,여자학생복,하얀비3000원쿠폰/린넨롱조끼/망사니트/정장롱베스트,13800,10800,-3000
2018-06-01,297327908,I031040,생화,파라솔킹260 230/엔젤썬라이트 파라솔/야외/테라스,46500,42780,-3720
2018-06-01,549546482,C012040,여자학생복,여성 라운드 니트 KKS 꽈배기언발 R,62000,61380,-620
2018-06-01,1503684300,C013040,청바지,[지오다노] 05418505 여 슬림핏 슬랙스,39800,33040,-6760
2018-06-01,133419619,E041050,냄비,요술 만능 조리기 유비쿠커/인덕션/하이라이트/전골,79000,79000,0
2018-06-01,432780030,E011050,책상,철제책상 조립식 1인용 사무실 좌식 입식 H형 컴퓨터,34900,32900,-2000
2018-06-01,1609590792,A013070,굴,다인 절단꽃게 5종 모음 손질꽃게 절단게,30000,30000,0
2018-06-01,258120230,A018090,잼,오뚜기 포도잼500gX12개(1박스) 블루베리잼 포도잼 딸,85910,85910,0
2018-06-01,735617648,E051030,디지털도어록,[빠른배송] 에버넷 디지털 도어락 EN570-N / 비밀번호,51600,39600,-12000
2018-06-01,502816361,C013020,티셔츠,커터앤벅 여성 간절기 봄 카라 긴팔티셔츠 7종 택1,39900,26620,-13280
2018-06-01,428621226,A011140,부침가루,[삼립] 삼립 초코무스 62g 3개 케이크 조각케익,6840,6840,0
2018-06-01,751229644,A014020,분유,[일동후디스]프리미엄 산양분유 2단계 800g 3캔,120000,120000,0
2018-06-01,1949542327,E041060,수저,방짜 유기 놋그릇 수저세트 젓가락 포크 숟가락,6900,6560,-340
2018-06-01,593129164,A012060,햄및베이컨,[오쿡] 신제품 출시 그릴 닭가슴살 5kg (200gx25개),46400,44400,-2000
2018-06-01,2079584827,C015040,장갑,봄 여름 남성 여성 등산 자전거 스포츠 장갑 반장갑,8900,8900,0
2018-06-01,603154778,A019070,양념소스,리코스 구어메이 나쵸치즈소스 3.11kg 파우치,20500,20500,0
2018-06-01,1845123558,D031010,주택수선재료,[노루페인트] 철재용 알루미늄 1액형 은분페인트 - 4L,28700,28700,0
2018-06-01,1099486353,A018100,꿀,베니폼파워토닉 15mlx30앰플 로얄제리 액상로얄제리,153000,151470,-1530
2018-06-01,305333579,A016020,배,신고배 실속선물세트 5kg 8-10과 나주배세트 과일세트,37500,37500,0
2018-06-01,1393304958,F012010,종이기저귀,리베로 기저귀/밴드형4단계 60매x3팩+물티슈70매,53500,53500,0
2018-06-01,254415307,C012040,여자학생복,꽃프린트 리본블라우스(715-84233)/ 오조크,45000,38250,-6750
2018-06-01,1011058705,E031070,에어컨,마이)리모컨좌석용선풍기(MF-1417SR),99000,44900,-54100
2018-06-01,342120716,L021030,가방,INTC-510X LG그램 삼성 맥북 노트북파우치 13/15인치,26000,24700,-1300
2018-06-01,1676198070,C021010,아동화,해피키즈 바퀴달린 운동화 아동화 휠리스 힐리스 신발,29900,29900,0
2018-06-01,1727346880,A021010,커피,자판기용커피믹스/국산차/아메리카노/초특가/이벤트,2500,2500,0
2018-06-01,1064679055,F011130,홍삼,웰라이프선물세트 대상홍삼을품은블루베리 50mlx30포 2017 추석선물세트 대상홍삼을품은블루베리 50mlx30포,19900,19900,0
2018-06-01,1011058704,E031070,에어컨,뉴그린선풍기(MFKA-A35M),79900,34900,-45000
2018-06-01,524546766,C013050,운동복,여자 비비드 트레이닝 상하의 세트 (머리띠포함),15500,15500,0
2018-06-01,1337282361,C013010,점퍼,밀리터리 후드 점퍼 MA1 BW후드점퍼점퍼빅사이즈점퍼,130710,130710,0
2018-06-01,927229562,C012030,여자상의,빅사이즈제한없는 여리여리핏 린넨원피스,15900,15900,0
2018-06-01,1433347340,A012010,국산쇠고기,[무항생제] 꼬리반골 2kg,41000,41000,0
2018-06-01,1797474111,E061080,키친타월,깨끗한나라 데일리키친타올130매x6롤x4팩=총24롤,14000,14000,0
2018-06-01,1867040331,A019140,이유식,[맘스푸드]미음부터 진밥까지200g유리병이유식,22500,22000,-500
2018-06-01,614459219,C013050,운동복,[3M] 3M 공업용수세미 마이티블루 1박스 100장/수세미/다목,117540,117540,0
2018-06-01,1624634186,E031020,가스레인지,렌지후드용 교환필터 1매입 10SET/ 렌지후드필터 레인,17000,15900,-1100
2018-06-01,1906298423,G022020,자동차타이어,넥센타이어 고급형 CP672 225/60R16 정품 무료배송,86600,73190,-13410
2018-06-01,1181724009,C013020,티셔츠,DGI1821 남자기본브이긴팔면티셔츠 남성티셔츠 남자티,7580,7360,-220
2018-06-01,1404786418,C013020,티셔츠,[더루비]여아/롱티셔츠/원피스/티셔츠/맨투맨/아동,11800,11800,0
2018-06-01,279133988,E011020,침대,에밀리 1층 철제 침대프레임 싱글 수퍼싱글(매트별도),99000,99000,0
2018-06-01,1682116387,C013020,티셔츠,여름신상/반팔티/반팔카라티/7부티/티셔츠/카라티,15800,14800,-1000
2018-06-01,1479281197,E061020,섬유유연제,아우라 명품 고농축 섬유유연제 1L x 6개 (택일),20900,20900,0
2018-06-01,31526079,C013020,티셔츠,15%쿠폰 반팔/티셔츠/밴딩팬츠/여름/셔츠/커플/7부티,9900,9900,0
2018-06-01,895771528,E051020,건전지,[에너자이져]에너자이져D형2입,5990,5990,0
2018-06-01,385652417,C011050,남자내의,남성반바지/면반바지/청반바지/카고반바지/밴딩반바지,12900,12900,0
2018-06-01,895771526,E051020,건전지,[에너자이져]에너자이져AAA4입,5590,4490,-1100
2018-06-01,1611482814,A022050,탄산음료,라무네 사이다도매 200mlx30병 한박스/산가리아라무네,40490,40490,0
2018-06-01,895771527,E051020,건전지,[에너자이져]에너자이져 C형건전지 2입,5490,5490,0
2018-06-01,688847479,C013010,점퍼,깔깔이/잠바/바지/내피용/작업복/낚시/단체복,6000,5900,-100
2018-06-01,188455940,I031010,장난감,벌쓰 유아 밸런스바이크 미니바이크 무소음 붕붕카,29900,29900,0
2018-06-01,707768651,C013050,운동복,자동차/사이드포켓/콘솔박스/틈새포켓/정리/수납포켓,8000,7180,-820
2018-06-01,508319985,C013050,운동복,/차량용 다용도 LED 경광봉(19.5cm×7cm)/ 경광봉 led경광봉 안전경광봉 미니경광봉 안,11700,10600,-1100
2018-06-01,79898289,I031010,장난감,PS4/PSVR 신형 본체 플레이스테이션VR 3번셋트/3번,471570,448000,-23570
2018-06-01,1260963820,C012060,여자내의,옆트임 롱롱스커트 DM-6414 면치마 미디스커트 롱치마,11390,11390,0
2018-06-01,1176410517,C012060,여자내의,SK1662-레이첼 프릴 스커트 FREE(44~66) 프릴치마 롱,39080,37130,-1950
2018-06-01,1004270849,C012020,원피스,데시데 분또배색 면스판 소재 슬림슬랙스 (DGW204),90000,72000,-18000
2018-06-01,1302715430,E031120,믹서,FDM301SS 켄우드 2in1 멀티 푸드 프로세서/ dk,149000,139880,-9120
2018-06-01,183776716,I011010,TV,상품평10만(공식파트너)삼성189cmUHD TV UN75MU6350F,3300000,2499000,-801000
2018-06-01,2117901830,L021010,손목시계,남성 손목시계 헨리코튼 메탈501,135000,135000,0
2018-06-01,899585834,A018060,스낵과자,[롯데]롯데 치토스 바베큐맛 (88G),1250,1250,0
2018-06-01,1210387016,C013010,점퍼,[트레몰로][TREMOLO] 남성 니트배색 요꼬에리 블루종_TRSCLTS2111,89000,84550,-4450
2018-06-01,988125672,E061010,세탁세제,초L) 베이킹소다 세탁세제 6KG,9990,9990,0
2018-06-01,988125673,E061010,세탁세제,초L프라임 자연담은 분말세제 3KG,9900,6990,-2910
2018-06-01,226578419,D031010,주택수선재료,[던에드워드]덤프록 약1L- 방수 및 곰팡이방지 페인트,25500,23460,-2040
2018-06-01,1475026507,C012040,여자학생복,[2001 OUTLET][VALLEYGIGL] 밸리걸 슬릿 롱 가디건(974820),14900,14610,-290
2018-06-01,371942012,E061030,전구,[무료배송]직관형광등 32W 40W/삼파장형광등/형광등,31900,31900,0
2018-06-01,657082179,A015020,식용유,오뚜기 식용유 18L /대상 쉐프원 식용유 18L,30900,30900,0
2018-06-01,369679972,A012060,햄및베이컨,한정특가 스팸200g 10캔 / 런천미트 30캔 통조림 햄,16790,16790,0
2018-06-01,2041560525,E011020,침대,전용깔판증정 패밀리침대 저상형침대,354000,354000,0
2018-06-01,328674977,A022050,탄산음료,음료수 175ml x 30캔/캔음료/탑씨/레쓰비/사이다/콜라,6270,5900,-370
2018-06-01,388170269,C015030,넥타이,(색상 : 네이비) BTIE_122 과녁 니트 보타이,15140,15140,0
2018-06-01,1315015698,F011150,건강기능식품,종근당 키드웰 어린이비타민칼슘360정/영양제종합,24400,24400,0
2018-06-01,467670350,C015040,장갑,(쟈가드남대) 눈꽃무늬 가볍고 편한 남성 손가락겨울,7890,7890,0
2018-06-01,473555034,I053030,복사용지,더블에이 A4 복사용지 A4용지 80g 2BOX,53900,46360,-7540
2018-06-01,1165223649,C013010,점퍼,[프랜치캣]Q83DKJ041 J051 J061 번아웃점퍼,35000,28700,-6300
2018-06-01,866982972,E011030,거실장,[풀씨]루트 로즈화이트 720x480 다용도 상 중 하이글로시,20000,20000,0
2018-06-01,866982971,E011030,거실장,[풀씨]루트 로즈화이트 800x600 다용도 상 대 하이글로시,22400,22400,0
2018-06-01,866982974,E011030,거실장,[풀씨]루트 로즈블랙 800x600 다용도 상 대 하이글로시,22400,22400,0
2018-06-01,866982973,E011030,거실장,[풀씨]루트 로즈화이트 600x400 다용도 상 소 하이글로시,17400,17400,0
2018-06-01,1608261254,L021020,장신구,실버)레이 체인 목걸이(50cm)주얼리 악세사리 기념일,49770,49770,0
2018-06-01,440318495,A018090,잼,오뚜기딸기잼 850gX8개딸기잼 식품 오뚜기 딸기잼 식,107600,94690,-12910
2018-06-01,866982976,E011030,거실장,[풀씨]루트 로즈블랙 600x400 다용도 상 소 하이글로시,17400,17400,0
2018-06-01,866982975,E011030,거실장,[풀씨]루트 로즈블랙 720x480 다용도 상 중 하이글로시,20000,20000,0
2018-06-01,467694346,C012040,여자학생복,체인 오버핏 쉬폰 블라우스 오버핏블라우스 체인블라,51990,46800,-5190
2018-06-01,766813129,C013010,점퍼,[TBJ]남여공용 기모쮸리 후드 집업 점퍼(T164TS400P)(센텀시티점),29000,25320,-3680
2018-06-01,430650604,C011050,남자내의,[지오다노] 118524 라이트웨이트 슬림 테이퍼드 치노/ 지오다노,26820,21730,-5090
2018-06-01,866982970,E011030,거실장,[풀씨]루트 골드브라운 600x400 다용도 상 소 하이글로시,17400,17400,0
2018-06-01,493974030,C012030,여자상의,기본루즈핏니트티 EB1711 라운드넥롱니트 빅라운드넥,37360,37360,0
2018-06-01,972524752,C012040,여자학생복,[조이너스][조이너스]넥장식 클래식블라우스-IJ6U5WBB259,27900,24560,-3340
2018-06-01,1838238798,C013010,점퍼,카라 하프패딩 자켓 초 경량패딩 오리털 봄패딩 점퍼,39800,39800,0
2018-06-01,2056577258,C013030,스웨터,양털 후드 남자후드티 후드 캐주얼후드티 남자양털후,38210,38210,0
2018-06-01,1972569562,L021030,가방,폴라리스 노트북 파우치 가방 케이스 11.6~15.6인치,12500,12500,0
2018-06-01,389067972,E011010,장롱,높이2m 프라임 장농/옷장/가구/이불장/수납/반장,69000,62100,-6900
2018-06-01,315547704,F012010,종이기저귀,[하기스] 하기스 매직핏 기저귀 4단계 공용 54px3팩,50400,50400,0
2018-06-01,866982969,E011030,거실장,[풀씨]루트 골드브라운 720x480 다용도 상 중 하이글로시,20000,20000,0
2018-06-01,866982968,E011030,거실장,[풀씨]루트 골드브라운 800x600 다용도 상 대 하이글로시,22400,22400,0
2018-06-01,899585806,L012070,바디워시,아모레 해피바스내츄럴촉촉바디워시 900ML,13600,3990,-9610
2018-06-01,210381891,E041050,냄비,백선생 라면냄비 / 편수냄비 냄비 삼겹살불판 뚝배기,16000,15200,-800
2018-06-01,800520616,C013040,청바지,[수비진] 봄/여름신상/청반바지/소문난 청바지/스키니,9900,9900,0
2018-06-01,580930372,C013020,티셔츠,스웨이드폴라티1 목폴라티셔츠 레이어드목폴라티 기본,13020,13020,0
2018-06-01,415904850,C013040,청바지,EX 1634 밴드 청반바지 청반바지 청5부 청 반바지 남,62260,61020,-1240
2018-06-01,243340400,C011030,남자학생복,[테이트](남) 골지 옆트임 니트베스트 KA8S1-MSP050[갤러리아],29950,23070,-6880
2018-06-01,1138660616,I031040,생화,[CTM] 야전삽 접이식 휴대용 야삽 다용도삽 캠핑용품,5500,5060,-440
2018-06-01,1762535194,A017110,감자,장흥표고_흑화고세트400g건강식품 명절선물세트 특산품 추석선물세트 효도선물 표고세,81440,81440,0
2018-06-01,866982967,E011030,거실장,[풀씨]루트 웨이브 600x400 다용도 상 소 하이글로시,17400,17400,0
2018-06-01,1233812770,A013120,낙지,정화 통오징어 숯불다리 50gx5.,21580,19210,-2370
2018-06-01,394082553,A016100,수박,수분가득 달달한 햇 수박 4-7kg,7900,7900,0
2018-06-01,1269735483,C012040,여자학생복,hh46 태슬 데님 뷔스티에 진청 조끼 뷔스티에조끼 캐,22010,22010,0
2018-06-01,1043519062,C013020,티셔츠,반팔 남자 카라 골프티셔츠 PK 남성골프웨어 HTST,24900,22170,-2730
2018-06-01,544639583,C012040,여자학생복,[샤틴]패턴포인트 하이넥 니트티셔츠(S181C933A핑크),79000,64780,-14220
2018-06-01,1807651597,C013010,점퍼,카모후드집업/바람막이/아동군복/유아동점퍼/사파리,33900,19900,-14000
2018-06-01,1119875471,A011030,찹쌀,흑보리 검정보리 800g / 국내산 100％,3200,3200,0
2018-06-01,1754495267,A019110,드레싱,[치즈몰]라베키아 발사믹비네거 블루라벨 250ml/20년산,69900,69900,0
2018-06-01,1754495268,A019110,드레싱,[치즈몰]라베키아 발사믹비네거 바이올렛라벨 250ml/15년산,59700,59700,0
2018-06-01,1754495269,A019110,드레싱,[치즈몰]라베키아 발사믹 젤리 140g,29700,29700,0
2018-06-01,1670366781,A013120,낙지,정화 통오징어 숯불다리 50gx5.,21600,19230,-2370
2018-06-01,447768596,C012040,여자학생복,[막스까르띠지오]울 캐시미어 라글란 니트가디건,162000,153900,-8100
2018-06-01,283510565,C014020,유아복,단가라 골지레깅스 유아레깅스 유아레깅스 유아바지,5060,4910,-150
2018-06-01,1754495266,A019110,드레싱,[치즈몰]라베키아 발사믹비네거 골든라벨 250ml/30년산,99900,99900,0
2018-06-01,1127124919,E021020,커튼,벌집블라인드 베이지 호프발스 60x155 cm/ 롤스크린,41100,36580,-4520
2018-06-01,1126196715,E021020,커튼,유로피안 프리미엄 플라워 모기장 커튼매쉬망 침대매,61040,61040,0
2018-06-01,1999961168,A013160,맛살,건맛살 (차오름 1K) X10,216770,192930,-23840
2018-06-01,298936313,C013010,점퍼,테이트TATE (KA8U4-MGJ020) 남성 아노락 후드 윈드브레이커,44950,37310,-7640
2018-06-01,21546670,F012020,생리대,템포 레귤러/슈퍼(100개입)+사은품/체내형생리대탐폰,29900,29900,0
2018-06-01,249370999,E031070,에어컨,리모컨선풍기 듀플레스 홍진테크 벽걸이선풍기,20900,20900,0
2018-06-01,1127124920,E011050,책상,/코너워크스테이션 화이트 미케 100x142 cm/ 코너책상,289540,257700,-31840
2018-06-01,431709632,L021020,장신구,14k핑크골드 꽃반지/큐빅세팅/프로포즈/JC43,150000,150000,0
2018-06-01,975073701,C013050,운동복,무쏘-미르웨이 후사경/4WD/RV용품/사각지대/후진주차/현대/기아/대우/쌍용,27000,24600,-2400
2018-06-01,1117143363,A021010,커피,[맥스웰하우스] 자판기용 /아로마/마일드믹스900g12개,50000,50000,0
2018-06-01,1635207875,C013010,점퍼,바람막이/기능성원단/등산/골프/초경량/홑/겹/빅,15800,15800,0
2018-06-01,1938368975,C013040,청바지,[게스]GUESS 남성_[기획] M톤 워싱 스키니(MI1D9060),70200,58970,-11230
2018-06-01,819651219,E031010,전기밥솥,[쿠첸正品] 쿠첸/원터치분리형/내외측한세트/압력패킹,15500,15500,0
2018-06-01,1311940999,C012040,여자학생복,프란체 체크 셔츠,14900,14900,0
2018-06-01,2060764465,C013020,티셔츠,밀레 반팔티셔츠,22000,19690,-2310
2018-06-01,854926422,C021040,실내화,키높이 스니커즈 여성 키높이 운동화 캔버스 슬립온,19000,17800,-1200
2018-06-01,1726380800,E031130,보온매트,(효암 온수보일러 카페트매트 대청마루 대형)거실용 온돌마루 온수매트 소음없는무동력,199000,189000,-10000
2018-06-01,1619862851,C012020,원피스,빅사이즈 울 코트 DB 97번 울코트 트랜치코트 모직코트 빅사이즈코트 코트 패딩코트,145650,129630,-16020
2018-06-01,1754495274,A019110,드레싱,[치즈몰]페라리니 발사믹 글레이즈 250ml /샐러드/드레싱/무침/요리/디저트,10900,10900,0
2018-06-01,483931045,C011030,남자학생복,당일발송 반팔/긴팔 솔리드 와이셔츠 남성 드레스,16800,14800,-2000
2018-06-01,1689160153,A011010,쌀,[오뚜기] 2017년 오뚜기 씻어나온 쌀 20kg/박스포장,49500,49500,0
2018-06-01,1195649163,C013020,티셔츠,[젤리스푼][젤리스푼] 캐티버블롱티셔츠_MO,10900,9810,-1090
2018-06-01,1754495271,A019110,드레싱,[치즈몰]폰티 발사믹 크렘 모스카토 (화이트 발사믹 글레이즈) 235g,11900,11900,0
2018-06-01,527247699,A017140,콩나물,도라지가루 200g 도라지효능 길경 도라지가루 도라지,18520,18150,-370
2018-06-01,1754495272,A019110,드레싱,[치즈몰]폰티 발사믹 글레이즈 500ml,12900,12900,0
2018-06-01,1754495273,A019110,드레싱,[치즈몰]빌라 빅토리아 살사모데나 발사믹소스500ml/샐러드/드레싱/무침/요리/디저트,12900,12900,0
2018-06-01,602611370,D031010,주택수선재료,미앤미 멀티 조립식마루 9p세트 모음 실내외 바닥재,29400,27930,-1470
2018-06-01,800965694,C012040,여자학생복,[대구백화점 I관] [캘빈클라인진]여성 소매패치 후드 집업가디건(J206977),118300,101740,-16560
2018-06-01,1172318055,A012010,국산쇠고기,명품 남선후계자 안동한우 1등급이상로스용모듬(500g),23900,23900,0
2018-06-01,866982943,E011030,거실장,[풀씨]400x1550 오마쥬 스탠딩 에칭 전신거울,29900,29900,0
2018-06-01,866982942,E011030,거실장,[풀씨]400x1500 오마쥬 스탠딩 프레임 전신거울,29900,29900,0
2018-06-01,895771503,E051020,건전지,[에너자이져]에너자이져AA4입,5590,4290,-1300
2018-06-01,1265544593,F012020,생리대,좋은느낌 솜솜 소중형 14P 특대형 12P 7팩 사은품증정,12900,12900,0
2018-06-01,866982945,E011030,거실장,[풀씨]루트 웨이브 720x480 다용도 상 중 하이글로시,20000,20000,0
2018-06-01,895771500,E051020,건전지,[에너자이져]에너자이져랜턴6V,5490,5490,0
2018-06-01,866982944,E011030,거실장,[풀씨]루트 웨이브 800x600 다용도 상 대 하이글로시,22400,22400,0
2018-06-01,895771501,E051020,건전지,[에너자이져]에너자이져 사각 건전지(9V),5490,5490,0
2018-06-01,1083984579,C021040,실내화,[리복Reebok] 남여 클레식 레더 베이직 운동화 - 2232,60100,50940,-9160
2018-06-01,663831330,I031040,생화,에어로젤 단열재 단열제 보온제 단열 보온 방수,5000,4600,-400
2018-06-01,109180,L021030,가방,골드 슬립 코르셋 복대겸용,52500,52500,0
2018-06-01,739063080,E061020,섬유유연제,포린스 핑크로즈 2L x 3개 섬유유연제,9900,9900,0
2018-06-01,899522251,A014010,우유,초L 세이브우유 930ML*2입기획,3490,3490,0
2018-06-01,1914916796,C011030,남자학생복,MCD-917 빈티지 스타일 롱가디건 남자롱가디건 남성롱,46270,46270,0
2018-06-01,400030830,C013050,운동복,현대 기아 실리콘 키케이스 YF소나타 투싼 I40 그랜저,3000,2680,-320
2018-06-01,1375920742,C013030,스웨터,빅사이즈 신상 루즈핏 티셔츠 긴팔니트티,5900,5900,0
2018-06-01,895685013,A017300,미역,RF)돌김자반 (50G*2봉),3990,3990,0
2018-06-01,2140796455,C012040,여자학생복,심플라운드니트 (J11PNT080)/ 매그제이(MAGJAY),16000,14400,-1600
2018-06-01,2067850641,C021020,구두,에스콰이아 남성 드레스화 9종 균일가모음전,53000,43460,-9540
2018-06-01,1808436117,C013050,운동복,3M 에탄올 워셔액 프로 2Lx8개,33000,33000,0
2018-06-01,468588079,I053010,공책,묶음상품 플라스틱링(28mm)흑색 50개입x3개 제본링 링,56990,56990,0
2018-06-01,898486292,E061010,세탁세제,[CJ]CJ라이온 비트리필 2KG*2입기획,15990,15990,0
2018-06-01,2144686179,I031040,생화,2층 국산 초대형 파라솔 세트 야외 테이블 캠핑 용품,41500,38090,-3410
2018-06-01,1301581458,C011030,남자학생복,시즌오프&여름신상 남녀 린넨 체크 7부 반팔,7900,7900,0
2018-06-01,1608322772,C021020,구두,[현대Hmall] 파라부트 남성 로퍼 미카엘 카페 MICHAEL MARCHE Ⅱ 715612,580000,464000,-116000
2018-06-01,629967975,A022050,탄산음료,일화 맥콜 355ml x 24캔/탄산음료/뚱캔/캔음료/,13300,13300,0
2018-06-01,2064152909,C014010,아동복,밍구키즈 여름신상/여아원피스/아동복/티셔츠,9900,9900,0
2018-06-01,1297104557,C013010,점퍼,리즈코 백패치 야상 카키 심플빈티지야상자켓 남성캐,109190,109190,0
2018-06-01,75474879,I031040,생화,와이드 캠핑 테이블/피크닉/접이/휴대용/야외/레져/,16900,15460,-1440
2018-06-01,1776918804,C013040,청바지,아동반바지/여아구제청바지/면팬츠/숏팬츠/유아츄리닝,10800,10800,0
2018-06-01,959371468,A013170,생선통조림,동원 볶음짜장 참치 (100g),2100,2100,0
2018-06-01,2092353793,L021010,손목시계,포체 남자 메탈 손목시계 FM1173,129000,124000,-5000
2018-06-01,2087384230,E021010,침구,쉬즈홈 호텔식 이불커버 매트리스커버 베개세트/침구,34900,34900,0
2018-06-01,1599063549,A011160,빵,[ 삼립/샤니] 햄버거빵/식빵/토스트/식자재용,1400,1400,0
2018-06-01,410907068,A018010,초콜릿,[해태제과] 자유시간 미니 690g,7800,7800,0
2018-06-01,1299012416,A021010,커피,[프렌치카페] 아이스커피믹스 남양 프렌치카페/아이스 커피 믹스 티,26000,25000,-1000
2018-06-01,866441220,E031120,믹서,쿠비엔 다용도믹서기 CMB-100 국내제조 믹서기+블렌더,22500,22500,0
2018-06-01,199135359,I031040,생화,아오맥스 원투낚시대 2종세트+케이스/TV쇼핑 낚시대,99000,85600,-13400
2018-06-01,888878864,C011020,남자상의,가볍고 시원한 여름 콤비자켓/남성자켓/여름신상할인,59000,59000,0
2018-06-01,861859450,C013060,등산복,슈나이더 미리 준비하는 여름!,9800,9800,0
2018-06-01,1601429936,C012040,여자학생복,[MLB]엠엘비 3종택1 남여공용 빅로고 MLB 후드집업(31TRD2811),49000,41650,-7350
2018-06-01,632897744,A011170,떡,전북고창 울어매 모시잎송편(2팩) 복분자송편(1팩)/75,66000,58080,-7920
2018-06-01,420001140,L012030,칫솔,뽀로로 양치컵 치약칫솔세트/어린이집선물/생일답례품,1900,1800,-100
2018-06-01,1597143696,F011130,홍삼,정관장 홍삼진본(1200ML),69000,69000,0
2018-06-01,899499314,A012010,국산쇠고기,E-한우 양지 차돌박이 냉동 (1등급/100g),7980,5980,-2000
2018-06-01,1462618407,C012060,여자내의,[BLACK UP] 크레미 커팅 데님스커트,25000,25000,0
2018-06-01,770798757,A012060,햄및베이컨,[동원] 리챔 자연레시피 200gx10캔 + 고추참치85gx3캔,25900,25900,0
2018-06-01,338583499,C012040,여자학생복,루즈핏 스트라이프 셔츠 시원한 남방 여름 자외선차단,22900,22900,0
2018-06-01,2048452340,C012060,여자내의,[에잇세컨즈] 핑크 리넨 블렌디드 미디 스커트 (128427B5FX),39900,37910,-1990
2018-06-01,1284503168,A012060,햄및베이컨,[초특가]남부햄 베이컨 1kg/슬라이스 1kg/소세지 햄,9900,9900,0
2018-06-01,1266636200,C011030,남자학생복,라벨 옥스포드셔츠 BTT0052 셔츠 남자셔츠(YA02004),26160,26160,0
2018-06-01,2068310058,C011020,남자상의,남자코트 심플 후드 떡볶이 코트 / 참고 남자코트 떡,103000,87550,-15450
2018-06-01,1054904607,I011010,TV,DSPTV 32인치 LED HDTV 모니터겸용,143290,139000,-4290
2018-06-01,133471883,E011070,식탁,수작업! 미송접이식 테이블 미니 /인테리어원목가구,27500,27500,0
2018-06-01,242365966,E061030,전구,에스에스라이트 국산 30W / 50W 슬림형 LED투광기,24000,24000,0
2018-06-01,1262529495,A013080,조개,건해삼(채 미국 600g)X3 건새우 건조해삼 식당용 해삼,282550,282550,0
2018-06-01,820986377,C011050,남자내의,밍크/여 밍크처럼 도톰한 밍크 숙녀파자마,13110,11670,-1440
2018-06-01,318695997,C015030,넥타이,나비넥타이 개별포장 행사용보타이 리본타이 넥타이,900,900,0
2018-06-01,885236127,C013020,티셔츠,(메이룸)여름신상입고 티셔츠 긴팔티 기본티 이너티,7000,6900,-100
2018-06-01,895685044,A017180,호박,꽈리고추 (봉),1990,1000,-990
2018-06-01,1142239141,E031010,전기밥솥,쿠첸 마이콤 6인용 CJE-B0601 전기밥솥,69000,69000,0
2018-06-01,1412696643,A011090,국수,[ 비상식량/여행용 ] 컵라면 6컵/소컵/컵라면/신라면,3750,3750,0
2018-06-01,1317145393,C013050,운동복,문콕방지도어가드/도어엣지 투명PPF필름 4M(차량1대),11000,11000,0
2018-06-01,550992171,A012060,햄및베이컨,[홈플러스][행사상품]사조대림_강황오리바베큐슬라이스_500G,8990,8550,-440
2018-06-01,228665072,C013010,점퍼,[빅사이즈][미스터빅]망사 반팔집업후드 4컬러-ION142,43200,43200,0
2018-06-01,371618509,C013020,티셔츠,콜핑 여름 기능성 반팔티셔츠 28종 균일특가,18500,18500,0
2018-06-01,984163721,A014010,우유,(가정배달) 서울우유 앙팡베이비우유 200ml,19800,19800,0
2018-06-01,1182409234,I031040,생화,버팔로 포시즌침낭/클래식/와이드/극세사/3계절침낭,26500,22610,-3890
2018-06-01,1340016558,C015040,장갑,버클포인트 양피장갑(남성) 남성가죽장갑 신사용가죽,16800,16800,0
2018-06-01,1344083520,C013010,점퍼,루즈슬림절개시크자켓 IR1710 둥근넥라인 일자핏자켓,106400,106400,0
2018-06-01,1968663604,F012010,종이기저귀,[하기스] [2018]하기스 에어솔솔 썸머팬티 4단계 여아 96매,38700,38700,0
2018-06-01,2102278492,E011020,침대,매트포함 서랍형침대 침대프레임/슈퍼싱글/더블/퀸,169000,152100,-16900
2018-06-01,865163745,A011180,파스타면,마카로니(라폰데 500g)X20/ 식자재 전문,38300,38300,0
2018-06-01,916813294,C012060,여자내의,[리스트][LIST] 주름 스커트 팬츠 TWWSPH60060 (3가지 색상),19000,15770,-3230
2018-06-01,1696115969,C011030,남자학생복,2018 앞서가는 패피을 위한반팔셔츠&반팔티 JBES2BSS150 A1외17종택1/ 질바이질스튜어,30000,24000,-6000
2018-06-01,990030380,E061030,전구,루미트론이관LED27W주광색(1입),25900,25900,0
2018-06-01,1660478267,F012020,생리대,시크릿데이 생리대 러브대형14PX6팩,13900,13210,-690
2018-06-01,1602801433,E061020,섬유유연제,샤프란 아로마시트 코튼블로섬 30매 x 12,66480,59170,-7310
2018-06-01,1189850983,E021010,침구,디오 이불세트/차렵이불/간절기이불/패드/매트커버,32000,29900,-2100
2018-06-01,1715913209,C011050,남자내의,빅사이즈 작업복 반바지 긴바지 쿨 등산바지 5부 7부,15800,15800,0
2018-06-01,1882029738,D031010,주택수선재료,[칠만표] 완전방수/하나로ok/완전방수/모체강화제,27000,27000,0
2018-06-01,161186943,L021050,우산,EVA 우의 우비 성인용 아동용 우의 우비 비옷 일회용,1990,1990,0
2018-06-01,325597075,C012060,여자내의,[위쉬몰]BM 쿨링웨어7부바지(0006H805),17640,15000,-2640
2018-06-01,957432388,E061010,세탁세제,[리뉴얼/특별가]비트 액체세제 2.1KGx5개 드럼세탁기,13900,13900,0
2018-06-01,1010300830,A013030,조기,[영광굴비] 굴비/영광굴비/보리굴비/법성포굴비/조기굴비/참조기,60900,60900,0
2018-06-01,47143834,E021010,침구,국산 올바른 사계절 이불커버/모던이불/북유럽풍/이불,13900,13900,0
2018-06-01,895685068,A017180,호박,풋고추(봉),2990,1990,-1000
2018-06-01,1429523833,A011180,파스타면,오뚜기 꽁꽁 해물맛 피자게티360g 스파게티/간식/야식,2500,2500,0
2018-06-01,1341713342,C012060,여자내의,jj41 니트 미디스커트_네이비 패션스커트 여성스커트,12560,12560,0
2018-06-01,873685605,C013020,티셔츠,전품목세일/린넨라운드티/브이넥/무지/여성,7900,7900,0
2018-06-01,1813683784,G011070,자전거,알톤 보뚜 L 2.0S 바구니/짐받이/여성용/클래식자전거,170000,121450,-48550
2018-06-01,906926925,E031120,믹서,[NUC] [신세계3만원상품권증정]엔유씨 고속블렌더 NPB-352K,319000,299000,-20000
2018-06-01,488803533,C012040,여자학생복,여성용 숄 머플러 겨울 망토 자켓 패션 스타일 가디건,15600,15600,0
2018-06-01,476885977,C013050,운동복,DYT 오픈져지(GLS-637) 남성져지 자전거긴팔져지 긴팔,85720,85720,0
2018-06-01,450946185,C012030,여자상의,봄 캐주얼원피스/미니/쉬폰/정장/롱/랩/프릴/나시,19800,19800,0
2018-06-01,1332170967,I011030,사진기,캐논 정품 EOS 5D Mark IV 명품마을,3850000,3541910,-308090
2018-06-01,1216736280,A013170,생선통조림,동원F&B 화끈한 골뱅이400g,5880,5880,0
2018-06-01,988149605,A013150,어묵,풀무원 SOGA 부산어묵 채소사각 180G,1200,990,-210
2018-06-01,1114226795,C014010,아동복,[펠릭스키즈]캐릭터 반팔 티셔츠 FXRA6FN2,2500,2500,0
2018-06-01,418336234,F012020,생리대,[화이트] 시크릿홀 슬림날개 대형12P,24800,24800,0
2018-06-01,901168507,A019080,고추장,해찬들 태양초고추장골드 1KG,13900,13900,0
2018-06-01,1980658472,A017110,감자,아삭아삭 싱싱한 하우스햇당근 3Kg~,6900,6400,-500
2018-06-01,1032578587,E011040,소파,레이디가구 파미에 3인 4인 천연 가죽 소파 쇼파,317000,317000,0
2018-06-01,1569615160,C012060,여자내의,[핑크시슬리] 페이비 멜빵팬츠/ 핑크시슬리,21800,17440,-4360
2018-06-01,895685072,A017180,호박,청피망 2입 (봉),1990,1990,0
2018-06-01,1393668866,A022050,탄산음료,코카콜라 1.5L/500ml/250ml 코크제로/라이트 탄산음료,24100,22900,-1200
2018-06-01,1528869334,C012040,여자학생복,[이사베이]글리터 오픈 가디건 (VMCCE2932)_C6G4,28900,27460,-1440
2018-06-01,1538662937,E061010,세탁세제,화미 식소다1kg x 24,75420,67130,-8290
2018-06-01,1240838003,C013050,운동복,IT 에보트레이닝 라이트 우븐 자켓(65472347) 점퍼 남,90830,90830,0
2018-06-01,47446802,A019050,간장,니비시 사시미 간장 360ml/일본 회간장/사시미 쇼유,3000,3000,0
2018-06-01,899585867,E061080,키친타월,쌍용 코디 키친타올 (150매*4롤),4650,4650,0
2018-06-01,1356302338,C013010,점퍼,(SR)SEL1973 양기모면집업후드자켓 / 참고 빅사이즈자,58100,51130,-6970
2018-06-01,573480776,C013050,운동복,럭셔리 차량용 옷걸이/행거/슈프림카,6800,6260,-540
2018-06-01,1275887464,A016070,귤,단감10kg (40-60 과) 신선농장 선물용 봉지단감 품절,40000,40000,0
2018-06-01,1265916676,A019090,카레,오뚜기 3분요리 카레 짜장 소스 즉석국 사골곰탕,290,290,0
2018-06-01,1632674433,C013010,점퍼,푸조 바람막이 스판바지 상하별도판매 기능성,18800,18430,-370
2018-06-01,1499807569,C012020,원피스,[쥬크(ZOOC)]루즈핏 후드 코트(MG)Z174MSG022(강남점),299000,261330,-37670
2018-06-01,1337284937,D031010,주택수선재료,국산 접착식 데코타일 7장 시공 스티커식 타일 바닥재,15240,15240,0
2018-06-01,1180772741,C013050,운동복,233_고구마베이비 아기옷- 무형광 핑크 물결무늬 민소,10910,10590,-320
2018-06-01,1246952480,E031070,에어컨,[11% 추가할인]신일 타워팬 선풍기 틈새없는 안전망,56800,53110,-3690
2018-06-01,986127729,A012060,햄및베이컨,훈제 목심 스테이크 200G,4990,4990,0
2018-06-01,1760837979,L021020,장신구,칠보 꽃 쌍가락지 / 커플링 우정링 쌍가락지 은반지 실버반지 여자반지,83000,83000,0
2018-06-01,960506535,L012060,샴푸,LG엘라스틴 실크샤이닝 샴푸 (400ML),3990,3990,0
2018-06-01,2093460976,A017250,고사리,브로콜리 2kg 당일경매 상품출고,11900,11900,0
2018-06-01,1597143752,F011130,홍삼,정관장 홍삼진황(1500ML),140000,140000,0
2018-06-01,2139132924,A013130,오징어채,[가온애]파품N0~!! 국내가공 특품 진미채 백진미채,4900,4900,0
2018-06-01,2093985,C014010,아동복,[블루독키즈4]컬러블럭7부티셔츠(2822533101/02)남아 칠부티셔츠2종택1,36400,30220,-6180
2018-06-01,1326874841,C012030,여자상의,[하루메이비]M480 로맨틱 레이스 포인트 린넨원피스,39900,39900,0
2018-06-01,283451758,G011070,자전거,알톤 베네통 BLT26 26인치 고급 클래식 여성자전거,278000,255760,-22240
2018-06-01,1511596752,A017080,무,(직수입)노니분말가루1kg(500g+500g)/건노니/쥬스원액,15900,15900,0
2018-06-01,1629820927,L021030,가방,세인트스코트 아이비 쇼퍼백 YBK4760 블랙,160800,136680,-24120
2018-06-01,1665387735,C012020,원피스,김발(속대 에브리홈)X20,16130,16130,0
2018-06-01,1009078328,I031040,생화,콜롬비아 블랙 커브드 캠핑나이프/낚시칼/생존야생,56000,56000,0
2018-06-01,1506275132,E061010,세탁세제,물없이 닦는 운동화 드라이클리닝 세제,10500,10500,0
2018-06-01,49459866,A013010,갈치,(국보수산)냉동 청정 남해안 갈치순살 2kg,21000,21000,0
2018-06-01,493077512,C013020,티셔츠,무지기본반폴라티 SM1711 여성티셔츠 폴라텍롱티셔츠,34820,34820,0
2018-06-01,604204558,A013020,명태,뽈찜용 대구머리 5kg,59000,55500,-3500
2018-06-01,381422765,A012060,햄및베이컨,선진 FS 소프트델리 베이컨 1kg,32000,31680,-320
2018-06-01,586959942,C012060,여자내의,[위쉬몰]BM 쿨링웨어7부바지(0006H805),17640,16590,-1050
2018-06-01,1938954167,C011030,남자학생복,[TI FOR MEN] 티아이포맨 도트배색 베스트 M144MVT263,15300,13470,-1830
2018-06-01,1158336010,I031040,생화,160cm 미니 빙어 민물 루어 바다 어린이 펜낚시대,8000,7500,-500
2018-06-01,1105787984,C013050,운동복,XTRA 타이어크림 1kg 3kg타이어 비드크림 왁스,6000,5940,-60
2018-06-01,415096592,C013040,청바지,EX 1636 밴드 청반바지 청반바지 청5부 청 반바지 남,62260,61020,-1240
2018-06-01,1279888042,C013010,점퍼,[로코식스][로코식스] 패스트크롭점퍼,73000,69350,-3650
2018-06-01,1319076774,C011050,남자내의,보풀방지 네이비 롱 교복조끼 남자 교복넥타이 교복,29980,29980,0
2018-06-01,324417786,C013020,티셔츠,[저스트원] 봄신상/원피스/블라우스/티셔츠/자체제작,14900,12900,-2000
2018-06-01,1590177305,A017010,배추,초록무(알타리) 3kg좌우 1다발,10000,10000,0
2018-06-01,2094185481,E041070,밀폐용기,스텐/밀폐/찬통/찬합/용기/반찬/그릇/도시락/통/고리,6500,6500,0
2018-06-01,876877112,E011040,소파,윌리 접이식 안락의자 포레스트체어,125000,108750,-16250
2018-06-01,1945430093,I012010,컴퓨터,(E)DM500T7A-A54-S1/7세대/i5/8G/SSD128G+1TB/윈10,1175000,1175000,0
2018-06-01,544639610,C012040,여자학생복,[샤틴]패턴포인트 하이넥 니트티셔츠(S181C933A아이보리),79000,64780,-14220
2018-06-01,1235331105,C014010,아동복,쿨썸머 유아 주니어 아동 상하복세트/나시세트,17900,17900,0
2018-06-01,2023064431,C011030,남자학생복,슬림핏 심플 화이트 셔츠 (95-110) 셔츠 패션셔츠 캐,28210,28210,0
2018-06-01,475663368,E031070,에어컨,[네모트리] 쿨타워 선풍기 NE-TF30/프리미엄 타워팬,159000,149000,-10000
2018-06-01,1806265453,C013060,등산복,아이스쿨 고탄력바지/여름 등산바지/등산복/아웃도어,9900,9900,0
2018-06-01,351604950,C012040,여자학생복,시스루나시니트,18800,18800,0
2018-06-01,429286780,I053030,복사용지,한솔 복사용지 75g A4용지 2박스(5000매),36840,30820,-6020
2018-06-01,1026524197,C013020,티셔츠,RT6 (티티뱅크) AT7805 쿨론 고급형 브이넥,17300,16960,-340
2018-06-01,1684324048,L012090,기초화장품,맨 워터리 크림50ml(21년01월까지),23990,23990,0
2018-06-01,1239044841,C012060,여자내의,오프라 맥시 롱스커트 DM-3800,9370,9370,0
2018-06-01,564428961,I031040,생화,캠핑COGHLAN'S - 캐나다 명품 코글란 - Mini Travel Tite 10 in PKG 25cm 516 고정끈,7960,7240,-720
2018-06-01,232358857,I012010,컴퓨터,[E]Z70EV-AP73S2/7세대/i3/8G/SSD256G+500G/윈10프로,881000,836950,-44050
2018-06-01,453600492,A016160,과일가공품,블루베리안주 (소울 350g),26940,23980,-2960
2018-06-01,978684449,L021030,가방,사은품증정/Macknite방수백팩28종/가방/여자여성,17800,17800,0
2018-06-01,1597143724,F011130,홍삼,정관장 홍삼진본(40ML*42입),96000,96000,0
2018-06-01,1899939140,A014050,달걀,무항생제 방사 유정란 40알 / 동물복지 계란,21900,21900,0
2018-06-01,240254403,A022050,탄산음료,스파클링 355ml 24캔/오렌지/사과/포도/망고/복숭아,10000,9500,-500
2018-06-01,893110380,A017170,풋고추,이동영 생산자의 무농약 미니오이 10개/15개/20개,7900,7900,0
2018-06-01,168660413,E061010,세탁세제,애경 울샴푸 (리필) 캡1.3L x 9개,36470,36470,0
2018-06-01,1775089618,A012030,돼지고기,(맛나)돈육/목심(국내산)500g,18400,16560,-1840
2018-06-01,1092364340,A019160,밑반찬,오징어채무침(진미) 1kg 양념 잘베인 부드런운 진미채,17900,17900,0
2018-06-01,1702447676,C011030,남자학생복,[제이브로스]노버튼 헨리넥 린넨 반팔 셔츠,20800,17890,-2910
2018-06-01,1226252631,C013020,티셔츠,후드티셔츠 맨투맨/롱티/루즈핏 F-4XL 빅사이즈여성,22800,21800,-1000
2018-06-01,2098368701,E041010,식기,청동/방짜/유기/쌍학/반상기/부부/혼수/예단/선물/외국인/식기/추천/가격/파는곳/VIP/,390000,380000,-10000
2018-06-01,52520275,C013050,운동복,소낙스 워셔액 더 뷰 2L X 6ea 1박스 에탄올워셔액,33000,30360,-2640
2018-06-01,443812976,C013030,스웨터,압구정클럽 삼색단가라 목폴라짚업니트자켓 가디건 스,53000,53000,0
2018-06-01,1183893413,F012020,생리대,예지미인 늘 산뜻한 롱 40px10개 팬티라이너 생리대,23200,23200,0
2018-06-01,1375230140,A016160,과일가공품,블루베리(건조 한끼 350g),20140,20140,0
2018-06-01,1345779286,C011030,남자학생복,[탑텐]남성 슬럽 스트라이프 티셔츠(MSX2TR1103),9900,8420,-1480
2018-06-01,804326523,E031110,청소기,(공식)한경희 회전스팀 물걸레청소기 AM-7000S 민박집,145000,145000,0
2018-06-01,463450153,A022030,생수,초정탄산수 플레인 500ml x 20펫 / 탄산음료 /음료,12700,12700,0
2018-06-01,2010068750,C013050,운동복,LED 손전등 겸용 경광봉 지시봉 신호봉 안전봉 블루,12900,12520,-380
2018-06-01,1658535026,E011040,소파,[동서가구] 하이디 라텍스탑 천연가죽 4인소파,489000,439000,-50000
2018-06-01,528956363,E061060,살충제,크린베이트앤트액20g 맥스앤트그래뉼 5gx2세트 맥스포스퀀텀12g 개미퇴치 개미약 개미,5700,5700,0
2018-06-01,1113233136,C013010,점퍼,[올리비아로렌][올리비아로렌] 캐주얼 솔리드 점퍼 VVCCLTM3211,80700,76670,-4030
2018-06-01,901193521,A012020,수입쇠고기,E-멕시코산 냉장 돈삼겹살 (100G),1390,1000,-390
2018-06-01,1267678739,C012060,여자내의,T185SL4Z001(/678쿨베이직PT)/ 토모톰스,16800,15960,-840
2018-06-01,1979838866,A016150,아몬드,산과들에 2017년 캘리포니아산 햇 생/슬라이스 아몬드,10900,10900,0
2018-06-01,957945152,C013050,운동복,오토반 와인 프레스티지 LED 차량용 재털이 AW-D72,13000,11440,-1560
2018-06-01,295766108,E041060,수저,스텐 진공저 10모/스텐 젓가락 10벌/가정용 업소용 식당용 한식용 /저분/젓가락,4000,3900,-100
2018-06-01,1117290793,E011030,거실장,파란나무 릴리 1100 TV 거실장 TV대,162000,162000,0
2018-06-01,1358645828,A019040,소금,나티브유기농설탕5kg/유기농설탕/매실/오미자/오디,17500,17500,0
2018-06-01,1117290794,E011030,거실장,파란나무 다올 2단 1500 TV 거실장,182000,182000,0
2018-06-01,1320535416,E011020,침대,프리미엄 패밀리침대 Q+Q 오픈형 포켓양면 매트리스,765100,742150,-22950
2018-06-01,608203406,C013050,운동복,요가바지 여자트레이닝 홈웨어 통바지 면 요가복 세트,9900,9900,0
2018-06-01,1117290799,E011030,거실장,흑경/백경 2단 1200 높은 TV 거실장,165000,165000,0
2018-06-01,852351949,E031010,전기밥솥,(추천)쿠첸 10인용 1등급 전기압력밥솥 CJS-FC1005F,111000,111000,0
2018-06-01,1117290795,E011030,거실장,파란나무 다올 1100 TV 거실장 TV대,162000,162000,0
2018-06-01,1117290796,E011030,거실장,파란나무 SC 800 거실장 TV 장식장 TV대,110000,110000,0
2018-06-01,1117290797,E011030,거실장,흑경/백경 900 TV 거실장 TV 대,125000,125000,0
2018-06-01,1117290798,E011030,거실장,흑경/백경 1단 1500 TV 거실장,155000,155000,0
2018-06-01,1309911298,A022050,탄산음료,코카콜라 185ml x 30캔 음료수 캔커피 사이다 쥬스,12800,12800,0
2018-06-01,1140087551,A012060,햄및베이컨,초원 그라운드미트 450g2개 민찌 냉동식품 즉석조리식,17630,15870,-1760
2018-06-01,2015577050,L021020,장신구,써지컬피어싱 귀걸이 남녀공용 무알러지 LB29,50,50,0
2018-06-01,2100806899,C011030,남자학생복,셔츠/남방/체크남방/여름셔츠/남방셔츠/린넨셔츠/신상,31000,31000,0
2018-06-01,1541396719,L021030,가방,[CK언더웨어][여] 코어 라이프스타일 플립플랍 KW00395 001[갤러리아],28000,22400,-5600
2018-06-01,536382280,C013010,점퍼,[APM]아르크네 양털 무스탕/여성/여자/퍼/재킷/버튼/더블/코트/자켓/정장/캐주얼/재킷,121000,119790,-1210
2018-06-01,1250078642,C014010,아동복,[네파키즈] 티셔츠 2팩 세트 KEG5300,21000,19950,-1050
2018-06-01,1966820496,A017110,감자,싱싱한 제주흙당근3kg/5kg,7900,7900,0
2018-06-01,1085494897,C012040,여자학생복,아이스 니트 조끼 LRT094 니트조끼 여자조끼 (YA02004,50660,50660,0
2018-06-01,95234956,E031130,보온매트,(추천)로얄크로스북유럽 카페트/ 극세사카페트 북유럽카페트 거실카페트 러그카페트 극,60500,59300,-1200
2018-06-01,1295716623,C012060,여자내의,매그제이 언발프릴스커트 J11NSK332,39920,39920,0
2018-06-01,297418203,A014020,분유,1+1 후디스 트루맘 Premium 액상분유 1 2 3단계 24입,39500,39500,0
2018-06-01,1117290766,E011030,거실장,파란나무 에플스 1200 TV 거실장,212000,212000,0
2018-06-01,1117290767,E011030,거실장,파란나무 피보 1500 TV 거실장,162000,162000,0
2018-06-01,2009462197,C013020,티셔츠,[지오다노] 01018501 반팔 피케 폴로(st),19800,16440,-3360
2018-06-01,1117290768,E011030,거실장,파란나무 피보 1200 TV 거실장 TV대,133000,133000,0
2018-06-01,1117290769,E011030,거실장,파란나무 닥터 2단 1500 TV 거실장,242000,242000,0
2018-06-01,366676461,A017140,콩나물,[종근당건강] 도라지 청 조청 진액고 차 농축 액 엑기 4만원대 선물,42000,42000,0
2018-06-01,1295175112,C012020,원피스,[더아이잗][더아이잗] .더아이잗 소매퍼 포인트 코트 IGAA0CT25 (P000363374),79000,71100,-7900
2018-06-01,1117290764,E011030,거실장,파란나무 에플스 높은 1500 TV 거실장,249000,249000,0
2018-06-01,1117290765,E011030,거실장,파란나무 에플스 낮은 1500 TV 거실장,237000,237000,0
2018-06-01,865934668,A017120,고구마,18년 하우스 햇 감자 3kg,6900,6900,0
2018-06-01,1966942801,C012040,여자학생복,NB143-데님 유니크 포켓 롱 남방 데님롱남방 청남방,36480,35390,-1090
2018-06-01,1383658805,C013010,점퍼,[행텐주니어] 여아바람막이점퍼1417011040146nc아울렛,59800,39900,-19900
2018-06-01,886707808,I012010,컴퓨터,특가 159만/2018 삼성게이밍PC DM800V7Z-AD7S/GTX1070,1788420,1699000,-89420
2018-06-01,324611240,C011050,남자내의,GNN7001 남자매직스판생지청바지슬렉스 빅사이즈청바,43790,43790,0
2018-06-01,1271282763,C011030,남자학생복,오버 스트라이프 배색 셔츠 남성셔츠 심플남성셔츠 남,29440,29440,0
2018-06-01,928604156,C015040,장갑,아이비 여성 등산장갑 여자 등산 장갑 여름등산장갑,11000,10020,-980
2018-06-01,2117697584,C012040,여자학생복,아베크롬비 구제매니아 여성 M 골지 울 롱 니트 겨울,29110,29110,0
2018-06-01,1037233777,E041050,냄비,업소용 냄비 전골냄비 경질 찌게 국수 해물탕 매운탕,11500,11500,0
2018-06-01,1117290770,E011030,거실장,파란나무 닥터 1단 1500 TV 거실장,200000,200000,0
2018-06-01,1117290771,E011030,거실장,파란나무 릴리 2단 1500 TV 거실장,182000,182000,0
2018-06-01,1074783657,A018060,스낵과자,할인! 2 990원~과자/초콜릿/껌/젤리/사탕/간식/초코바,4950,4950,0
2018-06-01,1078573990,C013060,등산복,여름 남성 등산바지 아웃도어 등산복 작업복 바지 쿨,19800,19800,0
2018-06-01,1507793255,E031020,가스레인지,/자동 개폐 환풍기 (ESV-250GA)/ 공기정화기 욕실환풍,36500,35300,-1200
2018-06-01,541084160,E061030,전구,LED전구 8W 필립스 PAR30 할로겐 촛대 볼전구 형광등,1130,1130,0
2018-06-01,1329325706,C013030,스웨터,30%쿠폰 봄코디 훈남코디룩 남자 니트/셔츠/바지/코디,13900,13900,0
2018-06-01,270947733,A014030,치즈,아메리칸 싱글즈 슬라이스 치즈 16개입 1+1,7900,7900,0
2018-06-01,58983944,C013010,점퍼,[크록스키즈][크록스키즈] 듀크라글란매쉬집업(CBG2TJ004P),23900,22710,-1190
2018-06-01,265569234,C013050,운동복,불스원 레인성에 OK 유리세정제 불스원 물기 자동차용,11010,10030,-980
2018-06-01,1208826005,A016100,수박,달콤한 풍부한과즙 수박 5~7kg 내외,12900,12900,0
2018-06-01,960386168,L012070,바디워시,LG 온더바디 아이리스 바디워시 (500ml),10500,3490,-7010
2018-06-01,1522252853,C011030,남자학생복,남성 스트라이프 링클프리 셔츠 헨리넥 파자마 남방,21800,19800,-2000
2018-06-01,2052878358,C021020,구두,레페토 산드리옹 발레리나 플랫슈즈 V086V 모음전,209000,182290,-26710
2018-06-01,1237762000,E061020,섬유유연제,샤프란 꽃담초 섬유유연제 용기.리필 1300mlx8 1Box,26900,26900,0
2018-06-01,989883350,A014020,분유,맘마밀 브로콜리와닭가슴살 100G,2700,1890,-810
2018-06-01,2040581682,E061060,살충제,전기모기채/전자모기채/모기체건전지형 인증완료상품,5000,4900,-100
2018-06-01,1594068407,A013040,고등어,FDA검증/여수 간고등어2kg(10~12팩)고등어,23900,23900,0
2018-06-01,1686564204,C013020,티셔츠,[타미힐피거] 반팔 커스텀핏 카라티셔츠 15종 택1,39900,39900,0
2018-06-01,1122624437,E041010,식기,루미낙 루미락 나뭇잎 접시19.5소6p,38000,36100,-1900
2018-06-01,369354870,C013040,청바지,여성 쿨맥스 브러쉬 워싱 10부 데님 AI2DL081-MB,79000,63200,-15800
2018-06-01,299852068,C012040,여자학생복,[대구백화점 I관] [탑걸]후드시스루가디건(TIZ4GD708F),39000,33540,-5460
2018-06-01,398289889,C012040,여자학생복,지홍 여름신상 셔츠 66~빅사이즈 루즈핏 롱 쉬폰 린넨,34900,34900,0
2018-06-01,1020126876,E031090,공기청정기,당일발송(s) 위닉스 공기청정기 제로필터 CAF-SS349,53000,53000,0
2018-06-01,989883349,A014020,분유,맘마밀 표고버섯과소고기 100G,2700,1890,-810
2018-06-01,1656147255,C012040,여자학생복,[2001OUTLET][BESTI BELLI] 베스띠벨리 아크릴느낌 롱 조끼 (BUVCC29060),59000,57230,-1770
2018-06-01,1747501254,C021010,아동화,[백화점SAY][스텝케어][팁토이조이] 걸음마신발 운동화 아기구두 모음,53000,42430,-10570
2018-06-01,1002788781,A019040,소금,[신안소금] 신안 천일염 함초 소금 400g/돌잔치 돌 답례품 기념품,6000,5500,-500
2018-06-01,1033622224,D031010,주택수선재료,폼블럭 인테리어 파벽돌 벽돌무늬 시트지 포인트시트,6020,6020,0
2018-06-01,983385005,L012080,화장지,[쌍용씨앤비]코디 러블리 베어 230매*3,6000,6000,0
2018-06-01,1097810864,A017050,미나리,[국산100%]양배추환/1kg대용량/양배추가루/다시마환/양배추분말/양배추분태/양배추,37000,37000,0
2018-06-01,829906486,E021010,침구,굿몽 국산 먼지없는 이불세트 차렵이불세트 침구세트,17900,16470,-1430
2018-06-01,2120552627,L021020,장신구,은반지 실버925 순은 레이어드 체인 원석큐빅반지,23000,20800,-2200
2018-06-01,1926374444,E021020,커튼,[윈홈스]암막커튼 2장 최애특가! 소형에서 특대형까지,17900,17900,0
2018-06-01,1274115174,A017050,미나리,한끼 샐러드 양배추믹스 120g,2700,2700,0
2018-06-01,187336796,C021040,실내화,리복 운동화/런닝화/스니커즈 모음(무료배송),46000,41090,-4910
2018-06-01,1539225729,C013050,운동복,M-5XL 여름 트레이닝 7부바지 츄리닝 반바지 남자배기,14800,12800,-2000
2018-06-01,1209281829,C013040,청바지,[세컨플로어] [여성] 솔리드 밴딩 와이드 팬츠 SWMS2WP51100031,156000,149940,-6060
2018-06-01,439993712,C012040,여자학생복,[나나살롱] 링클 체크 SHIRTS,32000,32000,0
2018-06-01,735721121,E021010,침구,여름대비! 산뜻한 줄누비 이불 초특가!,11900,9900,-2000
2018-06-01,1102061803,A019180,즉석식품,대복 궁중 갈비탕/육개장/부대찌개/사골도가니탕/뚝불,25900,25900,0
2018-06-01,1086334838,E011010,장롱,[라자가구]도노&에버튼&베라 슬라이딩 장롱/옷장,419000,376900,-42100
2018-06-01,866982998,E011030,거실장,[풀씨]루트 로즈와인 800x600 다용도 상 대 하이글로시,22400,22400,0
2018-06-01,1158637130,C011050,남자내의,르젠 네오프렌 삥줄 5부 트레이닝 팬츠(LNHP115PN),29800,28310,-1490
2018-06-01,866982999,E011030,거실장,[풀씨]루트 로즈와인 720x480 다용도 상 중 하이글로시,20000,20000,0
2018-06-01,1856397417,F011150,건강기능식품,아사히 에비오스 600정/지친 위장 천연소재 영양효모,17470,17470,0
2018-06-01,1689277280,E041010,식기,한국도자기 공기 1p  대접 1p 더 셰프 화이트부케,7520,7520,0
2018-06-01,2138025830,I031040,생화,VIP 카텐트/오토캠핑/차박캠핑/캠핑용품,135000,124200,-10800
2018-06-01,531093184,A019130,스프,[샘표] 폰타나 프렌치 어니언크림 수프 68.4g (22.8 x3개입)/ 샘표,2480,2360,-120
2018-06-01,964614529,A013040,고등어,부산자갈치 뱃자반고등어 2마리 특가!,2500,2500,0
2018-06-01,1694714759,D031010,주택수선재료,센스멜DIY1L/DIY용/젯소NO!바니쉬NO!/신나필요없어요,11500,11500,0
2018-06-01,1250027052,A012040,닭고기,[무배]마테차숙성new하나푸드훈제닭가슴살5kg200g25팩,47900,41500,-6400
2018-06-01,944326120,A013170,생선통조림,동원 번데기 130g x10캔 /골뱅이/안주/간식/무침/유동,10500,10500,0
2018-06-01,216943221,A017010,배추,자연미가 배추우거지 2kg/냉장진공포장 고랭지농특산,11000,8800,-2200
2018-06-01,1327826121,A013040,고등어,[애터미] 노르웨이 간고등어 2kg 14~16팩 아이스냉동,41500,41500,0
2018-06-01,1832370488,C011020,남자상의,남성정장 순수 국내제작 생산 수트/정장,119000,119000,0
2018-06-01,1509132254,A017020,상추,(맛나)#양상추(국산)1통,5700,5130,-570
2018-06-01,1579609122,F012010,종이기저귀,메리즈 기저귀 일본내수용 정품 밴드형4팩/팬티형3팩,47900,47900,0
2018-06-01,1054420326,C013010,점퍼,30%쿠폰! 웨건 바람막이 윈드브레이커 등산 항공점퍼,27900,27900,0
2018-06-01,299852040,A012060,햄및베이컨,에스푸드 후레쉬베이컨 1kg2개 베이컨 후레쉬베이컨,65650,59090,-6560
2018-06-01,1924127184,G011070,자전거,[스마트] 엘레강스24 여성용자전거 7단 24인치,85000,85000,0
2018-06-01,694729859,A012060,햄및베이컨,롯데 로스팜 엔네이처 340g x1캔 /s/스팸/리챔/뚝심,2490,2490,0
2018-06-01,1250027049,A012040,닭고기,[무배]마테차숙성 new하나푸드 훈제닭가슴살10kg (200gx50팩)소금무첨가/다이어트/헬스,92830,77900,-14930
2018-06-01,2042595819,A018060,스낵과자,팝콘 12컵 커널스 슈퍼믹스/프링글스/인기과자,8300,8300,0
2018-06-01,674429411,A021010,커피,(당일발송)네스프레소 정품캡슐/25종 캡슐커피,5800,5800,0
2018-06-01,1701253188,C013010,점퍼,[크루클린]후드집업/후드티/맨투맨/반팔/아노락/무지,19800,9900,-9900
2018-06-01,451171599,A019010,고춧가루,시골맛 아주매운 중식용 고추가루 2.5kg2개 가루 고추,94380,84950,-9430
2018-06-01,588441089,C013010,점퍼,봄/남자점퍼/작업복/캐주얼/카라점퍼/아우터,49800,49800,0
2018-06-01,815106026,C014010,아동복,[키키제제]남아 맨투맨/반팔티/남방/후드/가디건/셔츠,10900,10900,0
2018-06-01,245317805,C013040,청바지,[게스] 게스키즈 인디고 스키니 진 G76KCP321N3,79000,55300,-23700
2018-06-01,522760177,C012040,여자학생복,[나이스클랍]프린트블라우스(N182YSC001),119000,101150,-17850
2018-06-01,152527065,A017180,호박,건고추(호식이네 1k) 식자재 업소용식자재 대량구매,20040,19240,-800
2018-06-01,705257180,A019170,냉동식품,[냉동] CJ 비비고 왕교자 455g×4개+김치왕교자 420g×4개+청양고추 찐만두 168g×2개,31800,31800,0
2018-06-01,1359463185,A018010,초콜릿,하와이안 호스트 티키 56gX1세트/초콜릿/마카다미아,2000,2000,0
2018-06-01,1747344745,E031130,보온매트,글루바인 전기요(에르사)(슈퍼싱글)/전기매트,109000,109000,0
2018-06-01,1747344746,E031130,보온매트,대원 사계절 전기요/효도선물용 거실형 전기매트,32900,32900,0
2018-06-01,1391196895,C011050,남자내의,면반바지 남자반바지 남성 린넨 청 여름 5부 스판 7부,12900,11900,-1000
2018-06-01,1747344744,E031130,보온매트,글루바인 전기요(프레위르)(슈퍼싱글)/전기매트,79800,79800,0
2018-06-01,1468526597,A012010,국산쇠고기,[무항생제] 불고기샤브샤브 300g 1등급,16100,16100,0
2018-06-01,1657905396,I031040,생화,물병주머니 물병커버 물병 파우치 수통커버 물통,2200,2030,-170
2018-06-01,2069842685,C021040,실내화,나이키 스타 러너 PS 키즈 운동화 검흰 921443-001,47800,42070,-5730
2018-06-01,358010737,C013050,운동복,올뉴K7 리무진 콘솔박스 팔걸이 쿠션 차량콘솔박스 팔,61430,55960,-5470
2018-06-01,1266661254,C011030,남자학생복,린넨 7부셔츠 BTT0165 셔츠 여름셔츠(YA02004) 남자셔,26160,26160,0
2018-06-01,2120588602,C013010,점퍼,[레노마키즈]여아핑크메쉬집업점퍼 (R1825J566_10),31500,28350,-3150
2018-06-01,1113607849,C013020,티셔츠,(스파이더) 봄의류후드 아동후드 기모안감 후드티셔츠,9900,9900,0
2018-06-01,150273328,A013160,맛살,한성 크래미(F2) 1kg2개,52180,52180,0
2018-06-01,1231077336,I031040,생화,타이탄코리아/3500루멘/충전식 헤드랜턴/등산/낚시,19600,17550,-2050
2018-06-01,63864353,C013010,점퍼,빅보이스 후드 집업자켓/후드나시/가디건/후드티,17800,17800,0
2018-06-01,897736809,F011120,인삼,고기 느타리버섯150G(팩),2490,2490,0
2018-06-01,1750489285,C013020,티셔츠,[간쓰리] 비침없는 20수 반팔티 머슬핏 면티 티셔츠,9900,9800,-100
2018-06-01,663351324,A019020,참깨,함양농협 흑임자1kg /검은깨/참깨/들깨/국내산 검은깨,27500,27500,0
2018-06-01,789232511,C015040,장갑,등산장갑 반장갑 자전거장갑 낚시장갑 등산용품 장비,6900,6350,-550
2018-06-01,1895973647,C012030,여자상의,nn66 스트랩 베이직 린넨원피스 - 소라 린넨원피스 긴,36060,32100,-3960
2018-06-01,239358622,E011030,거실장,CF 이케아 라크 TV장식장/다이/선반/LACK TV banch,13900,13900,0
2018-06-01,1192215340,A013170,생선통조림,오뚜기 참치/고추참치 100g 10+2개,14900,14900,0
2018-06-01,661072867,C013050,운동복,올뉴카니발 프런트 바디킷(GSC)/범퍼가드/에어댐,163400,150330,-13070
2018-06-01,884942002,A018080,설탕,유기농 코코넛슈가 1kg 코코넛설탕 자일리톨 가루,12900,12900,0
2018-06-01,1747344720,E031130,보온매트,글루바인 전기요(헤라)(더블)/전기매트 온열매트,116000,116000,0
2018-06-01,1229112697,A022030,생수,페리에 플레인 탄산수330x24병/싱하소다325x24/씨그램,19900,19900,0
2018-06-01,1747344721,E031130,보온매트,글루바인 전기요(프리그)(슈퍼싱글)/전기매트,145200,145200,0
2018-06-01,1747344722,E031130,보온매트,글루바인 전기요(프레이야)(슈퍼싱글)/전기매트,101400,101400,0
2018-06-01,444467897,C014020,유아복,[디플랜][디플랜] 컴포터블바지 BLUE,5000,4750,-250
2018-06-01,579515066,C015040,장갑,스마트폰 터치 사슴 니트 여성장갑 편한장갑 캐주얼장,11840,11840,0
2018-06-01,1747344718,E031130,보온매트,글루바인 전기방석(L)/3인용전기방석 소파용 온열방석,86800,86800,0
2018-06-01,1747344719,E031130,보온매트,글루바인 전기요(헤라)(슈퍼싱글)/전기매트 온열매트,109000,109000,0
2018-06-01,1434395649,C012040,여자학생복,Y넥 프릴 블라우스 (BASB373-A)[예약상품 2018.06.08 부터 발송]/ 보니알렉스,22000,18700,-3300
2018-06-01,1460798304,E011020,침대,리버퍼니쳐 65T 캐미칼 코모드라텍스매트리스 수퍼싱,135580,131520,-4060
2018-06-01,1643705871,C013030,스웨터,(반팔/긴팔)알렉 단가라 니트/스트라이프 돌돌이,22400,22400,0
2018-06-01,1371749767,E011060,의자,초특가 판매1위 프리미엄 메쉬 의자/학생/책상/사무용,33000,29700,-3300
2018-06-01,357764784,C012040,여자학생복,[매그제이(MAGJAY)]슬리브벨트니트 (J11PNT213),36900,34690,-2210
2018-06-01,468649614,C011020,남자상의,남성의류 정장 정장자켓 더블 슬림핏 투버튼 자켓 자,94540,94540,0
2018-06-01,531308374,A012060,햄및베이컨,한성 런천미트200gx10캔,13900,13900,0
2018-06-01,1920092490,C012040,여자학생복,그로 우들랜드그로백1.0 6 18m 유아 의류 아동 실내,103060,103060,0
2018-06-01,735879491,L012060,샴푸,[댕기머리]허벌 샴푸 트리트먼트1000ml+파우치증정,14000,11800,-2200
2018-06-01,1357521938,C014020,유아복,[신디키즈]이랜드키즈 여름 반팔 티셔츠/팬츠 BEST 모음전!,4900,4900,0
2018-06-01,1160269993,I011030,사진기,캐논 정품 EOS 80D 본체 + 가이드북 + 16GB 명품,1167000,1073550,-93450
2018-06-01,354109083,C013040,청바지,디와이진 남자 반바지/청바지/스판/일자핏/빅사이즈,9900,9900,0
2018-06-01,521997318,I053030,복사용지,한솔 75g A4용지 8팩 2박스 4000매,30400,25470,-4930
2018-06-01,439631659,F011120,인삼,야생산삼 산양산삼 자연산 7-8년근 5뿌리산양삼 장뇌,187900,165360,-22540
2018-06-01,1005765695,I011030,사진기,(정품)소니 ILCE-7M2(바디 렌즈미포함)/A7M2/A7 ll,1359000,1250280,-108720
2018-06-01,1219415045,E051020,건전지,페어맨 26650 리튬이온 배터리 페어맨 충전지 건전지,20000,20000,0
2018-06-01,1780870209,A019160,밑반찬,부대찌개 재료 모음/민찌/베이크드빈스/후랑크/콘킹/,2000,2000,0
2018-06-01,775736504,C013060,등산복,등산복 티셔츠 바지 사계절 모음 4900원~11800원,5900,5900,0
2018-06-01,1870559469,A022010,주스,[델몬트] 델몬트 매실 1.5L x 6펫 주스 매실음료 음료수,12300,12300,0
2018-06-01,1826174614,E011060,의자,캐릭터의자/아동의자 학생 컴퓨터책상의자/어린이의자,35000,35000,0
2018-06-01,484553739,C013010,점퍼,-제너럴 레이스 프릴 블루종- 레이스블루종 레이스항(,88400,75140,-13260
2018-06-01,1155842608,C012040,여자학생복,[타미힐피거여성]여성 알파카 혼방 니트 스웨터 (TFMS1WOE06A0),178500,160650,-17850
2018-06-01,1162584940,C021010,아동화,터닝메카드 캔버스화 캐릭터 운동화 아동신발 아동신,22850,22850,0
2018-06-01,343202943,L012060,샴푸,케라시스 두피 클리닉 샴푸 3개/린스/프레쉬쿨/지성,10900,10900,0
2018-06-01,371055809,C021040,실내화,[리복(Reebok)]MEN FITNESS & TRAINING EEBOK TRAINFUSION NINE 3.0 리복 트레인퓨전,55200,46590,-8610
2018-06-01,949954874,I031040,생화,GDF 카본포이즌300 입문용 카본원투대셋트/원투낚시대,34000,34000,0
2018-06-01,2066586166,C013020,티셔츠,(4926상)랩스타일 산전산후 수유가능한 면스판 임부상,18130,18130,0
2018-06-01,1082967458,E031120,믹서,한일 유리 믹서기 HMF-1410 /믹서/분쇄/타이머기능,52500,52500,0
2018-06-01,1008299744,A017220,양파,[맘스허브]국산 손질대파 300g,1250,1250,0
2018-06-01,1431285823,C013060,등산복,[케이투(의류)]남여공용 마조람 롱 다운자켓 (KMW17581),199000,155220,-43780
2018-06-01,53893729,C013020,티셔츠,챔피온 후드집업/맨투맨/후드티!,24900,24400,-500
2018-06-01,1090484495,L021010,손목시계,카파 손목시계 DS116UA 카파 손목시계 전자시계 스포,31110,31110,0
2018-06-01,581159786,F012020,생리대,뉴템포/화이트 탐폰/체내형 생리대/무료배송/당일발송,10500,10500,0
2018-06-01,1775975458,A014030,치즈,매일유업 상하 체다슬라이스치즈25매X4팩 (총100매),24900,24900,0
2018-06-01,245589127,E061010,세탁세제,세제혁명 프리미엄 700g 1통 특가판매,4990,4990,0
2018-06-01,1010348798,A018010,초콜릿,[롯데]롯데 가나 미니 초코바 500G,12000,8590,-3410
2018-06-01,1027826624,C012030,여자상의,에레나 반팔 청원피스 SD-6287-데님원피스 원피스,29410,26180,-3230
2018-06-01,1196781204,C013040,청바지,허리가 편한 인생핏 짤막 코튼 일자진 / 슬랙스,17000,16800,-200
2018-06-01,453337936,C012040,여자학생복,롱 청자켓 로이청롱 NB KD 여성용롱셔츠 여자청셔츠,37580,37580,0
2018-06-01,944941373,C012040,여자학생복,당일발송 국내제작 블라우스/정장셔츠/화이트셔츠,8900,8900,0
2018-06-01,1784672527,I053020,스케치북,흰도화지/흑도화지/125매/8절/4절/A4/B4,4400,4400,0
2018-06-01,1494217040,I031040,생화,코스모스 바퀴형 테이블 아이스박스 쿨러백 대원산업,79000,72590,-6410
2018-06-01,410767898,C012040,여자학생복,[앤아이]레이스메쉬 시스루 웨어 BL,17100,16250,-850
2018-06-01,449969259,E031010,전기밥솥,(추천)쿠첸 명품철정 4인용 IH압력밥솥 CJH-PA0404ID,233000,219020,-13980
2018-06-01,950499784,E011040,소파,보니타빈백 럭셔리 트루파우치 LP502 쇼파/소파베드,124900,124900,0
2018-06-01,1011058921,A019180,즉석식품,CJ 햇반컵반오징어덮밥 230G,4150,2380,-1770
2018-06-01,1997096618,A014030,치즈,[냉동냉장배송][소와나무] 모닝버터오메가3 450g,7800,7800,0
2018-06-01,1708365276,E031020,가스레인지,하츠 3구 가스쿡탑 GC-3605SDSH/전화구안전센서,130000,130000,0
2018-06-01,1973057777,C012060,여자내의,[보니스팍스][90%세일 보니스팍스] 블링블링 스커트 D732SK020,10000,10000,0
2018-06-01,1011058920,A019180,즉석식품,CJ 비비고 스팸부대찌개기획 460G*2,9980,9980,0
2018-06-01,1789627946,I053040,기타문구,테이프형접착메모/포스트잇/메모테이프/메모스티커,1000,1000,0
2018-06-01,246632985,C013010,점퍼,빅사이즈 프리스타디움점퍼 MS1704 빅사이즈 여성의류,67070,65730,-1340
2018-06-01,928867514,A021010,커피,스타벅스 원두커피 1.13 kg 브렉퍼스트 블랙퍼스트,23490,23490,0
2018-06-01,1457569889,C014010,아동복,[블루독아동/키즈6]남아) 이월행사) 히어로그래픽티셔츠(27375-332-06/7/9) 라운드/여,26000,23400,-2600
2018-06-01,293359332,C012040,여자학생복,[루시다]M107 V4810/로하스 사이드버튼 린넨베스트/ 루시다(의류),43800,38550,-5250
2018-06-01,464129322,I031040,생화,전구형 캠핑 랜턴/램프/USB/LED/텐트등/후레쉬/야외등,1900,1750,-150
2018-06-01,56159532,A018100,꿀,꽃샘 사양벌꿀 2kg/곰돌이꿀/아카시아꿀/잡화꿀/꿀차,12900,12900,0
2018-06-01,63852204,E011060,의자,철제간이의자 화장대 1인용 2인용 벤치 식탁의자,27840,27840,0
2018-06-01,1588175177,E041060,수저,국산 스텐레스 수저세트-티스푼/포크/숟가락/젓가락,14000,12500,-1500
2018-06-01,1740843189,G011070,자전거,시애틀모던F 삼천리 하이브리드21단,118100,106290,-11810
2018-06-01,17247924,L021020,장신구,실버링 은반지 졸업 입학 우정 92.5% 순은 선물,13000,13000,0
2018-06-01,1170406721,C011050,남자내의,[리바이스] 남성 502 레귤러 테이퍼드 디스트로이드 데님 반바지 라이트 워시 32792-0,79000,65570,-13430
2018-06-01,446442306,D031010,주택수선재료,16L 오일스테인 우드케어 가구 도장공사 목재페인트,118370,118370,0
2018-06-01,1491495550,A022050,탄산음료,나랑드사이다 1.5Lx12펫 사이다/탄산음료,10900,10900,0
2018-06-01,979400919,A017160,오이,건표고버섯선물 거래처선물세트 명절선물 부모님선물,34000,34000,0
2018-06-01,292345508,E021010,침구,/의자패드 블루 라티오/ 의자패드 의자매트 디자인방,7500,6150,-1350
2018-06-01,1196756267,C021040,실내화,[푸마]8종 공용 운동화/스니커즈/런닝화(당일발송),35000,25960,-9040
2018-06-01,1535394288,A019110,드레싱,기라델리 다크 초콜렛 카라멜 초코 소스 토핑 시럽,16590,16590,0
2018-06-01,1209256913,C012040,여자학생복,롱 시스루 가디건,16700,16200,-500
2018-06-01,686734397,I012010,컴퓨터,정품 삼성컴퓨터 데스크탑 본체/사무용/업무용/PC/SSD,648000,622080,-25920
2018-06-01,1981958255,E031110,청소기,유진로봇 아이클레보 A1 로봇청소기 YCR-M05-A10,299000,299000,0
2018-06-01,2146151798,A017010,배추,베이비채소 야채 씨앗텃밭 상추 배추 쑥 갓 오이 부추,2000,2000,0
2018-06-01,1175026865,I031010,장난감,(Step2)병아리차 (2016.4.1 소비자가 인상) 자동차운,209300,209300,0
2018-06-01,950522626,L021030,가방,리바케이스 7860 17.3인치 노트북 가방/게이밍 백팩,129000,126420,-2580
2018-06-01,65074987,A011020,현미,[2017년 찹쌀10kg/현미찹쌀10kg] 찰현미/찹쌀현미/쌀,29900,29900,0
2018-06-01,1141688290,I012010,컴퓨터,2014년형 뉴맥북프로 13인치 MGX82KH/A /SG/재고보유,1874640,1874640,0
2018-06-01,1859171605,C012020,원피스,(무료배송) (해외직배송)리본 프릴 정장 원피스 여자,76120,66990,-9130
2018-06-01,989944757,E031070,에어컨,마이초절전써큘레이터(MFSS-09S),129000,69900,-59100
2018-06-01,1233809017,G022020,자동차타이어,넥센타이어 N7000 플러스 215/45R17 정품 무료배송,66000,55680,-10320
2018-06-01,1997287142,E011020,침대,[골든잼]잣나무 원목 카우치/돌쇼파 카우치소파,2677300,2596990,-80310
2018-06-01,989944755,E031070,에어컨,마이16인치스텐드선풍기(MFBM-16M),89900,30900,-59000
2018-06-01,895746417,A013170,생선통조림,[동원]동원 살코기참치 100G*3입,6250,6250,0
2018-06-01,1135597296,L012090,기초화장품,50%할인+추가증정! 마몽드 플라워 토너 5종 1+1 외,15000,15000,0
2018-06-01,1128784262,E041070,밀폐용기,사각밀폐용기/일회용용기/샐러드/반찬통/소풍/도시락,11900,11900,0
2018-06-01,464414309,C012020,원피스,[플라스틱아일랜드] 소매 플레어 핸드메이드 자켓(PH4HJ061)/ 플라스틱아일랜드스토리,79000,64780,-14220
2018-06-01,1886907166,C013010,점퍼,봄 여름용 콤비자켓 와사자켓 체크자켓,43900,43900,0
2018-06-01,668005537,C013020,티셔츠,에스닉시스루티/자수티셔츠/망사티셔츠/레이스티,9900,9900,0
2018-06-01,235236043,E031050,냉장고,T딤채소형김치냉장고 쁘띠100L WDS10BEACL/WDS10BPACL,579000,549000,-30000
2018-06-01,1846352565,E031010,전기밥솥,[공식]쿠첸 프리미엄 IH압력밥솥 6인용 CJH-VE0682ID,147000,147000,0
2018-06-01,177530255,C011030,남자학생복,[아메리칸웨스트]Angina 남성가디건/니트/정장가디건,12800,6400,-6400
2018-06-01,649518456,C013020,티셔츠,[톰보이]트윌 트렌치코트 9108111995,199000,161190,-37810
2018-06-01,798295297,C012060,여자내의,[로엠][로엠] 캐주얼 멜빵 스커트 RMWH525G52,9900,9410,-490
2018-06-01,2095221589,A013170,생선통조림,유동 자연산골뱅이400g,6350,6350,0
2018-06-01,266326355,A021010,커피,맥심 아이스 커피믹스 블랙 110T,14400,14400,0
2018-06-01,505160083,E041020,컵,한국도자기 2인조 커피잔 모음/ 티스픈증정,50400,50400,0
2018-06-01,937031165,C013040,청바지,리바이스/CK/ 청바지/자켓/데님 남방/진/스키니/진,45000,45000,0
2018-06-01,2102973737,A011100,라면,사포코 에그누들 500g,3500,3500,0
2018-06-01,1895255739,C013040,청바지,레깅스 하이웨스트 9부 밍크털 슬림핏 레깅스 레깅스,19670,19670,0
2018-06-01,146534508,C014010,아동복,티파니 11세 67-145 마혼방 반팔 자켓 미사용 /823,10000,9900,-100
2018-06-01,1700570549,C013040,청바지,[앙투] 여름신상 바지25~36빅사이즈 청 반바지 슬랙스,24800,24800,0
2018-06-01,439606540,A019100,식초,(무)일회용 토마토케찹9g(1000개입)케찹 식자재 마요,51600,43860,-7740
2018-06-01,895746423,A013170,생선통조림,[동원]동원 야채참치 100g,2100,2100,0
2018-06-01,769538139,L021030,가방,에일리언웨어 Alienware AWV17BP 17인치 노트북백팩,135000,129000,-6000
2018-06-01,142664266,A016090,참외,참외하면 성주! 비교불가 꿀 참외 4kg,8900,8900,0
2018-06-01,336149068,A018030,껌,롯데 자일리톨 껌 오리온 리필 알파 코팅 용기 통 판,3600,3600,0
2018-06-01,1841323133,E031120,믹서,신일 다용도 믹서기 SFM-353NK /칼날 2가지/컵 총4개/,26300,26300,0
2018-06-01,1816802127,I031040,생화,MS 미니테이블/2폴딩 접이식 테이블 캠핑용품,20000,15850,-4150
2018-06-01,1420347027,C015020,모자,힙합모자/스냅백/야구모자/군모/빈티지/여름모자,4900,4800,-100
2018-06-01,1563372188,D031010,주택수선재료,(MD추천~드라마협찬)숲속에느낌그대로/포인트스티커/시트지/벽지/창문/그래픽/데코/유,10000,6210,-3790
2018-06-01,1050288076,E021010,침구,자연미학 어반 링클피그먼트 워싱이불3장 + 베개커버6장 세트 퀸(Q),89900,89900,0
2018-06-01,1487223379,C012040,여자학생복,[마리끌레르]무봉제니트가디건(MA8BKN07M4)(김해점),180600,166430,-14170
2018-06-01,149469965,A016110,딸기,세미원 냉동 딸기 1kg 2개,25480,25480,0
2018-06-01,2113993648,E031140,비데,[본사직영점] 노비타 비데 BD-H210 /스테인리스노즐,148000,148000,0
2018-06-01,1206204532,C011050,남자내의,(남자옷도매) DP-249 린넨마 ST팬츠 (S-XL) 연소라 패,30140,30140,0
2018-06-01,1930829278,C013050,운동복,LED하이브리드화살표 2차사고예방 공공기관납품,38000,32200,-5800
2018-06-01,508403932,E011060,의자,모던식탁의자/인테리어/거실/책상/컴퓨터/카페/다용도,27900,27900,0
2018-06-01,1803094050,C013010,점퍼,[인디고뱅크키즈]베이직 절개배색 바람막이 IKJA183G2,15900,15900,0
2018-06-01,1022366976,G011070,자전거,뮤트 접이식자전거 미켈란 20인치/26인치 MTB형 21단,73100,65790,-7310
2018-06-01,1049938910,E031120,믹서,JB3060WH 브라운 믹서기 1.75L/내열강화유리 dk,82500,77370,-5130
2018-06-01,945602597,E031080,선풍기,니코 세라믹히터 UMH-6702C,28100,28100,0
2018-06-01,2029493944,C012060,여자내의,난닝구 트레빌로 밴딩스판숏팬츠/ 난닝구,17900,17370,-530
2018-06-01,318044723,C013010,점퍼,봄 여름 자켓 블루종 롱 점퍼 바람막이 남자 남성,26900,23900,-3000
2018-06-01,988091888,A016130,키위,제스프리 썬골드키위 (6~12입/팩),9990,9590,-400
2018-06-01,1582003405,C011030,남자학생복,심쿵가디건/베이직/롱/배색/숄가디건/자켓가디건/남자,14800,14800,0
2018-06-01,291997749,C012040,여자학생복,앤플러스 여성 집업 롱베스트/롱조끼/가디건/캐주얼/단체복/셔츠/반바지/티셔츠,49800,49800,0
2018-06-01,486398806,F011130,홍삼,천제명 진홍삼액골드(60ML*30입),37000,37000,0
2018-06-01,1045980470,L012090,기초화장품,정품 피지오겔로션/크림/클렌징/베스트1+1(9비누증정),34900,34900,0
2018-06-01,898603624,A018060,스낵과자,[크라운]크라운 쵸코하임 (142G),2750,1990,-760
2018-06-01,424642352,A019030,생강,백초생강 (참존 1.2k) X10,45560,40550,-5010
2018-06-01,1597263696,F011130,홍삼,정관장 홍삼정진(200G),130000,130000,0
2018-06-01,1565870225,I031040,생화,LED 헤드 랜턴 헤드 렌턴 충전식 랜턴 18650충전지,13900,13900,0
2018-06-01,1956328225,E031130,보온매트,#TV홈쇼핑정품#한일/보일러매트{더블사이즈}온수매트,398000,394020,-3980
2018-06-01,988150534,A017130,도라지,[CJ직배송] 맛고구마 60g X10개,31500,20900,-10600
2018-06-01,990005269,A022050,탄산음료,롯데 클라우드클리어제로(캔) 350ML,1300,1300,0
2018-06-01,1388144574,F011150,건강기능식품,야미베어스 유기농 멀티비타민(대용량180T)/야미베어/,35900,35900,0
2018-06-01,1426546896,A021010,커피,빈스힐 하루두잔 빼자카페 10포,21000,20000,-1000
2018-06-01,836122497,A022030,생수,바두아 스파클링(750미리/330미리) 무료배송/빠른배송,41900,41900,0
2018-06-01,173374049,C012060,여자내의,[디어제인][디어제인]9부베이직팬츠M4283,6700,6370,-330
2018-06-01,1216819017,C011020,남자상의,3pcs 투피스 세트 조끼는옵션 여름용 린넨 정장세트/,99000,98000,-1000
2018-06-01,488086491,E041010,식기,금원보/삼족두꺼비/풍수지리/인테리어/소품/개업선물,76800,75270,-1530
2018-06-01,895685138,A011110,당면,풀무원 SOGA 부침용두부 300G,1590,1590,0
2018-06-01,2046214649,E021010,침구,바이알러 진드기 알러지 방지 딜라잇 차렵토퍼 침구세트 (차렵이불+토퍼+누비베개커버,69900,69900,0
2018-06-01,2126168050,C013020,티셔츠,a라인레이스ops/레이스원피스/레이스민소매/롱티,19500,19500,0
2018-06-01,1125572986,A021010,커피,아이브루 1+1(70T+70T)/커피믹스/홍차or녹차 10T 증정,9900,9900,0
2018-06-01,1011093300,A021020,차,수입커피모음패키지 커피모아 믹스_25종 25개입,12500,12500,0
2018-06-01,256516515,A011080,밀가루,백제쌀국수 면마루쌀국수 24개/30개/쌀떡국 떡뽁이,22700,22700,0
2018-06-01,476498360,C013010,점퍼,MJ-997 ( 인기) 생지노멀1 청자켓 (M-L) 진청 남성코,37520,37520,0
2018-06-01,1121540545,F012020,생리대,엘리스 생리대 순수감촉 날개형 대형 10P x 4팩/ 엘리스,8500,8080,-420
2018-06-01,1779631307,L021020,장신구,[바보사랑]두산베어스 원형 손거울 스트라이프,4000,4000,0
2018-06-01,452798988,L021060,유모차,프라메떼 - 디럭스사륜 180도차양 170도등받이조절 유,776330,690940,-85390
2018-06-01,350739948,I031010,장난감,와우토이즈 맥스 모터바이크 장난감 완구 어린이 아,39190,39190,0
2018-06-01,1533175804,C012040,여자학생복,[ab.f.z]혜리블라우스 AFR3GB53F[갤러리아],39000,33150,-5850
2018-06-01,2097186361,A012030,돼지고기,오늘도돼지예 삼겹살/오겹살/목살/왕목살 500g,3900,3900,0
2018-06-01,378320477,C012060,여자내의,[쿠키세븐]P6576 린넨 클래식 버튼 큐롯팬츠,52000,49400,-2600
2018-06-01,2024871628,A012010,국산쇠고기,(롯데햄 선물세트)카놀라유 1호 x 6개 고급 쇼핑백 포,100580,89520,-11060
2018-06-01,1346852423,I011020,영상음향기기,PA500S/뷰소닉/빔프로젝터/3600안시/15000시간/ABC,369000,321030,-47970
2018-06-01,1506133866,C013060,등산복,[빈폴아웃도어]스카이 블루 여성 칼라리스 재킷 (BO8339C03Q),159000,125610,-33390
2018-06-01,1104147653,F012010,종이기저귀,[2018 ALL NEW] 보솜이 디오가닉 신생아/소형 2팩,25900,25900,0
2018-06-01,1865833030,C013020,티셔츠,[반에이크]젤리티셔츠J(VA84TSQ394A),19800,17820,-1980
2018-06-01,1036226045,C021040,실내화,크록스 성인/아동/여성 샌들/아쿠아슈즈/슬리퍼,20900,20900,0
2018-06-01,1458253452,A013040,고등어,50년 간잽이/이동삼 간고등어/안동간고등어,22800,22800,0
2018-06-01,2057077449,C013040,청바지,남성 D톤워싱 캣브러쉬포인트 스키니핏 스판데님팬츠 FNMEDDK120M/ 닉스,29500,26550,-2950
2018-06-01,1172048794,C012040,여자학생복,추가금NO.자체제작상품.빅사이즈까지 블라우스 셔츠,19900,19900,0
2018-06-01,1121540573,F012020,생리대,엘리스 생리대 메가미 날개 중형 22P x 2팩/ 엘리스,10500,9980,-520
2018-06-01,1536511557,C012040,여자학생복,지나블리스 체크 롤업 긴팔 셔츠 7455,18900,18900,0
2018-06-01,718040778,E011040,소파,보니타빈백 대형 코쿤 C207 빈백/쇼파베드/1인용쇼파,79900,79900,0
2018-06-01,1391375505,C011050,남자내의,[지큐][지큐쿨제이][여름신상] 01 심플 스트링 고무줄 5부 반바지 하프팬츠,16800,15960,-840
2018-06-01,1120129188,A022010,주스,웅]자연은제주감귤1.5/내사랑알로에1.5/내사랑토마토1,1100,1100,0
2018-06-01,1110581193,E011050,책상,무료배송 1인용컴퓨터책상/학생책상/서재/좌식책상,19900,19900,0
2018-06-01,2068334148,C013010,점퍼,남자청자켓 와펜 패치 빈티지 데님자켓 C0216001a /,57700,49050,-8650
2018-06-01,692864714,C012030,여자상의,로로텐 롱/미니/쉬폰/레이스 원피스/빅사이즈,37900,37900,0
2018-06-01,451061057,C012060,여자내의,아리아나 뒷트임 청롱스커트-청치마 DM-5037,20720,20720,0
2018-06-01,1216021971,A019180,즉석식품,정인혜의 맛있는 집밥도시락/즉석밥/식단관리 도시락,26000,26000,0
2018-06-01,1121539581,F012020,생리대,엘리스 생리대 순수감촉 일반형 소형 28P x 4팩/ 엘리스,8500,8080,-420
2018-06-01,1168213661,I011030,사진기,소니 A7S II 본체 정품 명품,2662480,2662480,0
2018-06-01,395561076,C012030,여자상의,오프숄더어깨끈원피스/미니/섹시/어깨트임/클럽.,10900,10900,0
2018-06-01,818685759,I011020,영상음향기기,가즈아특가 삼성 빔프로젝터 SSB-10DLFN08 스마트빔,249000,249000,0
2018-06-01,1346140250,A014010,우유,엿기름(신화 15K )/대용량 엿기름가루 식혜재료,55100,52350,-2750
2018-06-01,562978158,E021020,커튼,로만블라인드 화이트 링블롬마 120x160 cm/ 로만쉐이,55950,49800,-6150
2018-06-01,173374013,C012060,여자내의,[디어제인][디어제인]9부카브라팬츠M4282,6700,6370,-330
2018-06-01,895685160,A011110,당면,풀무원 SOGA 찌개용두부 300G,1590,1590,0
2018-06-01,1013469420,C012040,여자학생복,깔끔화이트셔츠 롱블라우스 고급셔츠 플러스사이즈,56800,56800,0
2018-06-01,1121540576,F012020,생리대,엘리스 생리대 메가미 날개 대형 18P x 2팩/ 엘리스,10500,9980,-520
2018-06-01,1184702203,A011050,콩,팜앤팜 국내산 땅콩 수입 땅콩 모음,3900,3900,0
2018-06-01,448320348,A013150,어묵,(냉장)부산 등대어묵(범벅)800gx20개,81570,81570,0
2018-06-01,1209435469,C013040,청바지,[Blouson]쿨 나뭇잎나염 와이드 밴딩팬츠_[B1806PT063B],29000,25780,-3220
2018-06-01,1226144963,I053040,기타문구,핑크풋 귀여운 캐릭터 떡메 브라더 메모지,1500,1200,-300
2018-06-01,1555885492,A014020,분유,베비언스 산양 액상분유 3단계 20개입(니플 미포함),45400,43120,-2280
2018-06-01,1240432490,C021040,실내화,더구두 꾸민듯 안꾸민듯 운동화/패션/슬립온/스니커즈,9900,9900,0
2018-06-01,1493084668,C012060,여자내의,스판여자슬랙스/여성정장바지/예프클럽,19800,19800,0
2018-06-01,194769331,A013070,굴,당일조업 싱싱홍게 3kg 홍게 박달급 산지직송,34000,21800,-12200
2018-06-01,146629455,E031040,전기레인지,휴대용냉장고 작은냉장고 차량냉온장고 차량용냉온장,75360,75360,0
2018-06-01,1072638190,C014010,아동복,[아동조끼정장]남아정장 여아정장 아동복 합창단복,49900,49900,0
2018-06-01,960447725,E061050,청소용세제,한입 베이킹소다 리필 2KG,5990,4990,-1000
2018-06-01,2012276563,I031010,장난감,랜드로버 레인지로버 붕붕카 이보크붕붕카 벤츠붕붕카,34000,34000,0
2018-06-01,1996154999,A019010,고춧가루,김치용 고춧가루 (진성 1k),41150,36630,-4520
2018-06-01,988091828,A013170,생선통조림,[동원]고소한 꽁치 300G,3690,3690,0
2018-06-01,1153997621,A022010,주스,코코씸 코코넛 워터 퓨어 100% 330ml 1박스(12개입),11200,10820,-380
2018-06-01,1065475081,A013080,조개,[굴철철]냉동굴10kg~20kg/건조굴/굴수출기업,77800,77800,0
2018-06-01,400125739,A017050,미나리,국내산 양배추2통(3kg내외)/4통(6kg내외),9800,9800,0
2018-06-01,1940084584,I031010,장난감,벤츠 벤틀리 레인지로버 이보크 붕붕카 / 아기붕붕카,25440,22900,-2540
2018-06-01,538577143,D031010,주택수선재료,아이생각 가구 방문용페인트 광택 1리터,8900,8900,0
2018-06-01,502948239,L021010,손목시계,유로스타일 남성 시계 MV2097025BK 손목시계 패션시계,68500,68500,0
2018-06-01,2113454530,A015020,식용유,해표 식용유 1.8L x 2개 / 백설콩기름1.8L x 3개,10600,10600,0
2018-06-01,1945383154,E061040,부엌용세제,커피머신세정제 어넥스카피자 - 커피머신세정제 커피,41790,37200,-4590
2018-06-01,1845568031,E021010,침구,봄신상품/이불+패드+베개커버/이불3종세트,47900,39900,-8000
2018-06-01,392414119,C011030,남자학생복,폴로 빈폴 남방 버버리 체크 구제 남방 카라 티 셔츠,9900,9900,0
2018-06-01,1385852005,A011160,빵,안흥찐빵마을 수제 슈크림찐빵 500g(10입) 수제 찐빵,26120,26120,0
2018-06-01,1505107137,C012040,여자학생복,[쉬즈미스]쉿!시크릿가 썸머 원피스/블라우스/팬츠 18종,30000,24000,-6000
2018-06-01,1991678487,C013020,티셔츠,엘룬/M~4XL/반팔티/티셔츠/쿨론티/빅사이즈,11800,11800,0
2018-06-01,1468502642,A012010,국산쇠고기,[무항생제] 불고기샤브샤브300g 1+등급,18700,18700,0
2018-06-01,385882867,E011050,책상,[이스마트] 엘리트 독서실책상 3종/혼공책상,54000,48600,-5400
2018-06-01,1751280935,E041010,식기,세세라 혼밥세트/접시/공기/대접/식기세트/1인세트,14800,13490,-1310
2018-06-01,1497914522,D031010,주택수선재료,옥상방수 우레탄방수재 중도 1액형(4KG) 모노탄/원샷,24900,24900,0
2018-06-01,184551538,L012060,샴푸,[댕기머리]가장싼곳!(1+1+1)3개특가/허벌 명품 뉴골드,19800,19800,0
2018-06-01,468419100,C021040,실내화,[국내당일배송]나이키 베이퍼맥스 트리플블랙,105000,105000,0
2018-06-01,1840676592,C014010,아동복,[에꼴리에]소이 PNC02 슬림공용원워싱데님바지 18S0208,29800,29210,-590
2018-06-01,447864289,A013160,맛살,(냉장)한성통통맛살H(1kg)x5개,37580,37580,0
2018-06-01,41211033,L012060,샴푸,[본사직영]미쟝센 퍼펙트 세럼 샴푸 680mlx3개,12900,12900,0
2018-06-01,500326833,A019140,이유식,[아이배냇] 홈메이드 죽 만들기/햅쌀 아기 이유식,5530,5530,0
2018-06-01,1896009196,A019110,드레싱,폰타나 파인드레싱(무지방)(230G),2580,2580,0
2018-06-01,982579656,E031070,에어컨,SUPERCOOL 스텐드선풍기 40CM,29900,29900,0
2018-06-01,597240221,E041070,밀폐용기,대용량 매실병 효소병 3L~25L 과실주병 담금주병,10900,10030,-870
2018-06-01,982579657,E061090,방향제,불스원 폴라패밀리 북극곰 클립(4.3ML),6500,6500,0
2018-06-01,1297202928,A011140,부침가루,두레생협 감귤컵푸딩(78g)5개,17000,16490,-510
2018-06-01,451146549,A019010,고춧가루,가을 다데기 상 고추가루 2.5kg2개 가루 고추가루 다,107410,96670,-10740
2018-06-01,116178459,A021010,커피,2만원 무배/돌체구스토 캡슐/싱글오리진 단독판매,9880,9880,0
2018-06-01,1302860120,C013050,운동복,7부팬츠트레이닝세트/운동복세트/밴딩팬츠/츄리닝세트,9900,9900,0
2018-06-01,1743916190,I031010,장난감,[파파야나인] 포르쉐 박스터 유아용 아기 어린이 푸시카,229000,229000,0
2018-06-01,1356302215,C013010,점퍼,(티티뱅크) 웰론 하이넥 롱패딩 블랙 / 참고 롱패딩,139800,123030,-16770
2018-06-01,1829677675,L012110,색조화장품,AHC 내추럴 플러스 선스틱 20g+20g/썬스틱/선크림,19800,18900,-900
2018-06-01,578350551,C011030,남자학생복,FS-929 땡땡이포인트 청남방 청남방 남성남방 남성청,18670,18670,0
2018-06-01,127093244,L021060,유모차,아발론&오샤인 초경량 쌍둥이 휴대용 유모차,159000,159000,0
2018-06-01,23368730,L021020,장신구,원석sale/천연투어멀린/3.7ct/tourmaline,75000,75000,0
2018-06-01,550417552,I031040,생화,자충식 에어베게 공기베게 캠핑배게 쿠션베개 W086517,6440,6440,0
2018-06-01,2147409164,A016160,과일가공품,블루베리(건조 한끼 350g)X6,110760,110760,0
2018-06-01,1667542936,A013080,조개,왕중왕 해물나라 900g2개 해물나라 해물모듬 냉동식품,35910,35910,0
2018-06-01,1620621430,L012090,기초화장품,대용량 페디슨 아로마틱 카밍토너 500ml 무자극 스킨,12900,12900,0
2018-06-01,994361477,E061060,살충제,[방역전문용]바퀴벌레약 피프로겔 250g/맥스포스 셀렉,22700,14990,-7710
2018-06-01,1010289928,F011120,인삼,[동횡성농협] 강원도 더덕 800g (생더덕),19900,16000,-3900
2018-06-01,2058365478,C012040,여자학생복,[에이인][에이인]kiko check cardigan,35650,32090,-3560
2018-06-01,1407944624,C013050,운동복,콜라보배색집업 MS1710 운동복상의 운동 상의 여자이,53210,53210,0
2018-06-01,895830275,A019060,된장,[해찬들]해찬들 재래식된장 1KG,6540,5690,-850
2018-06-01,1329058130,C013040,청바지,[버커루진]남성용 저온스 데님 팬츠 청바지(B162DP140M)(강남점),30000,26190,-3810
2018-06-01,1264745884,C013020,티셔츠,크리비아 랩스타일 수유가능한 면스판 임산부 8부상의,13000,13000,0
2018-06-01,502890484,C013020,티셔츠,T1432-베이직 슬라브 티셔츠 캐주얼티셔츠 데일리티셔,12080,12080,0
2018-06-01,344827703,C012040,여자학생복,수지네 구제 sgf 오렌지 구스다운 경량베스트 여성 S,13370,13370,0
2018-06-01,1615593102,A019180,즉석식품,손맛진한 정성온 즉석국 11종 600g x 6팩 6봉묶음특가,15900,15900,0
2018-06-01,817679,E011040,소파,버즈가구 BEST 니올 4인용 전체풀커버 패브릭소파,704000,633600,-70400
2018-06-01,1096025011,E031080,선풍기,홍진_ 사파이어 전기라디에이터 SF-007T (타이머 7핀),48200,48200,0
2018-06-01,1096025012,E031080,선풍기,홍진_ 사파이어 전기라디에이터 SF-009T (타이머 9핀),55800,55800,0
2018-06-01,940012242,E061080,키친타월,[코디] 뽑아쓰는/기름먹는 키친타올 150매x12개,17200,17200,0
2018-06-01,1096025013,E031080,선풍기,홍진_ 사파이어 전기라디에이터 SF-15T (타이머 15핀),80300,80300,0
2018-06-01,563400933,A021020,차,쥬피터 카라멜 바닐라 헤이즐넛 커피시럽 740ml,8500,8500,0
2018-06-01,2058595592,A011170,떡,명미당 45년전통 평택 인절미 세트(쑥밥 흑임자) 각55,61820,61820,0
2018-06-01,874363587,A017020,상추,적상추 4kg내외 최상품 한박스,33900,33900,0
2018-06-01,577461762,C012040,여자학생복,빅사이즈/캐주얼/후드/조끼,33610,33610,0
2018-06-01,1407488703,C013060,등산복,[펜필드]역시즌 남성 롱다운/숏다운 129000원 균일가(FH4WD11M/FH4WD14M/FH4WD19M) MS,129000,116100,-12900
2018-06-01,586695703,E041010,식기,토프 다이어트 식기 모음전,2900,2670,-230
2018-06-01,1011152106,L012110,색조화장품,참존화장품 알바트로스 레포츠 선크림 60ml,30000,12000,-18000
2018-06-01,537192052,C011030,남자학생복,오투웜발열조끼(조끼+발열체+베터리+충전기)],134900,134900,0
2018-06-01,992249220,G011070,자전거,무료조립 알루미늄 하이브리드 자전거 리버스 어반H,290000,265880,-24120
2018-06-01,605286294,C013020,티셔츠,시크폭스 매듀이 티셔츠/ 시크폭스,13800,10770,-3030
2018-06-01,599062217,C013040,청바지,여름신상 예쁜 반바지 모음전 청바지/스커트/레깅스,18900,18900,0
2018-06-01,1287133104,C013020,티셔츠,[필잇]S~5XL/빅사이즈/예쁜반팔티/남여공용/무지티,10630,8510,-2120
2018-06-01,89654762,C012040,여자학생복,[MLB]엠엘비 2종택1 여성 등판엠보로고 MLB 후드집업(31TRC5811),104300,88660,-15640
2018-06-01,648098341,A013040,고등어,숨비소리 전자렌지OK/맛있게 구운 제주고등어구이12팩,25800,25800,0
2018-06-01,450309394,A017040,양배추,수입산 사상자70g 뱀도랏 사상자 뱀도랏 토사자 미나,3310,2980,-330
2018-06-01,1443593789,A016020,배,찬바람N(앤) 도라지배즙 (100mg25포)-도라지 배즙 겨,60150,53540,-6610
2018-06-01,1150426578,C013020,티셔츠,타미힐피거 타미 카라티 반팔티 라운드 맨투맨 단체티,23000,23000,0
2018-06-01,1238104460,C012040,여자학생복,[제쉬나인][제쉬나인]컬러플라워 로브 가디건,27600,24840,-2760
2018-06-01,94475238,A022050,탄산음료,탄산음료 캔커피 음료 캔음료 웰치스 포카리 음료수,9900,7900,-2000
2018-06-01,471746259,C013020,티셔츠,77 88빅사이즈 면혼방 후드 단가라 스트라이프 박스티,23900,23900,0
2018-06-01,2124065715,A013030,조기,인천수협수매 서해안 반건조 두절 참조기400gx3팩/팩10~12미,18900,18900,0
2018-06-01,1706536527,E051030,디지털도어록,무료설치 WF-20 지문키 도어락 디지털도어록 번호키,125000,112500,-12500
2018-06-01,1363193899,F012020,생리대,좋은느낌 생리대 순수 순면 유기농 화이트 중형/대형,10000,10000,0
2018-06-01,2072782758,A021010,커피,무료택배 치보5종세트 카피시모 캡슐커피/에카페 cbtl,35000,33500,-1500
2018-06-01,1337003774,I011010,TV,NEX 32인치 TV/ 100% 무결점/ LG패널 아닐시 1억 배상,155300,149000,-6300
2018-06-01,453215520,E061040,부엌용세제,퍼실 프릴 베이킹소다 1000mlx2 레몬 허브 주방세제,11200,11200,0
2018-06-01,989018258,C015040,장갑,초L)예식장갑3P,3990,3990,0
2018-06-01,1117290855,E011030,거실장,파란나무 드론 600 거실장 협탁,98000,98000,0
2018-06-01,1117290856,E011030,거실장,자연둥이 멀바우 철다리 1800 TV거실장 거실장세트,224000,224000,0
2018-06-01,815682177,E011050,책상,코너책상/책장세트/L형책상/컴퓨터책상/책상/학생책상,146000,139900,-6100
2018-06-01,1117290857,E011030,거실장,자연둥이 멀바우 철다리 2400 TV거실장 거실장세트,282000,282000,0
2018-06-01,895830280,A019060,된장,[해찬들]해찬들 재래식 된장(봉/500g),3300,3300,0
2018-06-01,530425326,L021030,가방,타거스 16인치 TSB705AP 노트북가방 노트북백팩/ WR,52000,51000,-1000
2018-06-01,494367645,C013050,운동복,[리베리베]여자요가/요가복세트/트레이닝복/세트,15800,15800,0
2018-06-01,988066810,F011150,건강기능식품,정관장 홍삼원골드 50ml*60포,70000,52900,-17100
2018-06-01,988066811,F011150,건강기능식품,정관장 아이키커 사과맛 10팩,15900,9900,-6000
2018-06-01,334391276,C013030,스웨터,라인 니트 집업 니트집업자켓 긴팔아우터 니트자켓 아,70870,70870,0
2018-06-01,916654095,C012020,원피스,[로엠][로엠] 클래식 베이직 코트 RMJH5221R2,15500,14730,-770
2018-06-01,1545078986,C011050,남자내의,여름신상 남자 면반바지/청/5부/7부/린넨/카고/스판옷,15700,15700,0
2018-06-01,986272585,E041040,프라이팬,초L) 셰프 양면팬,29900,29900,0
2018-06-01,618791496,L021020,장신구,스와로브스키 은침귀걸이 이어링 귀고리 유색 크리스탈 여성악세사리선물 패션쥬얼리,21300,20670,-630
2018-06-01,1563840043,C012020,원피스,[나이스클랍]넝클 자켓 (N172MSF106)(의정부점),89000,72150,-16850
2018-06-01,1755350717,C012060,여자내의,[공구우먼]팬츠 모음 바지 청바지 레깅스 숏 빅사이즈,19800,19800,0
2018-06-01,602552566,C013060,등산복,[밀레(MILLET)][2018 여름 신상품][남성용] 피곳 팬츠 ( MUNUP476 )(김해점),59000,47650,-11350
2018-06-01,572287231,C015030,넥타이,명품 고급 실크넥타이/백화점납품/수동/패션캐릭터/,34900,34900,0
2018-06-01,1028370972,E011040,소파,[에보니아] 라떼 2인소파/방수패브릭/패브릭/2인쇼파,77000,69300,-7700
2018-06-01,2058860978,C013040,청바지,[에이인]slim leg line denim pants (s  m  l),31000,29450,-1550
2018-06-01,896931706,C021040,실내화,[리복(Reebok)]REEBOK CLASSIC/UNISEX 리복 로얄 컴플리스 2 LT(CM9636 CM9635 CM963,52000,43890,-8110
2018-06-01,461008758,C011020,남자상의,레드 체크 밍크털 코트 코트 남성털코트 캐쥬얼코트,107510,104290,-3220
2018-06-01,1824616746,A013090,전복,장흥무산김 4호 선물세트일반김2봉+조미김10봉+구운김7봉김 재래김 일반김 조미김 구운,46400,46400,0
2018-06-01,1004796258,F011130,홍삼,[농협홍삼/한삼인] 홍삼활력고 250g*2,199800,199800,0
2018-06-01,1435156258,C011020,남자상의,체크 밍크털 코트 남성용코트 남성털코트 남자코트 털,109100,109100,0
2018-06-01,1462354410,C013040,청바지,에이브릴진 봄신상 청바지/일자핏/부츠컷/스키니,8900,8900,0
2018-06-01,1320807387,A018090,잼,오뚜기)딸기쨈 500g x 6개 국산딸기 달콤 빵 과자,39690,39690,0
2018-06-01,875022128,E061060,살충제,바이벅스(프리미엄형) 초음파 해충퇴치기 바퀴벌레,39800,39800,0
2018-06-01,1899700487,C013020,티셔츠,[필골드] SLKN503505 오버핏라운드니트 폴라니트 1,39800,39800,0
2018-06-01,107982545,A016110,딸기,23311307/ 냉동가당딸기(1kgX15개)-청솔,85580,85580,0
2018-06-01,384817830,C011030,남자학생복,오투_쿨링타올(프리미엄),25720,24180,-1540
2018-06-01,440822899,A017300,미역,대천 갓바위 김선물세트/재래김/파래김/돌김/김자반,10900,10900,0
2018-06-01,895685101,A017180,호박,취청오이 (2입/봉),1990,1990,0
2018-06-01,689883964,L021050,우산,우비 여성우비 비옷 레인코트 우의 여성레인코트 여자,16200,16200,0
2018-06-01,895685100,A017180,호박,파프리카 (3입/봉),3990,3990,0
2018-06-01,895685103,A017180,호박,다다기오이(2입/봉),2490,1790,-700
2018-06-01,1420915467,E011040,소파,루카스/로젠/뉴비비/TS철재/카페암소파-1인용/2인용,93000,93000,0
2018-06-01,1011093298,A021020,차,수입커피모음패키지 커피모아 ALL(블랙+믹스)_38종 38개입,16500,16500,0
2018-06-01,628647089,L021020,장신구,14K피어싱 바두께1.2mm /귀걸이 쥬골드 진주 골드볼,27700,27700,0
2018-06-01,386460983,C011030,남자학생복,오투아이스_쿨링프리미엄얼음조끼,65480,61560,-3920
2018-06-01,555182428,A017280,김,[일가집] 일가집 쫄깃치자단무지1kg,5300,5300,0
2018-06-01,227487936,C012040,여자학생복,[SOUP]오간자 자수 카라 블라우스_SUDBL15,29000,24650,-4350
2018-06-01,1517874001,A014020,분유,아이배냇 순 산양분유 3단계 800g 3캔,88500,88500,0
2018-06-01,1650120353,E031070,에어컨,동일 업소용바닥팬 선풍기 FGD-18 스텐 3엽날개 43cm,56200,56200,0
2018-06-01,976050944,C013050,운동복,뉴스포티지-미르웨이 후사경/4WD/RV용품/사각지대/후진주차/현대/기아/대우/쌍용,27000,24600,-2400
2018-06-01,36112319,C014010,아동복,[노스페이스] 키즈 슈퍼 하이크 자켓 NJ3LJ02TBLK,96600,92740,-3860
2018-06-01,495496202,C012060,여자내의,(JJ지고트) 심플 A라인 스커트 GI2A0SK20/ 제이제이지고트,139000,125100,-13900
2018-06-01,345781095,C012040,여자학생복,V넥프릴블라우스[P173MSC004]/ 블루페페,57600,54720,-2880
2018-06-01,1010289904,A018100,꿀,[백화농원] 스위트 허니 국내산 벌꿀 2.4kg,24900,19400,-5500
2018-06-01,1010289905,A016090,참외,[껍질째 먹는 경북사과]산들네 세척사과 5kg 25과내,33900,20500,-13400
2018-06-01,430155280,A018050,비스킷,삼립식품/디저트 /미니 누네띠네 벌크 2.5kg /무료배,11800,11800,0
2018-06-01,693792593,C011030,남자학생복,여름신상 프린트 셔츠 남방 7부 반팔셔츠 솔리드 체크,14700,14700,0
2018-06-01,1038810680,A013070,굴,프리미엄 활랍스타 500g 2마리 랍스터 캠핑음식 새우,39900,39900,0
2018-06-01,1640330165,C013050,운동복,트레이닝세트/추리닝세트/트레이닝복/봄신상세트,12900,12900,0
2018-06-01,1457229008,C011030,남자학생복,밀란시아 빅사이즈 신내피조끼 dda11-1 빅사이즈 남성,68770,67400,-1370
2018-06-01,1004796234,F011130,홍삼,[농협홍삼/한삼인] 순수홍삼본 50ml*30(1 500ml),67100,67100,0
2018-06-01,1004796232,F011130,홍삼,[농협홍삼/한삼인] 순수홍삼본 50ml*30(1 500ml)*3box,201800,201800,0
2018-06-01,330361401,I011010,TV,삼성패널 자비오 49인치 50인치 55인치 TV 4K UHDTV,309000,309000,0
2018-06-01,1168333787,C012020,원피스,체크 루즈핏 재킷(Z174MSF031)/ 쥬크,159600,135660,-23940
2018-06-01,1004796233,F011130,홍삼,[농협홍삼/한삼인] 순수홍삼본 50ml*30(1 500ml)*2box,134500,134500,0
2018-06-01,1588657630,C013030,스웨터,루즈핏 러브 시퀸 시스루 그물 커버업 NT,19800,19800,0
2018-06-01,1420939422,C012040,여자학생복,로로텐 레이스/셔츠/루즈핏/블라우스/남방/빅사이즈,26900,26900,0
2018-06-01,436268623,C013020,티셔츠,패치배색맨투맨(ZYD_1602) 티셔츠 여성큰티셔츠 빅사,17260,17260,0
2018-06-01,1471924192,A014020,분유,[아이배냇] NEW 순 산양분유 1단계~4단계(800gX1캔),32900,32900,0
2018-06-01,1914772255,C013020,티셔츠,[디스커버리]여성 반팔티셔츠 DWRT6V731,34300,30870,-3430
2018-06-01,2083118828,C012060,여자내의,그뤠잇 민소매 가죽자켓-m1070 /(참고)여성자켓 가죽,51000,44880,-6120
2018-06-01,420642395,C012020,원피스,[쉬즈미스][쉬즈미스] 스트라이프 코튼 베이직 셔츠_SWWSTI11060_RE,59000,50150,-8850
2018-06-01,1214026333,C013060,등산복,[내셔널지오그래픽] 내셔널지오그래픽 로고 반팔 티셔츠,39000,39000,0
2018-06-01,444707949,C011020,남자상의,남성 넓은체크 그레이 자켓 D0216007 남자정장마이 남,132990,132990,0
2018-06-01,420642399,C012020,원피스,[쉬즈미스][쉬즈미스] 스트라이프 코튼 베이직 셔츠_SWWSTI11060_BL,59000,50150,-8850
2018-06-01,1011996073,F012030,안경,2018신상 남녀 안경테/오버사이즈/메탈테/하금테/뿔테,9800,9800,0
2018-06-01,378596345,L021010,손목시계,로제타 메탈 손목시계 FW-13 이쁜시계 패션시계 팔찌,17420,17420,0
2018-06-01,196625214,C012030,여자상의,[하와이원피스]셀프웨딩/오프숄더/레이스/드레스,36500,36500,0
2018-06-01,1471466482,A019180,즉석식품,피자도우 또띠아모음/크기별/남향/레이나/도우/,3000,3000,0
2018-06-01,2144013428,C013010,점퍼,남성 여름자켓 남자 캐주얼자켓 린넨 자켓 마이 더블,99000,99000,0
2018-06-01,631918429,A016060,감,달콤샤르르 자연그대로 만든 아이스 홍시 30개(컵)/개,46100,40570,-5530
2018-06-01,1597118830,F011130,홍삼,정관장 홍삼정옥고(250G),65000,65000,0
2018-06-01,1484694281,C012040,여자학생복,(보니알렉스)차이나카라 노멀 블라우스(BASZ180C),9990,9990,0
2018-06-01,222373687,F011150,건강기능식품,[세노비스] 여성 멀티비타민미네랄 (60캡슐),36000,32400,-3600
2018-06-01,1996764049,L021050,우산,조아몰/우비/무료배송/올망사/상하/코트/우의/비옷/판쵸/바람막이/등산/낚시/오토바이,14000,13500,-500
2018-06-01,1320535348,E011020,침대,프리미엄 패밀리침대 Q+Q 오픈형 본넬 매트리스,659800,640010,-19790
2018-06-01,305335504,A016020,배,나주신고배 선물세트 5호 15kg(25과내) 과일선물세트,113100,113100,0
2018-06-01,2039714711,C013050,운동복,아디다스 여성 스타디움 후드자켓(BP7066) 후드자켓,115760,103030,-12730
2018-06-01,1326658192,C021040,실내화,[푸마] (SIZE : 260) 플레어 2(18951701) 신발 러닝,85190,85190,0
2018-06-01,1074603115,C012040,여자학생복,[오빵스타일]봄가디건꽈배기가디건마들렌 꽈배기 가디건,24000,22800,-1200
2018-06-01,504133700,A022010,주스,신제품출시! Dole 100% 과즙주스 6종 120mlX32팩,13900,13900,0
2018-06-01,2068312819,C013010,점퍼,(티티뱅크) JK700 블루종 점퍼 / 참고 블루종 항공점,63100,53640,-9460
2018-06-01,1555105204,A017140,콩나물,간장(진 햇살 대상 15L)/돌자반/대용량간장,33130,33130,0
2018-06-01,2023257659,C013050,운동복,4기능 LED 경광봉 차량부착 가능 차량용고휘도 LED 경광봉 비상용품 멀티 안전봉 점멸,12800,12800,0
2018-06-01,638369984,C012020,원피스,김발 겉대x10,10380,10380,0
2018-06-01,1158410527,C013010,점퍼,[모다아울렛][앤듀]여성)사이드 지퍼 스타디움 점퍼O173JP500P,69000,65550,-3450
2018-06-01,357776893,E061020,섬유유연제,샤프란 아로마시트 섬유유연제 50매x3개,13900,13900,0
2018-06-01,2042507146,C013010,점퍼,양털 야상 남자점퍼 남자야상 남성용점퍼 남성점퍼 점,131280,131280,0
2018-06-01,1237595389,A011130,시리얼,혼합고구마맛전분(화미 1k)X20 믹스 식자재 식자재용,56130,56130,0
2018-06-01,10094319,C013050,운동복,남성 M~4XL 트레이닝 반바지 세트 배기 저지,9800,9800,0
2018-06-01,805003064,C013020,티셔츠,엄마티셔츠 블라우스 4060대50대중년여성의류 미시옷,29800,29800,0
2018-06-01,2071083474,C013010,점퍼,빅사이즈/클래식/투/버튼/코트 / 참고 클래식투버튼코,123200,108420,-14780
2018-06-01,1093967772,A019040,소금,(면)CJ백설 꽃소금1kg 꽃소금 소금 맛소금 천일염,2380,2380,0
2018-06-01,1038012077,E011050,책상,[높이.각도조절책상] 접이식테이블/접이식 책상/침대/노트북 테이블/간이책상/사이드/,22900,22900,0
2018-06-01,8804190,L012060,샴푸,려 함빛 샴푸 500g x3개 함빛모 한방샴푸 / 린스,15300,15300,0
2018-06-01,1837651842,A016030,복숭아,토종개복숭아10kg 돌복숭아 당일채취직배송,44000,44000,0
2018-06-01,1308792450,C013020,티셔츠,브랜드특가 반팔티/카라티/라운드티/단체티/운동복,26000,22800,-3200
2018-06-01,1025329484,E021010,침구,[슈에뜨룸]세미마이크로 이불토퍼세트/차렵이불세트,56900,56900,0
2018-06-01,631076684,C012060,여자내의,빅사이즈/쉬폰/주름/롱/스커트 빅사이즈,48650,47200,-1450
2018-06-01,1425559645,C011020,남자상의,남성여름정장바지/체크슬림핏슬랙스/남자봄일자면스판,27800,27800,0
2018-06-01,1223501657,C011020,남자상의,MJ_1135 블랙 더블트렌치,241920,215310,-26610
2018-06-01,746397389,A016110,딸기,제이제이 냉동딸기 1kg 2개,19770,19770,0
2018-06-01,491293311,E021020,커튼,"[라떼심플""암막커튼]주문제작/린넨 아일렛커튼/국내산",16000,14720,-1280
2018-06-01,521592421,C013020,티셔츠,[MRBOB] 두꺼운 헤비 기모 후드티 후드집업 M~3XL,36800,33800,-3000
2018-06-01,1677633240,E061040,부엌용세제,EM주방세제/식기과일채소겸용/친환경 천연/쌀뜨물발효,10100,9950,-150
2018-06-01,2068312822,C013010,점퍼,(티티뱅크) JK950W 이누이트 파카 / 참고 돕바 자켓,113400,99800,-13600
2018-06-01,80438398,L012030,칫솔,시스테마 치석케어 칫솔 14개 치약 구강청결,18900,18900,0
2018-06-01,450515578,C013010,점퍼,나이키 드라이 팀 우븐 자켓 그레이나그랑 드라이자켓,79630,79630,0
2018-06-01,227546798,C013020,티셔츠,선인장프릴티셔츠 (47424-332-03)/ 블루독베이비,26000,21840,-4160
2018-06-01,238673555,C021040,실내화,[리복]남성 스니커즈 클럽 씨 85 프로 CM9430,76300,64860,-11440
2018-06-01,474172946,C013050,운동복,[인앤테크] (색상 : 화이트) 도어가드원4M ㅣ 문콕방,23770,21660,-2110
2018-06-01,460148550,C013050,운동복,[오싸지]반바지 청바지트레이닝 티셔츠면바지여성의류,10500,10500,0
2018-06-01,1133142392,A015020,식용유,[오뚜기] 오뚜기 쇼팅 14kg (박스포장후 발송),28300,28300,0
2018-06-01,959900193,A015010,참기름,사조해표 재래압착식 참기름1.8L 해표참기름1.8L,16100,16100,0
2018-06-01,1271080378,D031010,주택수선재료,쟈스민락 0.9리터/친환경/곰팡이방지/젯소 바니시NO,15000,15000,0
2018-06-01,887476452,C014020,유아복,아가방 본사공식 유아여름의류 내의/상하복 외,10000,6900,-3100
2018-06-01,1375016916,E051020,건전지,벡셀 알카라인 건전지 40알/고성능 플래티넘AA/AAA,10000,9900,-100
2018-06-01,1123399220,C011030,남자학생복,커스텀멜로우 hound tooth check vest_CWUAM17351GYX/ 커스텀멜로우,119400,102690,-16710
2018-06-01,100123454,L012060,샴푸,올뉴 TS 샴푸 100g X 5개 뉴프리미엄 티에스샴푸,11500,11500,0
2018-06-01,1782463438,L021010,손목시계,EMPORIO ARMANI 엠포리오 아르마니 AR1908 여성용 메탈밴드 패션시계,339000,339000,0
2018-06-01,1572188111,C012030,여자상의,로로텐 롱/미니/쉬폰/레이스 원피스/빅사이즈,26900,26900,0
2018-06-01,1782463439,L021010,손목시계,EMPORIO ARMANI 엠포리오 아르마니 AR1911 여성용 가죽밴드 패션시계,249000,249000,0
2018-06-01,1982072882,E031120,믹서,국내생산 로젠느 다용도 파워 믹서기 빙수기 쥬서기 분쇄기 칼날2개 안전장치 팥빙수,24900,23900,-1000
2018-06-01,1402565377,A022010,주스,웅진 초록매실 1.5L x 12개,22900,22900,0
2018-06-01,2025955662,A012010,국산쇠고기,[무항생제] 차돌박이 600g 1등급,44600,44600,0
2018-06-01,1951519699,C012040,여자학생복,[스위트바니]데일리룩!여름신상/단가라/반팔,6900,6900,0
2018-06-01,1638401850,A015010,참기름,CJ 백설 진한 참기름 500ml / 오뚜기참기름 500ml,4300,4300,0
2018-06-01,1269279764,C012040,여자학생복,[난닝구]딜라이 골지롱썸머가디건,19800,18220,-1580
2018-06-01,2068131236,A013070,굴,간장게장/300간장게장/연평도100%/ 최상급 알백이,28800,28800,0
2018-06-01,1303582387,A019090,카레,SB 골든카레 중간매운맛 1kg 대용량,11900,11900,0
2018-06-01,1987306975,A013150,어묵,부산어묵 오뎅 수제어묵 잡채만두어묵 700g,4900,4900,0
2018-06-01,1368394150,A021010,커피,[프렌치카페] 프렌치카페 카페믹스 360T(160T+20TX2개),31800,29900,-1900
2018-06-01,1782463435,L021010,손목시계,EMPORIO ARMANI 엠포리오 아르마니 AR11087 여성용 메탈밴드 패션시계,249000,249000,0
2018-06-01,1782463436,L021010,손목시계,EMPORIO ARMANI 엠포리오 아르마니 AR11088 여성용 메탈밴드 패션시계,249000,249000,0
2018-06-01,222686151,A021010,커피,네스프레소 청소캡슐 10입/네스프레소캡슐 클리닝캡슐,11000,11000,0
2018-06-01,7046005,A017180,호박,대웅산 흑마늘 젤리 350g 해풍과 해무를 먹고자란 남,14610,14180,-430
2018-06-01,1782463437,L021010,손목시계,EMPORIO ARMANI 엠포리오 아르마니 AR1764 여성용 메탈밴드 패션시계,339000,339000,0
2018-06-01,1710059699,F012010,종이기저귀,[2018년형]폴라리스 더마테스트인증 팬티/밴드기저귀,15000,13900,-1100
2018-06-01,923771445,A013010,갈치,군산 밥도둑 반건조 조기 박대 갈치 고등어,7900,7900,0
2018-06-01,1747344620,E011030,거실장,[채우리] 소니 좌식 소파베드,200000,200000,0
2018-06-01,2095184661,C012040,여자학생복,[비키]시스루 빅포켓 롱 가디건 (TMCCD2907)_Q8X4,35900,34110,-1790
2018-06-01,1342753214,E031030,전자레인지,독일 보랄 전자레인지/전자렌지/20L,45900,45900,0
2018-06-01,1387495376,C013010,점퍼,AG 후드 집업점퍼 T절개배색오픈 CC 집업 후드집업 후,45990,45990,0
2018-06-01,2006223288,C012060,여자내의,엄마옷 마담4060 레이스짜임슬림팬츠-XPN804084-,34900,32340,-2560
2018-06-01,58885240,I031040,생화,자이너스 원목 캠핑 3단우드쉘프 WF001,53900,49590,-4310
2018-06-01,196698199,C013020,티셔츠,전품목세일/민소매티셔츠/나시/라운드/린넨/여성,7900,7900,0
2018-06-01,2120733910,C014010,아동복,아둘 가족티 쥬니어 콜라 나그랑 래글런 반팔티 28,11100,11100,0
2018-06-01,415784489,C013050,운동복,여성 여름츄리닝세트/트레이닝세트/반팔후드티/반바지,13800,13800,0
2018-06-01,1297261200,C011030,남자학생복,남자셔츠 썸머 스트라이프 셔츠 Z0416006 심플반팔셔,39170,39170,0
2018-06-01,1254715345,C012040,여자학생복,[멋진큰옷 빅댄디] 88-100 슬릿롱셔츠자켓 루즈핏박스핏롱가디건 큰옷,29800,29800,0
2018-06-01,1081775608,C012020,원피스,리가 여 90 트렌치 코트 + 렉스 토끼털 내피 가을겨울,54950,54950,0
2018-06-01,1349312926,A013050,오징어,동원 꽁치캔 (400g) x24,65190,65190,0
2018-06-01,1117290824,E011030,거실장,쥬얼리 1단 1500 TV 거실장,119000,119000,0
2018-06-01,1870728702,F012020,생리대,2000원할인)바디피트생리대 볼록맞춤중형220P/대형200,35400,33400,-2000
2018-06-01,402581639,F012010,종이기저귀,[15%쿠폰]팸퍼스 베이비드라이 팬티 기저귀 3팩,43900,43900,0
2018-06-01,410767961,C012040,여자학생복,[앤아이]레이스메쉬 시스루 웨어 WI,17100,16250,-850
2018-06-01,1117290829,E011030,거실장,파란나무 드론 1500 TV 낮은 거실장,157000,157000,0
2018-06-01,1016939419,L021020,장신구,저렴처분/2.6캐럿 천연에메랄드/광택칼라굳,390000,390000,0
2018-06-01,1117290825,E011030,거실장,파블로 1200 거실장,83000,83000,0
2018-06-01,1117290826,E011030,거실장,파블로 1500 거실장,110000,110000,0
2018-06-01,1117290827,E011030,거실장,파란나무 드론 1500 TV 높은 거실장,174000,174000,0
2018-06-01,1117290828,E011030,거실장,파란나무 드론 1500 TV 낮은 거실장,157000,157000,0
2018-06-01,1120470178,C013050,운동복,아디다스 여성 아디제로 트랙자켓(CE0330) 여성트랙자,136020,133300,-2720
2018-06-01,485050890,C011020,남자상의,체스트맨 스판 콤비자켓 남성 여름마이 남성정장 양복,72000,72000,0
2018-06-01,2049253826,E061030,전구,필립스 LED전구 7W(3W/4W/9W/11W/14W)촛대구/PAR30,1800,1360,-440
2018-06-01,462384916,C013050,운동복,[사은품][국산] 유아 아동 상하복 츄리닝 트레이닝복,13900,13900,0
2018-06-01,1782463413,L021010,손목시계,EMPORIO ARMANI 엠포리오 아르마니 AR11060 여성용 가죽밴드 패션시계,249000,249000,0
2018-06-01,1181606850,I031010,장난감,Ladybugs붕붕카/레이디벅붕붕카/붕붕카,27500,27500,0
2018-06-01,468649740,C011020,남자상의,남성의류 정장 정장세트 솔리드 원버튼 슬림핏 정장세,179010,179010,0
2018-06-01,1117290832,E011030,거실장,명품 심우 자작나무 원목 1600 TV거실장/tv장식장/tv대/tv다이,463000,463000,0
2018-06-01,1117290833,E011030,거실장,명품 심우 자작나무 원목 1200 TV거실장/tv장식장/tv다이/tv대,388000,388000,0
2018-06-01,190311469,A017220,양파,냉동 아스파라거스 1kg (약40개입) / 아스파라거스,9600,9600,0
2018-06-01,1117290830,E011030,거실장,파란나무 드론 1200 TV 거실장 TV대,113000,113000,0
2018-06-01,1117290831,E011030,거실장,명품 심우 자작나무 원목 1800 TV거실장/tv장식장/tv대/tv다이,498000,498000,0
2018-06-01,1010348740,A017150,버섯,종가집 국산숙주 230G,1990,1990,0
2018-06-01,2095098223,C012030,여자상의,핀탁라운드원피스 PS1709 라운드원피스 여자원피스 블,39730,39730,0
2018-06-01,1670087003,C011030,남자학생복,[하프클럽/HooAngs]배색 다이아 패딩조끼 BNPV6290,52800,47520,-5280
2018-06-01,324613942,C013040,청바지,PBMFJ701 캣스판스키니일자남성청바지 빅사이즈청바지,43790,43790,0
2018-06-01,532346509,C013010,점퍼,남자무스탕브랜드 라쿤무스탕코트 빅사이즈남성무스탕(국내제작/90~120사이즈별맞춤제,1190000,1190000,0
2018-06-01,439631530,A013170,생선통조림,(무)이츠웰 자연산골뱅이400gX24개이츠웰 골뱅이캔 자,290700,247100,-43600
2018-06-01,1183398015,C013050,운동복,3M 고휘도 반사테이프/축광/반사판/양면테이프/빛반사,3300,2990,-310
2018-06-01,1117290800,E011030,거실장,흑경/백경 1단 1200 TV 거실장,128000,128000,0
2018-06-01,1117290801,E011030,거실장,우드라인 1단 1500 TV 거실장,92000,92000,0
2018-06-01,237800050,C012040,여자학생복,[모다아울렛][쉬즈미스]쉬즈미스 타이넥 프린트 블라우스(SWWBLI11100-TG),54000,51300,-2700
2018-06-01,2059352585,C012040,여자학생복,꾸제꾸제/GUESS 집업 니트 가디건/여성 L/면혼방/스웨터/자켓/세일/브랜드/빈티지/중고,22900,22900,0
2018-06-01,1117290802,E011030,거실장,우드라인 1단 1200 TV 거실장,74000,74000,0
2018-06-01,1521540140,C012060,여자내의,편안하고 시원한 고품질 냉감통바지 SD-5668,7330,7330,0
2018-06-01,2046848974,A014040,발효유,마시는 액티비아 130ml 2+1 12입 아이스박스무료,10980,10980,0
2018-06-01,427093024,E061060,살충제,식물 살충제 화초 비오킬 진드기 깍지 친환경 다육,6300,6300,0
2018-06-01,414998955,F012050,의료측정기,브라운 체온계 IRT-6520/6510/6030 필터21개포함/正,77950,72500,-5450
2018-06-01,1011058952,E041060,수저,[토마스풀] 엠버 디너세트 28p,350000,210000,-140000
2018-06-01,114048414,C013020,티셔츠,빅사이즈 라운드루즈맨투맨 WW02109 라운드루즈맨투맨,43390,43390,0
2018-06-01,1044498373,L012060,샴푸,케라시스/미장센 대용량 샴푸+린스+바디워시 리필 6kg,19800,19800,0
2018-06-01,805367531,I011030,사진기,니콘 D5600 + AF-P 18-55mm VR 정품+사은품 명품마을,749890,749890,0
2018-06-01,17233210,I031040,생화,특가! 라이언스톰 캠핑용품 트윈연결 침낭 동계침낭,19900,19310,-590
2018-06-01,1101108423,E011050,책상,스터디홀릭 2인용 학생 각도조절 책상,360000,324000,-36000
2018-06-01,1509132160,A017020,상추,(맛나)#양상추(국산 6입)박스,32600,29340,-3260
2018-06-01,429599913,A022030,생수,프리미엄샘물몽베스트생수1L/2L/0.5L/330ml,6280,6280,0
2018-06-01,120642661,C011020,남자상의,2018여름신상/쿨모아텍스 원턱정장바지/노턱정장바지,18900,18900,0
2018-06-01,389988310,E041070,밀폐용기,국산 글라스락 밀폐용기세트/반찬통/양념통,11900,10030,-1870
2018-06-01,687535801,I012010,컴퓨터,애플 MF885KH/A 아이맥 레티나 5K 디스플레이/정품/SG/빠른배송,2320590,2320590,0
2018-06-01,1218920677,C011050,남자내의,[C.P 컴퍼니]C.P.COMPANY(88P7011/82) 한정판 면 스판 렌즈 포켓 캐주얼 카고 팬츠 (강,207000,192510,-14490
2018-06-01,1011058945,E041060,수저,[밀양본차이나] 델라 롱티스푼_2p,15000,11900,-3100
2018-06-01,1011058946,E041060,수저,[밀양본차이나] 노마 롱티스푼_2p,15000,11900,-3100
2018-06-01,744428526,C011030,남자학생복,셔츠온리(ShirtsOnly) 구김없는 슬림핏 와이셔츠,12400,12400,0
2018-06-01,406442735,I012060,저장장치,로지텍코리아 G302 Daedalus Prime 게이밍마우스,34900,34900,0
2018-06-01,1175356015,C013040,청바지,남성 린넨바지 조거팬츠 와이드팬츠 마바지 여름바지,44500,44500,0
2018-06-01,1279830964,C013020,티셔츠,V넥긴팔티/기본티/쫄티/무지티/라운드넥/스판티/반팔T,4900,4900,0
2018-06-01,453988997,C013010,점퍼,JK448-미쉘 베이직 항공점퍼 항공점퍼 데일리점퍼 간,78880,70210,-8670
2018-06-01,452194734,A022010,주스,망고원액(참존835ml)/망고스틴 젤라또 아이스크림 재료 푸딩 망고원액 스무디 스틴젤라,6760,6560,-200
2018-06-01,1340051129,C015040,장갑,고급 트리플버튼 가죽장갑(여성) 여성용겨울장갑 숙녀,28860,28860,0
2018-06-01,596784042,I031040,생화,재난대비 긴급구호세트 sos 생존용품세트 비상용품,12500,12500,0
2018-06-01,1946502347,I012010,컴퓨터,[E]B70EV-AG77S2/7세대/i7/16G/256G+1TB/GTX1060(6G),1908000,1812600,-95400
2018-06-01,1815328044,L012060,샴푸,어성초샴푸1+1 /어성초+녹차+자소엽/천연계면활성제,29700,29200,-500
2018-06-01,418762806,C012020,원피스,[BCBG] B8M4P334 SP베이글 팬츠,179000,161100,-17900
2018-06-01,279588123,A014050,달걀,[감동란]간이 배어 있는 촉촉한 반숙계란 30개입 (무료배송),19900,19900,0
2018-06-01,1356123443,C011030,남자학생복,빅오버핏 롱가디건 BMD0053 남자가디건 남성가디건(YA,58400,47890,-10510
2018-06-01,1549185617,C013020,티셔츠,[MLB]엠엘비 7종택1 남여공용 흘리미 MLB기본반팔티셔츠(31TSD4831),33000,28050,-4950
2018-06-01,1765648861,C013010,점퍼,[포에버21]도그 패치 자켓/FOREVER21/점퍼/야구점퍼,57900,28950,-28950
2018-06-01,834482284,C013050,운동복,신상입고트레이닝팬츠4900~ 요가복 ~4XL 전품목할,9900,6900,-3000
2018-06-01,1320559285,E011020,침대,프리미엄 패밀리침대 Q+Q 가드형 20T라텍스매트리스,975500,946240,-29260
2018-06-01,450997508,C011030,남자학생복,(SR)BIG0225 빅사이즈 기본가디건긴팔니트,34580,34580,0
2018-06-01,24009417,C013040,청바지,[패션플러스][플레이팝][빼빼닷컴]구제일자데님팬츠 204,38900,35790,-3110
2018-06-01,650292109,C013020,티셔츠,[앨빈클로] 반팔 후드티 오버핏 무지티 레이어드 남자,24900,9900,-15000
2018-06-01,1192372337,E011020,침대,베니스 황토 카우치/돌소파 흙침대,2121300,1951600,-169700
2018-06-01,739339093,A019060,된장,[농협] 우리땅우리콩 전통식 재래된장 2kg 대용량,29900,27900,-2000
2018-06-01,1828133176,C013010,점퍼,아동 패딩 점퍼/자켓/후드집업/아동복 여아 유아,19800,19800,0
2018-06-01,900298925,A018060,스낵과자,[오리온]오리온 포카칩 소금맛 (66G),1300,1300,0
2018-06-01,1244479245,D031010,주택수선재료,미앤미 편백나무 원목 끼움식마루 73P 조립식 베란다,51000,48450,-2550
2018-06-01,1172306296,A018090,잼,트라피스트 수녀원 유기 포도 잼 410g 과일잼 식빵과,17990,17460,-530
2018-06-01,900298926,A018060,스낵과자,오리온 포카칩 양파 (66G),1250,1250,0
2018-06-01,751738956,E061020,섬유유연제,샤프란 리필 2000mL x 7개 섬유유연제 /피죤,16500,16500,0
2018-06-01,1189180544,L021030,가방,서류가방 메신저백 정장 크로스백 남성 노트북 가방,34900,34900,0
2018-06-01,986369894,A011110,당면,풀무원 네컵 연두부 360G,2490,2490,0
2018-06-01,1843532521,C012040,여자학생복,[랩(LAP)]**테일러 카라 핸드메이드 베스트 (AH4WVW01)(경기점),119000,102940,-16060
2018-06-01,1513748535,A017150,버섯,[한그루식품]시루 콩나물 400g×30개,74710,74710,0
2018-06-01,529642802,C012060,여자내의,백합주름치마 네이비 전체 주름 교복치마 교복 예쁜교,55060,53410,-1650
2018-06-01,1950712231,E061010,세탁세제,G2 고농축 액체세제 2.5Lx4개 / 13L 대용량 세탁세제,9000,8900,-100
2018-06-01,1513748538,A017150,버섯,[한그루식품]시루 콩나물 400g×5개,17040,17040,0
2018-06-01,934731981,A011090,국수,라면20개/컵라면12개/육개장/신라면/진라면/사발면,10800,10800,0
2018-06-01,544953506,C013050,운동복,안전 경광봉,8100,7860,-240
2018-06-01,414107246,C013020,티셔츠,스트라이프 티셔츠 캐주얼 티셔츠 스트라이프티셔츠,29330,29330,0
2018-06-01,263566631,C013050,운동복,USD351_2114_LM 트레이닝복 스포츠트레이닝세트 남성,78350,78350,0
2018-06-01,1632072286,E041070,밀폐용기,스텐그릇 소스볼 종지 라마킨 캠핑식기 모음,1000,820,-180
2018-06-01,824064435,A014020,분유,[아이배냇]순산양분유 2단계 400g,16900,16900,0
2018-06-01,1385881949,A011160,빵,안흥찐빵마을 수제 슈크림 초코 찐빵 베이직 3종세트,34220,34220,0
2018-06-01,1300024077,C021020,구두,267 6.0cm 가죽 여성슬링백 수제화,173350,173350,0
2018-06-01,1808270677,C013020,티셔츠,여성 여름 반팔 나시 골프 웨어 크라운 치마 레깅스,38900,38900,0
2018-06-01,728733731,E031090,공기청정기,인증점P 삼성 공기청정기 AX40M3030WMD 무료출고P,275530,259000,-16530
2018-06-01,1226142406,A017250,고사리,2018년 국내산 햇 레드비트 5kg/5월 출하기념 할인가,16900,16900,0
2018-06-01,2002677395,A019130,스프,나가사끼짬뽕소스 (초담원 2K) X8,213540,190060,-23480
2018-06-01,2125228059,E061040,부엌용세제,자연 EM (활성액) 1리터/이엠발효액 용액 원액 만물상,3950,3950,0
2018-06-01,604718952,E061030,전구,파30/PAR30/LEDPAR30/PAR30LED/레일조명/파삼공,4500,4500,0
2018-06-01,1666374528,C012020,원피스,김발(속대 에브리홈)X20,16130,16130,0
2018-06-01,349579791,C012060,여자내의,[공구우먼] 키키 스카시 투피스 29713 빅사이즈 여성의류 스커트,52000,52000,0
2018-06-01,1301955909,L021030,가방,백팩 가방 학생가방 책가방 남성백팩 여성백팩 빅백,22800,19800,-3000
2018-06-01,98984849,I012060,저장장치,#NAME?,42440,39900,-2540
2018-06-01,972367601,L021030,가방,KARAS 正品 노트북가방 13인치 14인치 15.6인치,23000,22500,-500
2018-06-01,1331122801,A011140,부침가루,동서 필라델피아 치즈케익 1.7kg / 60oz,31900,31900,0
2018-06-01,1310987592,D031010,주택수선재료,물에빠진 조각벽지 마블브릭그레이 60장 셀프실크벽지,68000,63920,-4080
2018-06-01,368282521,C013010,점퍼,[조이너스][조이너스] 7부소매 항공점퍼 JA6U4-WGJ070_110 (P000342725),47800,43020,-4780
2018-06-01,1044858158,I012060,저장장치,로지텍코리아 G100s Optical Mouse 게이밍마우스,21170,19900,-1270
2018-06-01,864499115,C012040,여자학생복,[30수]2 900원/면티/반팔티/무지티/기본티/남성런닝,6000,5900,-100
2018-06-01,611664988,C013010,점퍼,안감양털 박시 오버사이즈 코트 DM-4043-이쁜코트 오,75010,66760,-8250
2018-06-01,683226105,E031080,선풍기,최신형 원적외선 전기온풍기 3.0kw (HV-3100) - 난로,428960,381780,-47180
2018-06-01,1186435050,L021030,가방,[뉴엔] 맥북 삼성 엘지 LG그램 노트북 파우치 가방 15.6인치,10900,10900,0
2018-06-01,1849038199,A017010,배추,건나물12종/고사리/취나물/무말랭이/건가지/고구마순,2900,2900,0
2018-06-01,1382405363,C013010,점퍼,빅사이즈 DSM1044 빅 포인트 울 자켓 801 임부자켓 큰,87660,87660,0
2018-06-01,1008320340,F011130,홍삼,[정원삼] 황후애궁(70ml x 30포) 갱년기여성에 도움을 줄 수 있음,58900,58900,0
2018-06-01,1498448786,F012050,의료측정기,메비 마더터치 전자체온계/고온알림표시기능,42500,39530,-2970
2018-06-01,379607504,C014020,유아복,여자 아이 아동 주니어 상하 실내복 여름 반팔 순면,12470,12470,0
2018-06-01,983481006,E061010,세탁세제,[LG]LG테크 실내건조 5KG,11900,11900,0
2018-06-01,1513748562,A017150,버섯,[한그루식품]시루 콩나물 400g×10개,28020,28020,0
2018-06-01,210138394,C011050,남자내의,옆밴딩 스트라이프 블랙 기모 정장 바지_GP1701 두꺼,20490,20490,0
2018-06-01,442762190,C011050,남자내의,DON 1846 린넨9부밴딩슬렉스남자바지 린넨팬츠 남성바,27030,27030,0
2018-06-01,1206204686,C011050,남자내의,(남자옷도매) DP-250 린넨마 ST팬츠 (S-XL) 진소라 밴,30140,30140,0
2018-06-01,1340136621,C015040,장갑,리본장식 가죽장갑(여성) 숙녀용가죽장갑 여성용가죽,25940,25940,0
2018-06-01,1470262003,E061100,습기제거제,최저 가격/국산실리카겔/ 방습제/ 제습제/ 곰팡이방지,17500,17500,0
2018-06-01,2023257630,C013050,운동복,자동차 LED 경광봉 다기능 LED경광봉 지시봉 비상등 안전용품 안전봉 경광봉 교통신호,9500,9400,-100
2018-06-01,415204646,C013010,점퍼,[오가게/나크21]55~100 여성용 린넨 롤업 롱 자켓,23900,21510,-2390
2018-06-01,186849909,I011020,영상음향기기,방문AS 4000안시 벤큐 리얼빔 프로젝터/HDMI케이블5M,579000,550050,-28950
2018-06-01,2119553226,A012010,국산쇠고기,[무항생제]이유식 냉장 다짐육 200g 1등급 (6구),10900,10900,0
2018-06-01,2070155053,C012060,여자내의,빅사이즈/페미닌/레이스/스커트 / 참고 페미닌레이스,75500,61910,-13590
2018-06-01,1739859755,D031010,주택수선재료,[노루] KSM-6010 1종2급 외부용 수성페인트 - 18L,45000,45000,0
2018-06-01,828584582,E031010,전기밥솥,CRP-JHR1020FD 쿠쿠 10인용 IH압력밥솥 전기밥솥 ens,469000,431300,-37700
2018-06-01,867094954,C014010,아동복,[게스키즈] 게스기본티셔츠 G74KDT711-B1,19000,15200,-3800
2018-06-01,69686136,L012060,샴푸,올뉴TS샴푸500ml/트리트먼트500ml/프리미엄TS샴푸,14900,14900,0
2018-06-01,1551946643,A014010,우유,매일 남양 저지방 멸균 우유 1% 2% 깔끔한 고소한,15900,15900,0
2018-06-01,1229112506,E011050,책상,유로입식책상/학생/사무용/컴퓨터/철제/테이블/사무실,58900,52200,-6700
2018-06-01,21341567,A011120,두부,[당일출고/무료배송]포스트 오레오오즈 500gx2개+증정,13500,13500,0
2018-06-01,2123105017,A017090,열무,[익산원예농협] 붉은속살 뿌리채소  비트 3kg,16500,15940,-560
2018-06-01,296875371,E031050,냉장고,(중복2%쿠폰)딤채스탠드형김치냉장고WDT33BPGBS,1350000,1296000,-54000
2018-06-01,1940741316,A011030,찹쌀,국내산 통보리 2kg/보리/겉보리/보리쌀/곡물/잡곡,7000,6900,-100
2018-06-01,945602470,E011030,거실장,[채우리] 모나코 3인 서랍형 소파베드+스툴,519000,519000,0
2018-06-01,945602476,E011030,거실장,[PookShuim] 푹쉼 루시드 가죽 4인용 가죽 소파세트,959000,959000,0
2018-06-01,945602475,E011030,거실장,[PookShuim] 푹쉼 아레스 1인용 라탄 그네 (카우치변형),379000,379000,0
2018-06-01,1096198920,L021010,손목시계,BABY-G 베이비지 BGS-100-7A2 여성용 디지털 시계,179000,179000,0
2018-06-01,945602472,E011030,거실장,[채우리] 페치 3인 서랍형 소파베드+스툴,579000,579000,0
2018-06-01,945602474,E011030,거실장,[채우리] 메리 좌식 소파베드,179000,179000,0
2018-06-01,945602473,E011030,거실장,[채우리] 레이크 소파베드,409000,409000,0
2018-06-01,1385881984,A011160,빵,안흥찐빵마을 수제 슈크림찐빵 500g(10입) 2봉 수제,43460,43460,0
2018-06-01,570127715,A017140,콩나물,일송정 도라지배즙 기침 기관지 임신중배즙/배즙원액,42900,42900,0
2018-06-01,2146645934,C011030,남자학생복,청남방 청자켓 남자 남성 데님 체크남방 셔츠 워싱,24800,24800,0
2018-06-01,1331024365,C012040,여자학생복,무조건이가격.자체제작 데님 롱블라우스 빅사이즈,18900,18900,0
2018-06-01,416027560,L021020,장신구,은반지 엥게지반지 링반지 애끼반지 민스지 쌍가락지,5000,5000,0
2018-06-01,527343742,I053020,스케치북,무림 켄트지 220g 4절 100매 두꺼운 도화지 백상지,15800,15800,0
2018-06-01,378657540,L021020,장신구,(유색보석 큐빅 드롭 귀걸이) 데일리 쥬얼리 연예인,12700,11430,-1270
2018-06-01,2121592374,C011030,남자학생복,여름/와이셔츠/빅사이즈/스판/긴팔/반팔/남자/남성,13700,13700,0
2018-06-01,1811846077,E011040,소파,썬퍼니처 베스트셀러 소파/쇼파/2인/3인용 17종,149000,149000,0
2018-06-01,1124504044,A013010,갈치,제주어가 옥돔 2호(7 8마리 선물포장) 탐라의 진상품,159100,154330,-4770
2018-06-01,677095804,C012060,여자내의,BYC여성 100데니아 레깅스타이즈(T9900) BYC 타이즈 레깅스 스타킹 팬티스타킹,17650,15710,-1940
2018-06-01,2038914378,C012040,여자학생복,베니토 올슨 NB/2컬러/스트라이프/카라/오피스/데일리,36000,36000,0
2018-06-01,747998645,C021040,실내화,아디다스 남녀공용 이큅먼트16 런닝화 ( AF4969 ),110240,98120,-12120
2018-06-01,579133747,C013010,점퍼,[오가게/리맨즈]2018 여름신상 남성 콤비자켓//잔피엘정품,57000,53010,-3990
2018-06-01,40275849,E061060,살충제,애경 홈즈 쌀벌레/잡곡용 by 방충선언/잡곡벌레퇴치제,3900,3900,0
2018-06-01,1540554851,C011050,남자내의,아디다스 여성 우븐 슬릿 쇼트(BP9307),42000,37800,-4200
2018-06-01,90531448,C014020,유아복,아동 유아 여아 로맨틱 러블리 숄더 오픈 셔링 세트,16900,16900,0
2018-06-01,458631750,A011010,쌀,햅쌀 씻어나온 오뚜기쌀 가바백미 3kg 5kg/명품쌀,14500,14500,0
2018-06-01,2076244400,C021040,실내화,LF공식수입원 버켄스탁 아리조나 여성화슬리퍼 8E132I3 타우페,102590,102590,0
2018-06-01,1356302181,C013010,점퍼,(티티뱅크) 웰론 롱패딩 블랙 / 참고 롱패딩 자켓 점,132500,116600,-15900
2018-06-01,1001894852,C013020,티셔츠,커터앤벅 남성 스판소재 반팔티셔츠 - 1472-101-64,44900,39900,-5000
2018-06-01,867094979,C014010,아동복,[게스키즈] 게스기본티셔츠 G74KDT711-W1,19000,15200,-3800
2018-06-01,2115596196,A011100,라면,구포국수310gx5p.소면.국수선물세트.명절.돌.답례품,4200,4200,0
2018-06-01,653850854,C013050,운동복,타이어밸브캡/게이지캡/LED밸브캡/타이어밸브/벨브캡/,1960,1960,0
2018-06-01,1227063768,A019020,참깨,박피 들깨가루 (삼진 1k) X10,113150,100710,-12440
2018-06-01,412431173,A012010,국산쇠고기,롯데 엔네이처 혼합 특호 x 3EA(1박스) 쇼핑백 포함,148230,148230,0
2018-06-01,1129861726,C011030,남자학생복,ACC(필골드) PT716 와플 가디건 8종중 택일 긴팔가디,25930,25930,0
2018-06-01,1344168857,C013040,청바지,핑크돼지 여성슬림융털트레이닝 운동복 겨울트레이닝,25580,25580,0
2018-06-01,479091654,C011050,남자내의,마바지/마남방 /비치웨어/통바지/남자린넨셔츠/마셔츠,28500,28500,0
2018-06-01,17367685,L021020,장신구,925 순은 팔찌 실버 DIY 판도라 참 패션팔찌 실버팔찌,17600,16720,-880
2018-06-01,1398164338,A013020,명태,두레생협 바다마을대구전(500g) 부침용냉동대구 대구,32960,32960,0
2018-06-01,117097232,C013040,청바지,[게스진] YI2D9091 여성용 화이트 앵클스키니 데님 팬츠 바지,62400,50550,-11850
2018-06-01,464896066,C011020,남자상의,MT-216 여름-초가을 바다보카시 싱글수트 (M-2XL) 블,204520,204520,0
2018-06-01,1178755199,E061080,키친타월,크리넥스 스카트 키친타올/뽑아쓰는 타올,4000,4000,0
2018-06-01,391021872,E061030,전구,금호전기(LED일자등)30W/50W/형광등/등기구/방등/주방,9500,9400,-100
2018-06-01,1480113164,F012020,생리대,[위스퍼]보송보송 날개 오버나이트/울날오버/중/소/대,3800,3800,0
2018-06-01,1946793206,E061040,부엌용세제,WEIMAN 와이만 전기렌지 크리너/HEAVY DUTY/전기렌지 세정제/핫플레이트 세정제/인덕션,18000,18000,0
2018-06-01,751197968,A014020,분유,[일동후디스]프리미엄 산양분유 3단계 800g 3캔,120000,120000,0
2018-06-01,1619147062,C013010,점퍼,마르잔 무지 바람막이 남녀 빅사이즈 LM5021_LM5033 빅사이즈자켓 자켓 점퍼 바람막이,44600,39700,-4900
2018-06-01,300629238,C012040,여자학생복,[쉬즈미스][쉬즈미스] 컨트라스트 트림 울 가디건_SSKCDI10020_GN,117600,99960,-17640
2018-06-01,681267461,E061040,부엌용세제,커피머신세정제 어넥스카피자 - 커피머신세정제 커피,41790,37200,-4590
2018-06-01,1650758067,A021010,커피,[쿠폰가33 800/당일출고]모카골드340T/화이트골드320T,33800,33800,0
2018-06-01,1405000232,I031010,장난감,[다용도밧데리]오토바이/전동차/로케트 배터리/델코/아트라스/12V**7A/12A/18A*캠핑 낚,33000,33000,0
2018-06-01,906293521,E031070,에어컨,캠핑용&가정용 22인치 천정형 조립식 선풍기 S-FAN50,18500,18500,0
2018-06-01,2028685828,C013020,티셔츠,[쁘니걸]여름/박스/롱티/티셔츠/원피스/빅사이즈,15900,12900,-3000
2018-06-01,986127508,L012110,색조화장품,쉬즈) 썬크림 SPF50 파우치 10ML,1000,1000,0
2018-06-01,512897685,C011050,남자내의,여름 청반바지 5부 7부 밴딩 남자 남성 면 반바지,13800,13800,0
2018-06-01,1368876398,I012010,컴퓨터,에누리행사106만원/NT900X3Y-A58A/NVMe탑재/초경량799,1169140,1099000,-70140
2018-06-01,1849161249,C011030,남자학생복,오마샤리프/로랑베농 긴팔와이셔츠 남자 남성 셔츠,9900,9800,-100
2018-06-01,434842181,F012020,생리대,[동아제약] 뉴템포 20P*5팩=100p/ 템포,35900,34830,-1070
2018-06-01,1588682506,L021020,장신구,0.13ct 다이아몬드 반지/14K골드/all diamond/4851,280000,280000,0
2018-06-01,411483747,C011030,남자학생복,스트라이프 반팔남방 is176-004 남성캐쥬얼 캐쥬얼셔,29990,29400,-590
2018-06-01,1496797967,C012040,여자학생복,뒷트임카라남방 LTD_1803 여자블라우스 블라우스 셔츠,26670,26670,0
2018-06-01,1955236742,E061100,습기제거제,[무한반복사용]실리카겔 초강력방습제 제습제 탈취제,7700,7700,0
2018-06-01,434842184,F012020,생리대,[동아제약] 뉴템포 20P/ 템포,7700,7320,-380
2018-06-01,1881205733,A016090,참외,아삭 당콤한 성주참외/당일수확/박스제외중량3kg/5k,9900,9900,0
2018-06-01,1010165131,A014030,치즈,에비츄 스트링치즈 105G,5400,5400,0
2018-06-01,327952962,I053010,공책,신학기 과목노트(음악)(10개입)-랜덤 음악공책 음악노,10960,10960,0
2018-06-01,1023568550,C021040,실내화,[푸마(PUMA)]푸마 브레이커 스니커즈 PUMA Breaker LTHR 366078-01 02 2018 신상(의,76300,64400,-11900
2018-06-01,1399151379,A013090,전복,금진 생생이 세척홍합 5kg+5kg /홍합요리,31100,31100,0
2018-06-01,1058199598,E031030,전자레인지,[SK매직] 20L 간편쿡 전자레인지_자동요리특화모델 MWOD20H,87020,82670,-4350
2018-06-01,564619484,I031010,장난감,(키움)썬플라워샤워 어린이목욕장난감 물놀이장난감,51600,51600,0
2018-06-01,822581634,A014020,분유,(앙띠베베맘)후디스 비오타민/초유밀 1g/100포/1캔,17000,17000,0
2018-06-01,479052026,C012040,여자학생복,(미사용 여M/66) moussy PISSED 브이넥니트 여자니트,26000,25500,-500
2018-06-01,369799536,C015040,장갑,방수 방한장갑 스웨드 방수장갑 눈썰매장갑 보드장갑,11290,11290,0
2018-06-01,1010202671,A022060,혼합음료,[대웅] 홍삼정 굿타임스틱 (10gx30포) - 2세트,120000,58800,-61200
2018-06-01,1283374256,A018080,설탕,[CJ제일제당] CJ 제일제당 함수결정포도당 20kg [무료배송],23900,23900,0
2018-06-01,2145830216,A013130,오징어채,국내가공 진미채 1KG / 백화점납품 저가상품 비교불가,27900,27900,0
2018-06-01,1010202670,A022060,혼합음료,[대웅] 홍삼정 굿타임스틱 (10gx30포) - 1세트(쇼핑백증정),60000,24900,-35100
2018-06-01,333379574,C014010,아동복,[나이키조던키즈]AJ하드블러반바지세트(NMM11QST51),49000,44100,-4900
2018-06-01,1341835946,E031070,에어컨,국내산 천장형 신일 선풍기 SIF-16CSM SIF-16CSH,53000,50070,-2930
2018-06-01,1079844047,A014020,분유,[아이배냇]순산양유아식 4단계 800g,32900,32900,0
2018-06-01,2127512941,C013050,운동복,BAU아이팝 배선정리 클립 선홀더 차량선정리클립 배선,6720,6130,-590
2018-06-01,1280818588,C012060,여자내의,[174] 아름다운 뒤트임롱스커트/ 일칠사,20000,16400,-3600
2018-06-01,1697368978,A022010,주스,썬키스트 후레쉬 오렌지주스/포도주스/제주감귤 1.5L,1320,1320,0
2018-06-01,1946768282,A017170,풋고추,(허브앤팜) 여주 여주환 여주분말 생여주 건여주,19800,19800,0
2018-06-01,1582050086,A014030,치즈,치즈(파마산 아담스 1K)X10 뿌리는 가루 분말 파스타,114120,114120,0
2018-06-01,1135683690,C012060,여자내의,[나무그림]깔끔한코디에딱_커먼5부팬츠/C18MIT4B060P5,34000,27880,-6120
2018-06-01,1761020504,A021010,커피,초이스 맥심 모카골드 오리지날 500g 리필용 알커피,10310,9700,-610
2018-06-01,1735756687,F012010,종이기저귀,그로 헤티스와들 유아 의류 아동 실내 어린이 실내의,32810,32810,0
2018-06-01,982494060,A012020,수입쇠고기,E-호주산 냉장우 와규 사태(100G),4500,4500,0
2018-06-01,272285103,A011180,파스타면,파스타/스파게티/토마토홀/까르보나라/알프레도소스,4000,4000,0
2018-06-01,2019940303,E011020,침대,릴렉사 접이식 이동 바퀴 보조 침대,134000,134000,0
2018-06-01,482077111,C013010,점퍼,패딩점퍼/패딩/오리털점퍼/빅사이즈/파카/점퍼,43700,43700,0
2018-06-01,49301147,C011030,남자학생복,발렌시아 반팔셔츠 여름남방 남성 카라/차이나셔츠,29800,29800,0
2018-06-01,1181643514,C011020,남자상의,30-46까지 빅사이즈 캐주얼 정장바지/기모 [더블온스],29900,29900,0
2018-06-01,1801104330,I053020,스케치북,말리스타 스케치북 4절(200g-17매),7850,7850,0
2018-06-01,2094002150,I031040,생화,강호낚시원투낚시대세트/릴대2개+릴2개/총14종/원투대,26600,25030,-1570
2018-06-01,1845231013,C012060,여자내의,브랜드특가 요가복/필라테스레깅스 팬츠 상의 25종,19800,19800,0
2018-06-01,300629266,C012040,여자학생복,[쉬즈미스][쉬즈미스] 컨트라스트 트림 울 가디건_SSKCDI10020_NA,117600,99960,-17640
2018-06-01,534350889,C012060,여자내의,[루코루코]린넨 버커루 팬츠 2color(RSC4PT008),26000,24700,-1300
2018-06-01,1087740065,L012030,칫솔,[이천사 어린이칫솔]치과용칫솔 유아칫솔 아동칫솔,16900,16900,0
2018-06-01,34422465,L012010,면도기,질레트 프로쉴드 면도기 + 면도날 x 9입 초특가!,48900,43800,-5100
2018-06-01,1385771432,C013030,스웨터,KJN-NW100 남자레쉬가드요가복후드집업상의 요가집업,32510,32510,0
2018-06-01,897533913,A013020,명태,국산 고등어자반(2마리/손),1390,1390,0
2018-06-01,1945287194,I031040,생화,써치라이트/DC 12V/투광등/써치등/캠핑등/서치등/LED,40000,39600,-400
2018-06-01,1871847426,E031110,청소기,[악팩+필터4세트증정] 아이클레보 디즈니 로봇청소기,499000,499000,0
2018-06-01,1301079432,A022040,기능성음료,파워에이드/게토레이/이프로/포카리스웨트/캔음료,19900,19900,0
2018-06-01,1521760804,D031010,주택수선재료,주방 기름때방지 시트지,4500,4400,-100
2018-06-01,494509350,C021020,구두,9083 6.0cm 가죽 여성슬링백 수제화,149300,149300,0
2018-06-01,1054503099,C012040,여자학생복,포켓꽈배기니트조끼 EB1712 라운드니트조끼 꽤배기조,41600,41600,0
2018-06-01,1099655284,A018060,스낵과자,푸른농장 참쌀설병 128gx10/참쌀선과 115gx10/쌀과자,19800,19800,0
2018-06-01,138304565,C011050,남자내의,[올젠]18 S/S 뱀부소재 아쿠아 캐주얼팬츠 3종 택1 (ZPY2PP1503GR 외)(강남점),45000,37110,-7890
2018-06-01,2125544481,C013020,티셔츠,[NBA]_[미첼엔네스]뉴욕 닉스 레전드 플레이어 패트릭 유잉 스윙맨 저지(N185TS051P)(,159000,131100,-27900
2018-06-01,960362389,A019120,혼합조미료,백설 다시다 남해산 멸치 명품 골드 (300G),4890,4890,0
2018-06-01,960362387,L012070,바디워시,LG 온더바디 체리블라썸 바디워시 500ML,10500,3490,-7010
2018-06-01,419350532,E021020,커튼,일루션 암막커튼2장+레이스커튼2장/긴창4장세트,39900,36710,-3190
2018-06-01,960362388,L012070,바디워시,LG 온더바디 로즈 바디워시 500ml,10500,3490,-7010
2018-06-01,1535732846,L012010,면도기,질레트 면도기 모음전 (프로쉴드/프로글라/퓨전/마하),9900,9900,0
2018-06-01,504202037,C014020,유아복,삐삐롱 여자 아이 아동 어린이 반팔 상하 실내복 순면,14210,14210,0
2018-06-01,529701670,C012060,여자내의,허리조절 그레이체크 교복치마 교복 예쁜교복 교복쇼,49840,48350,-1490
2018-06-01,1558948983,I053040,기타문구,3m 포스트잇 대용량 오피스팩 opp 투명 스카치 테이프,11700,11700,0
2018-06-01,1916462576,E031020,가스레인지,동우환풍기 250mm/ 가정용환풍기 일반환풍기 화장실환,36800,35700,-1100
2018-06-01,708525914,A017120,고구마,제주산 무농약 햇 감자(특품) 3kg,9900,9900,0
2018-06-01,983481097,F012020,생리대,쏘피 한결 울트라슬림 날개형 중형(16P),5600,3300,-2300
2018-06-01,949819551,L021020,장신구,실버 귀걸이 SC0797/ 스톤헨지(주얼리),45000,39600,-5400
2018-06-01,366725855,C013050,운동복,후드 트레이닝복set 요가복 운동복 츄리닝 트레이닝복,61000,60390,-610
2018-06-01,836178413,C013010,점퍼,힐피거 주니어 아동 80-85 누빔 패딩 점퍼 좋음/K05,32000,31680,-320
2018-06-01,705221310,E031010,전기밥솥,리홈 밥솥 정품 패킹/ 밥솥패킹/ IH패킹/ 압력밥솥/SY,6000,5900,-100
2018-06-01,1619174678,C013010,점퍼,메덱스 윈드자켓 바람막이 고급형 MC260 점퍼 등산점퍼 바람막이 빅사이즈 집업점퍼,58250,51850,-6400
2018-06-01,1062968246,A016110,딸기,세미원 냉동 딸기 1kg 딸기 세미원 냉동식품 세미원냉,17430,17430,0
2018-06-01,1544580900,E041070,밀폐용기,[토프]냉장고(냉동실) 문짝정리수납용기 균일가,990,990,0
2018-06-01,414051958,D031010,주택수선재료,노루 친환경 다용도 뽀로로 키즈바이오 페인트 0.9L,10900,9900,-1000
2018-06-01,103891277,C011050,남자내의,남성스판면바지/밴딩바지/스판슬랙스팬츠/남자면바지,15900,15900,0
2018-06-01,721932815,I012060,저장장치,로지텍코리아 G810 RGB KEYBOARD 게이밍키보드,211700,199000,-12700
2018-06-01,918428004,F012010,종이기저귀,하기스네이처메이드 1~6단계 (밴드형/팬티형) 3팩,44800,44800,0
2018-06-01,50384435,A011120,두부,골든 그래놀라360gx2개+시리얼머그증정,11900,11900,0
2018-06-01,757752289,A013100,마른멸치,바다소풍 고급선물세트11~12미 1kg 선물포장,50000,47500,-2500
2018-06-01,248089271,C013050,운동복,안전봉/경광봉/지시봉/안전조끼/야광조끼,3000,2900,-100
2018-06-01,574290132,L021030,가방,러브캣 (베이직49)미니숄더백(LIS2S600GYLC01),220800,176640,-44160
2018-06-01,1065306562,C013030,스웨터,(기획특가)MNT029 배색 포인트 스트라이프 니트 니트,18160,18160,0
2018-06-01,299854832,A013060,게,인풍 오징어채 5kg 오징어 오징어채 건어물 찢은오징,67280,60560,-6720
2018-06-01,973756445,A021020,차,대상 카페시럽 1.5리터 x2 와 시럽펌프 x2 /커피시럽,9600,9600,0
2018-06-01,1656341366,A011010,쌀,2017년 햅쌀 경기미10kg 국내산 쌀 백미 맛있는쌀,26500,26500,0
2018-06-01,89652005,C012040,여자학생복,[MLB]엠엘비 2종택1 여성 등판엠보로고 MLB 후드집업(31TRC5811),104300,88660,-15640
2018-06-01,1827800845,I031040,생화,프리폼 럭셔리 접이식 야전침대,45900,41090,-4810
2018-06-01,983481075,F012020,생리대,쏘피 한결 울트라슬림 날개형 대형(10P),4200,3000,-1200
2018-06-01,1600122132,A013130,오징어채,정화 진미오징어 전기 50gx5.,27400,24390,-3010
2018-06-01,2103434550,C015040,장갑,ELH핫템 발열장갑 ( M ) 보온기 겨울용아웃도어장갑,279210,279210,0
2018-06-01,1985528122,F011150,건강기능식품,일양약품 키즈 유산균 프리바이오틱스 6박스,28900,28900,0
2018-06-01,1304058861,C013010,점퍼,바람막이 도트점퍼 집업점퍼 여성점퍼 긴팔점퍼 후드,12170,12170,0
2018-06-01,1387172791,C013020,티셔츠,남 피케 폴로 반팔티 017500/ 지오다노,12000,9840,-2160
2018-06-01,987317192,F011120,인삼,[참다올]유기농 장흥표고세트(백화고혼합 버섯세트370g),103000,79000,-24000
2018-06-01,2005147475,C011020,남자상의,(무료배송) AG 남성자켓 마이 DB793 퍼플보카 자켓 빅,208920,183850,-25070
2018-06-01,539660054,D031010,주택수선재료,[조색비용저렴]숲으로SE/내부수성/3.78L/베란다/콘크리트면/DIY/리폼/냄새無/꽃향유무,11000,11000,0
2018-06-01,1689625128,C013020,티셔츠,딥v넥영문티/루즈핏/박스티/브이넥/섹시티/레이어드.,8900,8900,0
2018-06-01,1860196341,A015020,식용유,[샘표]폰타나 포도씨유/올리브유 500ml,6900,6900,0
2018-06-01,1474974290,C012030,여자상의,[특가SALE] 뷔스티에 원피스/나시 롱 플라워,12800,12800,0
2018-06-01,1475444783,E031030,전자레인지,무료배송 SK매직 복합전기오븐 전자렌지 EON-25ES1,180000,168770,-11230
2018-06-01,1339333899,C012030,여자상의,#NAME?,25500,25500,0
2018-06-01,444620249,A011130,시리얼,메밀부침가루 900g X 2개 메밀전가루 국산메밀가루 밀,21400,21400,0
2018-06-01,658105460,C012020,원피스,부천) 몽고진간장13L,28070,28070,0
2018-06-01,1986796670,C013010,점퍼,[쉬즈미스] 클래식 원버튼 슬림 자켓_SWJKG50030,39000,31200,-7800
2018-06-01,378295365,C012040,여자학생복,플라워 비즈장식 가디건 MRBAKC5260/ 미니멈,149000,131120,-17880
2018-06-01,2027693621,E041050,냄비,음이온 다용도 내열 냄비/뚝배기/친환경 도자기 냄비,16000,16000,0
2018-06-01,716113521,A012050,소시지,쟌슨빌 핫도그3종 7.7.7 패키지 특가(총 21개입),24900,24900,0
2018-06-01,729176092,C013040,청바지,[게스진] MI1D6080 남성용 M톤 구제 스키니 데님 팬츠 청바지,138600,112270,-26330
2018-06-01,2119374456,A012010,국산쇠고기,[무항생제] 우족 1kg 1등급,27300,27300,0
2018-06-01,1711130485,E041050,냄비,반반 분리형 태극 냄비 훠궈 샤브샤브 전골,14500,14500,0
2018-06-01,499044153,C013010,점퍼,[쿠기][KOOGI]네오플랜항공점퍼_KL1JP101A,34800,33060,-1740
2018-06-01,1890637978,E031010,전기밥솥,쿠쿠 6인용 IH압력밥솥 CRP-FHXB0610FD (당일출고),321450,321450,0
2018-06-01,2141881603,A017160,오이,자연산 능이버섯 [특품] 냉동1kg / 건조100g 금강송이,9800,9800,0
2018-06-01,1041823941,C014010,아동복,펑키 로봇 후드 티셔츠 (3-24개월) 201965-티셔츠 유,19540,17400,-2140
2018-06-01,984547690,A012040,닭고기,닭가슴살 350G,6990,6990,0
2018-06-01,1668099270,C014010,아동복,[룰라비]빅플라워블라우스(78312-312-22)[갤러리아],88000,67760,-20240
2018-06-01,988066962,E061010,세탁세제,[LG]LG) 테크 산소 크린 1KG*2,13800,13800,0
2018-06-01,382048999,L021020,장신구,[티르리르] 다즐링(수정큐빅) 팔찌TBSSVW10636M-3,59000,50150,-8850
2018-06-01,494926478,A011020,현미,두레생협 배아미(4kg)(유기)두레생협배아미 쌀 식품,57400,50520,-6880
2018-06-01,1938932592,A015020,식용유,[오뚜기] 해표 업소식용유 18L /태성푸드/콩기름,27900,27900,0
2018-06-01,1822878184,C012060,여자내의,[하늘바라기]포그니 기모 스커트,9900,9410,-490
2018-06-01,7048719,F012010,종이기저귀,국내/빠른배송) 미국산 팸퍼스 스와들러 5단계 기저귀,81700,81700,0
2018-06-01,611591413,C011050,남자내의,배기 린넨 청바지 슬랙스 밴딩 남자 여름 바지 마바지,19800,19800,0
2018-06-01,1354363879,C013020,티셔츠,심플 후드집업 LTT0044 여성후드집업 트레이닝복,30210,29610,-600
2018-06-01,1277344732,A011050,콩,[가온애]커피땅콩 대용량 초코볼 고구마스틱 찹쌀땅콩,3600,3600,0
2018-06-01,1786981298,F012010,종이기저귀,[하기스썸머] 2018년형 에어솔솔(팬티/밴드) 3~5단계,39900,39900,0
2018-06-01,1322508534,C012060,여자내의,썸머 허리밴딩 캉캉 롱 스커트- 캉캉스커트 롱스커트,38280,38280,0
2018-06-01,491110396,F012020,생리대,팬티라이너/400매 /생리대/좋은느낌/화이트/순수한면/,7900,7900,0
2018-06-01,1863543898,C014010,아동복,[아디다스키즈] I 트레포일 크루 (CE1159),71200,64080,-7120
2018-06-01,423498423,A011100,라면,당면(찰 화미 1K)X10,54950,54950,0
2018-06-01,1503696042,L021020,장신구,럭셔리 특가2 최신상 22종 고급 실버반지 (svr14) 커플반지 선물 골드조아,42000,42000,0
2018-06-01,2054648611,C012030,여자상의,스트라이프끈롱원피스/나시/단가라/섹시/클럽/맥시롱.,10900,10900,0
2018-06-01,1727545378,L012030,칫솔,[본사직영샵]메디안 칫솔 모음전,10900,10900,0
2018-06-01,1218151946,F012020,생리대,[중형10p 증정] 좋은느낌 오가닉 순면 울트라 날개 중형 18x3,16700,15940,-760
2018-06-01,544121341,C013050,운동복,프론트 리어 범퍼 가드 보호대 몰딩 블랙 보호대 자동,22660,20650,-2010
2018-06-01,601445958,A011040,보리쌀,[무료배송](주)세립농산 직접재배한 작두콩차300g,14000,14000,0
2018-06-01,420666412,E011050,책상,BLMG블루밍홈 심플좌식책상/테이블/밥상/베드트레이,12900,11900,-1000
2018-06-01,1747344598,E011030,거실장,[채우리] 토니 패브릭 소파베드,150000,150000,0
2018-06-01,1722800701,A017050,미나리,무농약 적양배추(적채) 1kg / (친환경농산물/친환경인증),6500,6500,0
2018-06-01,1985459993,F012050,의료측정기,오므론 일제 자동혈압계 JPN500+수첩 혈압측정기,90000,82000,-8000
2018-06-01,1371938961,E031110,청소기,[블랙앤데커]2in1 다목적 스팀청소기 FSMH1621+사은품,159000,147870,-11130
2018-06-01,919755808,E011020,침대,[우아미ON]빅와이드 트리플서랍 수납침대(매트-SS),179000,179000,0
2018-06-01,2017100865,C012030,여자상의,[쁘띠시앙] 여름신상 롱원피스 SUMMER ITEM,9900,9900,0
2018-06-01,373272210,A013070,굴,선주직송 울진붉은대게 2kg 3kg 홍게 고급형,39000,39000,0
2018-06-01,1752732110,E011030,거실장,동글이 1500+600+유리장세트,665000,665000,0
2018-06-01,1752732112,E011030,거실장,동글이 1500거실장,165000,165000,0
2018-06-01,1752732111,E011030,거실장,동글이 1500+600 거실장세트,305000,305000,0
2018-06-01,25432679,A017040,양배추,시금치 4kg / 국내산 / 최상품 / 팜웨이,17900,17900,0
2018-06-01,1404003970,E061010,세탁세제,소프넛(인도) 1kg 솝베리 천연 세정제 세제 바디워시,18000,18000,0
2018-06-01,599931484,L021020,장신구,14k정품 귀걸이 14k피어싱 골드 TR124_한쪽,29900,29900,0
2018-06-01,1920660539,A011130,시리얼,튀김가루(감자 버터양파맛 푸드 500g),10860,10860,0
2018-06-01,693765093,A017050,미나리,(프랑스산)냉동미니양배추1kgx6개(단가6 500),39000,39000,0
2018-06-01,1067419853,E011030,거실장,[채우리] 보노 LPM 600 도어형 낮은신발장,80000,80000,0
2018-06-01,1305549698,C013010,점퍼,집업점퍼 와이엠보 소매지퍼 블루종 R2 점퍼 집업점퍼 블루종 바람막이 트랙자켓,68880,61310,-7570
2018-06-01,1067419854,E011030,거실장,[채우리] 보노 LPM 800 오픈형 낮은신발장,98000,98000,0
2018-06-01,1763813669,C021010,아동화,업체최저가판매 아동슬립온 아동화 유아신발 단화,18900,18900,0
2018-06-01,168588270,C011050,남자내의,HUM 남성 밴딩 슬랙스 팬츠 FHMECPS102,19840,19840,0
2018-06-01,985025301,C011050,남자내의,[필골드] YS3083 절개배색 기모 트레이닝팬츠,22800,22800,0
2018-06-01,1747344589,E011030,거실장,하모니수동3인리클라이너,499000,499000,0
2018-06-01,1067419855,E011030,거실장,[채우리] 보노 LPM 600 오픈형 높은신발장,112000,112000,0
2018-06-01,1067419856,E011030,거실장,[채우리] 보노 LPM 600 오픈형 낮은신발장,72000,72000,0
2018-06-01,1090930866,C012040,여자학생복,아도라블/SJSJ/5부 스티치 가디건식 니트/55/66/F,19800,19800,0
2018-06-01,282065327,C012040,여자학생복,소매 프릴 블라우스 (BASB364-A)[예약상품 2018.06.05 부터 발송]/ 보니알렉스,22000,19800,-2200
2018-06-01,1269701919,C013020,티셔츠,aa12 부들 목폴라 크림 폴라 목폴라티셔츠 긴팔폴라티,14830,14830,0
2018-06-01,1167630422,C013040,청바지,시크폭스 힙업 스키니데님팬츠/ 시크폭스,37800,29490,-8310
2018-06-01,1775124414,F011130,홍삼,정관장 활기력세트,69300,69300,0
2018-06-01,588575255,C012040,여자학생복,난닝구 델루이 린넨롱베스트/ 난닝구,29000,28130,-870
2018-06-01,1376306252,C011050,남자내의,[나쁜남자] P2346 내추럴 워싱 밴딩 와이드팬츠,26800,26800,0
2018-06-01,1224729597,L012060,샴푸,사은품증정이벤트)뉴프리미엄 TS샴푸/린스 500ml,16300,15900,-400
2018-06-01,1752732114,E011030,거실장,동글이 1200 거실장,138000,138000,0
2018-06-01,895710861,F011120,인삼,초L프레시)팽이버섯 100G,590,590,0
2018-06-01,1752732113,E011030,거실장,동글이 1200+1200거실장세트,269000,269000,0
2018-06-01,1752732116,E011030,거실장,엘다원목 카르텔 거실장세트,810000,810000,0
2018-06-01,1752732115,E011030,거실장,엘다원목 마리타 거실장세트,830000,830000,0
2018-06-01,1977189,C013050,운동복,포드 익스플로러 2018 크롬도어킥패드 133번 차량용품,112000,112000,0
2018-06-01,1344406351,A011030,찹쌀,보리쌀 (1K) X10,55760,49630,-6130
2018-06-01,1752732118,E011030,거실장,편백원목 카르텔 거실장세트,880000,880000,0
2018-06-01,1752732117,E011030,거실장,편백원목 마리타 거실장세트,900000,900000,0
2018-06-01,895710864,A017020,상추,샐러리 (절단/봉),2990,2990,0
2018-06-01,194221647,C013020,티셔츠,로로텐 롱/루즈핏/라운드/티셔츠 빅사이즈 여성의류,18800,18800,0
2018-06-01,1752732119,E011030,거실장,에쉬원목 마리타 거실장세트,850000,850000,0
2018-06-01,386408659,C015020,모자,(컬러:사이즈 : 베이지:FREE) ACC-CAP106 찡,26080,26080,0
2018-06-01,80438466,L012030,칫솔,시스테마 스탠다드 칫솔 8개 치약 구강,9500,9500,0
2018-06-01,1732062653,E021010,침구,2018#여름이불세트/토퍼세트,49900,49900,0
2018-06-01,1163221948,F012030,안경,초경량국산안경테/베타/울템/카본/이중사출/뿔테안경,29800,29800,0
2018-06-01,468588262,I053010,공책,묶음상품 플라스틱링(19mm)흑색 100개입x3개 링 책제,60480,60480,0
2018-06-01,1308588883,C012060,여자내의,다니엘크레뮤린넨슬랙스(80035197)/ 스타일온에어플러스,20000,18000,-2000
2018-06-01,494990989,A011170,떡,(냉동)명가에프씨 호박떡볶이1kgX6개명가에프씨 분식,54700,44860,-9840
2018-06-01,665425609,A012060,햄및베이컨,부대햄(노미트 런천미트1.81K)X6 / NORMEAT /(참고),191200,168260,-22940
2018-06-01,1488696970,A012010,국산쇠고기,[무항생제] 사골 1kg 1등급,20700,20700,0
2018-06-01,1747344561,E011030,거실장,에이블1500거실장,169000,169000,0
2018-06-01,1747344562,E011030,거실장,에이블거실장SET,359000,359000,0
2018-06-01,1453202969,A017080,무,1+1도라지배즙 총60포 해썹 선물 홈플러스 입점,17900,17900,0
2018-06-01,1747344560,E011030,거실장,에이블협탁,95000,95000,0
2018-06-01,499044185,C013010,점퍼,[쿠기][KOOGI]파스텔배색점퍼_KL1JP102A,24800,23560,-1240
2018-06-01,1747344565,E011030,거실장,모던원형2인테이블SET,193000,193000,0
2018-06-01,1336295539,E021020,커튼,레이스 캐노피 모기장(화이트) 장 가정용모기장 침대,18030,18030,0
2018-06-01,1747344566,E011030,거실장,스너그4인소파,599000,599000,0
2018-06-01,1747344563,E011030,거실장,모던4인테이블,99000,99000,0
2018-06-01,1747344564,E011030,거실장,모던4인테이블SET,335000,335000,0
2018-06-01,1747344567,E011030,거실장,스너그3인소파,379000,379000,0
2018-06-01,968762936,C012040,여자학생복,[퍼스트레인] 1st Lane Novick 여성가디건/숏가디건/무늬가디건/브이넥가디건/포켓가디,19800,9900,-9900
2018-06-01,2083118710,C011020,남자상의,남자코트 베이직 베이지 싱글 롱코트 /(참고)캐주얼코,55700,49020,-6680
2018-06-01,898535445,L021030,가방,(제니터)정품 서류가방 품질우선 노트북가방 크로스백,32800,29800,-3000
2018-06-01,2145819891,I031040,생화,무료배송 야외 대형 폴딩 파라솔 야외천막 그늘막,69000,61760,-7240
2018-06-01,859025334,E031090,공기청정기,[삼성전자] 인증점 삼성 무풍공기청정기 AX80N9080WWD 무료배송,1000000,748060,-251940
2018-06-01,886658820,I031010,장난감,new 편백나무 레고 접이식 테이블/빠른배송,118000,106200,-11800
2018-06-01,595610174,A017280,김,초생강(백색 참존 1.2k)X10,35200,35200,0
2018-06-01,1906489423,C012030,여자상의,인기신상 롱원피스 린넨 쉬폰 플라워 ops 특가모음전,16900,16400,-500
2018-06-01,417474785,C012040,여자학생복,블라우스/남방/시스루 셔츠/여성의류/빅사이즈/쁘니걸,26800,26800,0
2018-06-01,195247,A019130,스프,냉장 스프 5가지/양송이/브로콜리/고구마/크림/치킨,5400,5400,0
2018-06-01,1512157083,C012040,여자학생복,[지지피엑스]데님 롱베스트(IGB5VT720F),38000,29640,-8360
2018-06-01,1449897806,C011030,남자학생복,[체이스컬트]남성용 매쉬조직 레터링 집업-DBAK4322DY0,9900,9410,-490
2018-06-01,310291712,C012040,여자학생복,캘빈클라인 민소매 집업 니트가디건/여성XS/중고/구제,19900,19900,0
2018-06-01,675221021,C013010,점퍼,네이비 베이직 경량 패딩 _AJT002_Navy 패딩 점퍼 경량패딩 남자아우터 남자패딩,31930,28420,-3510
2018-06-01,1846459264,A017080,무,전남담양 명물 삶은 죽순 500g,10000,9900,-100
2018-06-01,373858899,A016030,복숭아,발송중)2018 자연산(야생)개복숭아/돌복숭아 10KG 5KG,24800,24800,0
2018-06-01,984547688,A012040,닭고기,하림자연실록닭날개 350G(점포마다 브랜드 및 이미지가 상이할수 있습니다),6990,6990,0
2018-06-01,984547689,A012040,닭고기,무항생제 닭봉 350G(점포마다 브랜드가 상이할수 있습니다),6990,6990,0
2018-06-01,1298960488,E031080,선풍기,[지비텍] 발난로/국내산/온풍기/발온풍기/미니히터/GBH-480w,37300,37300,0
2018-06-01,1076279909,C013040,청바지,하이웨스트스키니 반하이 일자청바지 세미부츠컷 여자,19900,19900,0
2018-06-01,1982652977,L012030,칫솔,죽염칫솔 4입x4=16개/시린이 잇몸 전용 칫솔/죽염치약,21900,21900,0
2018-06-01,2099737351,C013050,운동복,[엑토] 차량용 고리 후크 뒷자석 가방걸이 CAC-01,4300,3960,-340
2018-06-01,1848536490,A012060,햄및베이컨,퀸주트 수제바베큐/슈바인학센/햄/베이컨/소세지/캠핑,11900,11670,-230
2018-06-01,1336410767,C012020,원피스,빅사이즈/아이스/포켓/가디건 아이스포켓가디건 빅사,36150,35070,-1080
2018-06-01,2079403832,C012060,여자내의,톰스 연청 멜빵 청반바지(멜빵탈부착) SD-4085,15610,15150,-460
2018-06-01,1822878158,C012060,여자내의,[패션플러스][하늘바라기]양털 미니 스커트,9900,9410,-490
2018-06-01,344420019,E031130,보온매트,GPS-한일꽃잠 건강 온열매트 커피(더블 140x200) 절전,254840,254840,0
2018-06-01,484646340,E041010,식기,스텐/식기/합식기/밥그릇/국그릇/물컵/주방용/업소용,700,650,-50
2018-06-01,552072475,A012060,햄및베이컨,사조오양 페파로니 1kg/소시지/햄/피자/토핑/치즈/,9200,9200,0
2018-06-01,880100561,E011020,침대,2주특가(전남오픈마켓/온돌라이프)구들목 킹침대,2820000,2820000,0
2018-06-01,1482473142,I031040,생화,캠핑테이블 의자 셋트 /캠핑의자/접이식테이블/용품,29900,25670,-4230
2018-06-01,1181939843,C013010,점퍼,남자아우터 데님배색 사파리 야상 자켓 봄자켓 봄점퍼,59810,59810,0
2018-06-01,1717157203,A014020,분유,[아이배냇] 순산양분유 1단계 800g,32900,32900,0
2018-06-01,895710830,A017020,상추,국산 브로커리(2입/봉),8990,3490,-5500
2018-06-01,171093011,A022050,탄산음료,웰치스 250mlx30캔 1박스/355mlx24캔/해태음료/음료수,11400,10900,-500
2018-06-01,1451944308,C012060,여자내의,[대구백화점 I관] [4CUS]프릴 멜빵팬츠(FS8C9PT5015),29000,27260,-1740
2018-06-01,186668580,C013050,운동복,[사랑손님]안전봉/점멸등/지시봉/신호봉/야광봉/비상용품/led경광봉/차량용/교통/자동,3410,3410,0
2018-06-01,2061220636,C011030,남자학생복,브랜드 캐주얼//반팔/셔츠/셔츠/남방/빅사이즈/린넨,14900,14900,0
2018-06-01,1010674738,A018080,설탕,브라질산 고이아사 유기농설탕25kg/비정제원당/천연당,60000,60000,0
2018-06-01,1010261076,A019050,간장,일본계란간장소스 150ML,7500,7500,0
2018-06-01,1456226472,C012060,여자내의,PT1356-도트 배색 패턴 숏 팬츠 캐주얼바지 편한반바,19410,15730,-3680
2018-06-01,1447692010,C013010,점퍼,바람막이 옷 수선 접착 테이프 패치 경량 다운 점퍼,9000,9000,0
2018-06-01,1096198863,L021010,손목시계,BABY-G 베이비지 BA-110GA-1A 여성용 디지털 시계,184000,184000,0
2018-06-01,1096198862,L021010,손목시계,BABY-G 베이비지 BA-110GA-7A1D 여성용 디지털 시계,184000,184000,0
2018-06-01,1096198865,L021010,손목시계,BABY-G 베이비지 BA-110CA-4A 여성용 디지털 시계,184000,184000,0
2018-06-01,1096198864,L021010,손목시계,BABY-G 베이비지 BA-110DE-2A2 여성용 디지털 시계,203000,203000,0
2018-06-01,1096198866,L021010,손목시계,BABY-G 베이비지 BA-110BE-4A 여성용 디지털 시계,184000,184000,0
2018-06-01,1176228436,C013010,점퍼,J by SUMMER18 메모리얼 썸머 재킷1종,59000,51570,-7430
2018-06-01,2138686243,C013030,스웨터,남자니트 헨리넥 폴라 니트 단추니트 폴라니트 니트,49290,49290,0
2018-06-01,1400173907,I031010,장난감,PSN 플러스 12개월 이용권 / 050 안심번호 금지,42800,42800,0
2018-06-01,246412259,C012060,여자내의,옆레이스 가죽레깅스 SD-4084 레깅스 치마레깅스 기본레깅스 면레깅스 반바지레깅스,9580,8530,-1050
2018-06-01,393875948,C012060,여자내의,매그제이 린넨체크슬릿스커트 J11NSK335,47920,47920,0
2018-06-01,1155044018,C013050,운동복,쿨 트레이닝 반바지/빅사이즈/츄리닝/팬츠/남자/남성,7900,7900,0
2018-06-01,1387671369,E061040,부엌용세제,커피머신세정제 어넥스카피자 전문가용커피머신세정제,38170,38170,0
2018-06-01,1658928290,A011080,밀가루,복만네 콩국수용 콩가루 850g,4280,4280,0
2018-06-01,313049256,I053020,스케치북,스케치북 20권+문구세트 대용량10권 +문구세트 종합장,11900,11900,0
2018-06-01,1306487168,E031080,선풍기,건강온열난방기 근적외선골드 HV-1730/3.2K난로 한빛,424700,424700,0
2018-06-01,1096198861,L021010,손목시계,BABY-G 베이비지 BA-110LP-4A 여성용 디지털 시계,191000,191000,0
2018-06-01,1096198860,L021010,손목시계,BABY-G 베이비지 BA-110GA-7A2D 여성용 디지털 시계,184000,184000,0
2018-06-01,1096198858,L021010,손목시계,BABY-G 베이비지 BA-110LP-9ADR 여성용 디지털 시계,191000,191000,0
2018-06-01,1109724818,C013020,티셔츠,메모리즈 반팔 후드 여성 티셔츠 여름,18000,18000,0
2018-06-01,2095184560,C012040,여자학생복,[비키]스트라이프 레이어드 7부 니트 (TMUCA2933)_S3K9,27900,26510,-1390
2018-06-01,2115802971,F012020,생리대,초특가 할인 좋은느낌 팬티 라이너 3팩 외 구성,10900,10900,0
2018-06-01,570235510,A016040,포도,[크라운제과] 크라운 마이쭈복숭아 44g x 60개 맛있고 간편하게 심,59100,59100,0
2018-06-01,1030937996,A012060,햄및베이컨,한성 런천미트340gx24캔,30900,30900,0
2018-06-01,442668853,I011020,영상음향기기,비비텍 BS564 밝기4000 HDMI단자 빔프로젝터 프로젝트,499100,499100,0
2018-06-01,759248202,A013170,생선통조림,[동원] 라이트스탠다드 135gx8캔 + 동원참치 85gx2캔,14330,14330,0
2018-06-01,462020553,F012020,생리대,화이트 시크릿홀 슬림 일반 (소/중/특대형)x5팩선택,25500,25500,0
2018-06-01,1297938736,C013020,티셔츠,베이직폴라티(블랙) 목폴라 심플 여성 목폴라 티셔츠,28970,28970,0
2018-06-01,2018989421,L021020,장신구,스와로브스키스톤 유색 비즈 은침귀걸이 이어링 귀고리 악세사리귀걸이 패션귀걸이 실,21100,20470,-630
2018-06-01,750361801,L021020,장신구,14K/18K 바치오 팔찌[당일출고],130000,130000,0
2018-06-01,416974447,E011050,책상,MT101W-L 높이조절 워크스테이션 화이트 높이조절책,701790,701790,0
2018-06-01,1297914767,C011030,남자학생복,MCD-904 컬러배색 하이니 브이넥 가디건 남성가디건,20220,20220,0
2018-06-01,2064003100,A014030,치즈,디엘 파마산 플러스 100/일회용 치즈가루/4g*500개,35200,35200,0
2018-06-01,1033225368,A013170,생선통조림,[사조해표] 연어 살코기 or 매운맛 135g(안심따개) x8캔,11900,11900,0
2018-06-01,1119887141,C012020,원피스,니트 배색 코트 BACT87761/ 베네통,248960,224070,-24890
2018-06-01,1721127986,I012010,컴퓨터,특가124만구매NT900X3N-K517S 메모리16GB NVMeSSD256,1409470,1339000,-70470
2018-06-01,1775124442,F011130,홍삼,정관장 활기세트,57000,57000,0
2018-06-01,472493552,A019070,양념소스,오뚜기 닭볶음탕양념 160g X 20EA / 오뚜기(Hanworld2,66100,56190,-9910
2018-06-01,1033225369,A013170,생선통조림,[사조해표] 연어 살코기 or 매운맛 90g(안심따개) x10캔,12900,12900,0
2018-06-01,1898840152,E041050,냄비,유기그릇 놋그릇 방짜 샤브샤브 전골냄비 샤브냄비,85000,80750,-4250
2018-06-01,969765847,E061010,세탁세제,정품 런드레스 베이비 디터전트 1L 아기옷용세제,20900,20900,0
2018-06-01,358321420,A019040,소금,백설 브라운 각설탕/백설각설탕/슈가/설탕/커피 설탕/원두커피/헤이즐넛/맥심커피,3800,3800,0
2018-06-01,60946285,C013020,티셔츠,네파키즈 더블팩셋트 KEG5307,16170,16170,0
2018-06-01,556651380,C013010,점퍼,AG 가죽자켓 라이더자켓 가죽점퍼 P171 남성용가죽자,96160,96160,0
2018-06-01,787676957,L012090,기초화장품,No.1 폰즈 모이스처 스파 클렌징크림 2개 / 폼클렌징,14900,14900,0
2018-06-01,1096198830,L021010,손목시계,BABY-G 베이비지 BA-112-1A 여성용 디지털 시계,184000,184000,0
2018-06-01,1010405282,A013160,맛살,동원)더킹리얼크랩스 140G*2,4680,3990,-690
2018-06-01,1096198832,L021010,손목시계,BABY-G 베이비지 BA-110TX-1A 여성용 디지털 시계,223000,223000,0
2018-06-01,1096198831,L021010,손목시계,BABY-G 베이비지 BA-110TR-7A 여성용 디지털 시계,188000,188000,0
2018-06-01,1010405283,A013160,맛살,동원)더킹리얼랍스터 140G*2,4680,3990,-690
2018-06-01,959008590,A014010,우유,[파스퇴르]바른목장우유125mlx48팩/유기농/컵홀더증정,26900,26900,0
2018-06-01,1096198834,L021010,손목시계,BABY-G 베이비지 BA-110TP-7A 여성용 디지털 시계,212000,212000,0
2018-06-01,591936393,C015040,장갑,등산장갑 반장갑 터치 자전거 운전 여성 여름 장갑,2500,2300,-200
2018-06-01,2054136712,C012040,여자학생복,[루시다]C97 KN4782로렌즈 린넨 니트 가디건,41040,36530,-4510
2018-06-01,1096198833,L021010,손목시계,BABY-G 베이비지 BA-110SN-4ADR 여성용 디지털 시계,175000,175000,0
2018-06-01,1096198836,L021010,손목시계,BABY-G 베이비지 BA-110SN-3ADR 여성용 디지털 시계,175000,175000,0
2018-06-01,1096198835,L021010,손목시계,BABY-G 베이비지 BA-110SN-1ADR 여성용 디지털 시계,175000,175000,0
2018-06-01,518974986,E021020,커튼,/벌집블라인드 화이트 호프발스 120x155 cm/ 롤스크린,63870,56850,-7020
2018-06-01,180871663,I011010,TV,상품평5만(공식파트너)삼성 UHD TV UN49MU6500FXKR,831000,719000,-112000
2018-06-01,796190327,A017160,오이,산지직송 생 표고버섯 파지 4kg,26900,26900,0
2018-06-01,199652070,C012040,여자학생복,[무료배송]150501N_민소매 블라우스/기본나시/실크나시/면나시/슬립/이너웨어/유니폼/,16500,15500,-1000
2018-06-01,117301070,E011030,거실장,[PookShuim] 블레드 PU가죽 3인용 소파,530000,530000,0
2018-06-01,1387495252,C013010,점퍼,AG 후드 집업점퍼 블랙앤화이트 오픈 CC 집업점퍼 후,45990,45990,0
2018-06-01,649269100,C011030,남자학생복,[9800원]신상/긴팔/셔츠/남방/스판/슬림/체크/린넨,17000,9800,-7200
2018-06-01,539936204,C013060,등산복,이월상품 봄/여름 여성용 등산기능성 기본트레킹팬츠 D울트라팬츠-2/ 블랙야크,25000,20750,-4250
2018-06-01,1741451601,A016040,포도,동원)황도 슬라이스 400g x 12개 사시사철 맛있는,41360,41360,0
2018-06-01,972524913,C012040,여자학생복,[조이너스][조이너스]레이스 페플럼티셔츠-IJ6U4WIB901,25900,22800,-3100
2018-06-01,2088104548,A017180,호박,대웅산 흑마늘 젤리 350g 해풍과 해무를 먹고자란 남,21490,19130,-2360
2018-06-01,1506640814,L021030,가방,고퀄 남자 서류가방/남성 크로스백/브리프케이스/노트,40950,39900,-1050
2018-06-01,1854152250,I031040,생화,[밀레] 아웃도어 남여 공용 UV 넥마스크 MXLXE537 2종 택1,29000,23200,-5800
2018-06-01,873130483,C013050,운동복,아디다스 트레이닝 모음/에스트로 반팔 긴팔 반바지/,14000,14000,0
2018-06-01,689285553,F011150,건강기능식품,우콘파워 드링크 1박스 10병 일본 NO1 숙취해소제,32900,32900,0
2018-06-01,1619150720,C013010,점퍼,메덱스 아웃도어 등산자켓 빅사이즈 JK180 등산점퍼 등산자켓 바람막이 빅사이즈점퍼,95480,84980,-10500
2018-06-01,1320559247,E011020,침대,프리미엄 패밀리침대 Q+SS 가드형 20T라텍스매트리스,883800,857290,-26510
2018-06-01,1897226251,C011030,남자학생복,[큰옷_세종대왕]허리36-44권장 IP52비치지퍼조끼후드/빅사이즈조끼,34000,34000,0
2018-06-01,853168466,E061100,습기제거제,선반 제습제 A570 X 24개 외,18900,18900,0
2018-06-01,1122986754,C011030,남자학생복,봄신상 브이넥 가디건/남자옷/롱단추집업지퍼니트,13800,13800,0
2018-06-01,1547808908,A011090,국수,[오뚜기] 오뚜기 비빔면/볶음면 골라담기 진짜쫄면,2500,2500,0
2018-06-01,227620877,A015020,식용유,트레드키 NON-GMO 카놀라유18L 업소용 식용유 BIB,28800,28800,0
2018-06-01,909198398,E021010,침구,쿨~시원한 여름이불/패드/토퍼/이불세트,24900,24900,0
2018-06-01,117301078,E011030,거실장,[끄망메블루] 스텔라 거실 테이블,490000,490000,0
2018-06-01,2062548166,C013020,티셔츠,블루페페 블라우스(P173MSC004)GN,57600,48960,-8640
2018-06-01,117301079,E011030,거실장,[끄망메블루] 스텔라 장식장,620000,620000,0
2018-06-01,1319172379,L012060,샴푸,약국판매 약산성 트리플S탈모샴푸 2+2+10 2250m,28900,28900,0
2018-06-01,117301075,E011030,거실장,[채우리] 가이 3단 신발장 700,40000,40000,0
2018-06-01,117301076,E011030,거실장,[채우리] 가이 2단 신발장 700,30000,30000,0
2018-06-01,117301077,E011030,거실장,[채우리] 가이 2단 신발장 465,30000,30000,0
2018-06-01,1067419828,E011030,거실장,[채우리] 보노 LPM 800 도어형 높은신발장,153000,153000,0
2018-06-01,1067419829,E011030,거실장,[채우리] 보노 LPM 800 도어형 낮은신발장,108000,108000,0
2018-06-01,1634025177,L021030,가방,쌈지 S/S 프리미엄 펜던트 15종 여성가방/숄더백/쇼퍼,16800,16800,0
2018-06-01,1093341684,E031080,선풍기,젠텍 가스스토브 로터리히터 GTK-1010P (82.5㎡~99㎡),240000,240000,0
2018-06-01,1405386012,E061030,전구,금호전기/LED형광등/FPL호환형/삼파장대체용/조명전구,14900,14900,0
2018-06-01,1093341683,E031080,선풍기,대성하이원_우드 원적외선 오일히터 DSO-70 (25~42㎡),720000,720000,0
2018-06-01,860783370,L021020,장신구,원석sale/천연자수정/79.9캐럿/큼직/amethyst,150000,150000,0
2018-06-01,1093341682,E031080,선풍기,대성하이원_우드 원적외선 오일히터 DSO-350F (231~330㎡)-송풍기능,1950000,1950000,0
2018-06-01,1324911681,C013030,스웨터,MTSSF18014 크랙 후드 남성후드티 캐쥬얼후드티 캐주,42040,42040,0
2018-06-01,2054974774,F012020,생리대,릴리안 순수한면롱라이너40p-3팩,9500,9500,0
2018-06-01,391031193,C012040,여자학생복,(KN)-칼라 니트세트(AJ2EX541)/ 랩,139000,118150,-20850
2018-06-01,1823174878,A022010,주스,무배 탕 오렌지 쥬스 주스 분말 가루 파우더 350g,10480,10480,0
2018-06-01,1011103470,L012060,샴푸,아모스/녹차실감샴푸/스마트샴푸/컬링에센스/헤어팩,18900,18900,0
2018-06-01,1096198896,L021010,손목시계,BABY-G 베이비지 BA-110-7A1 여성용 디지털 시계,184000,184000,0
2018-06-01,2085439020,C012060,여자내의,푸조 워테레깅스 ( S26-3 ),28300,28300,0
2018-06-01,1096198895,L021010,손목시계,BABY-G 베이비지 BA-110-4A2 여성용 디지털 시계,184000,184000,0
2018-06-01,1096198898,L021010,손목시계,BABY-G 베이비지 BA-110-1A 여성용 디지털 시계,184000,184000,0
2018-06-01,1010674773,C013060,등산복,[마운티아] 남여공용 펜타팬츠#5#6 1MQPNS7002 4종 택1,30000,24900,-5100
2018-06-01,2064837902,C013010,점퍼,CN054-플랩포켓 후드 퍼 코트 겨울후드퍼코트 모자털,46650,46650,0
2018-06-01,1096198897,L021010,손목시계,BABY-G 베이비지 BA-110-4A1 여성용 디지털 시계,184000,184000,0
2018-06-01,1874590280,E061010,세탁세제,구스다운워시(다운패딩침구전용세제)10회분X2팩(20회),18900,18900,0
2018-06-01,135562299,G011070,자전거,삼천리자전거 아동용/어린이자전거 하운드 팝콘16/18,97000,87300,-9700
2018-06-01,528122237,C021040,실내화,15% 쿠폰 [나이키] 인기 남성 여성 운동화 모음,23800,23800,0
2018-06-01,1067419831,E011030,거실장,[채우리] 보노 LPM 800 오픈형 높은신발장,133000,133000,0
2018-06-01,1067419830,E011030,거실장,[채우리] 보노 LPM 600 도어형 높은신발장,122000,122000,0
2018-06-01,828533033,C011050,남자내의,아로미 601 늦가을부터 초겨울까지 따뜻한 치마레깅스,10950,9750,-1200
2018-06-01,628987864,C021040,실내화,여성용 스카이스케이프 하모니 M45742/ 리복,59000,53100,-5900
2018-06-01,896605774,E061090,방향제,블랙라벨 벨트클립,5500,5500,0
2018-06-01,370627825,C011050,남자내의,어스앤뎀 남성 마이크로 스판슬랙스 V11US TBPB605,47990,47990,0
2018-06-01,989968749,E041040,프라이팬,테팔그래픽판다프라이팬28cm,19800,19800,0
2018-06-01,2057879885,C012040,여자학생복,+신상 루즈핏셔츠+빅사이즈77-99 체크/기본/남방/면접,26800,26800,0
2018-06-01,1096198890,L021010,손목시계,BABY-G 베이비지 BA-110BC-9ADR 여성용 디지털 시계,164000,164000,0
2018-06-01,1096198892,L021010,손목시계,BABY-G 베이비지 BA-110-8ADR 여성용 디지털 시계,164000,164000,0
2018-06-01,980902592,A017090,열무,[오창농협] 무농약 세척무 1개,10800,9210,-1590
2018-06-01,1096198891,L021010,손목시계,BABY-G 베이비지 BA-110BC-1A 여성용 디지털 시계,184000,184000,0
2018-06-01,1096198894,L021010,손목시계,BABY-G 베이비지 BA-110-7A2DR 여성용 디지털 시계,184000,184000,0
2018-06-01,1530740850,A014030,치즈,슬라이스치즈100매/멀티/무색소/업소/뼈속칼슘치즈,14000,14000,0
2018-06-01,1387671360,E061040,부엌용세제,제빙기세척제 어넥스프리즈 제빙기세정제 제빙기살균,43070,43070,0
2018-06-01,1096198889,L021010,손목시계,BABY-G 베이비지 BA-110BC-2ADR 여성용 디지털 시계,164000,164000,0
2018-06-01,591180769,A013010,갈치,제주산 은갈치 500g 3팩(15마리내외)총1.5kg한정특가,15900,15900,0
2018-06-01,875748892,L021020,장신구,14K 골드핀 핑크골드 피어싱 균일가 14K귀걸이,9900,9900,0
2018-06-01,1164927066,C014010,아동복,밍구키즈 여름신상 아동복/상하복세트/반팔/반파지,8900,8900,0
2018-06-01,724727808,C012060,여자내의,[테이트] 여성 쇼츠 KA4U5WPH310470,10000,9000,-1000
2018-06-01,721582578,C011030,남자학생복,남여후드시보리롱패딩점퍼 WWS1814M 빅사이즈,55890,54220,-1670
2018-06-01,308626972,A017100,당근,아삭아삭 맛있는 일산열무,10000,10000,0
2018-06-01,129380302,C014020,유아복,[디플랜][디플랜] 마론티셔츠,5500,5230,-270
2018-06-01,996395521,C013020,티셔츠,여름신상반팔박스티셔츠맨투맨오프숄더빅사이즈브이넥,8900,8900,0
2018-06-01,2040977530,F012020,생리대,[위스퍼]코스모 메모리폼 생리대 5팩 모음전,46900,46900,0
2018-06-01,340791687,F011120,인삼,장수산삼 10년근 3주(3뿌리) 장뇌삼 산양산삼 산양삼,275000,247500,-27500
2018-06-01,938024681,C013010,점퍼,아디다스 유소년 콘디보16 스타디움자켓 ( AB3152 ),149040,132650,-16390
2018-06-01,504591487,L021010,손목시계,BELCARINO 화이트 남녀공용 고급 손목시계 MV201033BL,69650,69650,0
2018-06-01,1860554946,C013020,티셔츠,블루페페 블라우스(P162MSC037),19000,16150,-2850
2018-06-01,1587255379,A015020,식용유,캡슐1850원특가·세렌디브코코넛오일 캡슐 식초·비누,1850,1850,0
2018-06-01,1101863564,C012040,여자학생복,웨이브넥슬림니트(SFGF1KT9100)/ 포커스,19800,17820,-1980
2018-06-01,1405075785,C013020,티셔츠,[하루비나] 고급맨투맨티셔츠/남여공용/22컬러/후드티,9900,9900,0
2018-06-01,230258741,C012060,여자내의,4부 린넨 숏 팬츠 MIWTH8511A/ 미쏘,35900,34110,-1790
2018-06-01,623406107,E041010,식기,광명유기 찬기/종지/앞접시 모음전 / 놋그릇 / 유기,22000,19780,-2220
2018-06-01,1748558156,I031040,생화,일산화탄소경보기/CO가스누출/측정기 감지기 휴대용,13800,12700,-1100
2018-06-01,1422327037,E031010,전기밥솥,풍년 파워클래드 SJPC-20C/SJPC-22C/SJPC-24C부품판매,6000,6000,0
2018-06-01,1070347878,E031120,믹서,[NUC] [냄비3종증정]엔유씨 스마트 고속 블렌더 NPM-671KC,195000,185000,-10000
2018-06-01,705154334,A019080,고추장,ⓒ 해찬들 조림요리장(285G),4380,4380,0
2018-06-01,415216594,C013040,청바지,[행텐주니어](행텐주니어)남아베기밴딩5부청바지_14120-056-403-10_평촌점,12000,12000,0
2018-06-01,985326038,A011090,국수,농심 메밀소바 127G*5입,5150,3490,-1660
2018-06-01,1915970653,F012010,종이기저귀,18년 군 수영장 기저귀 3매/방수 기저귀/하기스,5900,5900,0
2018-06-01,656838727,C013020,티셔츠,[체스][체스골프]비비드 볼레로 이너웨어,17000,16150,-850
2018-06-01,1181883187,A018100,꿀,골든넥타 Golden Nectar 헝가리 벌집꿀 400g,35900,35900,0
2018-06-01,325597167,C012040,여자학생복,[모다아울렛][막스카라]가디건M82QKC349MEB1,99000,89100,-9900
2018-06-01,895771658,A019090,카레,[오뚜기]오뚜기 3분카레 매운맛 200g,1690,1690,0
2018-06-01,857471778,L021010,손목시계,LED손목시계/스포츠/전자/어린이/젤리/패션/밴드시계,1150,1150,0
2018-06-01,895771659,A019090,카레,[오뚜기]오뚜기 3분카레 약간매운맛 200g,1690,1690,0
2018-06-01,895771656,A019090,카레,[오뚜기]오뚜기 3분 짜장 200g,1690,1690,0
2018-06-01,895771657,A019090,카레,[오뚜기]오뚜기 3분카레 순한맛 200g,1690,1690,0
2018-06-01,895771654,A019130,스프,[오뚜기]오뚜기 3분 쇠고기짜장 200G,1590,1590,0
2018-06-01,895771655,A019130,스프,[오뚜기]오뚜기 3분 쇠고기카레 200G,1590,1590,0
2018-06-01,895771650,A019090,카레,오뚜기 3분 미트볼 150G,1950,1950,0
2018-06-01,1969593302,C021040,실내화,SALE/나이키/아디다스/뉴발란스/아동화/축구화/조던/,59900,59900,0
2018-06-01,1018876027,F012010,종이기저귀,LG 토디앙 자운보 밴드/팬티기저귀 3팩,34900,34900,0
2018-06-01,1741487712,A017010,배추,동수농원 시래기(건무청) 100g 자연건조[삶지않음]/청정지역 물맑은 양평 시래기,3500,3500,0
2018-06-01,367034028,C015040,장갑,리본 모직 장갑 여성모직장갑 겨울장갑 여성장갑 리본,20590,20590,0
2018-06-01,1470528570,A018070,파이,롯데 초코파이 420g(12입)x8곽 오예스/몽쉘/오리온,14900,14900,0
2018-06-01,1760231127,C011020,남자상의,봄여름균일가12종/결혼식하객패션정장/면접정장/수트,68900,68900,0
2018-06-01,1719999584,C013050,운동복,아웃사이즈 ~4XL 빅사이즈 요가복/트레이닝복 세트,18800,18800,0
2018-06-01,193010297,E061100,습기제거제,초강력 방습제셋트 [무한반복사용]실리카겔 제습제,7700,7700,0
2018-06-01,689809731,I031040,생화,등산 스포츠 캠핑 물병 물통 보틀 텀블러 스텐 판촉,4500,4140,-360
2018-06-01,1783514382,I031040,생화,캠핑용 초경량 팩망치 캠핑용품/캠핑망치/텐트/소품,15900,14360,-1540
2018-06-01,985351116,A013170,생선통조림,오뚜기 마일드참치200G,3390,3390,0
2018-06-01,824003390,A018040,아이스크림,하겐다즈 아이스크림 미니컵 100ml X 8개,30200,30200,0
2018-06-01,587983902,E011050,책상,40T 서재책상 /일자형책상/컴퓨터책상/*일주일간 무료,18800,18800,0
2018-06-01,1606127738,F011150,건강기능식품,일동 어린이 유산균 멀티비타민 칼슘 비타민D 모음전,19900,19900,0
2018-06-01,1892501684,I031040,생화,키모니 손목보호대 팔꿈치보호대 암슬리브 2개세트,7800,7180,-620
2018-06-01,372568038,I053010,공책,신학기 과목노트(한문)(10개입)-랜덤 학교공책 과목노,10960,10960,0
2018-06-01,179835251,A022030,생수,트레비 355 24캔/라임/레몬/콜라/사이다/포카리/마운틴듀/립톤복숭아/탄산음료/음료수,12900,12900,0
2018-06-01,1952571141,I031010,장난감,레고판 레고 듀플로 테이블 옥스포드 블럭판 책상,900,900,0
2018-06-01,1057301441,E051030,디지털도어록,[무료설치] 삼성 디지털 도어락 SHP-DH520/카드키2개,178900,160110,-18790
2018-06-01,1864968519,A022010,주스,썬업100%/과일야채샐러드200ml 24팩,17400,17400,0
2018-06-01,1578953912,E031070,에어컨,신일 벽걸이선풍기 SIF-16WBC 가정용 사무실 선풍기,45500,43230,-2270
2018-06-01,490734705,E031090,공기청정기,[2018년 출시] 위닉스 공기청정기 타워Q ATQE400-HWK,246390,224580,-21810
2018-06-01,119203658,I031040,생화,무릎보호대 등산무릎보호대 무릎아대,9900,8870,-1030
2018-06-01,872409914,C013010,점퍼,[DUCLY]듀클라이 후드티 맨투맨 후드집업 남여공용,27900,27900,0
2018-06-01,1437019027,A013090,전복,국내산 새꼬막 1.5kg (대) 새벽조업후 발송 산지직송,29960,29960,0
2018-06-01,1630467419,C013020,티셔츠,리얼리T #국산 #기본티 #흰티 #단체티#면티 #무지티,3400,3400,0
2018-06-01,362815758,I012060,저장장치,로지텍 G PRO /LogitechG PRO Gaming mouse/유선/병행,69900,67900,-2000
2018-06-01,395213587,C013060,등산복,[머렐] 남여 기능성 폴로티셔츠 (5217NL210~256)(강남점),21000,16960,-4040
2018-06-01,1861185993,E041050,냄비,네오플램 무균열 뚝배기 3종세트/내열 냄비/계란찜기,46900,44900,-2000
2018-06-01,63901940,A022010,주스,킹아일랜드 코코넛워터 1000ml 12팩,31000,31000,0
2018-06-01,382117060,I031040,생화,캠텔 아이스박스 50리터/캐리어형/AS5000 50L/대용량,59900,55020,-4880
2018-06-01,618489340,A013070,굴,급냉 알가득 봄 알배기 암꽃게 1kg,30000,30000,0
2018-06-01,841627797,F012020,생리대,유한킴벌리 좋은느낌 울트라 일반형 소형 18매 1팩,3900,3900,0
2018-06-01,2006425983,C012040,여자학생복,(해외직배송) 와이드 브이넥 나팔소매 니트,35590,35590,0
2018-06-01,278024632,C012060,여자내의,[대구백화점 II관] [에꼴]하와 로즈 팬츠(P86WPB080ZGN),83400,65890,-17510
2018-06-01,509208777,C013020,티셔츠,어깨트임태슬티/오프숄더티/섹시티셔츠/셔링티셔츠,7900,7900,0
2018-06-01,958418254,A011060,땅콩,율무(봉/450G),9900,9900,0
2018-06-01,34529168,E031110,청소기,싹스 로봇청소기 진공 물걸레청소기,299000,299000,0
2018-06-01,1772002705,C012040,여자학생복,[베스티벨리]패턴 믹스 메탈 버튼 가디건 (BMCCC2967)_B4E6,58800,55860,-2940
2018-06-01,117641743,I031040,생화,[아웃팅]무료배송/특대형파라솔/2층파라솔/팔각파라솔,21900,21900,0
2018-06-01,473337033,C013040,청바지,[쉬즈미스]와이드크롭 데님팬츠(SSMSLI20010)(센텀시티점),89600,85120,-4480
2018-06-01,438636123,I053020,스케치북,색칠공부 그림일기 스티커놀이북 스티커놀이 색칠놀이,1600,1600,0
2018-06-01,1990883060,A022010,주스,맛과 영양을 담은 롯데 델몬트 망고 1.5리터 x12페트 빠른배송 정품정량 과즙음료 주스,50040,48040,-2000
2018-06-01,2091366968,E061020,섬유유연제,[다우니]초고농축 섬유유연제 1Lx3개,11900,11900,0
2018-06-01,795521162,A019130,스프,보노 스프 30박스 총 90봉(시금치크림+어니언크림+콘스프+포르치니버섯+포타주+머그컵,58900,58900,0
2018-06-01,396971256,A018100,꿀,잡화꿀 (오뚜기 1k),41760,37170,-4590
2018-06-01,1978622868,C012020,원피스,[드레스날다]퓨린 허리끈 더블 퍼프 원피스 코트(outer963),95800,86220,-9580
2018-06-01,477979656,A013090,전복,냉동 키조개 관자 관자살 1kg 1팩,30000,30000,0
2018-06-01,493528106,A011170,떡,떡국떡 1kg X 10개입 / 태광식품(HanGlobal),29200,25700,-3500
2018-06-01,1096198827,L021010,손목시계,BABY-G 베이비지 BA-112-2ADR 여성용 디지털 시계,184000,184000,0
2018-06-01,440915213,C012040,여자학생복,[블루종]쓰리 단추 포켓 롱가디건_[B1806CD035B],37000,29270,-7730
2018-06-01,488984097,I012060,저장장치,{단독특가}ABKO K8500 청축 게이밍 기계식키보드,29900,29900,0
2018-06-01,1096198829,L021010,손목시계,BABY-G 베이비지 BA-110TX-4A 여성용 디지털 시계,223000,223000,0
2018-06-01,1716310581,A015020,식용유,CJ제일제당 백설 포도씨유 900ml 오늘출발~,4550,4550,0
2018-06-01,1096198828,L021010,손목시계,BABY-G 베이비지 BA-112-4DR 여성용 디지털 시계,184000,184000,0
2018-06-01,380501364,A019110,드레싱,포모나 카라멜소스/포모나 초코소스,14000,14000,0
2018-06-01,1477181362,A012050,소시지,코리원/사조오양 불고기구이햄_1kg/슬라이스/불고기햄,6000,5900,-100
2018-06-01,1900726369,A018060,스낵과자,농심 새우깡 20봉/바나나킥/알새우칩/오징어집 외,16380,16380,0
2018-06-01,2019048714,A011030,찹쌀,민가네 2017년햅곡 국내산 쌀찰보리 10kg,28000,28000,0
2018-06-01,895746665,A018030,껌,[롯데]롯데 자일리톨 껌 (87g),4000,3290,-710
2018-06-01,2106956923,A012030,돼지고기,허브럽삼겹살/허브럽목살/칼집삼겹살/고추장삼겹살,5000,5000,0
2018-06-01,895746666,A018030,껌,[롯데]롯데 자일리톨 아이스민트(90g),4000,3290,-710
2018-06-01,1410017897,C013010,점퍼,스타일엔터 남자무스탕 G무스탕자켓 블랙 (사이즈 맞춤제작),982000,982000,0
2018-06-01,1603572544,A013120,낙지,꾸이시대 20봉 꽃보다오징어 주전부리 간식 안주,13900,13900,0
2018-06-01,686966859,A011090,국수,최저가 라면 x 6봉 까르보불닭 비빔면 진라면 신라면,2300,2300,0
2018-06-01,2138084404,I031040,생화,SWISSMILITARY 진공 보온보냉 수통/정품/등산/캠핑 필수 아이템,39500,34530,-4970
2018-06-01,509353366,C012060,여자내의,[바비앤펌킨]로제썸머 린넨 점프수트,63000,56700,-6300
2018-06-01,826980935,E011020,침대,[에이스침대] BMA 1139-E CA등급/DD(더블사이즈),920000,920000,0
2018-06-01,1256749376,C013010,점퍼,[올리브데올리브][18여름]하늘하늘 후드 점퍼(OW8MM560)[갤러리아],298000,238400,-59600
2018-06-01,1178662871,E061010,세탁세제,EM-1 발효원액 500ml-이엠 다목적 세정제,6000,4950,-1050
2018-06-01,1039387880,D031010,주택수선재료,3M 방수제 방수액 다용도 방수코팅제 방수스프레이 옥상방수 욕실 옥상 화장실 벽지 베,6300,6300,0
2018-06-01,318729576,C013010,점퍼,세젤예 블루종 항공점퍼 항공자켓 여성블루종 여성자,20580,18120,-2460
2018-06-01,1529528261,C013010,점퍼,남성 골지가디건 숄가디건 후드가디건 롱가디건 봄 긴,67500,67500,0
2018-06-01,1168479952,I011030,사진기,소니 A7III 바디 본체 + 상품권 3만원증정 정품 명품,2668270,2668270,0
2018-06-01,449359045,C012060,여자내의,[무료배송]모와비 트레이닝 팬츠 츄리닝 바지 특양면,17900,17900,0
2018-06-01,2087298081,F012020,생리대,[CLEARANCE SALE] 순수한면 생리대 3+3팩,9900,9900,0
2018-06-01,1488633515,A012010,국산쇠고기,[무항생제] 불고기샤브샤브 600g 2등급,29500,29500,0
2018-06-01,817324832,C013010,점퍼,STYLEENTER 여자무스탕자켓 핸드메이드 무스탕 천연무스탕자켓 여자무스탕 사이즈별맞,897000,897000,0
2018-06-01,2035161722,E031010,전기밥솥,쿠첸 판매1위 음성안내 6인용 압력밥솥 CJS-FA0605V,135000,126900,-8100
2018-06-01,441897387,A015020,식용유,영미고추맛기름 1.8L,22190,22190,0
2018-06-01,1516809656,I031040,생화,휴몬트/등산물병/(파우치증정)/물병/물통,5000,5000,0
2018-06-01,1775999689,L021010,손목시계,[CASIO]카시오 LTP-V005G-7B 여성용 메탈밴드 패션시계,39900,39900,0
2018-06-01,300597805,A013150,어묵,대림선 선종합어묵 1kg2개 어묵 종합어묵 대림선 대림,22120,19910,-2210
2018-06-01,2096352715,F012010,종이기저귀,킨도 프리미엄 슬림 기저귀 밴드형 3팩 (3/4/5단계),53700,53700,0
2018-06-01,453516655,C011030,남자학생복,빅사이즈 가디건 니트짚업 JA 주머니 블루종 큰사이즈,54450,54450,0
2018-06-01,504735822,C021020,구두,soyou162 3.0cm 여성슬링백,62200,58470,-3730
2018-06-01,1775999694,L021010,손목시계,[CASIO]카시오 LTP-V005D-1B 여성용 메탈밴드 패션시계,29900,29900,0
2018-06-01,1775999693,L021010,손목시계,[CASIO]카시오 LTP-V005D-4B 여성용 메탈밴드 패션시계,29900,29900,0
2018-06-01,1096198801,L021010,손목시계,BABY-G 베이비지 BGA-131-7B 여성용 디지털 시계,129000,129000,0
2018-06-01,1183675155,C012060,여자내의,피핀 머렛 히든밴딩 데님스커트 #5918/ 피핀,29800,23550,-6250
2018-06-01,1775999692,L021010,손목시계,[CASIO]카시오 LTP-V005D-2B 여성용 메탈밴드 패션시계,29900,29900,0
2018-06-01,1096198800,L021010,손목시계,BABY-G 베이비지 BGA-131-4B2DR 여성용 디지털 시계,129000,129000,0
2018-06-01,1775999691,L021010,손목시계,[CASIO]카시오 LTP-V005D-7B 여성용 메탈밴드 패션시계,29900,29900,0
2018-06-01,1096198803,L021010,손목시계,BABY-G 베이비지 BGA-131-2BDR 여성용 디지털 시계,129000,129000,0
2018-06-01,1775999690,L021010,손목시계,[CASIO]카시오 LTP-V005G-1B 여성용 메탈밴드 패션시계,39900,39900,0
2018-06-01,1096198802,L021010,손목시계,BABY-G 베이비지 BGA-130TR-7B 여성용 디지털 시계,151000,151000,0
2018-06-01,1096198805,L021010,손목시계,BABY-G 베이비지 BG-6902-4BDR 여성용 디지털 시계,125000,125000,0
2018-06-01,1096198804,L021010,손목시계,BABY-G 베이비지 BA-112-7A 여성용 디지털 시계,184000,184000,0
2018-06-01,988957807,A011080,밀가루,풀무원 생라면 매운맛 4입 (383.6G),3980,3980,0
2018-06-01,988957808,A011080,밀가루,[풀무원]풀무원 생라면 순한맛 4입 (387.6G),3980,3980,0
2018-06-01,301323733,A018100,꿀,뉴질랜드/프로폴리스추천1000/캡슐/비타민E/프로폴리스원액/플라보노/로얄제리/항산화,57000,57000,0
2018-06-01,610594844,C013040,청바지,정품 리바이스 아베크롬비 GIA 프리미엄 청바지 티셔츠 스키니진 카고바지 일자 데님,10000,9900,-100
2018-06-01,983481103,L012040,치약,[애경]2080 어드밴스 캐비티 치석 치약 120G*3,7900,7900,0
2018-06-01,859409006,E061040,부엌용세제,EM 활성액 20리터(L)/이엠 발효액/유용미생물,27450,27450,0
2018-06-01,1138073012,F011120,인삼,산삼나라 15년근 장뇌삼 5뿌리/선물세트/산양삼/홍삼,143800,143800,0
2018-06-01,895771626,A019100,식초,[오뚜기]오뚜기 하프 마요네즈 (315g),3090,3090,0
2018-06-01,990029422,E041070,밀폐용기,락앤락스피드쿡냄비편수16CM*2P,35600,35600,0
2018-06-01,1174599072,A022040,기능성음료,포카리스웨트 340mlx20/이온음료/스포츠음료/물/행사,12400,12400,0
2018-06-01,1119887107,C012020,원피스,니트 배색 코트 BACT87761/ 베네통,248960,199170,-49790
2018-06-01,619621619,L021020,장신구,스와로브스키 귀걸이 이어링 귀고리 은침 실버침 크리스탈 유색 비즈 여성악세사리선물,7200,6990,-210
2018-06-01,509353388,C011030,남자학생복,보풀방지 블랙 교복 가디건 남자 교복 교복쇼핑몰 교,37070,35960,-1110
2018-06-01,1775757551,L021010,손목시계,[CASIO]카시오 LTP-V005L-7B 여성용 가죽밴드 패션시계,29900,29900,0
2018-06-01,1775757552,L021010,손목시계,[CASIO]카시오 LTP-V005L-1B 여성용 가죽밴드 패션시계,29900,29900,0
2018-06-01,1178039659,A014010,우유,[매일우유] 매일 소화가 잘되는 멸균 우유 190ml 24개 락토프리,17500,17500,0
2018-06-01,1775757553,L021010,손목시계,[CASIO]카시오 LTP-V005GL-7B 여성용 가죽밴드 패션시계,29900,29900,0
2018-06-01,1775757554,L021010,손목시계,[CASIO]카시오 LTP-V005GL-1B 여성용 가죽밴드 패션시계,29900,29900,0
2018-06-01,1311502477,C012040,여자학생복,DWB1111 봉쥬 레터링 남방 801S 여성블라우스 여성셔,55970,55970,0
2018-06-01,2016503411,A016110,딸기,(냉동)국내산 딸기1kg,12730,12730,0
2018-06-01,1443162240,L012060,샴푸,로레알 에르네뜨 샤땡 헤어스프레이 500ml/체리/밍키,8400,8400,0
2018-06-01,299911129,E061010,세탁세제,유한젠 표백제 액체형 기획2세트/유한젠액체/멀티액션,19500,19500,0
2018-06-01,155926071,E061080,키친타월,깨끗한나라 키친타올 130매x2롤x8팩/ 130매x4롤x4팩,10200,10200,0
2018-06-01,176112863,E021010,침구,굿몽 국내산 60수 워싱 피그먼트 차렵이불 여름이불,49900,45820,-4080
2018-06-01,857951281,A016120,바나나,[산과들에] 바나나칩 500g,3900,3730,-170
2018-06-01,2104360151,C012030,여자상의,여성 빈스 단가라 니트 KK단가라 니트니트여자 니트여,61260,61260,0
2018-06-01,1075738954,C013010,점퍼,빅사이즈 패딩 점퍼 MC 1300 패딩 점퍼 패딩점퍼 빅사이즈 빅사이즈패딩,118170,105180,-12990
2018-06-01,1995263904,A015020,식용유,데체코 올리오 엑스트라버진 디 올리바 1L 올리브유,11600,11600,0
2018-06-01,378329065,C012020,원피스,[쥬크(ZOOC)]러블리 A라인 모직코트(Z174MSG517Z)(영등포점A),259000,210020,-48980
2018-06-01,1242767759,C012040,여자학생복,[무료배송]빅사이즈 DYP1152 더블 프릴 체크 블라우스,59480,59480,0
2018-06-01,1695802452,A021010,커피,네스카페 바리스타 골드블렌드 원두커피 사은품증정,29200,29200,0
2018-06-01,758956646,C011050,남자내의,[지오지아] ANDZ 프린트 면혼방 5부팬츠 BLV2PH1018NV/ 지오지아,10000,8000,-2000
2018-06-01,1086574292,E021010,침구,SESA 마르셀 웰인견워싱이불베개세트 SS,300000,300000,0
2018-06-01,1088807816,F011130,홍삼,[풍기인삼] 5년근 수삼 1채 500g (15-17뿌리),56000,56000,0
2018-06-01,744484,C013020,티셔츠,반폴라줄무늬반팔티/봄폴라티/반목티/단가라티..,7900,7900,0
2018-06-01,1981227178,C012060,여자내의,[구엘]Guell_ 린넨플레어스커트(G83-WSK012),39800,37810,-1990
2018-06-01,643672355,A019140,이유식,(10+1) 완료기 이유식 24종/ 팜투베이비,4090,3890,-200
2018-06-01,791244258,A017230,마늘,특가세일 양파3kg/ 5kg/10kg/9900원/품질엄선,9900,9900,0
2018-06-01,576816353,C011020,남자상의,남자 구김방지 슬랙스 정장바지/남성 체크 스판 바지,20800,19800,-1000
2018-06-01,1640559554,A013100,마른멸치,완도 꼬마전복 1kg 50-80미,22900,22900,0
2018-06-01,1860198814,C011030,남자학생복,슬림 카라포인트 비취패턴 블루 셔츠 남자남방 남성남,20190,20190,0
2018-06-01,735499572,E021010,침구,국내생산 면100% 솔리드 이불커버/매트커버/패드/베개,21900,21900,0
2018-06-01,2120420728,C012040,여자학생복,케네스레이디 라라 가디건 EKCDHL02,33920,33920,0
2018-06-01,1396620526,I031040,생화,캠핑 용품 다용도 캠핑해머 텐트망치 캠핑망치 캠핑공,27240,27240,0
2018-06-01,2028714578,C012060,여자내의,난닝구 메리브 실크속바지/ 난닝구,10000,9700,-300
2018-06-01,1545282777,E061010,세탁세제,1+1 써보고 세탁세제 10kgx2 가루세제/세제/드럼겸용,11900,11900,0
2018-06-01,602562160,E031120,믹서,테팔 BL-311E 블렌드포스 믹서기 (당일발송),47750,47750,0
2018-06-01,443773230,C013050,운동복,불스원 레인성에 OK 불스원 성애제거기 성에제거제 성,11010,10030,-980
2018-06-01,1977909094,F012010,종이기저귀,18년 군기저귀 팬티 대형 L여자44매x3팩,42900,42900,0
2018-06-01,1395608555,C013020,티셔츠,라일로 니트골지 반목티셔츠 STLD-6565/반폴라티 반폴,17000,16150,-850
2018-06-01,1249217042,C012040,여자학생복,[모다아울렛][나인스텝]N18NJ8209 (바람꽃로브가디건),39000,35490,-3510
2018-06-01,1692089218,C013050,운동복,스포티지 QL 2016-2018 콘솔트레이 중앙스토리지박스,5200,4790,-410
2018-06-01,677095992,C012060,여자내의,BYC여성 80데니아 무발 9부 레깅스타이즈(T9140) 타이즈 BYC 레깅스 팬티스타킹 스타킹,10130,9020,-1110
2018-06-01,464154111,C011020,남자상의,MT-215 여름-초가을 신사스트라이프 싱글수트 (M-2XL),179770,179770,0
2018-06-01,806641126,C013040,청바지,[컨셉원] 10117903 히든밴딩 TR 사방스판(4way) 슬림핏 슬랙스 117903,32000,26240,-5760
2018-06-01,1473180093,A018060,스낵과자,해태 홈런볼 146gx8봉/46gx15봉 대용량/과자/간식,12900,12900,0
2018-06-01,1404040743,I031040,생화,서빙트레이 무빙 웨곤 무빙카 운반카트,299300,272610,-26690
2018-06-01,1319050081,C015040,장갑,스마트터치 체크 등모 여성 장갑 모장갑 킹스맨 체크,28720,28720,0
2018-06-01,712661122,A017110,감자,수입 세척당근 10kg,17900,17900,0
2018-06-01,1345814032,C013020,티셔츠,(4926상)랩스타일 산전산후 수유가능한 면스판 임부상,17530,17530,0
2018-06-01,397898521,C012060,여자내의,SK1019-데일리 20대 30대 예쁜스커트 땡땡이 니트sk,18840,17900,-940
2018-06-01,1220598847,E061040,부엌용세제,주방세제/1kg리필 3개/1kg본품+리필1set/중 선택,5350,5350,0
2018-06-01,1162535713,A011050,콩,팜앤팜 국내산/수입산 생땅콩 볶음땅콩 800g~1kg,5500,5500,0
2018-06-01,217574382,E011040,소파,블레스 가구 루이스 2/3인 패브릭 수납쇼파 서랍소파,199000,197010,-1990
2018-06-01,468588173,I053010,공책,묶음상품 플라스틱링(19mm)백색 100개입x3개 제본스프,60480,60480,0
2018-06-01,824412184,A019060,된장,진미 춘장(300G),1300,1300,0
2018-06-01,142556128,E031070,에어컨,솔리스 타워팬/타워형선풍기 TYPE757/TYPE7581K,89000,89000,0
2018-06-01,1104363389,E011050,책상,[가구광장]미트책상 책꽂이포함 세트모음전/서랍통,87900,87900,0
2018-06-01,1037520209,A013030,조기,[새우몰] 민어조기 한두릅 7미,9900,9900,0
2018-06-01,2021905581,L012030,칫솔,조르단칫솔 8~12개+네임스티커)유아 아기 어린이 아동,11900,11900,0
2018-06-01,478883985,C013050,운동복,[만원이상무료]신상추가 트레이닝바지/반바지/세트42A,6900,6900,0
2018-06-01,1366922707,C011050,남자내의,탑텐 남여 면바지 슬랙스 MSX3PP1001외 14종/ 탑텐,9000,8100,-900
2018-06-01,855111731,E031130,보온매트,[한일] 자연愛매트 WH-자연애65 (183x65cm),68000,68000,0
2018-06-01,900331350,A018010,초콜릿,롯데 ABC초콜릿 (200G),2400,2400,0
2018-06-01,1121167657,F011130,홍삼,대상 홍삼을 품은 블루베리 50mlx60포 (2개월분),16900,16900,0
2018-06-01,1432970358,C012020,원피스,[바이레더] LF-513G 그레이 레오파드스킨 밍크 롱코트/ 바이레더,749000,749000,0
2018-06-01,890773892,C012020,원피스,[막스까르띠지오]레이스플라워 섬머트렌치,113000,91530,-21470
2018-06-01,86647737,A021010,커피,[당일출고]카누 라떼/더블샷라떼 50T+보온병 or 3T,17900,17900,0
2018-06-01,895891504,E061070,가정용비닐용품,[크린랩]크린랩(22cm*50m),4590,4590,0
2018-06-01,953984914,A013170,생선통조림,[동원]동원 마일드참치 210G,2990,2990,0
2018-06-01,535069315,F012030,안경,코지패드/안경코받침/선글라스 흘러내림/실리콘코패드,750,750,0
2018-06-01,2059555294,C014010,아동복,[30%쿠폰][델라누리] 여름신상 상하복&풍기인견 잠옷,8900,8900,0
2018-06-01,724407722,A017110,감자,하우스 햇 흙당근10kg 햇 당근,15900,15900,0
2018-06-01,306200409,C013020,티셔츠,[앨빈클로]후드티 맨투맨 양털집업 루즈핏 기모 남자,25000,14900,-10100
2018-06-01,1729187422,E061080,키친타월,해동지 미트페이퍼 200매/소분 천연펄프 무형광 참치,6900,6900,0
2018-06-01,1739894229,D031010,주택수선재료,[노루] 목재/철재용 유성페인트 슈퍼에나멜-4L 기본색,29200,29200,0
2018-06-01,389518591,C012040,여자학생복,빅사이즈 나시/끈/롱나시/망고나시,5900,5900,0
2018-06-01,456844729,C011030,남자학생복,130(4XL) 빅사이즈까지 완벽한 슬림핏 반팔와이셔츠,11900,11900,0
2018-06-01,1509641586,E041010,식기,보타닉가든 국공기1p/ 포트메리온,16500,15840,-660
2018-06-01,224448593,A021010,커피,아이수 페루산 카카오닙스500g,19800,17630,-2170
2018-06-01,1755795257,F011150,건강기능식품,얼라이브 멀티 비타민 미네랄 종합영양제 멘 우먼,23900,23900,0
2018-06-01,1556395117,A014030,치즈,코리원/본가드 아메리칸 슬라이스치즈 200매/햄버거,23900,23900,0
2018-06-01,700747541,C013010,점퍼,아디다스/트레이닝/자켓/저지/25종/슈퍼스타/후드티,38900,38900,0
2018-06-01,2128110167,I053030,복사용지,HP A4 복사용지(A4용지) 80g 2500매 1BOX/더블에이,19500,16970,-2530
2018-06-01,1022956990,E041050,냄비,s할인이벤트중s 효리네 IH 인덕션 냄비 후라이팬 세트,20000,20000,0
2018-06-01,1322810290,E051030,디지털도어록,AIG2(번호전용) 디지털도어락 번호키 백프로 도어락,54340,48910,-5430
2018-06-01,16313527,C011050,남자내의,아디다스 여성 우븐 슬릿 쇼트 ( BP9307 ),34130,34130,0
2018-06-01,1151189040,C015040,장갑,스포츠장갑/등산장갑 자전거장갑 낚시장갑/랜덤박스,5000,4510,-490
2018-06-01,661674833,A012060,햄및베이컨,롯데 런천미트 340g X 24개입/b / 롯데푸드 /(참고),88900,78240,-10660
2018-06-01,314264056,C013020,티셔츠,[PAT] 여성 배색 단가라 반팔 카라 티셔츠 1C45136,22000,19800,-2200
2018-06-01,389773668,C012040,여자학생복,라운드 배색 라인 반팔 니트 (S83KP03)/ 숲,22000,19800,-2200
2018-06-01,1254054451,E031080,선풍기,나노카본 터보 온풍기 FU-4033 - 온풍기 터보온풍기,597210,531520,-65690
2018-06-01,1010167887,A019180,즉석식품,초L)포차식직화데리야끼윙봉 200G,6780,6780,0
2018-06-01,1782884241,C012060,여자내의,[모다아울렛][지컷]지컷 니트스커트7217250011,119400,113430,-5970
2018-06-01,1277498050,C013010,점퍼,[JR주니어] 스타배색스키점퍼(핑크_민트),17900,16110,-1790
2018-06-01,348458418,C012040,여자학생복,수지네 구제 exr 블랙 패딩조끼 여성 M 18-28,13770,13770,0
2018-06-01,1728249702,I011020,영상음향기기,CnK 빔프로젝터 GM60 스마트미니빔 실수1탄,109000,109000,0
2018-06-01,392784122,A019040,소금,황기(한진 500g)X20 황기 황귀 식자재 업소용식자재,266200,239580,-26620
2018-06-01,198655701,A022010,주스,와일드 망고 씨드 분말 가루 아프리칸 씨앗 차 추출물,17900,17900,0
2018-06-01,1467487773,A017200,토마토,Roasted Eggplant 650g / 구운가지속 페이스트 Paste,5900,5900,0
2018-06-01,2117720584,C012060,여자내의,라비쥬 구제매니아 힙업 리프팅 거들 70 보정속옷 짱,12680,12680,0
2018-06-01,981603160,I031040,생화,SOS 긴급 구호세트 야외구호세트 캠핑공구 캠핑안전용,24540,22360,-2180
2018-06-01,445694830,C021010,아동화,[무료배송]쥬쥬 레몬 셔벗 운동화 아동운동화 어린이,44500,44500,0
2018-06-01,1673591191,C012030,여자상의,레이어드 롱원피스 레이스원피스 나시 미니원피스,9900,9900,0
2018-06-01,1400866996,E031140,비데,필터가 필요없는 대림도비도스 방수비데 DLB-712W,178000,178000,0
2018-06-01,1699033934,A021010,커피,카누240T/카누아이스블렌드/카누아이스라떼,34900,34900,0
2018-06-01,1494376531,C013010,점퍼,멋남 필수아이템 봄 레더자켓 13종 무료배송,60000,49900,-10100
2018-06-01,499752972,A017300,미역,소문난 삼부자-오부자 도시락김 5gX72봉-식탁김,17900,17900,0
2018-06-01,318428591,C014010,아동복,한국 체크 원피스 유아정장3종 세트(3-24개월)203456,57970,55660,-2310
2018-06-01,582199625,I011020,영상음향기기,캐시백포인트 비비텍 DU978 울트라 풀HD 빔프로젝터,2191000,1690000,-501000
2018-06-01,1906813150,F011150,건강기능식품,[세노비스] 남녀 멀티비타민미네랄 2개 세트,68400,68400,0
2018-06-01,1345926936,C021040,실내화,여자 키높이 운동화 스니커즈 패션운동화 커플 신발,24800,24800,0
2018-06-01,234655489,C011050,남자내의,C조이크루C 마바지/반바지/린넨/남자/면/여름바지,9900,9900,0
2018-06-01,984523758,A019120,혼합조미료,[CJ]CJ다시다 명품골드 해물(300G),6550,6550,0
2018-06-01,984523759,A019120,혼합조미료,[CJ]CJ다시다 명품골드(180G),5750,5750,0
2018-06-01,760222514,E031090,공기청정기,DS일렉 피톤치드 공기청정기 DS-715P / 불만족시 환불,59500,59500,0
2018-06-01,1920985590,A019070,양념소스,(참소당 아구찜양념2kg) 아귀찜 해물찜 꽃게찜양념,20700,20700,0
2018-06-01,1061597637,A017160,오이,참사랑친환경(주)/양송이버섯[특1kg][상2kg][꼬마2kg],12500,12500,0
2018-06-01,991692475,C013050,운동복,(55~110)빅사이즈/여름트레이닝바지/츄리닝/남녀공용,13900,13900,0
2018-06-01,441067985,C013050,운동복,소방차차량용소화기250,28980,26410,-2570
2018-06-01,862498690,A013160,맛살,화인 깐메추리알1kg 메추리알 간식 냉장식품 반찬류,15050,15050,0
2018-06-01,272261048,A011180,파스타면,파스타면/스파게티면/파스타소스/토마토소스/크림소스,4000,4000,0
2018-06-01,1817947383,G011070,자전거,[삼천리]2018 캄피오네14 알루미늄 시마노듀얼컨트롤,349000,349000,0
2018-06-01,1579599232,A018100,꿀,뉴트리나 마누카꿀 UMF5+ 500g 마누카꽃 수입꿀 벌꿀,103000,101970,-1030
2018-06-01,1949818637,I031040,생화,BLMg블루밍홈 캠핑의자 테이블세트 2인용 3인용 4인,21900,20150,-1750
2018-06-01,323020010,A016040,포도,동원 황도 슬라이스 400g x 12개 사시사철 맛있는 복,34150,34150,0
2018-06-01,900331318,A011120,두부,[농심]농심켈로그 오곡첵스초코 570G,7250,7250,0
2018-06-01,1241115283,C013020,티셔츠,역대급 첫30%쿠폰! 칼카니 공용 반팔티 반바지 48종,7900,7900,0
2018-06-01,745899707,A013040,고등어,초특가 A급 제주 간고등어 8마리 大사이즈,12900,12900,0
2018-06-01,1319764878,L021020,장신구,초커목걸이 체인초커 가죽초커 레이스초커 스웨이드초,12950,12950,0
2018-06-01,2134392616,A022010,주스,웅진)자연은 포도100 180ml12개입 과채음료 포도음료,15250,14950,-300
2018-06-01,1572465325,C013020,티셔츠,[와이드앵글] B&L콜라보 패턴 민소매 티셔츠-WWM17249,52000,52000,0
2018-06-01,534790679,C013010,점퍼,와팬롱홑겹야구점퍼 THB4JP701F/ 탑걸,39000,33150,-5850
2018-06-01,1009296565,E011030,거실장,[PookShuim] 푹쉼 루앙 패브릭 3인 소파베드,352000,352000,0
2018-06-01,1009296564,E011030,거실장,[PookShuim] 푹쉼 루앙 FPL가죽 3인 소파베드,352000,352000,0
2018-06-01,1009296566,E011030,거실장,[PookShuim] 푹쉼 루앙 패브릭 2인 소파베드,254000,254000,0
2018-06-01,1233016970,F012020,생리대,예지미인 울트라슬림 날개 중형 16개입 x 40,179040,159350,-19690
2018-06-01,1009296563,E011030,거실장,[PookShuim] 푹쉼 루앙 FPL가죽 2인 소파베드,254000,254000,0
2018-06-01,1511315188,E051030,디지털도어록,신제품 CDL-215S 카드키4+번호키 현관문 디지털도어락,69000,61900,-7100
2018-06-01,1242682352,C012040,여자학생복,[무료배송]DMS1236 탄 체크 포켓 남방 802S 여성이쁜,37210,37210,0
2018-06-01,1378066991,C013020,티셔츠,주말3000원쿠폰/정장조끼/쉬폰 민소매블라우스/롱나시,13800,10800,-3000
2018-06-01,29130576,C013050,운동복,프론트 리어 범퍼 가드 보호대 몰딩 화이트 차량범퍼,22500,20500,-2000
2018-06-01,1942442264,A017010,배추,(맛나)쌈배추(국내산)300g,8400,7560,-840
2018-06-01,2069262289,C013020,티셔츠,베이직 후드티 LTT0034 여성티셔츠 여성후드티(YA0200,32100,28250,-3850
2018-06-01,1114570232,C013020,티셔츠,원단굿/여름/후드집업/여성/후드점퍼/후드/간절기,19800,19800,0
2018-06-01,318379167,A019020,참깨,(수입) 참깨/검은깨(흑임자)/들깨,5400,5400,0
2018-06-01,282102992,I031040,생화,홀러 에스닉 감성 해먹/그물 야전침대 캠핑용품,38900,33950,-4950
2018-06-01,860043801,A014050,달걀,(맛나)닭가슴살2kg/우리,19200,17280,-1920
2018-06-01,431526290,E011040,소파,[에보니아](행사중) 피코 1인소파/칸나/샤인/싱글쇼파,99000,70020,-28980
2018-06-01,153213323,A012010,국산쇠고기,o한우로스 초특가o/꽃등심/모듬구이/부채살400g,22900,22900,0
2018-06-01,407223568,C013010,점퍼,스테판조셉 프린티드 레인코트 요트A (택1) 우비 레인,65290,62680,-2610
2018-06-01,599740866,A021010,커피,아이수 페루산 카카오닙스500g,14800,14360,-440
2018-06-01,1688315957,L021020,장신구,덤핑세일/1.6캐럿천연루비/피빛미얀마산/최상급칼라굳,199000,199000,0
2018-06-01,478710022,E021010,침구,20%쿠폰! 올리이바데코 사계절/간절기 침구 이불,19900,19900,0
2018-06-01,143690600,C013020,티셔츠,가족 커플 자녀선물 외국인 외국방문선물티 한글티,19900,15920,-3980
2018-06-01,450165433,C015040,장갑,아놀드파마_APGW_BY1219(여성가죽장갑) 장갑 가죽장갑,21010,18910,-2100
2018-06-01,1715771744,F012020,생리대,[쏘피] 귀애랑 생리대 슈퍼롱 20P×2팩+중형증정4P(총44P)/ 바디피트,17900,17900,0
2018-06-01,362274845,A016120,바나나,[6kg 대용량] 정품 Dole 바나나/부드럽고 달콤해요,19900,19500,-400
2018-06-01,1318964776,C015030,넥타이,남성 플라워 패턴 고급 슬림 스키니 지퍼 자동 넥타이,7200,6770,-430
2018-06-01,2028504913,C015020,모자,[대구백화점 II관] [미스트랄]베이직 서프 버킷 햇(M182HTU02),43500,36540,-6960
2018-06-01,613245850,E031110,청소기,18년5월 싹스 로봇 물걸레 청소기 ARW-C100 LG 비켜,317420,302420,-15000
2018-06-01,437855248,E011070,식탁,율키친H 1200아일랜드홈바 (수납형),119000,119000,0
2018-06-01,524845049,C012060,여자내의,A라인반바지 3부바지 여름바지 3부팬츠 사이드 지퍼장,19410,19410,0
2018-06-01,1668378880,C015040,장갑,봄가을 냉감소재 마스크  터치장갑  토시 모음전,7900,7900,0
2018-06-01,692032547,L021010,손목시계,보헤미안 시계/팔찌시계/악세사리/가죽시계/엔틱/여자,2900,2900,0
2018-06-01,1445519122,C012030,여자상의,[30%쿠폰]안녕미미 여름원피스 빅사이즈 린넨,9900,9900,0
2018-06-01,1236246574,C021040,실내화,[리복(Reebok)]MENS RUNNING 패스트 플렉스위브 (CN1602)(의정부점),79000,66670,-12330
2018-06-01,1084344932,E011040,소파,[동서가구] 헤라 천연가죽 3.5인 소파(스툴미포함) DS908050,614000,588450,-25550
2018-06-01,973239862,A013050,오징어,실속 런천미트햄(백설 340g)X20,86280,86280,0
2018-06-01,1462283439,C013040,청바지,[A+G]엣지 SUMMER18 에어로쿨 라이크라 데님 3종,78000,78000,0
2018-06-01,931318789,C013010,점퍼,[RUDDER] 브랜드 기모 맨투맨 후드티 후드집업 ~3XL,24800,24800,0
2018-06-01,200517948,A021020,차,매일유업 소프트 믹스 M5 엠오 아이스크림 액상,40000,40000,0
2018-06-01,1446500114,A011140,부침가루,삼립 케이크 미니다크 브라우니 25g,500,500,0
2018-06-01,1201141975,E021020,커튼,[쁘리엘르]북유럽풍 아일렛 암막커튼/햇빛차단/거실창,6900,6900,0
2018-06-01,416710886,C011020,남자상의,체크 밍크털 코트 캐쥬얼코트 캐주얼코트 남성털코트,99980,99980,0
2018-06-01,1372484633,A011010,쌀,[팸쿡][특가][한정수량]2017년 햅쌀 송탄농협 맛춤설계 황금미 특등급 고시히,62900,62900,0
2018-06-01,154435474,C011030,남자학생복,남성 와이셔츠 슬림남방/긴팔/7부/반팔/스판/체크,11800,11800,0
2018-06-01,1579431421,A014020,분유,분유(탈지 서울우유 1K)X10 우유 가루 분말 파우더,177970,177970,0
2018-06-01,1692501973,E031010,전기밥솥,쿠쿠 내솥 [H212] CRP-HUXF101SR 밥솥 교체용,55440,55440,0
2018-06-01,314205612,C012040,여자학생복,헤지스레이디스 HSSH8B035I1 면혼방 아우터형셔츠/ 헤지스 레이디스,137970,113140,-24830
2018-06-01,1953148650,C012040,여자학생복,[하늘바라기]AP 골지 폴라 니트슬림핏여자니트골지티니트티셔츠티셔츠니트,14800,14060,-740
2018-06-01,1349224112,E031020,가스레인지,/벽고정레인지후드 스테인리스 유리 060 마텔스카레/,297460,264740,-32720
2018-06-01,2147448406,A016150,아몬드,[길림양행] 허니버터아몬드+단팥맛아몬드+와사비맛아몬드/3봉,12900,12900,0
2018-06-01,497988302,E031030,전자레인지,대우전자 20L 전자렌지/레인지 KR-M202BMP/KR-L202COP,62100,59000,-3100
2018-06-01,47529897,C013050,운동복,타이어 공기압체크/공기압체크기/에어밸브캡/밸브캡/에어캡/타이어캡/게이지/에어게이,5800,4400,-1400
2018-06-01,1142301455,F011150,건강기능식품,[동화약품] 까스활 75ml 20병/소화제 음료/까스활명수/까스명수,16000,16000,0
2018-06-01,574096083,A017150,버섯,머리딴 두절 콩나물 4Kg,10660,10660,0
2018-06-01,1554801215,A012030,돼지고기,국내산 얼리지않은 돼지 목살 500g / 벌집 구이 수육,10500,10500,0
2018-06-01,413863016,A021010,커피,고다스길드와플 2종/고다스와플 토피넥와플 로투스,6800,6800,0
2018-06-01,797839888,E051020,건전지,티웨이 충전용건전지 충전건전지 니켈수소충전지,6500,6500,0
2018-06-01,862665261,E021010,침구,신상순면100%차렵이불/패드/배게커버/직접자체생산,52000,52000,0
2018-06-01,438260904,C012040,여자학생복,(예사랑)여성 인견 조끼 16YB14,59000,58410,-590
2018-06-01,1597143602,F011130,홍삼,정관장 홍삼담은 아로니아(50ML*30),58500,58500,0
2018-06-01,1096198797,L021010,손목시계,BABY-G 베이비지 BGA-180-4BDR 여성용 디지털 시계,175000,175000,0
2018-06-01,458787647,I031040,생화,감성캠핑 꺼지지 않는 캠핑향초 종이냄비 캠핑용품,1900,1750,-150
2018-06-01,1096198796,L021010,손목시계,BABY-G 베이비지 BGA-180-7B1 여성용 디지털 시계,175000,175000,0
2018-06-01,826246067,C013050,운동복,사계절 트레이닝복 세트/맨투맨/루즈핏/트랙,26800,18800,-8000
2018-06-01,1096198799,L021010,손목시계,BABY-G 베이비지 BGA-180-4B3DR 여성용 디지털 시계,175000,175000,0
2018-06-01,545724952,A013170,생선통조림,유동 뚝배기 번데기탕 280g x 24캔/얼큰한맛/구수한맛,36900,36900,0
2018-06-01,1019941065,C013020,티셔츠,시스루티/시스루블라우스/레이스티/망사티/쉬폰,7900,7900,0
2018-06-01,1413404791,A021020,차,빅트레인 쿨캡 모카페 글라쎄 파우더모음-할인판매,27600,27600,0
2018-06-01,1550465509,C011050,남자내의,여름신상/남자반바지/5부/7부/청반바지/남성/빅사이즈,12800,12800,0
2018-06-01,1140014252,F012020,생리대,(증정)체내형 생리대 뉴 템포 60p/화이트 탐폰 48p,17900,17900,0
2018-06-01,748550317,A013070,굴,(살아서 도착) 대게 3마리 박달대게/영덕대게/포항대,74000,74000,0
2018-06-01,2104384044,C011020,남자상의,코트 스튜디오 더블롱코트 R2롱코트코트남자롱코트남,149680,149680,0
2018-06-01,2062333571,C013020,티셔츠,엄마옷 마담4060 라운드핀탁라인티셔츠-XATE804003-,15900,14740,-1160
2018-06-01,1495723380,A011090,국수,라면 신라면 짜파게티 삼양라면 진라면 불닭볶음면,1780,1780,0
2018-06-01,716901143,A022010,주스,가야 알로에 500ml 20개알로에음료 알로에주스 알로에,33720,33720,0
2018-06-01,1608310358,C012030,여자상의,홀복 섹시원피스 홀터넥 미니원피스 클럽 파티 지패션,35800,35800,0
2018-06-01,2013770868,F011150,건강기능식품,까스활 75ml x 20병_소화제_부채표 동화약품 소화제,24140,24140,0
2018-06-01,646078976,E011050,책상,AM접이식좌식/원형테이블/원탁/좌식책상/접이식테이블,30000,29000,-1000
2018-06-01,1041928194,A018030,껌,다시마젤리 250g 맛다시마 완도다시마 다시마,9900,9900,0
2018-06-01,931304125,A013040,고등어,앤쿡 어린이 순살 생선 스테이크,9900,9900,0
2018-06-01,117301110,E011030,거실장,[PookShuim] 푹쉼 델포이 PU가죽 2인용 소파,400000,400000,0
2018-06-01,1448619713,L021030,가방,[리뽀] 리뽀에코백 플룸 베이직 에코백 뉴트럴 (AZ036017),39000,32370,-6630
2018-06-01,211632631,C014020,유아복,여름/아동/아동옷/주니어/아동복/나시/여아반팔/옷,11200,11200,0
2018-06-01,473498979,E041070,밀폐용기,글라스락세트 강화유리 밀폐용기세트 이유식기 반찬통,23400,21530,-1870
2018-06-01,1244771793,C011030,남자학생복,[탑텐]탑텐)남성 코튼 포플린 셔츠_MSY1WC1903,9900,9900,0
2018-06-01,1192311444,A019080,고추장,견과류볶음고추장450Gx2EA 비벼먹고반찬으로바로먹는,9000,9000,0
2018-06-01,464982556,C013010,점퍼,MST랜더스 JK365 남성등산복 상의A21170 남성등산의류,60030,60030,0
2018-06-01,265533643,E021020,커튼,레이스 캐노피 모기장(화이트) 레이스 커텐캐노피 침,16610,16610,0
2018-06-01,558974524,E061100,습기제거제,[소다스쿨] 염화칼슘 대용량3kg 2개+부직포8장,7900,7510,-390
2018-06-01,117301108,E011030,거실장,[PookShuim] 푹쉼 에이번 PU가죽 2인용 소파 (오리털 내장),340000,340000,0
2018-06-01,628099289,E031010,전기밥솥,CRP-DHXB0610FS/쿠쿠/IH압력/6인용/음성/GH,305400,270110,-35290
2018-06-01,988003470,L012070,바디워시,[LG]LG) 더내추럴 코코넛 바디워시 900G,7490,4990,-2500
2018-06-01,1526125856,C013020,티셔츠,[레티노] 디즈니 반팔티/ 박스티/롱티/원피스,13900,13900,0
2018-06-01,117301107,E011030,거실장,[PookShuim] 푹쉼 에이번 PU가죽 3인용 소파 (오리털 내장),480000,480000,0
2018-06-01,117301101,E011030,거실장,[끄망메블루] 스텔라 1800 거실장,610000,610000,0
2018-06-01,1121637641,E031120,믹서,[SK매직] 다용도 미니믹서기 MCH-B402 (절약형),23820,23820,0
2018-06-01,1372484605,A011010,쌀,[팸쿡][특가][한정수량]2017년 햅쌀 송탄농협 맛춤설계 황금미 특등급 고시히,32900,32900,0
2018-06-01,117301102,E011030,거실장,[끄망메블루] 스텔라 1600 거실장,610000,610000,0
2018-06-01,380238926,A019170,냉동식품,산동 찐만두 10개 / 매운 만두 / 전자렌지3분ok,10900,10900,0
2018-06-01,626098754,C013010,점퍼,(보니알렉스) 버튼 봄버 자켓(BCUZ181C),20900,20900,0
2018-06-01,1752732020,E011030,거실장,라니아 블랙글래스 1500미리 1단거실장,245000,245000,0
2018-06-01,1226249326,A022010,주스,Tipco 팁코 오렌지쥬스 200ml 24개 쥬스세트 주스 귤,39040,39040,0
2018-06-01,1752732022,E011030,거실장,라니아 블랙글래스 1500+600+600 1단거실장세트,465000,465000,0
2018-06-01,1752732021,E011030,거실장,라니아 블랙글래스 1500+600+600 2단거실장세트,499000,499000,0
2018-06-01,1752732024,E011030,거실장,벨크 블랙글래스 1500 2단 거실장,305000,305000,0
2018-06-01,695443380,C011050,남자내의,아디다스 여성 에센셜 리니어 타이츠 ( AY4824 ),51740,46050,-5690
2018-06-01,1752732023,E011030,거실장,벨크 블랙글래스 1500+600+600 2단 거실장세트,525000,525000,0
2018-06-01,958181811,E011070,식탁,베스트리빙 하이그로시 2인식탁세트/의자/식탁/원목,87000,78300,-8700
2018-06-01,1923853377,I012010,컴퓨터,[단독특가][벧엘]삼성 DM500S7A-A54A i5/4GB/1TB/윈10,892630,848000,-44630
2018-06-01,675221141,C013010,점퍼,블랙 베이직 경량 패딩 _AJT002_Black 점퍼 경량패딩 패딩 남자아우터 남자패딩,31930,28420,-3510
2018-06-01,643672411,A019140,이유식,(10+1) 아이반찬 성장식 16종(닭고기  야채제품)/ 팜투베이비,3600,3420,-180
2018-06-01,987317255,A011180,파스타면,[농심][정기배송]농심 얼큰한너구리 120G*5입,3790,3790,0
2018-06-01,1752732017,E011030,거실장,엘다원목 바니엘 거실장,480000,480000,0
2018-06-01,392870579,A019040,소금,치킨파우더(이금기 1K)X12 치킨 파우더 식자재 업소용,325580,293030,-32550
2018-06-01,1752732019,E011030,거실장,라니아 블랙글래스 1500미리 2단거실장,295000,295000,0
2018-06-01,2106569655,C013010,점퍼,(SIZE : L) MJ-164 옐로우 스티치 데님 자,53010,53010,0
2018-06-01,1305549548,C013010,점퍼,집업점퍼 분또 소매배색 블루종 R2 집업점퍼 블루종 점퍼 바람막이 트랙자켓,40880,36390,-4490
2018-06-01,1752732018,E011030,거실장,엘다원목 테트리 거실장,480000,480000,0
2018-06-01,1433201140,A012010,국산쇠고기,[무항생제] 국거리 600g 1등급,30400,30400,0
2018-06-01,1597057268,F011130,홍삼,정관장 홍삼천보(50ML*30),55000,55000,0
2018-06-01,568632602,E011010,장롱,[포레아] 7자 10자 슬라이딩/장롱/장농/슬라이드/이불장/붙박이장/옷장/하이그로시/흑,495000,490000,-5000
2018-06-01,582258359,F012020,생리대,예지미인 슈퍼롱 오버나이트 10개입 x 24,91330,81290,-10040
2018-06-01,1127423567,A021010,커피,그린커피빈다이어트/그린커피100%/클로로겐산/효능/커피생두/그린커피빈가루/그린커피,30900,30900,0
2018-06-01,534789616,C013020,티셔츠,헤지스남성 OUTS7BH13G2 컬러블록 면 반팔카라티셔츠,83400,65060,-18340
2018-06-01,392042138,C012040,여자학생복,[톰앤래빗] 모츠레이스니트 /니트/니트티/브이넥니트/레이스니트,14000,12600,-1400
2018-06-01,1091289574,A018090,잼,[복음자리] 2018 햇딸기잼380g+(증정)기프트박스+포도잼370g,9600,8640,-960
2018-06-01,960447912,A022050,탄산음료,코카콜라(185ML*6입캔),4090,2950,-1140
2018-06-01,2101612472,F011130,홍삼,김포파주인삼농협 홍삼정 파워스틱(10ML*30포),66000,66000,0
2018-06-01,2031877405,E011070,식탁,주방의 로망  도블러 아일랜드 폴딩 키친카트 조리대,169900,129900,-40000
2018-06-01,1752732025,E011030,거실장,벨크 블랙글래스 1500+600+600 1단 거실장세트,469000,469000,0
2018-06-01,1660478214,F012020,생리대,시크릿데이 생리대 러브오버10PX5팩,12900,12260,-640
2018-06-01,937792490,D031010,주택수선재료,아이생각 베란다 벽지용페인트 무광 1리터,5000,5000,0
2018-06-01,1865639124,E031120,믹서,정품/신일 대용량믹서기 모음/SMX-5800LM/국내생산,62000,56900,-5100
2018-06-01,1241729035,C011030,남자학생복,[무료배송](SR)KHM749-751 남성빅사이즈버튼카라긴팔,56860,56860,0
2018-06-01,1156794803,C012060,여자내의,[화이트폭스]귀여운무드스타일점프수트,31000,28210,-2790
2018-06-01,814949801,A018010,초콜릿,허쉬 리세스 피넛바 47gx18개/초코바/골든버그/츄엣,17500,17500,0
2018-06-01,1405388741,A017140,콩나물,도라지 250g (경북 영주 재배산) 도라지차재료 도라지,18220,18220,0
2018-06-01,1386660395,C013010,점퍼,빅사이즈 DDK00219 도톰 후리스 후드 집업 803 여성용,88580,88580,0
2018-06-01,959018048,D031010,주택수선재료,KCC 도로표지용 KSM6080-1종 4L 주차라인 차선도색,24000,24000,0
2018-06-01,608590185,A011010,쌀,밥맛좋은! 2017년 호남평야 반딧불쌀 20kg,43900,43900,0
2018-06-01,1935134295,C011030,남자학생복,[겐트] 카사린 케이블 반팔 R니트 GK7202C,15800,15180,-620
2018-06-01,1461604851,F012010,종이기저귀,메리즈기저귀 남여공용 단계별 밴드형/팬티형 1팩,17900,17900,0
2018-06-01,1096198742,L021010,손목시계,BABY-G 베이비지 BGA-230-3B 여성용 디지털 시계,184000,184000,0
2018-06-01,1096198741,L021010,손목시계,BABY-G 베이비지 BGA-230-7B 여성용 디지털 시계,184000,184000,0
2018-06-01,1096198743,L021010,손목시계,BABY-G 베이비지 BGA-230-4B 여성용 디지털 시계,184000,184000,0
2018-06-01,758968510,E061040,부엌용세제,피니시 리필 800g X 3개/파워볼 탭스/식기세척기 전용,18700,18700,0
2018-06-01,2146450377,F012020,생리대,예지미인 스키니라이너 롱46Px10개 생리대,21900,21900,0
2018-06-01,1170897820,C013010,점퍼,[메이룸]세무무스탕,21900,20810,-1090
2018-06-01,751061008,A011050,콩,18년햇 브라질너트/사차인치/타이거넛츠 분말 견과류,21000,19900,-1100
2018-06-01,1170897823,C013010,점퍼,[메이룸]와펜무스탕,21900,20810,-1090
2018-06-01,1357278258,E021020,커튼,낙엽문발 파리문발 목각발 비즈발 크리스탈문발,11900,11900,0
2018-06-01,1752732050,E011030,거실장,벨크 화이트글래스 1500 2단 거실장,305000,305000,0
2018-06-01,1752732052,E011030,거실장,벨크 화이트글래스 1500+600+600 1단 거실장세트,469000,469000,0
2018-06-01,1752732055,E011030,거실장,동글이 올리 장식장 1200,215000,215000,0
2018-06-01,1752732054,E011030,거실장,벨크 화이트글래스 1500 1단 거실장,245000,245000,0
2018-06-01,1441304679,E061060,살충제,1+1 바퀴벌레약 맥스포스 셀렉트겔,22400,15010,-7390
2018-06-01,981749412,C013050,운동복,(삼정)성에제거기 특대 솔형 9034 고급성에제거기 성,8810,8810,0
2018-06-01,1267617448,C013040,청바지,[쿠기(KOOGI)]하이웨스트와이드팬츠_KL1PT181A,29800,27160,-2640
2018-06-01,1556945805,A021010,커피,1kg 대용량 원두커피/3kg 무료배송/원두/,11000,11000,0
2018-06-01,393919030,C013040,청바지,생지느낌 그대로 팬츠 SXL 진청 DP278 남자바지 남성,24730,24730,0
2018-06-01,1096198740,L021010,손목시계,BABY-G 베이비지 BGA-230-7B2 여성용 디지털 시계,184000,184000,0
2018-06-01,2088973327,A016120,바나나,[Dole본사직영]Dole 바나나 3.9kg 3송이,10900,10900,0
2018-06-01,154374014,A017180,호박,고추(통 오포원 삐끼누 1K)X8 식자재 업소용식자재 대,116260,111610,-4650
2018-06-01,1142445144,C013020,티셔츠,여름 브이넥티셔츠 기본 무지티셔츠 슬라브 레터링,9900,9800,-100
2018-06-01,1096198735,L021010,손목시계,BABY-G 베이비지 BGA-240L-2A2D 여성용 디지털 시계,164000,164000,0
2018-06-01,1096198734,L021010,손목시계,BABY-G 베이비지 BGD-100-1BDR 여성용 디지털 시계,126000,126000,0
2018-06-01,1096198737,L021010,손목시계,BABY-G 베이비지 BGA-240L-1A 여성용 디지털 시계,164000,164000,0
2018-06-01,1383671457,E021010,침구,굿몽 국내산 순면 이불 먼지없는 간절기 차렵이불,16000,14630,-1370
2018-06-01,1096198736,L021010,손목시계,BABY-G 베이비지 BGA-240L-2A1D 여성용 디지털 시계,164000,164000,0
2018-06-01,1752732048,E011030,거실장,벨크 블랙글래스 1500 1단 거실장,245000,245000,0
2018-06-01,1096198739,L021010,손목시계,BABY-G 베이비지 BGA-240-7A 여성용 디지털 시계,145000,145000,0
2018-06-01,1096198738,L021010,손목시계,BABY-G 베이비지 BGA-240-1A1D 여성용 디지털 시계,145000,145000,0
2018-06-01,1752732049,E011030,거실장,벨크 화이트글래스 1500+600+600 2단 거실장세트,525000,525000,0
2018-06-01,1043847149,L012060,샴푸,올뉴 TS 샴푸 / 티에스 샴푸 500g,16900,16900,0
2018-06-01,901565342,D031010,주택수선재료,3M윈도우필름 데코 WDG01 Gradation 1220mm X 1m,39220,39220,0
2018-06-01,1847507649,L021010,손목시계,스포츠전자손목시계군용군인군대방수알람시계N19,13000,13000,0
2018-06-01,1843218797,L012110,색조화장품,30%+5%중복쿠폰! 아넷사/센카/스포츠커버 선크림BEST,25900,25900,0
2018-06-01,289765231,L012090,기초화장품,100% 순면 엠보싱 화장솜x210매,4000,3960,-40
2018-06-01,2079462087,E021010,침구,60수 사틴 호텔이불커버S/Q/K/LK 싱글 퀸 킹 라지킹,49900,49400,-500
2018-06-01,2115631004,I012010,컴퓨터,서울당일배송) LG컴퓨터 Z70EV-AR7P16 (윈10) MA,576280,576280,0
2018-06-01,601624423,C013040,청바지,[젤리스푼]멋나는배기데님팬츠,15900,14310,-1590
2018-06-01,37062238,I012010,컴퓨터,삼성컴퓨터 v600 i5 본체 업무용사무용PC(SSD128추가),179900,179900,0
2018-06-01,1011154925,F012020,생리대,데이위드울트라슬림롱라이너20P,5500,4120,-1380
2018-06-01,1011154924,F012020,생리대,데이위드울트라슬림중형16P,7800,5850,-1950
2018-06-01,1011154923,F012020,생리대,데이위드울트라슬림대형14P,7800,5850,-1950
2018-06-01,1881107433,C012040,여자학생복,[나인스텝]주문폭주(18 S/S) 배색컬러줄남방 A18SH8610[갤러리아],29000,24940,-4060
2018-06-01,1408389652,C013040,청바지,[키키제제]남아 청바지/7.5부/면바지/스키니/반바지,10900,10900,0
2018-06-01,1124504199,A013010,갈치,제주어가 옥돔 1호(5 6마리 선물포장) 탐라의 진상품,183900,178390,-5510
2018-06-01,2117937634,C013020,티셔츠,반팔 L~3XL 큐티/루즈핏/빅사이즈/무료배송/프린트티,13900,12900,-1000
2018-06-01,441873333,A015020,식용유,에버코코 엑스트라버진 코코넛오일120ml 3개,26800,26800,0
2018-06-01,205610109,C013050,운동복,빅사이즈/여자트레이닝복세트/츄리닝세트/후드집업/통,11900,9800,-2100
2018-06-01,986213995,F011150,건강기능식품,[풍기][풍기인삼농협][황풍정] 6년근 홍삼정환골드 150g,49500,49500,0
2018-06-01,794113404,C012060,여자내의,여름 슬랙스 정장바지 밴딩 와이드 부츠컷 여자 여성,9900,9900,0
2018-06-01,1590128464,E011040,소파,[오플로어] 3인 4인 5인 가죽 패브릭 소파 22종시리즈,698000,698000,0
2018-06-01,114862482,I031040,생화,씨마스터/8400루멘/7발 /스쿠버 /방수랜턴/해루질/,100900,80900,-20000
2018-06-01,119986163,C013020,티셔츠,[앙투] 여름신상 맨투맨44~110빅사이즈 후드 반팔티,19800,19800,0
2018-06-01,404462163,C012060,여자내의,트임에이치스커트 MYD_1712 여성치마 니트치마 패션치,18820,18820,0
2018-06-01,1973440076,C013010,점퍼,[대구백화점 I관] [르피타]레이디 트렌치 점퍼(L182UJP403),59800,53230,-6570
2018-06-01,1324078340,E021020,커튼,루베스 콤비 블라인드 대형 1 플러스 1 암막커튼 블라,84850,82310,-2540
2018-06-01,988003446,L012070,바디워시,[LG]LG) 더내추럴 아몬드 바닐라 바디워시 900G,7490,4990,-2500
2018-06-01,232452178,I031010,장난감,스텝2 파란말,46500,41850,-4650
2018-06-01,517248147,E061050,청소용세제,정품유한락스1L/2L/알뜰락스/세척락스/살균/세정,9900,9900,0
2018-06-01,1128597534,A011090,국수,[당일출고/무료배송]삼양 까르보불닭볶음면 큰컵16개,17970,17970,0
2018-06-01,921792156,C013050,운동복,탑크린 사계절 워셔액 1.8L 12개 유리세정제 동결방지,19800,17590,-2210
2018-06-01,1752732079,E011030,거실장,동글이 에플 장식장 1200,245000,245000,0
2018-06-01,1600146095,A013120,낙지,정화 맥반석 오징어. ( S ) 30gx5.,21560,19190,-2370
2018-06-01,1398129900,A013090,전복,두레생협 생홍합살(300g 국산) 탕용생홍합살 홍합 생,25600,25600,0
2018-06-01,386398742,E021020,커튼,롤스크린 그림 암막_1482,54130,54130,0
2018-06-01,1115357391,C014010,아동복,네파키즈 피스타 트레이닝세트 KE35920,31200,31200,0
2018-06-01,994420028,A017040,양배추,시금치 4kg 1박스 두리반농산,23000,23000,0
2018-06-01,899377299,E061030,전구,[GE삼성]GE삼성) 직관 형광등 삼파장 36W,6990,6990,0
2018-06-01,981013253,L021030,가방,[국산/사계절용] 신사 비지니스 정장양말 7족/10족 [고급 손봉조][KJC/피에르가르뎅],25390,25390,0
2018-06-01,716504460,A013090,전복,국산 키조개관자 500g내외 조개,15000,15000,0
2018-06-01,1770819860,A011170,떡,진공포장 밀떡볶이 20kg 1kgx20개 대용량 떡볶이 떡,42000,42000,0
2018-06-01,1461230552,C013050,운동복,여아 상하복 모음/ 상하의세트모음/ 여아 트레이닝복,12800,12800,0
2018-06-01,1269280997,C012060,여자내의,[대구백화점 I관] [톰보이](기존가:159 000원)PB와이드데님팬츠(9106231232),47700,40550,-7150
2018-06-01,1124881691,E011050,책상,고정테이블/작업테이블/작업대/회의용테이블/테이블,114000,106000,-8000
2018-06-01,1974259635,E061100,습기제거제,올굿 물먹는 제습제 10개/습기제거제/방습제/염화칼슘,9900,9900,0
2018-06-01,1752732084,E011030,거실장,동글이 에플 1200 거실장,245000,245000,0
2018-06-01,467670539,C015040,장갑,(이중 소.중.대)다양한 무늬 이중 레이어드 손가락장,7660,7660,0
2018-06-01,1752732083,E011030,거실장,동글이 에플 1500 2단거실장,295000,295000,0
2018-06-01,1752732086,E011030,거실장,동글이 올리 1500+600+장식장세트,595000,595000,0
2018-06-01,1752732085,E011030,거실장,동글이 올리 1500+장식장세트,425000,425000,0
2018-06-01,1752732088,E011030,거실장,동글이 올리 1500 거실장,215000,215000,0
2018-06-01,2123015271,C012040,여자학생복,[제쉬나인][제쉬나인]꽃자수 펀칭레이스 가디건,36500,32850,-3650
2018-06-01,1752732087,E011030,거실장,동글이 올리 1500+600 거실장세트,315000,315000,0
2018-06-01,2100238056,A018050,비스킷,[특가][무료배송] 로투스 1Box300개(50x6개)/커피과자,15900,15900,0
2018-06-01,1566541104,C013010,점퍼,써스데이아일랜드 (T184MJP234) 4포켓 집업 데님 점퍼,239000,191200,-47800
2018-06-01,1752732080,E011030,거실장,동글이 에플 1500+600 1단거실장,385000,385000,0
2018-06-01,1752732082,E011030,거실장,동글이 에플 1500+600+600 2단거실장세트,519000,519000,0
2018-06-01,1199119462,C013010,점퍼,봄철 자켓 린넨 가디건 간지난다 바람불때 입기 좋은,39700,39700,0
2018-06-01,1752732081,E011030,거실장,동글이 에플 1500 1단거실장,275000,275000,0
2018-06-01,294023955,I031040,생화,무료배송_노스베어 아이스박스 캠핑 쿨러백 SZS10021,13900,12790,-1110
2018-06-01,415226040,C014010,아동복,신상 엘사원피스 엘사드레스 공주풍드레스 캐리옷,20000,20000,0
2018-06-01,410525631,A012010,국산쇠고기,(제주 신어가 9호 세트) 제주 옥돔(대) 4마리,96180,96180,0
2018-06-01,539002293,A018040,아이스크림,하겐다즈 아이스크림 스틱바 80ml X 8개/스틱바,33600,33600,0
2018-06-01,606684491,C013040,청바지,꼼마제이 아동 셀럽 5부 스키니 청바지,24000,23500,-500
2018-06-01,271156885,A015020,식용유,사조 해표 식용유 콩기름 1.8L 1800ml 옵션추가요금X,3450,3450,0
2018-06-01,627178038,E021020,커튼,린넨북유럽 암막커튼1+1 2장/방풍방한/거실창문커텐봉,16900,16900,0
2018-06-01,1972700040,C013040,청바지,캘빈클라인진 여성 보이프렌드핏 스판데님팬츠 J207254,259000,220150,-38850
2018-06-01,267356817,A011100,라면,고구마전분 네모난당면300g 2입 당면 식자재당면 네모,25790,25280,-510
2018-06-01,209412466,A012060,햄및베이컨,롯데햄 런천미트 200g x 1캔/스팸/햄/롯데런천미트,1390,1390,0
2018-06-01,1790122106,E011050,책상,EL 코너L형책상외 시리즈/책상/컴퓨터책상/학생용/공,85800,85800,0
2018-06-01,1686625738,A016090,참외,[오늘만 이가격!]달콤한 성주참외 5kg,7500,7500,0
2018-06-01,1298960309,I031040,생화,에버라스트 레그 킥 패드,222800,218350,-4450
2018-06-01,954822039,A018070,파이,[롯데]롯데 몽쉘 카카오크림 384G,4900,3490,-1410
2018-06-01,1096198774,L021010,손목시계,BABY-G 베이비지 BGA-180-7B2 여성용 디지털 시계,175000,175000,0
2018-06-01,954822037,A018010,초콜릿,롯데 칙촉 180G,3870,3870,0
2018-06-01,954822038,A018070,파이,롯데 몽쉘크림 384G,4900,2490,-2410
2018-06-01,1139336199,C012020,원피스,체크대형숄 겨울체크 목도리 남여성목도리 겨울목도,28380,25550,-2830
2018-06-01,793531477,A019070,양념소스,[CJ]백설양념(소갈비/돼지불고기/돼지갈비/소불고기),1900,1900,0
2018-06-01,1896942838,E011050,책상,좌식책상시리즈4종/컴퓨터책상/공부방/학생책상/학원,43000,40900,-2100
2018-06-01,604204623,A013020,명태,뽈찜용 대구머리 3kg,38000,35900,-2100
2018-06-01,997594825,I012060,저장장치,맥스틸 TRON G100K LED/청축/게이밍/기계식/키보드,40300,37890,-2410
2018-06-01,525844116,A017280,김,[코스트코] NALLEYS 베이비 딜 피클1LX2,9060,9060,0
2018-06-01,601396498,A022030,생수,프리미엄샘물 몽베스트생수 330ml 20입/40입 미니생수,6400,6400,0
2018-06-01,386590288,C015020,모자,(컬러:사이즈 : 카키:FREE) ACC-CAP101 찡절,19630,19630,0
2018-06-01,1524690799,C013020,티셔츠,[체리온]여름신상 깔끔한 박시 박스맨투맨/후드티,9900,9900,0
2018-06-01,586717789,I053030,복사용지,하이플러스 A4 복사용지(A4용지) 75g 2BOX/더블에이,34830,34830,0
2018-06-01,673083908,A013040,고등어,[여수고기 생선]특A 노르웨이 녹차 고등어 3kg/5kg,32900,32900,0
2018-06-01,1096198771,L021010,손목시계,BABY-G 베이비지 BGA-190-4BDR 여성용 디지털 시계,175000,175000,0
2018-06-01,1096198770,L021010,손목시계,BABY-G 베이비지 BGA-195-8A 여성용 디지털 시계,184000,184000,0
2018-06-01,888433971,A017160,오이,1kg 표고버섯 슬라이스/건표고원형/목이버섯/은이버섯,17000,17000,0
2018-06-01,1096198773,L021010,손목시계,BABY-G 베이비지 BGA-190-3BDR 여성용 디지털 시계,175000,175000,0
2018-06-01,1096198772,L021010,손목시계,BABY-G 베이비지 BGA-190-9BDR 여성용 디지털 시계,175000,175000,0
2018-06-01,1096198766,L021010,손목시계,BABY-G 베이비지 BGA-230-1B 여성용 디지털 시계,184000,184000,0
2018-06-01,1096198765,L021010,손목시계,BABY-G 베이비지 BGA-220-7A 여성용 디지털 시계,212000,212000,0
2018-06-01,2070121574,C013020,티셔츠,심플 후드집업 LTT0042 여성후드집업 트레이닝복 / 참,35100,29840,-5260
2018-06-01,1096198768,L021010,손목시계,BABY-G 베이비지 BGA-210-7B3 여성용 디지털 시계,188000,188000,0
2018-06-01,916416996,F012020,생리대,위스퍼 보송보송케어 울트라 날개 중형 30P,5200,5200,0
2018-06-01,1096198767,L021010,손목시계,BABY-G 베이비지 BGA-210-7B2D 여성용 디지털 시계,188000,188000,0
2018-06-01,1096198769,L021010,손목시계,BABY-G 베이비지 BGA-210-1B 여성용 디지털 시계,188000,188000,0
2018-06-01,1000978540,A017100,당근,(면)(냉동)청학열무1kg,2970,2970,0
2018-06-01,984315033,A012040,닭고기,올품 닭 다리살 불고기 500G,7990,7990,0
2018-06-01,638367501,E061010,세탁세제,브라이트 10kg x 2 / 세탁 가루세제 수퍼타이 비트,17500,17500,0
2018-06-01,166911682,C012040,여자학생복,모슬린 S/S신상 가디건/조끼 특가전 무료배송,29900,29900,0
2018-06-01,345624183,F012030,안경,패션안경 5900/안경테/뿔테/안경/여자안경/명품안경테,5900,4900,-1000
2018-06-01,1895973551,C012030,여자상의,nn66 스트랩 베이직 린넨원피스 - 네이비 여성원피스,36060,32100,-3960
2018-06-01,744730209,C013010,점퍼,[리스트]트렌치형 셔츠카라디자인 롤업소매 집업점퍼,19800,17820,-1980
2018-06-01,616088266,E031010,전기밥솥,쿠첸 IH 10인용 전기압력밥솥 CJH-PC1000ICT,316000,293000,-23000
2018-06-01,994324285,C011030,남자학생복,남자 여름썸머셔츠/린넨셔츠/스트라이프남방/캐주얼,19000,19000,0
2018-06-01,217540977,E031050,냉장고,[삼성전자] 인증점 삼성 김치냉장고 김치 플러스 RQ47M9251M2,3188900,3188900,0
2018-06-01,283798175,A014050,달걀,제이미트 삼계탕 600g*3팩/1000g*3팩 무료배송대박,13600,13400,-200
2018-06-01,1492374713,E011060,의자,학생의자/컴퓨터의자/사무용의자/책상의자/PC방의자,28900,28900,0
2018-06-01,2011202026,C021040,실내화,인비고 블랙/화이트,77800,77800,0
2018-06-01,1056987947,L021030,가방,노트북파우치 맥북에어 레티나 10 11.6 13.3 15.6인치,5600,5600,0
2018-06-01,1772453084,C013040,청바지,2018 봄여름용 4050 기본일자 사방스판 남자 청바지,26800,26800,0
2018-06-01,1778566433,L021010,손목시계,[바보사랑]JA-928 가죽시계,25200,25200,0
2018-06-01,1381667601,C011050,남자내의,[UGIZ] 유지아이지 여성 반바지(UBPA505),15000,12450,-2550
2018-06-01,1778566431,L021010,손목시계,[바보사랑]JA-925 가죽시계,27360,27360,0
2018-06-01,2064965190,A012050,소시지,(한시특가) 오뗄 모듬 소세지 420g x 2개/소시지/,9200,8900,-300
2018-06-01,1388449808,C013010,점퍼,AGC후드 집업점퍼 T절개배색오픈 CC집업점퍼후드점퍼,45990,45990,0
2018-06-01,1981447511,L021050,우산,슈퍼렉스 고급형 남자 여자 레인코트 비옷 우비 우의,21300,21300,0
2018-06-01,784700908,C014010,아동복,[M.K] 한국 아가일패턴 유아정장 5종세트(3-36개월) 203036,78760,70100,-8660
2018-06-01,1204825866,C011030,남자학생복,여름반팔남방/셔츠/체크/헨리넥/빅사이즈/남자/남성,14800,14800,0
2018-06-01,1422301890,A013010,갈치,제주어가 모듬세트 08호 갈치 대 4마리와 옥돔 1kg,164780,164780,0
2018-06-01,11083807,C013050,운동복,다해몰/★4기능★ 경광등 안전삼각대/경광봉 삼각대 후레시기능이 하나로/판촉/교통안,5500,5200,-300
2018-06-01,952361975,C013050,운동복,[티탁]세련된 스타일의 세트웨어/후드세트/트레이닝복,17900,13900,-4000
2018-06-01,976151164,C013020,티셔츠,[패션24시30%쿠폰]신상 오버핏 반팔 루즈핏 롱티셔츠,6900,6900,0
2018-06-01,873930825,C021040,실내화,나이키 운동화 런닝화 슬리퍼 에어맥스 코르테즈 모음,54600,54600,0
2018-06-01,1781809908,A019180,즉석식품,사색 꾼고구마 식단/식단관리 도시락/닭가슴살/견과류,22900,22900,0
2018-06-01,1570026256,C013040,청바지,스판 밴딩 워싱 5부 6부 7부 청 데님 팬츠 청바지,19900,19900,0
2018-06-01,579272920,C012060,여자내의,탑걸 스커트 TIZ4SK734F 샤 레이스 골드밴드 플리츠 스커트 New.,31200,25590,-5610
2018-06-01,1130813146,A018090,잼,초록원 딸기잼 1kg 부엌딸기잼 음식딸기잼 조리딸기잼,10400,10400,0
2018-06-01,437312550,C012060,여자내의,밑단수술 청롱스커트 SD-5907,23500,23500,0
2018-06-01,1242621622,C013010,점퍼,[무료배송]포인트패치집업점퍼 ZYD_1802 잠바 상의집,29810,29810,0
2018-06-01,1369501330,C013040,청바지,[행텐] 여성여름면스판스키니 팬츠10070-150-401-51 NC아울렛,19800,9000,-10800
2018-06-01,1215801586,C012020,원피스,여성정장 투피스 자켓 치마 바지 유니폼 오피스3,88000,88000,0
2018-06-01,1180241664,A017300,미역,삼각김밥김100매/무료배송/스티커/지퍼봉투,11400,11400,0
2018-06-01,1425187119,C012060,여자내의,여름 여성슬랙스/빅사이즈여성바지/여성정장바지,26800,26800,0
2018-06-01,1139640446,E061050,청소용세제,유한락스 2L x 6개/펑크린/욕실청소/살균/ 소독,22200,22200,0
2018-06-01,121102589,C021040,실내화,나이키 런닝화 운동화 티라이트11 올검 616544-007,56800,49990,-6810
2018-06-01,2018131552,E031110,청소기,(욜로닉스)로봇청소기/진공+물걸레/1년보증/자동충전,198000,189000,-9000
2018-06-01,1089821820,E031130,보온매트,세일피엠씨_안방마님 한화골드륨 온열특대매트 2난방,248000,248000,0
2018-06-01,2112081052,C012040,여자학생복,[일라일(ILAIL)][17F/W]심플라운드니트티(BWKT-17811-SC)[갤러리아],114000,108300,-5700
2018-06-01,1721487262,L021020,장신구,원석sale/천연시츄린/29.7캐럿/큼직/Sichyurin,130000,130000,0
2018-06-01,975673068,E031110,청소기,효리신상/한경희 스팀물걸레청소기AM-7500WG/패드4장,179150,177250,-1900
2018-06-01,490756648,F011150,건강기능식품,종근당 슈퍼비젼 멀티비타민 12개월 종합비타민,29800,29800,0
2018-06-01,455328168,I031040,생화,거위털 오리털 침낭 동계침낭 사계절침낭 100%국산,59500,56500,-3000
2018-06-01,810391673,E011050,책상,포밍테이블 작업테이블 작업대 사무 입식 좌식 회의용,30000,29000,-1000
2018-06-01,288280187,C012060,여자내의,[바비앤펌킨]여친룩 하이웨스트 스커트,82800,74520,-8280
2018-06-01,269883903,F012020,생리대,좋은느낌 생리대 날개 솜솜/순수/오버/소형/중형/대형,8900,8900,0
2018-06-01,2078030093,A018060,스낵과자,커널스 슈퍼믹스 크리미 24컵/팝콘/주전부리/프링글스,16500,16500,0
2018-06-01,741444843,C012040,여자학생복,[ab.f.z][17여름][가격인하] 여성스러운 칠부 숏 가디건(AFR3GY05F)[갤러리아],18000,14400,-3600
2018-06-01,1778591412,L021020,장신구,[바보사랑]SINUOUS PEARL BRACELET,79000,79000,0
2018-06-01,1778566456,L021010,손목시계,[바보사랑]JA-929 가죽시계,28800,28800,0
2018-06-01,895895379,A018070,파이,해태 오예스 336G,3840,3840,0
2018-06-01,148900418,E051030,디지털도어록,머큐리UG-325S/카드키/유리문도어락/인체감지/마스타,77000,67740,-9260
2018-06-01,1704957551,E041020,컵,폴란드 자크라디 수입 머그컵/커피잔/머그잔/컵/찻잔,11900,11900,0
2018-06-01,952131602,F011130,홍삼,[김포파주인삼농협/산지직송] 진액플러스 80ml*60,140600,140600,0
2018-06-01,1778566458,L021010,손목시계,[바보사랑]JA-949 가죽시계,25560,25560,0
2018-06-01,190274548,C012040,여자학생복,[H스타일]H스타일(BJ)빈티지Y가디건니트가디건카디건,36900,33210,-3690
2018-06-01,952131601,F011130,홍삼,[김포파주인삼농협/산지직송] 진액플러스 80ml*30,75300,75300,0
2018-06-01,348309355,C013050,운동복,이지 차량용 소화기 산소공급기 캠핑용 휴대용 비상,14000,12790,-1210
2018-06-01,2118914513,A011140,부침가루,카네이션 케이크만들기(1호),11000,11000,0
2018-06-01,1778591416,L021020,장신구,[바보사랑]언발 큐빅 이어링,10800,10800,0
2018-06-01,1778591414,L021020,장신구,[바보사랑]SINUOUS PEARL NECKLACE,99000,99000,0
2018-06-01,579737223,A011090,국수,[당일출고/무료배송]팔도 체다치즈 틈새라면20개 4+1,18900,18900,0
2018-06-01,1778591418,L021020,장신구,[바보사랑]먼델 큐빅 이어링,7200,7200,0
2018-06-01,1242535166,C012030,여자상의,[무료배송]러블리 카라 원피스 PS1048M801 빅사이즈,49220,49220,0
2018-06-01,1778566463,L021010,손목시계,[바보사랑]JA-966 가죽시계,36720,36720,0
2018-06-01,226043808,L012030,칫솔,국산 치과칫솔 10개 아동칫솔 어린이칫솔 유아칫솔,12700,12700,0
2018-06-01,1327305258,I031040,생화,차량LED 써치라이트 집어등 랜턴 서치 작업등 해루질,40000,35720,-4280
2018-06-01,1778566460,L021010,손목시계,[바보사랑]JA-963 가죽시계,26640,26640,0
2018-06-01,693822416,C011030,남자학생복,여름 7부 리넨 셔츠 남성 편안한 케쥬얼남방 40여종,16700,16700,0
2018-06-01,1778566465,L021010,손목시계,[바보사랑]JA-967 가죽시계,27720,27720,0
2018-06-01,465572630,D031010,주택수선재료,워터제로 페인트(4리터)-베란다 결로 곰팡이 방지,70000,70000,0
2018-06-01,445449452,F012010,종이기저귀,군기저귀 밴드형 대형 L(54p)x1팩/전사이즈선택,14560,14560,0
2018-06-01,1164848429,E011050,책상,[안드로메다책상]책상/컴퓨터책상/사무용책상/접이식테이블/좌식책상/학원책상/학생책,29800,29800,0
2018-06-01,2092985587,A022030,생수,제주특별자치도개발공사 제주 삼다수 2L*6병,7800,7800,0
2018-06-01,1120242095,E031130,보온매트,일월 뉴나노륨 온돌마루 소형(183×100),99000,99000,0
2018-06-01,1495383146,A017010,배추,적양배추즙/자색/양배추/진액/브로콜리/즙/진액/위/,24900,24900,0
2018-06-01,401614777,C012020,원피스,진주버튼포인트자켓 RLBWHJ010/ 리안뉴욕,170000,153000,-17000
2018-06-01,952131604,F011130,홍삼,[김포파주인삼농협/산지직송] 홍삼농축액 120g,85400,85400,0
2018-06-01,952131603,F011130,홍삼,[김포파주인삼농협/산지직송] 도라지홍삼 50ml*60,50200,50200,0
2018-06-01,952131605,F011130,홍삼,[김포파주인삼농협/산지직송] 홍삼농축액 240g,165600,165600,0
2018-06-01,549730184,C012040,여자학생복,MJ_1220 브라운 양털 조끼 남성털조끼 양털조끼 조끼,32330,32330,0
2018-06-01,722510963,C013020,티셔츠,T2038-여성 데일리 베르아 캉캉소매 티셔츠 프릴티셔,18840,17900,-940
2018-06-01,570127903,A017140,콩나물,배즙/파는 곳/맑은 배즙/도라지즙 도라지배즙/탄닌성,42900,42900,0
2018-06-01,336213654,C012040,여자학생복,[위쉬몰][위쉬몰]EB 아이스포켓가디건(2177H805),37800,32130,-5670
2018-06-01,63414379,E061050,청소용세제,향락스 2Lx 6개-12L/락스/세제/살균/표백/소독/레몬향,8600,8600,0
2018-06-01,539202741,E011060,의자,빅토르 피씨방 컴퓨터 책상 레이싱 체어 게이밍의자,100200,100200,0
2018-06-01,657275041,E031130,보온매트,물세탁 OK 한일 전기요 전기매트/전기장판/GP-1000,20000,19800,-200
2018-06-01,1166423508,E041030,솥,뉴하이클래드IH 하이브 4인용(18C)/ 풍년,88700,79830,-8870
2018-06-01,1763240965,A017020,상추,친환경유기농 모듬쌈채소/상추/깻잎/캠핑/캠핑음식,7900,7900,0
2018-06-01,2072014197,L012090,기초화장품,맨즈스킨 워터빌딩크림 점보 남자수분크림,39000,39000,0
2018-06-01,1847409482,A022010,주스,매실 망고 사과 알로에 오렌지 주스캔음료수도매 모음,6300,6300,0
2018-06-01,380082984,C013050,운동복,남자 여름 빅사이즈 트레이닝복/운동복/츄리닝세트,29900,29900,0
2018-06-01,1054872978,A011010,쌀,[17년 햅쌀]천년고도 경주삼광쌀20kg/당일도정!,49900,48500,-1400
2018-06-01,1356639992,L012030,칫솔,[빠른배송] [추가입고] 럭스360 유아칫솔 레인보우5P/ 비바텍,35900,26900,-9000
2018-06-01,1557709603,A012010,국산쇠고기,[순우리한우] 1등급 무항생제 등심 400g 외~ / 무료배송,26000,26000,0
2018-06-01,158313839,E011040,소파,[동서가구]LV 엘레스 천연가죽 소파 5종택일,763000,679000,-84000
2018-06-01,1958912436,L021050,우산,오늘 비예보! 짱짱한 브랜드 패션우산/장우산~3단우산,3800,3800,0
2018-06-01,1778566488,L021010,손목시계,[바보사랑]JA-975 가죽시계,30000,30000,0
2018-06-01,1778591420,L021010,손목시계,[바보사랑][공식  백화점AS가능]Dawn Klinga (가죽)_KLST101-CL010112,278000,278000,0
2018-06-01,197296490,C012060,여자내의,편안하고 시원한 고품질 냉감통바지 SD-5668,7760,7660,-100
2018-06-01,881681053,A019100,식초,[슈퍼잼][슈퍼너츠]3+1이벤트! 무첨가 100% 땅콩버터 땅콩잼 2종 택1,10500,10500,0
2018-06-01,928476689,I053040,기타문구,포스트잇 대용량팩 40~50% 테이프 플래그 654 노트,17900,17900,0
2018-06-01,356185608,C012060,여자내의,소프트블루데님 (J11PPT185)/ 매그제이(MAGJAY),39000,35100,-3900
2018-06-01,356185609,C012060,여자내의,데일리언발슬랙스 (J11NPT234)/ 매그제이(MAGJAY),67900,61110,-6790
2018-06-01,990085899,A011010,쌀,L'grow 고시히카리 3KG,14900,12900,-2000
2018-06-01,1775006928,F011130,홍삼,정관장 활기력(20ML*10입),27000,27000,0
2018-06-01,1778566490,L021010,손목시계,[바보사랑]JA-976 가죽시계,30240,30240,0
2018-06-01,1722805324,A017050,미나리,무농약 적양배추(적채) 3kg / (친환경농산물/친환경인증),18900,18900,0
2018-06-01,366972489,C011020,남자상의,여름 남성 정장바지 신사바지 스판바지 빅사이즈w027,19900,19900,0
2018-06-01,1730886945,C013020,티셔츠,[사라걸스]고퀄 후드티 맨투맨 반팔 티셔츠 후드집업,19900,19900,0
2018-06-01,1778591451,L021010,손목시계,[바보사랑][공식  백화점AS가능]Ivory Lansen Chrono (가죽)_LCST106-CL010212,418000,418000,0
2018-06-01,1778566495,L021010,손목시계,[바보사랑]JA-980 메탈시계,53280,53280,0
2018-06-01,1241729970,C011030,남자학생복,[무료배송](SR)KHM763-764 남성빅사이즈체크주머니긴,58170,58170,0
2018-06-01,1775124198,F011130,홍삼,정관장 홍삼정환(168G),51000,51000,0
2018-06-01,1778566493,L021010,손목시계,[바보사랑]JA-979 가죽시계,28800,28800,0
2018-06-01,1851419751,E061030,전구,LED T5/LED슬림형광등/LED조명/LED바/무드등/간접조명,3680,3320,-360
2018-06-01,2064040246,C012060,여자내의,SK1087-빅플라워 시스루 볼륨 스커트 플레어스커트 시,18400,18400,0
2018-06-01,846208818,C014010,아동복,[월튼키즈]여름세일/아동복 여름신상특가,7800,7800,0
2018-06-01,1448274154,A013090,전복,국내산 새꼬막 1.5kg (대) 새벽조업후 발송 산지,33420,33420,0
2018-06-01,859987837,C013050,운동복,광각 후사경 UNDER MIRROR 대형차량용언더미러 대형자,16000,14580,-1420
2018-06-01,1276294254,C013020,티셔츠,[레이디플러스](2XL-5XL)로더 티-1577,16900,15210,-1690
2018-06-01,1213188683,E021010,침구,[이블랑] 100%국내원단 순면 침구세트! 차렵이불세트!,49900,49900,0
2018-06-01,1420726732,A019140,이유식,[엘빈즈]클래식 이유식 아기반찬 골고루(랜덤) 8팩,24900,24900,0
2018-06-01,2130122120,A019060,된장,제일 아와세 미소된장(1KG),5980,5980,0
2018-06-01,449866252,C013050,운동복,미르웨이 후사경 RV카렌스 카니발 투싼 싼타페SUV YKM,30000,24380,-5620
2018-06-01,1693365908,E031010,전기밥솥,쿠쿠 내솥 [H042] CRP-AHS109FS 밥솥 교체용,66310,66310,0
2018-06-01,537006139,C013040,청바지,[앤디애플]배색포켓사선지데님반바지,12900,11610,-1290
2018-06-01,356185615,C012060,여자내의,세미루즈핏데님팬츠 (J11PPT181)/ 매그제이(MAGJAY),39000,35100,-3900
2018-06-01,953986864,A014030,치즈,[남양]남양 드빈치 체다 슬라이스 치즈(15매),4980,4980,0
2018-06-01,1030585619,A022010,주스,제3도매/델몬트드링크팩 96팩/오렌지.포도.망고.사과,23290,21900,-1390
2018-06-01,946632782,C013020,티셔츠,TOPTEN10탑텐(MSY2TS2032) 여성) [유니] 마린 그래픽 반팔티,19900,18310,-1590
2018-06-01,1089774989,F012050,의료측정기,옵티엄네오 케톤측정기+케톤시험지10매+채혈침10개+채혈기,52000,42640,-9360
2018-06-01,1778591445,L021010,손목시계,[바보사랑][공식  백화점AS가능]Snow Aska (가죽)_AKST102-SS010213,278000,278000,0
2018-06-01,1778591444,L021010,손목시계,[바보사랑][공식  백화점AS가능]Walter Falken (가죽)_FAST102-CL010213,288000,288000,0
2018-06-01,1778591443,L021010,손목시계,[바보사랑][공식  백화점AS가능]Rose Falken (가죽)_FAST101-CL010214,288000,288000,0
2018-06-01,1094372083,C014010,아동복,튜튜스커트세트/아동치마세트/아동원피스/샤샤스커트,9900,9900,0
2018-06-01,1778591442,L021010,손목시계,[바보사랑][공식  백화점AS가능]Dawn Klinga (가죽)_KLST101-CL010112,278000,278000,0
2018-06-01,1566266753,C013010,점퍼,[시보니] 스웨이드컬러무스탕,85700,85700,0
2018-06-01,442793937,C012040,여자학생복,[C#SHARP][CSHARP] 망사프릴 니트티(S82KNW001),37000,32890,-4110
2018-06-01,409872656,C013010,점퍼,버버리 남성 105 고트 염소 세무 가죽 자켓 블랙 정품,742000,734580,-7420
2018-06-01,1923530540,A012060,햄및베이컨,슈가데일 베이컨(미국산)/팜랜드베이컨/호멜베이컨,5400,5400,0
2018-06-01,414345395,F012010,종이기저귀,톨로 베이비 드라이버 장난감 완구 어린이 아동 유,31230,31230,0
2018-06-01,492499532,C013010,점퍼,[에이비에프지]홑겹 칠부 야상점퍼 AFS2U04,159000,151050,-7950
2018-06-01,1782639108,A018080,설탕,백설 스위트리 알룰로스350g 타가토스350g 설탕블렌드,3400,3400,0
2018-06-01,1778591448,L021010,손목시계,[바보사랑][공식  백화점AS가능]Gleam Klinga (가죽)_KLST104-CL010312,278000,278000,0
2018-06-01,320269549,I031010,장난감,스텝2 사파리웨곤 new 대형완구 어린이날선물 유아동,581570,581570,0
2018-06-01,1778591446,L021010,손목시계,[바보사랑][공식  백화점AS가능]Ivory Klinga (메탈)_KLST103-ME021313,278000,278000,0
2018-06-01,289423040,A017180,호박,가을 특 고추가루 2.5kg,46600,45210,-1390
2018-06-01,475438352,C012060,여자내의,린넨와이드팬츠 린넨슬랙스 여름 하이웨스트 부츠컷,28800,28800,0
2018-06-01,778997870,F012050,의료측정기,오므론 일제 자동혈압계 JPN601+수첩 혈압측정기,129500,118000,-11500
2018-06-01,1245273044,E061060,살충제,에스파워킬골드 450ml x 2개 뿌리는 바퀴벌레약 에어졸 살충제 바퀴벌레구제 대롱장착,9700,9600,-100
2018-06-01,1752850317,E011030,거실장,나무향기 와인장,213000,213000,0
2018-06-01,1778591474,L021010,손목시계,[바보사랑][공식  백화점AS가능]MOKY NEVIL-STEEL MESH (메탈)_NEST114-ME021212,418000,418000,0
2018-06-01,1752850316,E011030,거실장,나무향기 4단 서랍장,213000,213000,0
2018-06-01,1778591473,L021010,손목시계,[바보사랑][공식  백화점AS가능]Loch Lansen Chrono (가죽)_LCST115-CL010312,398000,398000,0
2018-06-01,1321458158,A021010,커피,네스프레소 정품 5종세트(50)/캡슐커피/7종 자유선택,38750,38750,0
2018-06-01,1752850318,E011030,거실장,나무향기 갤러리장,190000,190000,0
2018-06-01,1255136530,L012090,기초화장품,클린앤클리어 에센셜 모이스처라이저 125ml x 2개,8900,8900,0
2018-06-01,1778591477,L021010,손목시계,[바보사랑]JA-1034 가죽시계,28600,28600,0
2018-06-01,1296986382,C011030,남자학생복,FS-929 땡땡이포인트 청남방 남성남방 남자남방 남자,18670,18670,0
2018-06-01,1778591476,L021010,손목시계,[바보사랑]JA-1033 메탈시계,57200,57200,0
2018-06-01,1398257652,C011030,남자학생복,AG 빅사이즈 바투스 청남방 BW 데님셔츠 청남방 남성,72050,72050,0
2018-06-01,1778591475,L021010,손목시계,[바보사랑]JA-1023 가죽시계 메탈시계,35200,35200,0
2018-06-01,758641768,L021030,가방,씨엘로 노트북 파우치 가방 케이스 11인치~15.6인치,13900,13900,0
2018-06-01,107074074,L012040,치약,3+3+3/죽염 잇몸고/시린고/5DAYS 치약,14900,14900,0
2018-06-01,984565295,E031130,보온매트,#TV홈쇼핑정품# 황토 맥반석 뜸질 매트/전기매트/전기요/전기온열 뜸질기 찜질기/온열,59210,59210,0
2018-06-01,989077777,E061020,섬유유연제,[아토세이프] 유아용 액체세제 리필 1.3L 2개/섬유유연제 리필 1.3L 2개 택1,11900,11900,0
2018-06-01,989077776,E061020,섬유유연제,[아토세이프] 유아용 액체세제 2L 4개/섬유유연제 2L 4개 택1,21900,21900,0
2018-06-01,1752850313,E011030,거실장,아네트 2단 서랍 수납장,218000,218000,0
2018-06-01,2069029058,I031040,생화,역대급특가 침낭/사계절 팬텀침낭 트윈연결/캠핑용품,34000,29720,-4280
2018-06-01,1752850314,E011030,거실장,아네트 갤러리 거실장,288000,288000,0
2018-06-01,1740189903,G011070,자전거,삼천리 시애틀 하이브리드 로드 모음기획전 135cm부터,114000,102600,-11400
2018-06-01,989077784,E061020,섬유유연제,[아토세이프] 유아용 액체세제 리필 1.3L 3개/섬유유연제 리필 1.3L 3개 택1,16900,16900,0
2018-06-01,1778591479,L021020,장신구,[바보사랑][액세서리키친] 925실버 탄생석목걸이(스와로브스키 정품 론델),39900,39900,0
2018-06-01,579884685,C014010,아동복,긴팔 기본티셔츠/ 면이 짱짱한 스판티셔츠/ 흰색 기본티/ 화이트 티셔츠/ 베이직 긴팔,7900,7800,-100
2018-06-01,559167567,C011050,남자내의,[스타일맨][스타일맨] [CF1098]앤디 트레이닝 팬츠,20000,19000,-1000
2018-06-01,778109055,C014010,아동복,로로샤 원피스/여름/여아/주니어/롱티/비치/상하복,19800,19800,0
2018-06-01,982437239,E061090,방향제,FR접이식 2USB 2구소켓,9900,9900,0
2018-06-01,982437236,E061090,방향제,휴대용 멀티 무선 카팩,19990,19990,0
2018-06-01,1751031109,L021010,손목시계,[Ange odor]앙쥬오도르 여성용 메탈시계 탄생석 4월 BLOSSOM no.04,210000,210000,0
2018-06-01,647036805,C013040,청바지,여름/청바지/밴딩/일자/스판/면/빅사이즈/남자/남성,17800,17800,0
2018-06-01,2055743250,I012010,컴퓨터,삼성컴퓨터 SSD장착 최대 80%할인판매,179000,179000,0
2018-06-01,1294120673,C013030,스웨터,[업타운홀릭]걸치기편한 니트/가디건,24000,21600,-2400
2018-06-01,749840922,E021010,침구,겨울왕국 면기모 패드 - 뷰티선샤인 (064187) 캐릭터,62510,56940,-5570
2018-06-01,2055743259,C013010,점퍼,빅사이즈 야상 피쉬 오버코트 BW 바람막이 점퍼 남자,95400,95400,0
2018-06-01,1224597347,A022050,탄산음료,롯데 칠성사이다 1.25L x 12병/펩시콜라/코카콜라,12900,12900,0
2018-06-01,277996890,C013010,점퍼,[대구백화점 II관] [레코브]잔꽃 조각 점퍼(LU2185CD802X),59800,55020,-4780
2018-06-01,1814576555,I031040,생화,대한민국 재난용품 전문브랜드-지진대비용품 11종세트,19800,19800,0
2018-06-01,1009840381,E031120,믹서,조영 초고속블렌더 JYL-Y5 믹서기 블렌딩마스터,139000,126000,-13000
2018-06-01,1011120233,A018090,잼,청우 딸기시럽 520G,5580,4990,-590
2018-06-01,1011120232,A018090,잼,청우 쵸코렛시럽 520G,5580,4990,-590
2018-06-01,1236429373,C012030,여자상의,단배색플리츠원피스 MN1710 원피스 모던스타일 임부복,42200,42200,0
2018-06-01,1509010143,A017010,배추,(맛나)#알배기(국산)1통,7000,6300,-700
2018-06-01,1227450813,E011060,의자,메이트 인테리어 원목 식탁 빠텐 의자,27900,27900,0
2018-06-01,1312879110,I012010,컴퓨터,Apple 공인판매점 iMac Pro [MQ2Y2KH/A] 27형,5990000,5690500,-299500
2018-06-01,369888067,L012090,기초화장품,시세이도브라바스 브릴란틴 헤어크림/MG5포마드2개중1,18900,18900,0
2018-06-01,1434049490,C011030,남자학생복,밀란시아 캐쥬얼 집업조끼 10-045-1 남성캐쥬얼 캐쥬,39660,38480,-1180
2018-06-01,28133329,C014010,아동복,초등학생남아세트복 주니어BEST50 상하복 트레이닝복,13900,13900,0
2018-06-01,983561824,L012060,샴푸,[아모레퍼시픽]미장센 퍼펙트리페어 샴푸 680ML,13000,5990,-7010
2018-06-01,1362828655,A017050,미나리,양배추(2통/3kg),9800,9800,0
2018-06-01,341031722,A012050,소시지,(부대찌개재료) 부대햄 소시지 민찌 분쇄육 콩 살라미,2900,2900,0
2018-06-01,1130876784,C011020,남자상의,[아즈바이] 국산 컬러 보카시 남자 여름 콤비 자켓 2컬러 중년,79800,79800,0
2018-06-01,676305340,L021060,유모차,베네지아 디럭스 유모차 사륜유모차 슈퍼조거,620000,613800,-6200
2018-06-01,117293576,E011030,거실장,[PookShuim] 아레나 PU가죽 3인용 소파,460000,460000,0
2018-06-01,483419454,C012040,여자학생복,골드버튼니트 (J11PNT167)/ 매그제이(MAGJAY),42000,37800,-4200
2018-06-01,117293575,E011030,거실장,[PookShuim] 아레나 PU가죽 4인용 소파세트,680000,680000,0
2018-06-01,483419453,C012040,여자학생복,이지펀칭가디건 (J11PCD055)/ 매그제이(MAGJAY),43000,38700,-4300
2018-06-01,1778591480,L021020,장신구,[바보사랑][신비의 원석] 테라헤르츠 실버팔찌,39900,39900,0
2018-06-01,1273190107,E041020,컵,국산 킴스아트 머그컵/커피잔 찻잔 잔 라떼잔 에스프레소잔 카페라떼 컵 답례품 돌잔치,2900,2900,0
2018-06-01,1235103042,A013120,낙지,장수왕 마른파품오징어500g 반건파품10마리,18800,18800,0
2018-06-01,803374711,D031010,주택수선재료,[물에빠진벽지]풀바른조각벽지_실버슬라이스(14조각),23000,23000,0
2018-06-01,959436850,A012040,닭고기,하림 뼈없는 양념닭발,26980,6480,-20500
2018-06-01,1700587070,A015020,식용유,백설 포도씨유 900ml x2/ 3개 / 올리브유 카놀라유,12300,12300,0
2018-06-01,391983581,A019040,소금,유자폰즈소스(오타후쿠 1.8L) 유자폰즈소스 식당용유,38410,34570,-3840
2018-06-01,560861934,C013040,청바지,JMM8541 물안빠지는남자생지청반바지진청 청바지 남자,15230,15230,0
2018-06-01,2111875646,L012090,기초화장품,[세이어스] 언센티드 위치하젤 토너 355ml,10930,9550,-1380
2018-06-01,1821389791,E021010,침구,순면60수 도비워싱커버&바이오 멜란지워싱 커버 특가,29900,29900,0
2018-06-01,607206306,A016100,수박,충남논산 2018년꿀수박(정품5kg),14900,14900,0
2018-06-01,1861673545,A016070,귤,밀감캔(화남 850g)X12개/밀감통조림 밀감캔 밀감 과일,42600,40050,-2550
2018-06-01,1374952959,C012040,여자학생복,목만있는 간단 목폴라목토시남자 목폴라 목폴라남성,2380,2380,0
2018-06-01,366568206,E031020,가스레인지,GOR-B5B01S/SK매직 빌트인 가스오븐레인지+4구/동양,750000,750000,0
2018-06-01,913412723,A016030,복숭아,산초가루(솔표 40g)X100개/산초 산초가루 산초분말 산,226760,213160,-13600
2018-06-01,1897456862,A022040,기능성음료,포카리스웨트900mlX20펫/이프로/게토레이/이온음료,22900,22900,0
2018-06-01,867462334,L021030,가방,슬립 코르셋 복대겸용 팬티,52500,52500,0
2018-06-01,1356890042,C011020,남자상의,[빅브라더]빅사이즈정장 슈트/바지/코트/자켓,94380,94380,0
2018-06-01,989077748,E061020,섬유유연제,[아토세이프] 유아용 액체세제 2L 1개/섬유유연제 2L 1개 택1,11900,11900,0
2018-06-01,1212086792,F011150,건강기능식품,종근당 락토핏 생유산균19 프로바이오틱스 180포-무배,34900,34900,0
2018-06-01,831548907,C021040,실내화,여성 키높이 신발 하이탑 운동화 여자 스니커즈캔버스,28600,28600,0
2018-06-01,989077751,E061020,섬유유연제,[아토세이프] 유아용 액체세제 2L 3개/섬유유연제 2L 3개 택1,16900,16900,0
2018-06-01,989077750,E061020,섬유유연제,[아토세이프] 유아용 액체세제 2L 2개/섬유유연제 2L 2개 택1,11900,11900,0
2018-06-01,1407278403,F012010,종이기저귀,(공식) 18년 군기저귀 오리지널 팬티 L (44매)X3팩,43900,43900,0
2018-06-01,1779408153,L012090,기초화장품,(무료배송)이자녹스 턴오버 28 리치 클렌징크림 200ml,14500,14500,0
2018-06-01,1904078236,E031010,전기밥솥,단 3일 특가 쿠쿠 전기/압력/밥솥/6인용/10인용,132000,124080,-7920
2018-06-01,555730780,C013010,점퍼,빅사이즈 DDK00219 도톰 후리스 후드 집업 803 여성용,85740,85740,0
2018-06-01,1751031110,L021010,손목시계,[Ange odor]앙쥬오도르 여성용 메탈시계 탄생석 3월 BLOSSOM no.03,210000,210000,0
2018-06-01,1751031111,L021010,손목시계,[Ange odor]앙쥬오도르 여성용 메탈시계 탄생석 2월 BLOSSOM no.02,210000,210000,0
2018-06-01,1751031112,L021010,손목시계,[Ange odor]앙쥬오도르 여성용 메탈시계 탄생석 1월 BLOSSOM no.01,210000,210000,0
2018-06-01,989136616,A018060,스낵과자,오리온 오감자 양념치킨 50G,960,960,0
2018-06-01,1219811983,A011020,현미,가현 찹쌀 10kg 찰진찰 찹쌀 10kg,29900,29900,0
2018-06-01,1751031113,L021010,손목시계,[Ange odor]앙쥬 오도르 여성용 메탈시계 BLEND no.06,168000,168000,0
2018-06-01,1751031114,L021010,손목시계,[Ange odor]앙쥬 오도르 여성용 메탈시계 BLEND no.05,168000,168000,0
2018-06-01,718331364,A011010,쌀,2017년햅쌀/고시히카리/쌀10Kg/경기미/농협쌀,37900,37900,0
2018-06-01,1751031115,L021010,손목시계,[Ange odor]앙쥬 오도르 여성용 메탈시계 BLEND no.04,148000,148000,0
2018-06-01,1751031116,L021010,손목시계,[Ange odor]앙쥬 오도르 여성용 가죽시계 BLEND no.02,140000,140000,0
2018-06-01,1751031117,L021010,손목시계,[Ange odor]앙쥬 오도르 여성용 가죽시계 BLEND no.03,140000,140000,0
2018-06-01,1751031118,L021010,손목시계,[Ange odor]앙쥬 오도르 여성용 가죽시계 BLEND no.01,128000,128000,0
2018-06-01,1011119240,L021050,우산,[터닝메카드] 모기제로 스프레이 (천연 모기 기피제) - 5개,35000,16900,-18100
2018-06-01,1856169258,E011040,소파,제니 3인소파/피닉스/하모니/라텍스탑/라벤다/티파니,290000,191160,-98840
2018-06-01,886097678,C013020,티셔츠,[타미힐피거진][여성] 레이온 혼방 스트라이프 셔츠 TUMS1HCE06D0 3종택1,73500,58800,-14700
2018-06-01,1550223099,C013010,점퍼,[그랜피니]집업/양털/후드/긴바지/데일리/무료배송,39900,39900,0
2018-06-01,952877899,A017180,호박,간편 단호박/팩,3990,3990,0
2018-06-01,1297224837,C013010,점퍼,MTS-009 특양면 지퍼후드 후드집업자켓 남성집업후드,28680,28680,0
2018-06-01,1948502226,A022030,생수,동원 샘물 미네마인 2L*27펫,15400,13860,-1540
2018-06-01,831950467,A022050,탄산음료,[롯데] 칠성사이다 190ml x 30캔/펩시콜라,10200,10200,0
2018-06-01,1361754003,E021010,침구,부드러운 광목30수 이불커버/이불/침구/싱글/더블/퀸,20900,20900,0
2018-06-01,1103419912,C013010,점퍼,랜더스 남여공용 노르딕 헤비 패딩자켓 (JK850W ) 레,81140,72220,-8920
2018-06-01,1372000723,E021010,침구,굿몽 시어서커 여름이불 이불세트 이불패드 패드 토퍼,22800,22800,0
2018-06-01,200733147,A013070,굴,바다향 가득 통영 활멍게(소)2kg/깐멍게,2900,2900,0
2018-06-01,587263398,E011050,책상,책꽂이 책장겸용 컴퓨터책상/ 노트북테이블/ 수납선반,39510,39510,0
2018-06-01,1710764770,C011020,남자상의,MNC 봄 코트/트렌치/오버핏/싱글/자켓/맥코트/남자,42000,36800,-5200
2018-06-01,1897371339,L021020,장신구,C14K 정품 Gold 슬림큐빅스틱 반지 오하나 스타일 일,227950,227950,0
2018-06-01,476464440,C013010,점퍼,수퍼노바 스톰 자켓 남성자켓 스포츠자켓 운동복 남성,145450,145450,0
2018-06-01,1332101999,C014010,아동복,하라 HARA 여름신상입고 편하고 스타일나는 상하복,24900,24900,0
2018-06-01,982437298,E041080,부엌용용구,에비앙 전사캡 과도,2900,2900,0
2018-06-01,982437299,E041080,부엌용용구,에이스 식도(중),5900,5900,0
2018-06-01,1891247673,A021010,커피,타시모 캡슐커피 16캡슐/아메리카노/에스프레소/커피,9200,8900,-300
2018-06-01,7555692,E041070,밀폐용기,[홈쇼핑 정품][무료배송] 이젠 황토 진공항아리 사각특가전/밀폐용기/김치통/쌀통/매실,14000,11980,-2020
2018-06-01,1354955415,A012030,돼지고기,전통웰빙음식 국내산 볏짚삼겹살 2018년 행사합니다,5600,5600,0
2018-06-01,2005892277,C011020,남자상의,(무료배송) AG 웰론 하프 패딩 코트 MC 1900 빅사이즈,152770,134440,-18330
2018-06-01,375730138,C012030,여자상의,[요즘에]여름신상 특가 원피스/티셔츠/맨투맨/스커트,9900,9900,0
2018-06-01,1206926190,C013020,티셔츠,여성나시티/반팔/탑/와펜/후드/민소매/망사홀/비취,12000,11000,-1000
2018-06-01,702808843,A014010,우유,상하목장 유기농 멸균 우유 남양 유기농 파스퇴르 바,18900,18900,0
2018-06-01,335603652,I031010,장난감,킨즈무브2+쿨러백+컵홀더 킨즈웨건 유아웨건 쌍둥이유모차 디럭스웨건 킨즈/ 킨즈웨건,339000,326000,-13000
2018-06-01,37695939,E061040,부엌용세제,트리오 대용량 홍초 주방세제 3L x2개/베이킹소다,15900,9900,-6000
2018-06-01,617148654,E011050,책상,[누마]알파데스크/책상/컴퓨터책상/2인용책상/학생용,79000,74000,-5000
2018-06-01,1442415543,A017200,토마토,[우리가락]가지 5kg 한박스,44900,44900,0
2018-06-01,1882312396,I012060,저장장치,몬스타 데빌스킬 MK108 게이밍 레트로기계식키보드 DC,42900,42900,0
2018-06-01,85416406,C013020,티셔츠,여름신상 반팔카라티/빅사이즈/단체커플티/남자옷,13800,13800,0
2018-06-01,1777224888,C013050,운동복,그리니치 S~XXL프로에디션트레이닝팬츠 요가복js904_2,15800,15800,0
2018-06-01,180464132,C011050,남자내의,신상 면바지 밴딩 슬랙스 와이드 9부 8부 부츠컷,16900,16900,0
2018-06-01,1197210947,C012060,여자내의,[모노드레스]741 앞트임 롱 데님스커트,23000,23000,0
2018-06-01,896818925,A018080,설탕,백설 각설탕 (763g),4200,4200,0
2018-06-01,1340106958,C015040,장갑,방울장식 가죽장갑(여성) 가죽장갑 여성용장갑 여성가,25940,25940,0
2018-06-01,2115354478,A016020,배,자연농부 나주배 선물 세트 7.5kg 고급 배 과일 명절,52000,50440,-1560
2018-06-01,1171062949,E021010,침구,베개솜까지 한번에OK/봄신상품/이불 풀세트,47900,34870,-13030
2018-06-01,311005894,E011050,책상,자작나무 사이드테이블/ 식탁테이블/ 노트북책상,25650,25650,0
2018-06-01,1194058831,C012040,여자학생복,폴라티/목폴라/목티/목폴라티/여성폴라티/롱폴라티/티,6000,5900,-100
2018-06-01,1605570065,C012030,여자상의,[공구우먼]원피스/ 린넨/롱/쉬폰/플라워 빅사이즈,14000,14000,0
2018-06-01,1528776730,A011050,콩,햇 국산 볶음땅콩 800g 견과류 국산땅콩 땅콩 견과,12900,12900,0
2018-06-01,953984172,A013170,생선통조림,사조 꽁치 (400G),2850,2850,0
2018-06-01,1743076779,C012020,원피스,[나이스클랍]페이스 코트 (N174XSG001)(센텀시티점),129000,115120,-13880
2018-06-01,1800842232,F011130,홍삼,㉤ 천제명 홍삼석류30포,37600,37600,0
2018-06-01,1377709034,E031070,에어컨,메시앙 FND 리모컨형 타워팬 선풍기 3종 택1,99000,79000,-20000
2018-06-01,880537770,A011070,혼식곡,백설 밀가루 (제빵용)(2.5KG),4070,4070,0
2018-06-01,839948580,A018070,파이,오예스 336g x 4곽 초코파이/몽쉘/간식/과자,11900,11900,0
2018-06-01,129593027,C011050,남자내의,무료배송/남여쿨팬츠/냉동고바지/여름바지/아이스바지,4900,4900,0
2018-06-01,984964848,C011050,남자내의,[필골드] CHP02 기모디자인 클라이밍팬츠,29800,29800,0
2018-06-01,121790957,F011130,홍삼,[농협홍삼/한삼인] 착한홍삼골드 50ml*30포 (1500ml) X 4상자,281100,281100,0
2018-06-01,121790956,F011130,홍삼,[농협홍삼/한삼인] 착한홍삼골드 50ml*30포 (1500ml) X 5상자,351300,351300,0
2018-06-01,121790959,F011130,홍삼,[농협홍삼/한삼인] 착한홍삼골드 50ml*30포 (1500ml) X 2상자,140200,140200,0
2018-06-01,121790958,F011130,홍삼,[농협홍삼/한삼인] 착한홍삼골드 50ml*30포 (1500ml) X 3상자,210800,210800,0
2018-06-01,1266012821,C012040,여자학생복,[모니카룸] 사각니트/ 모니카룸,36100,27440,-8660
2018-06-01,1314155673,A012030,돼지고기,순빛살 구룡농장 No항생제 돼지 목살1kg(보쌈)-(fresh,67610,67610,0
2018-06-01,895799524,A011130,시리얼,[CJ]CJ 튀김가루 1KG,2850,1590,-1260
2018-06-01,1581210986,F012010,종이기저귀,메리즈 기저귀 일본내수용 밴드형4팩/팬티3팩,47900,47900,0
2018-06-01,1888820098,C021040,실내화,영에이지 여성 캐주얼YA7SHZ504WH,81180,81180,0
2018-06-01,1248438627,F012020,생리대,시크릿데이 생리대 NEW러브코튼 대형14PX6팩,19200,18240,-960
2018-06-01,1417410284,E021010,침구,국내생산 보들보들 워싱면 간절기 차렵이불/여름이불,48000,43980,-4020
2018-06-01,115236405,A011050,콩,[서래푸드] 햇 국내산 땅콩 생땅콩500g x 2개/,12900,12900,0
2018-06-01,895799520,A011130,시리얼,[CJ]CJ 치킨 튀김가루 (1kg),5800,5800,0
2018-06-01,147661663,C021040,실내화,나이키 에어 볼텍스 903896-001,68000,68000,0
2018-06-01,694979399,C011050,남자내의,비비드 테이프 라인 트랙팬츠,47000,32900,-14100
2018-06-01,858443181,C012020,원피스,[플라스틱아일랜드]심플 더플 코트(PH4WC166)(김해점),79000,64090,-14910
2018-06-01,1974729160,A022050,탄산음료,[코카콜라] 코카콜라 1.25L x 12병,13900,13900,0
2018-06-01,731587425,E031040,전기레인지,차량 휴대용 냉온장고 175x320x315 7.5L 휴대냉장고,72350,72350,0
2018-06-01,294050356,C012020,원피스,엄마옷 데드라 YY-SW171 오렌지비치팬츠,45800,41410,-4390
2018-06-01,335135871,C013010,점퍼,빅사이즈 DSM1044 빅 포인트 울 자켓 801 미시울자켓,93600,93600,0
2018-06-01,1352646144,C021040,실내화,나이키 우먼스 탄준 샌달 882694-001,44500,44500,0
2018-06-01,2036888593,C012040,여자학생복,핵이득! 미쏘외 이랜드 여성 썸머 BEST~94%할인,3900,3900,0
2018-06-01,990085904,A011010,쌀,L'grow 추청쌀 3KG,11900,9900,-2000
2018-06-01,324338875,C013020,티셔츠,[15%쿠폰][타미힐피거칠드런][본사정품] BEST 의류,21600,21600,0
2018-06-01,1924038707,G011070,자전거,엘레강스24+4종사은품 여성용자전거 7단 24인치,99000,99000,0
2018-06-01,420644410,C012020,원피스,[쉬즈미스][쉬즈미스] 솔리드 하프 팬츠_SWWSPI10010_BE,75600,64260,-11340
2018-06-01,1607738190,A016030,복숭아,산초가루(산초 금하 40g)X10개/산초 산초가루 산초분,18690,17570,-1120
2018-06-01,781304071,L012060,샴푸,시원테크 쿨그린 샴푸 브러쉬/두피마사지기/엔젤핑거,7500,7500,0
2018-06-01,1269530618,L021050,우산,태광산업 상하형 코트형 우의 상하우의 코트우의 비옷,15000,15000,0
2018-06-01,1877653646,I031040,생화,바낙스 선상 카고 낚시대 맥스 한려 선상 양어장,30500,25370,-5130
2018-06-01,880537798,A011070,혼식곡,백설 밀가루 (다목적용)(2.5KG),3500,3500,0
2018-06-01,1163656665,C013010,점퍼,AG 가죽자켓 라이더자켓 가죽점퍼 P173 남성용라이더,91920,91920,0
2018-06-01,1271190419,A012060,햄및베이컨,선진FS 베이컨 스트립 1kg x 5EA,136910,136910,0
2018-06-01,687848423,C012020,원피스,44~88/여성정장/정장세트/결혼/단체복/오피스룩/면접,50000,50000,0
2018-06-01,1010167014,F011150,건강기능식품,[내츄럴플러스] 와일드망고 씨앗 추출분말 (100g) - 1통,25000,10900,-14100
2018-06-01,982437304,E041080,부엌용용구,루미아 핸디 채칼,4900,4900,0
2018-06-01,982437302,E041080,부엌용용구,루미아 다목적 오프너,2100,2100,0
2018-06-01,89845168,F012020,생리대,무료배송 템포 레귤러 리뉴얼 10P X 3팩/ 템포,10900,10360,-540
2018-06-01,609872828,A011100,라면,오뚜기 알뜰국수(소면) 3kg,5700,5700,0
2018-06-01,2128278519,E011050,책상,야외용 원목 접이식 식탁 캠핑 우드 테이블 책상,13900,13600,-300
2018-06-01,900355349,A017300,미역,초이스L 두번구운 김밥김 (15매),2990,2990,0
2018-06-01,1841262182,E021010,침구,곰돌이3 아동 아사 60수 리플 여름 홑이불 베개 세트(,31340,28550,-2790
2018-06-01,1999021811,A011030,찹쌀,보리쌀 (7K),37140,33060,-4080
2018-06-01,121790964,F011130,홍삼,[농협홍삼/한삼인] 착한홍삼골드 50ml*30포 (1500ml),70100,70100,0
2018-06-01,1109819833,C014020,유아복,아둘 가족티 유아 커플룩 단가라 슬라브 티셔츠 11,9600,9500,-100
2018-06-01,895799519,A015010,참기름,백설 진한참기름(캔) 500ML,11200,4990,-6210
2018-06-01,391983513,A019040,소금,파슬리후레이크(신영 250g) 파슬리후레이크 식자재도,12320,11090,-1230
2018-06-01,431671768,C012040,여자학생복,신상/루즈핏/여름/롱티셔츠/롱원피스/66-120/쁘니걸,15900,12900,-3000
2018-06-01,600005742,I012010,컴퓨터,Apple iMac 21.5형 아이맥 (ME087KH/A) / SG,1749910,1749910,0
2018-06-01,465968606,C013050,운동복,IT 에보트레이닝 라이트 우븐 자켓(65461957) 남자자,105570,105570,0
2018-06-01,1963272004,G011070,자전거,무료배송 베리벨로 뉴욕7 하이브리드 자전거,94330,84900,-9430
2018-06-01,933898036,L021020,장신구,남자 new 커플 팔찌/원석 가죽 남성 패션 은 실버팔찌,49800,49800,0
2018-06-01,502894510,L021010,손목시계,듀얼타임 젠틀 손목 시계 패션아이템 학생손목시계 가,71950,71950,0
2018-06-01,1615270001,E061020,섬유유연제,크로디 섬유유연제 1+1,13500,13500,0
2018-06-01,1155579641,C013010,점퍼,브랜드특가 사파리자켓/스판자켓/골프자켓/경량자켓,42500,39000,-3500
2018-06-01,1060478682,C015020,모자,볼캡 야구모자 남자 여자 빅사이즈 단체 착시 무지,4000,3800,-200
2018-06-01,1803802404,C013010,점퍼,앙팡 래쉬가드 집엎 (네이비) 아동복 아동집업 집업,21590,21590,0
2018-06-01,1478620834,A021010,커피,담터/오뚜기/코코아/율무차1kgX12개 1박스/자판기용,42900,42900,0
2018-06-01,6487230,I031070,애완동물관리비,[무료배송]미니 탁구 당구 축구 하키 게임기,9300,9300,0
2018-06-01,121790991,F011130,홍삼,[농협홍삼/한삼인] 착한홍삼 50ml*30포 (1500ml) X 3상자,180700,180700,0
2018-06-01,121790990,F011130,홍삼,[농협홍삼/한삼인] 착한홍삼 50ml*30포 (1500ml) X 4상자,240900,240900,0
2018-06-01,1183579541,C013030,스웨터,남성 긴팔티 라운드티 9부티 박스티 무지티 기본티 면,19800,19800,0
2018-06-01,121790993,F011130,홍삼,[농협홍삼/한삼인] 착한홍삼 50ml*30포 (1500ml) X 2상자,120500,120500,0
2018-06-01,1419571999,A011140,부침가루,수제 케이크시트 2호,4500,4500,0
2018-06-01,1171228670,A017140,콩나물,100개 한정 땅두릅 2kg 17 500원 참두릅 산지직송,17500,17500,0
2018-06-01,266345884,A014030,치즈,코리원/OK 모짜렐라치즈 2.5kg/치즈/피자/피자치즈,18500,18500,0
2018-06-01,896757543,A019010,고춧가루,[대상]청정원 제주 모슬포 멸치액젓 (750G),4990,4990,0
2018-06-01,2070611964,C012060,여자내의,남자몸빼/배기바지/남자바지/작업복바지/방수바지조끼,7990,7990,0
2018-06-01,895861922,A013160,맛살,[대림]대림 곤약 (600G),2790,2790,0
2018-06-01,1010228681,A013180,젓갈,[더반찬] 버터땅콩소스진미채,4200,4200,0
2018-06-01,1790550223,I011010,TV,인증점 삼성 32형 스마트 TV UN32M5500AFXKR 직배송,470000,409000,-61000
2018-06-01,1109819857,C014020,유아복,아둘 가족티 유아 커플룩 단가라 슬라브 티셔츠 12,9600,9500,-100
2018-06-01,1990743887,C011020,남자상의,MJSF18002 베이지 코튼 베이직 코트 남자베이직코트,95400,95400,0
2018-06-01,58851533,C011030,남자학생복,긴팔 셔츠 남방 와이셔츠 체크 스트라이프 빅사이즈,10800,10800,0
2018-06-01,2110142818,E061010,세탁세제,2017 퍼실 컴플리트솔루션 파워젤 라벤더젤 컬러젤,37800,37800,0
2018-06-01,795773660,A021010,커피,맥심 모카골드/화이트골드 640T(160Tx4개) + 증정,63900,63900,0
2018-06-01,703007008,I031040,생화,폴스타 그랜드 블루마린 해먹/캠핑용품,6000,6000,0
2018-06-01,761180327,A019090,카레,소공자 청정원 보크라이스 야채볶음밥양념 24g x 3,11980,11980,0
2018-06-01,1716684723,E041010,식기,방짜 유기그릇 놋그릇 반찬접시 찬기 앞접시,21500,18800,-2700
2018-06-01,1789399384,I031040,생화,파라코드나이프/서바이벌/생존가방/생존배낭/지진/EDC,7800,7800,0
2018-06-01,1356277265,C014010,아동복,한국 레드줄무늬 3종세트(3개월-24개월) 800017 / 참,74100,62990,-11110
2018-06-01,1565475545,A012040,닭고기,[그린푸드 훈제닭가슴살 3kg]국내산100%200g포장 헬스/다이어트/소금무첨가/1등몸짱/훈,40400,27800,-12600
2018-06-01,1178906804,C014010,아동복,여름상품_Air-cool퍼포먼스시리즈트레이닝바지_K162B3521AK,23900,23430,-470
2018-06-01,1224536461,I012010,컴퓨터,삼성 데스크탑/DM500T7Z-AD3S-R8S/SSD240G특가 이벤트,793850,793850,0
2018-06-01,1653344716,A018010,초콜릿,한국마즈 초콜릿 픽앤믹스 모음전,11200,11200,0
2018-06-01,279208789,A022010,주스,[동원]덴마크 데이크 얼라이브 망고 250ml12개,7900,7900,0
2018-06-01,1057278839,C013020,티셔츠,여성용 쿨 360 티셔츠 KWM17282/ 케이투,34000,28220,-5780
2018-06-01,349191120,C012060,여자내의,[에고이스트]밑단 레이스 벨트 팬츠 EH2WP560,109000,85020,-23980
2018-06-01,496092231,C013020,티셔츠,남성반팔카라티/반팔티/헨리넥/국내생산/M~2XL사이즈,13900,13900,0
2018-06-01,1272382296,C013020,티셔츠,jj77 홈쇼핑 탈부착워머set 기모티_브라운44-88 여성,18420,18420,0
2018-06-01,2056240549,I053010,공책,GT 모닝 초등 3-6 영어노트 남 초등영어노트 어린이영,5230,5230,0
2018-06-01,964083087,E031080,선풍기,인공태양히터 근적외선히터 원통형/인공태양히터 근적,154990,154990,0
2018-06-01,448348151,C011030,남자학생복,남성셔츠 남자셔츠 스트라이프셔츠 긴팔셔츠,25900,25900,0
2018-06-01,2116216605,A019180,즉석식품,[한성 균일가]숙성후랑크70g 10+1+크래미180g*2외 7개,11900,11900,0
2018-06-01,657894006,F012010,종이기저귀,[리베로]리베로기저귀 밴드형4단계 60매 4팩,73900,70210,-3690
2018-06-01,1010407210,A011090,국수,오뚜기 진짜쫄면 150G*4+1입 증정입고,4980,4490,-490
2018-06-01,1921642226,C013050,운동복,윌슨 스판트레이닝복/운동복/기능성츄리닝/단체복,59800,59800,0
2018-06-01,822967219,I031010,장난감,레고 놀이판 /레고판/블럭 조립판/테이블/클래식/밑판,3500,3500,0
2018-06-01,796106836,C014020,유아복,[키키제제]유아 면바지/여아/7.5부/청바지/스키니,10900,10900,0
2018-06-01,116671599,E021010,침구,[이룸샵]워싱광목 봄신상 이불커버/패드/침대커버,28900,28900,0
2018-06-01,2098638303,E011050,책상,[포밍테이블]국산/4발/5발/입식/좌식/사무용책상,46000,46000,0
2018-06-01,1163945764,C013020,티셔츠,닥스골프 여성 블랙 체크배색 면혼방 반팔카라티셔츠 OUTS7BN13BK,119700,107730,-11970
2018-06-01,1666484319,C013010,점퍼,시즌오프!! 플루크 롱패딩/패딩/항공/경량/코트 모음,44000,39000,-5000
2018-06-01,1667436473,A017160,오이,생생 말린표고버섯/건표고 슬라이스/목이버섯,15000,13500,-1500
2018-06-01,420644474,C012020,원피스,[쉬즈미스][쉬즈미스] 솔리드 하프 팬츠_SWWSPI10010_DN,75600,64260,-11340
2018-06-01,1223302754,A011080,밀가루,샘표 잔치국수.바지락칼국수.비빔국수.파스타//즉석식,980,980,0
2018-06-01,1718219302,E061020,섬유유연제,(FC 베이비전용 세탁세제 refill)유아용 아기 신생아,21230,20810,-420
2018-06-01,1546720206,F011150,건강기능식품,[술술풀리고10갑(50포)] 숙취해소제,127000,127000,0
2018-06-01,1881450102,F012020,생리대,시크릿데이 센스 중형12PX7팩/S홀 생리대/통기성UP,10900,10900,0
2018-06-01,564742682,C014020,유아복,아둘 유아 기모 NEW YORK 후디 양키 상하세트 06,31900,31900,0
2018-06-01,657894013,F012010,종이기저귀,[리베로]리베로기저귀 팬티형5단계 42매 4팩,73900,70210,-3690
2018-06-01,132608755,A011040,보리쌀,(10+2)우리콩100% 안동낫또 생청국장 24개,25900,25900,0
2018-06-01,1373420260,A011170,떡,백제 쌀떡국 163gX16개 1box 어머니손맛 햅쌀 떡국떡,27900,27900,0
2018-06-01,1447645043,F012050,의료측정기,애니템 체온계 1초측정 귓속형/이마겸용/비접촉,25800,25800,0
2018-06-01,989910157,F011150,건강기능식품,[내츄럴플러스] 조인트 엠에스엠 1500 (1 375mgx120정) - 1병(2개월분),40000,17900,-22100
2018-06-01,991757697,C011020,남자상의,남성 여름정장/린넨정장/린넨슬랙스/하프슬랙스,63000,63000,0
2018-06-01,1132377417,A013170,생선통조림,유동번데기130gx16캔 골뱅이/고등어/꽁치/,14900,14900,0
2018-06-01,392652377,I012010,컴퓨터,삼성DB400 인텔I5-3570/8G/SSD120G/GTX650TI/WIN10,458000,458000,0
2018-06-01,130112095,L021030,가방,백팩 가방 학생가방 책가방 남성백팩 여성백팩 신학기,22800,19800,-3000
2018-06-01,666164953,A017090,열무,유기농 무말랭이 1kg (친환경농산물),25000,22900,-2100
2018-06-01,1120242117,E031130,보온매트,일월 워셔블 잘자요 싱글+더블세트(살구원형),118000,118000,0
2018-06-01,1537768306,C013050,운동복,100%국내생산 트레이닝/팬츠/자켓/2장구매시 무료배송,25000,25000,0
2018-06-01,1254904404,A022010,주스,웅진)(6입)자연은 포도100-1.5L 과채음료 과일음료 과,30990,30990,0
2018-06-01,710971717,C021010,아동화,특가 아동운동화 아동신발 봄신상아동화 유아신발,23500,23500,0
2018-06-01,2003825892,C012020,원피스,[제이블리]오픈 플랩 트렌치 코트 10635,76400,67240,-9160
2018-06-01,1317967348,A016150,아몬드,바로 구운 아몬드 캐슈넛 호두 피스타치오 모음 홀썸,6900,6900,0
2018-06-01,1242429996,F012020,생리대,[쏘피] 귀애랑 팬티라이너 롱 38P×3팩(총114P)/ 바디피트,12900,12900,0
2018-06-01,23057128,A016120,바나나,건바나나(비앤지월넛 1K) X 10 말린 과일 건조,76880,76880,0
2018-06-01,2002741742,E031130,보온매트,(TV홈쇼핑정품) 조선황실 숨쉬는 황토보료[싱글+퀸]세,298000,295020,-2980
2018-06-01,1448274247,A013090,전복,국내산 새꼬막1.5kg (중품) 새벽조업후 발송 산지,28420,28420,0
2018-06-01,232281511,A018020,사탕,[캔디마을]달고나 뽑기 달구나 막대사탕 옛날사탕,9500,9500,0
2018-06-01,321991337,C012040,여자학생복,더블 체크 롱 베스트 IZ8SV500/ 코인코즈,94000,75200,-18800
2018-06-01,1422085541,C012040,여자학생복,(2XL-5XL)코타르 베스트-3804/ 레이디플러스,72900,65610,-7290
2018-06-01,688754766,E041070,밀폐용기,스텐맘 스텐밀폐용기 모음 반찬통 김치통,6900,6350,-550
2018-06-01,1011097359,A019100,식초,이즈 와사비마요네즈 140G,6500,5490,-1010
2018-06-01,1034251624,A014030,치즈,파마산치즈(크레프트 227g)X24/ 식자재 전문,325300,325300,0
2018-06-01,1799946588,I031040,생화,마린스/방수/해루질/랜턴/6000루멘까지/ L2 / 5발 /,26900,23900,-3000
2018-06-01,1135482509,C011030,남자학생복,빅사이즈와이셔츠/ 드레스셔츠~150 4XL [더블온스],29900,29900,0
2018-06-01,831661392,C012030,여자상의,플라워원피스/44-110/빅사이즈/쉬폰/체크,37800,27800,-10000
2018-06-01,406207576,A018040,아이스크림,하겐다즈 아이스크림 미니 스틱바 세트 [40mlX5개구성,10900,10900,0
2018-06-01,618615017,C014020,유아복,여름/아동/아동옷/아동의류/아동복/상하복/여아반팔,11200,11200,0
2018-06-01,2096295188,I031040,생화,Kershaw 커쇼 나이프 공식수입 Jens 카라비너 Black,15000,13430,-1570
2018-06-01,1431222570,I031010,장난감,[해피store][와우토이즈 루크 로우더] 자동차장난감 장난감자동차 장난감 완구,28270,28270,0
2018-06-01,1911809462,C013010,점퍼,세로영문바람막이/후드점퍼/여성비옷/비치웨어.,15900,15900,0
2018-06-01,1999968186,C014020,유아복,아둘 가족티 유아 옐로우 팔라스 반팔티셔츠 11,11100,11100,0
2018-06-01,628588599,E041070,밀폐용기,코멕스 렌지타임 전자렌지용기/라면 오븐 용기 찜기,4900,4510,-390
2018-06-01,276586700,L021010,손목시계,보이런던시계와치 토마스 블랙 팔찌시계 패브릭밴드시,47830,47830,0
2018-06-01,827610506,C011050,남자내의,아로미 925 편하고 착용감 좋은 고급패턴 9부남파자마,16060,14300,-1760
2018-06-01,1899641180,C013020,티셔츠,[필골드] DB002 베이직 목폴라 티셔츠,22800,22800,0
2018-06-01,896588138,F012010,종이기저귀,군기저귀 스마일 남녀공용 팬티형,24400,22400,-2000
2018-06-01,645053745,C013050,운동복,비상 경고등/마트판매용 자동차용품판매용 주유소사은,11700,10770,-930
2018-06-01,987226929,F011150,건강기능식품,[내츄럴플러스] 슬림컷 DIET 씨엘에이(CLA) -1병(3개월분),40000,14900,-25100
2018-06-01,1778566401,L021020,장신구,[바보사랑][액세서리키친] 925실버 크리스마스 귀걸이 2종택1,19900,19900,0
2018-06-01,1481506530,C015020,모자,[오늘출발]빅사이즈 정품스냅백/큰모자/야구모자/볼캡,13900,12900,-1000
2018-06-01,245763216,C012040,여자학생복,(예사랑)여성 인견 조끼 16YB17,59000,58410,-590
2018-06-01,516691034,A011030,찹쌀,쌀보리 (농협 1K) X10,65790,58560,-7230
2018-06-01,1778566403,L021020,장신구,[바보사랑]925실버 눈꽃 귀걸이,19900,19900,0
2018-06-01,1243422290,C012030,여자상의,[무료배송]빅사이즈 DWW0052A 맨투맨 줄지 원피스 801,59480,59480,0
2018-06-01,1887729387,C012040,여자학생복,[플라스틱아일랜드] V넥 투포켓 가디건(PH2KG582)/ 플라스틱아일랜드스토리,20000,16400,-3600
2018-06-01,12478366,L021060,유모차,스마트노블 디럭스유모차구매-카시트GIFT+슈팅스타 덤,437000,297160,-139840
2018-06-01,1767835492,A011010,쌀,[17년산 햅쌀]동송농협 철원 오대쌀 10kg/당일도정!,32500,32500,0
2018-06-01,1545955682,L021010,손목시계,젤리 아쿠아 방수시계 패션시계 고무밴드시계 고무밴,13870,13870,0
2018-06-01,1235730412,I011020,영상음향기기,벤큐/3000안시/램프만시간/빔프로젝터/프로젝트/ABC,519000,361050,-157950
2018-06-01,478408077,C013010,점퍼,MJ-1023 린넨사각체크 싱글자켓-블루 캐주얼점퍼 자켓,116070,116070,0
2018-06-01,275475049,L021020,장신구,925실버링 은반지 실버반지 모음전 커플 엔틱 검지,20000,20000,0
2018-06-01,305465808,C013050,운동복,신상 트레이닝세트 너무예쁜 츄리닝 ~XL88 빅사이즈,13800,13800,0
2018-06-01,491569399,C013020,티셔츠,[지오다노] 018503 슬릿넥 반팔 폴로/ 지오다노,19800,16040,-3760
2018-06-01,533282142,C013050,운동복,여름 추천/겨울 앞유리 자동차커버 임팔라 스포티지,12000,10860,-1140
2018-06-01,1265713519,C013040,청바지,올젠 OLZEN 2018 S/S 남성 리오셀혼방 면스판 치노팬트 6종택1 ZAY2PP1301[DONG],64000,51200,-12800
2018-06-01,1400009667,I012060,저장장치,앱코 HACKER K640 게이밍 기계식키보드 블랙 적축,38900,38900,0
2018-06-01,1023299907,L021060,유모차,[킨즈웨건]킨즈웨건 양면 쿠션매트(생활방수가능) 킨즈웨건 유아웨건 쌍둥,69000,60720,-8280
2018-06-01,737228257,L021060,유모차,토이파파 휴대용 유모차 3단계차양막 초경량 기내반입,36000,36000,0
2018-06-01,819004794,C012030,여자상의,롱/원피스/캐주얼원피스/정장원피스 빅사이즈/쁘니걸,28800,28800,0
2018-06-01,1263479758,C013010,점퍼,bb99 숨김 원버튼 fur 도톰 자켓 크림 퍼자켓 털자켓,45910,45910,0
2018-06-01,1210739966,E021020,커튼,아망떼 아일렛 암막커튼 1+1(2장) 거실커튼,10900,10900,0
2018-06-01,1687400249,L021020,장신구,덤핑세일/1.4캐럿천연루비/피빛미얀마산/최상급칼라굳,179000,179000,0
2018-06-01,1089821826,E031080,선풍기,한일 무단조절 할로겐히터 EHB-1556,92000,92000,0
2018-06-01,466921918,C013050,운동복,(518676)(미래안전) 안전삼각대 삼각대 차량안전삼각,17000,15490,-1510
2018-06-01,1424518857,A018070,파이,오리온 카스타드 12개입 4개/초코파이/과자,15900,15900,0
2018-06-01,1904878568,A016020,배,[상품리뷰3 700건] 산지직송 나주 신고배 7.5kg/15kg,15000,13900,-1100
2018-06-01,1356121561,C014010,아동복,도도하니/남아슈트/정장/턱시도/돌/연미복/연주/예복,28900,27900,-1000
2018-06-01,2117073546,C014010,아동복,밴드 카라 린넨셔츠 MKY2WC3001/ 탑텐키즈,24900,24900,0
2018-06-01,990061995,A018090,잼,로투스 스프레드 400G,4980,4490,-490
2018-06-01,1559414020,C013050,운동복,봄맞이 차량관리! [CARTECH] 카테크 차량용 세정/전동광택기 /AHT2001 [12V전용]/3018,52000,47840,-4160
2018-06-01,2048401189,E031010,전기밥솥,쿠쿠 내솥 CRP-HWXF1070FW CRP-HWXF1070FR,54500,54500,0
2018-06-01,1778566427,L021020,장신구,[바보사랑]925실버 & 벨벳스트랩 팔찌,15900,15900,0
2018-06-01,1778566426,L021010,손목시계,[바보사랑]JA-922 가죽시계,27000,27000,0
2018-06-01,497609617,A012060,햄및베이컨,(냉동)청정원고소하고바삭한베이컨 1kg베이컨 식품 식,26800,23590,-3210
2018-06-01,1778566429,L021020,장신구,[바보사랑]Silver Bell 반지,25900,25900,0
2018-06-01,36608912,A015020,식용유,유기농 올리브유/올리브오일/냉압착/엑스트라버진,22000,22000,0
2018-06-01,493320844,C015040,장갑,실버D 국내제조 성인용 손싸게 2개 1세트 할머니장갑,91110,91110,0
2018-06-01,1389076338,E031020,가스레인지,무료배송설치/ SK매직 가스 오븐 레인지/GOR-S2200,607600,607600,0
2018-06-01,1800842260,F011130,홍삼,㉤ 천제명 홍삼 흑마늘(70ML*30포),59000,59000,0
2018-06-01,1760759531,I031010,장난감,레고60141 경찰서/시티,120850,120850,0
2018-06-01,260450742,E041010,식기,[부비캣]마블 올인원 가방수저통 스텐식판세트(스파이더맨-어벤져스)[바보사랑],21800,20060,-1740
2018-06-01,657894036,F012010,종이기저귀,[리베로]리베로기저귀 밴드형6단계 52매 3팩,56500,52550,-3950
2018-06-01,885794819,A019130,스프,내맘대로/보노스프 컵스프 3각 9봉지 스프 보노보노,8900,8900,0
2018-06-01,119246839,L021020,장신구,은반지/순은반지 실버 애끼 마디 너클링 토우링/발찌,24900,24900,0
2018-06-01,451142613,A019010,고춧가루,가을 왕 고추가루 2.5kg2개 가루 고추가루 가을고추,104300,93870,-10430
2018-06-01,1195706730,C013010,점퍼,[잠뱅이]남성 배색 다운 베스트 레드 AG4WWV22-RE,17100,16250,-850
2018-06-01,1988258394,I031040,생화,피아누라 페스타 필드체어세트(2P)/캠핑의자 낚시의자,25000,21360,-3640
2018-06-01,1426296213,C013050,운동복,광각 후사경 UNDER MIRROR 대형차량용후사경 익스테리,16610,15140,-1470
2018-06-01,1806269239,E011030,거실장,[Joybee] 조이비 프리미엄 면 난방텐트 MINGLE-B 수퍼싱글 바닥o,169900,169900,0
2018-06-01,674430110,C011050,남자내의,아이스 반바지 츄리닝 트레이닝 남자 반바지 빅사이즈,9900,9900,0
2018-06-01,859216536,C013020,티셔츠,[앤디애플] 5%복수할인/단골쿠폰/무배 나들이 룩 BEST,8900,8900,0
2018-06-01,985409677,A019060,된장,샘표 토장 450G,5500,5500,0
2018-06-01,985409676,A019060,된장,샘표 백일 된장_450G,5100,5100,0
2018-06-01,989077814,E061020,섬유유연제,[아토세이프] 유아용 섬유유연제 리필 1.3L 3개,16900,5900,-11000
2018-06-01,94536162,E021020,커튼,국산고급원단 파스텔톤린넨암막커튼 거실안방커튼맞춤,28000,25760,-2240
2018-06-01,985409678,A019040,소금,샘표 한여름 눈꽃 꽃소금_500G,1600,1600,0
2018-06-01,1806269236,E011030,거실장,[Joybee] 조이비 프리미엄 면 난방텐트 MINGLE-A 퀸 바닥o,181400,181400,0
2018-06-01,770208344,E031130,보온매트,[파밀리아] 순면 전기요 GM-EM502S_싱글,45400,45400,0
2018-06-01,1806269235,E011030,거실장,[Joybee] 조이비 프리미엄 면 난방텐트 MINGLE-A 수퍼싱글 바닥x,159900,159900,0
2018-06-01,1806269238,E011030,거실장,[Joybee] 조이비 프리미엄 면 난방텐트 MINGLE-B 수퍼싱글 바닥x,159900,159900,0
2018-06-01,1806269237,E011030,거실장,[Joybee] 조이비 프리미엄 면 난방텐트 MINGLE-A 퀸 바닥x,171400,171400,0
2018-06-01,466908950,E021020,커튼,무료배송 로맨틱 플라워커튼 창 거실 안방 침실 커튼,21800,20060,-1740
2018-06-01,1806269234,E011030,거실장,[Joybee] 조이비 프리미엄 면 난방텐트 MINGLE-A 수퍼싱글 바닥o,169900,169900,0
2018-06-01,50384533,A011180,파스타면,스피가도로 파스타 재료모음 스파게티 향신료 소스,4000,4000,0
2018-06-01,577341601,C013020,티셔츠,17 여름 패셔니스타 레깅스_F17D2SP405,6000,6000,0
2018-06-01,266490703,L021020,장신구,[폭스타일] 헤론드 큐빅 반지,8000,7280,-720
2018-06-01,1619145169,C013010,점퍼,마르잔 자켓 바람막이 LM5337_LM5357 바람막이 등산자켓 점퍼 빅사이즈자켓 자켓,71900,64000,-7900
2018-06-01,542208318,I031010,장난감,Step2 이인용 밴 유아승용완구 유아완구 유아용완구,250530,250530,0
2018-06-01,1223292907,E061060,살충제,2배 강해진 바퀴벌레 퀵다운 다킬라 20L /(참고)개미,206200,181460,-24740
2018-06-01,884450712,C011030,남자학생복,푸마 집업 니트 가디건/size M/면혼방/세일/중고/구제,19900,19900,0
2018-06-01,2063449882,C013010,점퍼,[앤듀 (ANDEW)][앤듀] 앤듀 남성 여름용 코튼 린넨 점퍼 O162JP170P[갤러리아],29000,26100,-2900
2018-06-01,570788543,C012040,여자학생복,여성 니트 KKS 꼬마병정,66930,66930,0
2018-06-01,1195753105,L012040,치약,2080 페리오 특가! 치약 x 20개 죽염 리스테린 가그린,9800,9800,0
2018-06-01,958423859,A017130,도라지,[고구마루] 고구마 말랭이 150g,9900,7500,-2400
2018-06-01,1346193161,C014020,유아복,[유아] 슈퍼스타 트레이닝세트 4종택1-CE1978외/ 아디다스키즈(아동),75000,63750,-11250
2018-06-01,524373343,E061080,키친타월,1+1 스카트 빨아쓰는타올/크리넥스 키친타올,7700,7700,0
2018-06-01,958423860,A017130,도라지,[고구마루] 고구마 말랭이 300g,14900,11900,-3000
2018-06-01,612516371,A012060,햄및베이컨,CJ제일제당 스팸 클래식340g /스팸 마일드340g,3300,3300,0
2018-06-01,451142519,A019010,고춧가루,청양 고은 고추가루 1kg2개 가루 고추가루 고은고추가,41520,37370,-4150
2018-06-01,1265581239,C011030,남자학생복,남 라이트웨이트 코튼 린넨 셔츠 048520/ 지오다노,39800,32640,-7160
2018-06-01,130464884,A011050,콩,KT푸드 브라질너트/블랙커민시드/골든베리/모링가,9900,9900,0
2018-06-01,321991398,C012020,원피스,심플 루즈핏 코트IZ8SH4290/ 코인코즈,94000,75200,-18800
2018-06-01,179289309,L012040,치약,진지발리스치약 140gx10개 크리오/2080/페리오/시린이,10900,10900,0
2018-06-01,169311042,A022030,생수,[동원 FB]동원샘물 생수 2L × 36팩,19700,19700,0
2018-06-01,826395864,E011020,침대,홈잡스 평상서랍형침대 매트리스+서랍 무료포함,140000,137900,-2100
2018-06-01,303959196,G022020,자동차타이어,한국타이어 벤투스 S2 AS 225/45R18 H462 무료배송,155050,131800,-23250
2018-06-01,929081891,A018070,파이,오리온초코파이 몽쉘통통 카카오 크림케익x4갑,16900,16900,0
2018-06-01,259043033,A011020,현미,하늘바람 찹쌀가루 2kg 찹쌀 가루 농협 빠른배송 조리,21550,21550,0
2018-06-01,652405748,F011150,건강기능식품,캐피어스타터 10포/케피어종균/요거트종균/요구르팅,12000,12000,0
2018-06-01,348310229,C012060,여자내의,기모 야옹이 프린트팬츠 여성 캐주얼 기모팬츠레깅스,27920,27920,0
2018-06-01,1863722645,I053040,기타문구,프린텍 반투명 스티키 노트 CL7676 CL5176 메모지,1000,1000,0
2018-06-01,924639227,E031020,가스레인지,안심센서 가스오븐+4구레인지+그릴 GOR-S2200무료배송,614000,614000,0
2018-06-01,1370819181,E061080,키친타월,스카트 빨아쓰는 키친타올 45매 6롤,10500,10500,0
2018-06-01,723401748,C012020,원피스,[올리비아로렌] 솔리드 모던 팬츠 VOCDLSM4131,31300,29430,-1870
2018-06-01,1195263833,C013010,점퍼,[펠틱스][펠틱스] 퍼 점퍼 FEPDMJP02_NA_1,20900,19860,-1040
2018-06-01,277147701,A013070,굴,국내자연산 쏙(갯가재) 2kg(40미내외)/냉동,39700,39700,0
2018-06-01,989077809,E061020,섬유유연제,[아토세이프]유아용 섬유유연제 리필 1.3L 2개,11900,4900,-7000
2018-06-01,989077808,E061020,섬유유연제,[아토세이프] 유아용 액체세제 리필 1.3L 3개,16900,5900,-11000
2018-06-01,989077807,E061020,섬유유연제,[아토세이프] 유아용 액체세제 리필 1.3L 2개,11900,4900,-7000
2018-06-01,989077806,E061020,섬유유연제,[아토세이프] 유아용 액체세제 리필 1.3L 4개/섬유유연제 리필 1.3L 4개 택1,21900,7900,-14000
2018-06-01,1857146333,E021020,커튼,100%암막 100%방한방풍 쉬폰,35900,35900,0
2018-06-01,1479661125,L012060,샴푸,올뉴 티에스샴푸 500g + 500g / TS샴푸 [샘플증정],40800,40800,0
2018-06-01,985387785,A019030,생강,햇마늘(저장용) 반접,12900,12900,0
2018-06-01,445692877,C013020,티셔츠,HH 언더레이어티셔츠(사계절_기본형_여성용_화이트),60000,59400,-600
2018-06-01,826165545,A012010,국산쇠고기,[무항생제 한우선물세트]한우 보신 1호 약 3kg,127500,127500,0
2018-06-01,172143875,I011030,사진기,[사은품증정][파나소닉]루믹스 디카 DMC-LX100,732700,732700,0
2018-06-01,1948719695,C013010,점퍼,걸크러쉬 슬림 가죽 자켓-m1071 (블랙) 여성용자켓 여,57130,57130,0
2018-06-01,1806269241,E011030,거실장,[Joybee] 조이비 메쉬 모기장 텐트 베이직 슈퍼싱글 폴o 바닥o,122000,122000,0
2018-06-01,1806269240,E011030,거실장,[Joybee] 조이비 프리미엄 면 난방텐트 MINGLE-B 퀸 바닥x,171400,171400,0
2018-06-01,256146676,E011050,책상,[귀족가구] 책상/1000~2400/1인용  2인용 컴퓨터책상,95000,95000,0
2018-06-01,1842643739,C011030,남자학생복,[위앤드]썸머 루즈핏 니트 가디건[3 colorFREE size] 남자 여름 가디건여름 니트 가디,29800,28310,-1490
2018-06-01,1806269243,E011030,거실장,[Joybee] 조이비 메쉬 모기장 텐트 베이직 슈퍼싱글 폴o 바닥x,112000,112000,0
2018-06-01,1806269242,E011030,거실장,[Joybee] 조이비 프리미엄 면 난방텐트 MINGLE-B 퀸 바닥o,181400,181400,0
2018-06-01,953986930,A014040,발효유,빙그레 바이오플레(플레인)140ML*8,3700,2600,-1100
2018-06-01,1157628948,E031110,청소기,[샤오미] 스마트 로봇청소기 2세대,510000,510000,0
2018-06-01,925930372,C012060,여자내의,매리빌 쭈리 3부 반바지 JE-2479 캐주얼바지 반바지 3,7280,6560,-720
2018-06-01,751083485,C013010,점퍼,[로엠][로엠] 라이더 자켓 RMJK812G91,69300,60300,-9000
2018-06-01,2117998487,C011030,남자학생복,핏좋은 슬림남방/긴팔/헨리넥/체크/청/스판/와이셔츠,19800,16800,-3000
2018-06-01,1155842360,C012040,여자학생복,[타미힐피거여성]여성 코튼 그래픽 자수 니트 (TFMS1WOE32A0),178500,160650,-17850
2018-06-01,1964021521,I031010,장난감,플스4 VR 1번세트 (PS4) 소니 정품 새제품 -내용확인,285000,285000,0
2018-06-01,1089037022,A018010,초콜릿,유럽전통 카카오매스100/카카오닙스 초콜렛 초콜릿,7800,7600,-200
2018-06-01,662978981,C013020,티셔츠,원단굿/실켓/면/반팔티/라운드/기본/여성/무지/여름,6900,6900,0
2018-06-01,988032215,A018050,비스킷,[롯데]빠다코코낫 오리지날 100G,1120,1050,-70
2018-06-01,2111319238,C013050,운동복,아이야/ 여름신상입고 남성/커플트레이닝복 세트,25800,25800,0
2018-06-01,959495352,A013100,마른멸치,[청정수산] 청정 완도 참전복 500g(10∼13미),43000,32900,-10100
2018-06-01,241334628,I031040,생화,등산 낚시 캠핑 두랄루민 미니 접이식 의자/BBQ 체어,9900,8190,-1710
2018-06-01,1806269272,E011030,거실장,[Joybee] 조이비 메쉬 모기장 텐트 베이직 퀸 폴x 바닥x,87000,87000,0
2018-06-01,1569723373,C013020,티셔츠,[와이드앵글] 조직 니트 카라 변형 티셔츠 -WWM18250,108000,108000,0
2018-06-01,1806269271,E011030,거실장,[Joybee] 조이비 메쉬 모기장 텐트 베이직 슈퍼싱글 폴x 바닥x,82000,82000,0
2018-06-01,554863929,C013010,점퍼,빅사이즈 DDK00222 경량 바람막이 803 여자바람막이,98250,98250,0
2018-06-01,1806269274,E011030,거실장,[Joybee] 조이비 메쉬 모기장 텐트 베이직 퀸 폴x 바닥o,97000,97000,0
2018-06-01,1806269273,E011030,거실장,[Joybee] 조이비 메쉬 모기장 텐트 베이직 슈퍼싱글 폴x 바닥o,92000,92000,0
2018-06-01,140795531,E051020,건전지,파나소닉 BQ-CC55 급속충전기/에네루프 충전지/AA/AAA,17900,17900,0
2018-06-01,58212178,C012040,여자학생복,SK1445-또또 데님 투포켓 스커트 똑딱단추스커트 뒷밴,52160,51120,-1040
2018-06-01,1641720539,C013020,티셔츠,타임리스 봄 신상 린넨 티셔츠/원피스/나시/블라우스,10000,6900,-3100
2018-06-01,1806269270,E011030,거실장,[Joybee] 조이비 메쉬 모기장 텐트 몽시느 퀸 폴o 바닥x,183000,183000,0
2018-06-01,649032834,L012040,치약,페리오 알파치약 170g 치약 x 10개 외,7900,7900,0
2018-06-01,1774891888,F011130,홍삼,굿베이스 홍삼담은 자연블루베(50ML*30입),53100,53100,0
2018-06-01,280305704,C013010,점퍼,여성 집업점퍼(J207075)/ 캘빈클라인 진,163170,138700,-24470
2018-06-01,266487111,L021020,장신구,[폭스타일] 블런트 반지,10000,9100,-900
2018-06-01,84934647,C012060,여자내의,리즘 주름 롱스커트 SD-9028,17480,16960,-520
2018-06-01,242463852,D031010,주택수선재료,욕실 타일 방수 코팅제 방법 옥상 바닥 누수 방수제,6130,5830,-300
2018-06-01,1232267759,A013050,오징어,실속 런천미트햄(백설 340g)X20 ham 식자재,83310,83310,0
2018-06-01,1880668812,A022010,주스,웅진 자연은 제주감귤 주스 1.5L X 6펫 외 14종,12900,12900,0
2018-06-01,1830321263,C011050,남자내의,앤듀행사용유니5부 코튼린넨 전체밴딩 바지 O172Z2110P,8600,8600,0
2018-06-01,988032208,A019050,간장,청정원 맛간장 조림볶음용 0.84L,7400,7400,0
2018-06-01,1313191442,C013060,등산복,남성 바인스 2 바람막이 자켓 MVMUJ418/ 밀레,21000,18900,-2100
2018-06-01,1326776643,C013020,티셔츠,YAN2165 양털캥거루박스후드티셔츠,14670,14380,-290
2018-06-01,974902656,A019070,양념소스,오뚜기 통닭양념(매운맛)3.6kg/튀김닭용양념,8000,8000,0
2018-06-01,1453258044,A011180,파스타면,라리 스파게티면 500g,900,900,0
2018-06-01,451142550,A019020,참깨,은진 볶음참깨 1kg2개 깨 참깨 볶음참깨 은진참깨 은,29370,26440,-2930
2018-06-01,1806269269,E011030,거실장,[Joybee] 조이비 메쉬 모기장 텐트 몽시느 퀸 폴o 바닥o,232000,232000,0
2018-06-01,447986510,C013020,티셔츠,언더레이어티셔츠(사계절_스트링형_여성용_민트) 자전,113580,113580,0
2018-06-01,1806269268,E011030,거실장,[Joybee] 조이비 메쉬 모기장 텐트 몽시느 슈퍼싱글 폴o 바닥x,172000,172000,0
2018-06-01,959529200,A019180,즉석식품,CJ 햇반기획 (210g*4입),4650,4650,0
2018-06-01,1806269265,E011030,거실장,[Joybee] 조이비 메쉬 모기장 텐트 베이직 퀸 폴o 바닥o,127000,127000,0
2018-06-01,203681038,C012060,여자내의,예술핏 슬랙스/밴딩팬츠/~3XL 여성바지,27800,27800,0
2018-06-01,1902587142,A015020,식용유,행사특가[해표카놀라유 x4개 ] 백설 식용유 올리브유,10000,9800,-200
2018-06-01,1806269267,E011030,거실장,[Joybee] 조이비 메쉬 모기장 텐트 몽시느 슈퍼싱글 폴o 바닥o,221000,221000,0
2018-06-01,1806269266,E011030,거실장,[Joybee] 조이비 메쉬 모기장 텐트 베이직 퀸 폴o 바닥x,117000,117000,0
2018-06-01,2047005558,C011030,남자학생복,빅사이즈 가디건 니트짚업 JA 주머니 블루종,57560,51230,-6330
2018-06-01,1798538861,A017210,파,영양만점 산지직송 찰 토마토 5kg,9900,9900,0
2018-06-01,1997317065,E011020,침대,[골든잼]원목 천연생황토 더블 돌침대(모리아)/흙침대,2171600,2106460,-65140
2018-06-01,2073544275,C014010,아동복,[더루비]여아/원피스/롱티셔츠/티셔츠/맨투맨/아동,11800,11800,0
2018-06-01,1494046385,A017200,토마토,[우리가락]가지 1개,2300,2300,0
2018-06-01,549729283,E061040,부엌용세제,주방세제x5개 곡물설거지X4개/참그린 베이킹소다 프릴,7500,7500,0
2018-06-01,988032238,A018050,비스킷,[롯데]롯데 웰빙야채 레시피 83G,1120,1050,-70
2018-06-01,1233134668,C013020,티셔츠,[티렌]플라워프린트 기본 반팔티셔츠 T172PSM710,37000,29600,-7400
2018-06-01,385743215,C012020,원피스,포인트 빈티지 팬츠 RIN0362RM805 빅사이즈,53780,50560,-3220
2018-06-01,1274778149,E021020,커튼,[로즈퀸]특가찬스~최고급/암막커튼 로만쉐이드/햇빛차단/창문/2개무료배송/커튼/쟈가드,29800,29800,0
2018-06-01,1337370927,C012030,여자상의,여성 빈스 단가라 니트 KK단가라 니트니트여자 니트여,61260,61260,0
2018-06-01,1806269296,E011030,거실장,[Joybee] 조이비 메쉬 모기장 텐트 몽시느 슈퍼싱글 폴x 바닥o,191000,191000,0
2018-06-01,537006015,C013040,청바지,[앤디애플]NEW밑단프릴데님팬츠,12900,11610,-1290
2018-06-01,1433868926,L021030,가방,(10+1) 피에르가르뎅 80데니아 팬티스타킹 x 5족/9부 레깅스 x 5족 /학생스타킹,20700,19900,-800
2018-06-01,1806269298,E011030,거실장,[Joybee] 조이비 메쉬 모기장 텐트 몽시느 퀸 폴x 바닥x,153000,153000,0
2018-06-01,403597267,I053020,스케치북,[영신종이도매센터]도화지/켄트지/흑켄트지/색켄트지,57500,57500,0
2018-06-01,1806269297,E011030,거실장,[Joybee] 조이비 메쉬 모기장 텐트 몽시느 슈퍼싱글 폴x 바닥x,142000,142000,0
2018-06-01,950642917,F012010,종이기저귀,스웨덴 친환경 네띠 기저귀 밴드형 팬티형 대용량 8팩,82900,82900,0
2018-06-01,1806269299,E011030,거실장,[Joybee] 조이비 메쉬 모기장 텐트 몽시느 퀸 폴x 바닥o,202000,202000,0
2018-06-01,192642611,L021010,손목시계,TISSOT 티쏘시계 PRC200및 인기모델8종/국내당일발송,328000,328000,0
2018-06-01,604975483,C013010,점퍼,발렌시아 남성 중년자켓/여름자켓/정장자켓,52500,52500,0
2018-06-01,537021631,A019160,밑반찬,40년 전통 담양 생 청국장 170g×6개/낫또,13900,13900,0
2018-06-01,988095666,E041070,밀폐용기,PET)사각과실주병8L,5900,5900,0
2018-06-01,988095667,E061100,습기제거제,MR.홈스타 습기를 부탁해 8P,9900,9900,0
2018-06-01,1585720047,I031010,장난감,PS4 본체 프로 1TB/ps4pro/프로본체/ps4프로,541300,514240,-27060
2018-06-01,1699679510,E061010,세탁세제,EM친환경세탁세제/천연액체세제/섬유유연제 비누/리필,14950,14950,0
2018-06-01,1010194822,L012060,샴푸,[LG생활건강] 시즌세트 오가니스트 3호(B6)X 6입,215400,125400,-90000
2018-06-01,1257406372,E031110,청소기,에브리봇 물걸레 로봇청소기 RS700,268000,268000,0
2018-06-01,480635702,C012020,원피스,오버핏 베이직 코트 RJKWHC020/ 리안뉴욕,99000,89100,-9900
2018-06-01,348309200,C013050,운동복,이지 소화기 산소공급기 119 비상용 휴대용 다용도,14000,12790,-1210
2018-06-01,480635705,C012020,원피스,파스텔 심플 울코트 RKKWHC610/ 리안뉴욕,79000,71100,-7900
2018-06-01,324674453,E061010,세탁세제,웰로스 세탁볼 웰로스 세탁볼 친환경세제 향균세제 세,16740,16740,0
2018-06-01,1905897326,C014020,유아복,배냇베이비 허리라인이 들어간 순면 아동 티셔츠,13440,13440,0
2018-06-01,1562706548,C011030,남자학생복,와이셔츠/성인/어린이/학생/가족티/반티/긴팔/반팔/흰,8500,7900,-600
2018-06-01,1567348074,C011030,남자학생복,[할인판매]아디다스 콘디보 16 패딩조끼 다운 베스트,75890,75890,0
2018-06-01,1859455616,A017090,열무,나물모음/시래기 우거지 궁채 취나물 고구마순 토란대,6000,3960,-2040
2018-06-01,1000589683,F012010,종이기저귀,엘지 마미포코 기저귀 360핏팬티 남여 대형 특대 점보,46040,46040,0
2018-06-01,1715441296,A013010,갈치,국내산 순살 갈치 600g / 튀김용   전감용,10900,10900,0
2018-06-01,1778566396,L021020,장신구,[바보사랑]925실버 롱 슬림 Hook 귀걸이,35900,35900,0
2018-06-01,289401769,A017180,호박,가을 다데기 청양 고추가루 2.5kg,49900,48410,-1490
2018-06-01,2088688659,C013010,점퍼,JK442 루즈핏 투버튼 버클 자켓 여자자켓 심플트렌치,59240,59240,0
2018-06-01,1778566395,L021020,장신구,[바보사랑]925실버 볼드 링귀걸이,45900,45900,0
2018-06-01,868001850,E031130,보온매트,동천 황토전기매트 DC-263D [더블 / EMI인증 전자파 차단 / 절천형],109000,109000,0
2018-06-01,868001851,E031130,보온매트,동천 황토전기매트 DC-260S [싱글 / EMI인증 전자파 차단 / 절천형],89000,89000,0
2018-06-01,868001852,E031130,보온매트,대웅모닝컴 전기매트 DWM-L101B [ 싱글 / 마이콤방식 온도조절 / EMF전자파차단 ],105000,105000,0
2018-06-01,1778566399,L021020,장신구,[바보사랑]925실버 Wave 큐빅라인 링귀걸이,29900,29900,0
2018-06-01,546243530,C021020,구두,[무크]무크 스퀘어 발등 셔링 포인트 옥스포드 블랙[507417018wa],45900,45900,0
2018-06-01,13732685,C013050,운동복,[행텐주니어]행텐주니어 PNC02 트레이닝 쿨 반바지 1412013840369,12000,12000,0
2018-06-01,868001853,E031130,보온매트,대웅모닝컴 전기매트 DWM-L201B [ 더블 / 마이콤방식 온도조절 / EMF전자파차단 ],115000,115000,0
2018-06-01,1778566398,L021020,장신구,[바보사랑]925실버 볼드 하프 링귀걸이,35900,35900,0
2018-06-01,799829750,E041070,밀폐용기,프로메사 스텐밀폐용기/진공밀폐용기/반찬통/도시락통,9900,7090,-2810
2018-06-01,1267552391,C011030,남자학생복,풍기인견/인견남방,52000,52000,0
2018-06-01,303803363,C021040,실내화,[컨버스하이] 척테일러/잭퍼셀/기본코어 10종모음전,42900,42900,0
2018-06-01,335314644,C014010,아동복,어린이 방한 마스크 FL0200 플라이봇우주,8720,8720,0
2018-06-01,1746787876,E061010,세탁세제,퍼실 컴플리트솔루션 밀리언파워젤 라벤더2.7L+1.8L,21900,21900,0
2018-06-01,529730374,C012060,여자내의,라인이 예뻐보이는 블랙체크주름치마(주름 교복치마),49840,48350,-1490
2018-06-01,1843149589,E061020,섬유유연제,아로마뷰 섬유유연제 2.1Lx5개+증정,10900,10900,0
2018-06-01,561623131,A013070,굴,업소용 냉동랍스타 500g(급냉),10500,10500,0
2018-06-01,1132198796,C021040,실내화,퓨리 맥스 탄준 다이나모프리/런닝화 축구화 외 100종,21600,21600,0
2018-06-01,637804887,A018040,아이스크림,아이스크림/박스/3세트이상구매시5%추가할인,15000,15000,0
2018-06-01,514502132,E031040,전기레인지,미니바 자판기냉장고.무소음 냉장고 무소음냉장고 자,691570,691570,0
2018-06-01,561879860,A013170,생선통조림,한성 골뱅이400g+400g,10900,10900,0
2018-06-01,424843085,A022010,주스,제주감귤 매실 사과 포도 오렌지 파인 쥬스 1.5Lx12펫,15900,15900,0
2018-06-01,483845073,C013030,스웨터,밀란시아 왕 니트폴라티 is12-2 남성캐쥬얼 캐쥬얼티,45500,44590,-910
2018-06-01,688524332,E021010,침구,[이블랑] 모던하고 심플한 순면 이불커버세트 47종,43900,43900,0
2018-06-01,988960789,C015040,장갑,초L)반코팅장갑3P,1990,1990,0
2018-06-01,1010314918,A019180,즉석식품,[대광]대광 매운직화구이꼬치 200G,5980,5980,0
2018-06-01,988960788,C015040,장갑,초L)면장갑3P,1990,1990,0
2018-06-01,1347951384,C013050,운동복,위하여 고급 안전 삼각대,15100,14800,-300
2018-06-01,1561964273,A013020,명태,523 먹태 1kg이상10마리 속초아바이,60150,60150,0
2018-06-01,80534518,L021050,우산,장마대비 제비표 우비 우의 낚시용 등산용 행사용,19800,19800,0
2018-06-01,2069296201,C012020,원피스,빅사이즈/테잎/오픈/롱/가디건 / 참고 빅사이즈 큰옷,67100,57040,-10060
2018-06-01,776800005,F012020,생리대,예지미인 울트라슬림 날개 대형 16개입 x 40,179060,159370,-19690
2018-06-01,579162545,C012040,여자학생복,[CC콜렉트]펀칭레이스칠부블라우스(C181MSC019),153300,122640,-30660
2018-06-01,1010314917,A019180,즉석식품,대광 파닭데리꼬치 200G,5980,5980,0
2018-06-01,1362420450,A022050,탄산음료,해태 코코팜 24캔 1box/갈아만든 배/사이다/트레비,8900,8900,0
2018-06-01,988095696,A012040,닭고기,브랜드 토종닭(백숙용/1kg이상)-부재료포함(점포별 브랜드 다를수있습니다),7990,6990,-1000
2018-06-01,1606813970,C013050,운동복,빅사이즈 휘트니스/S~3XL/트레이닝/운동복/요가복 H1,24800,24800,0
2018-06-01,675866728,C013010,점퍼,[티탁]55~120야상점퍼/롱/자켓/루즈핏/가디건,32800,27500,-5300
2018-06-01,954366305,L012090,기초화장품,위치하젤 토너 355ml (옵션) 8종 택 1/ 세이어스,10930,9730,-1200
2018-06-01,2119610828,A012010,국산쇠고기,[무항생제] 이유식 냉장 다짐육 200g 2등급 (6구),10300,10300,0
2018-06-01,1641475610,A016150,아몬드,산과들에 색다른 맛! 유산균칼슘 치즈아몬드 400/800g,7900,7900,0
2018-06-01,558095649,A022010,주스,(무료배송)미닛메이드 매실 175ml x30can,9500,9500,0
2018-06-01,188152644,A017090,열무,최상품 콜라비 적콜라비 제주적콜라비 5kg내외,279000,279000,0
2018-06-01,632403402,I031010,장난감,소니 신형 플레이스테이션4 Pro (CUH-7117BB02) -미성,678530,678530,0
2018-06-01,985410605,E061040,부엌용세제,트리오 베이킹소다 용기 3L,9900,3990,-5910
2018-06-01,1948502142,A021010,커피,동서식품초특가/맥스웰하우스 아로마900g*12/마일드/,39570,37200,-2370
2018-06-01,488801485,C012040,여자학생복,여성용 숄 머플러 목도리 롱스카프 겨울 패션 스타일,15600,15600,0
2018-06-01,1733710251,A021010,커피,맥심 모카400T+머그/화이트400T,40900,40900,0
2018-06-01,1708365656,C012040,여자학생복,[팡팡샵]신상 남방/롱남방/셔츠/블라우스/빅사이즈,12900,12900,0
2018-06-01,1047890576,C014010,아동복,네파키즈 KDD5909 리가 트레이닝 세트/ 네파키즈,34500,28290,-6210
2018-06-01,1181697285,C013010,점퍼,[벤트그라스] 남성 배색 바람막이 경량 점퍼-DBMK4158CH0,19900,17320,-2580
2018-06-01,329896904,C013020,티셔츠,텐셀100 썸머데일리티 2841/여름티/시원한옷/텐셀,12800,12800,0
2018-06-01,1297200717,C011020,남자상의,MJ-925 컬러격자 라이니 투버튼 자켓 캐주얼자켓 남자,139000,137610,-1390
2018-06-01,649888035,C013020,티셔츠,루즈핏 7부/5부/반팔 박스 오버핏 빈티지 남자 롱티,12900,12900,0
2018-06-01,178107343,C013050,운동복,[모다아울렛][ASK 주니어]유니 폴리 싱글 상하의 SET - JB2ZTR391UL,47200,42480,-4720
2018-06-01,255164870,A018080,설탕,설담 비정제원당10kg (5kgX2개)/ 비정제설탕,15300,15300,0
2018-06-01,1296451286,C012040,여자학생복,[로엠] [로엠(ROEM)]기본 R넥 블라우스 RMBL725R01,49900,19000,-30900
2018-06-01,1565174430,L021030,가방,백팩  책가방  학생가방  여성백팩  신학기가방  가방,19800,17800,-2000
2018-06-01,1018993805,C021040,실내화,윌슨 러쉬 프로2.5 테니스화 (WRS322630 ) 그레이,149570,133120,-16450
2018-06-01,957619596,L012030,칫솔,케이엠 뽀로로 어린이 칫솔 2단계(3세~5세/2P),5200,5200,0
2018-06-01,1329555824,C014010,아동복,스텐레스 보급형 참빗 2종 택1,3250,3090,-160
2018-06-01,2089490214,C014010,아동복,에스크주니어 유니 폴리 싱글 상하세트 JB2ZTR391UL,30420,30420,0
2018-06-01,423183330,C012060,여자내의,[에스크]빈티지 포켓 면팬츠 (AO3MPT004F)(여카키),2900,2900,0
2018-06-01,1600122264,A013120,낙지,정화 해오징어 버터구이 30gx5.,22040,19620,-2420
2018-06-01,2010699845,A016020,배,자연마을 배도라지즙 30팩,30000,30000,0
2018-06-01,1932369937,A012040,닭고기,[아임닭] 닭가슴살 BEST 33종 골라담기,1950,1950,0
2018-06-01,440881521,E021020,커튼,GT 퍼셀 강아지 고양이 이동가방 펫 슬링백 그린 대,62040,62040,0
2018-06-01,1169128184,C012060,여자내의,[악녀일기](체크)클레시아원피스,74480,64810,-9670
2018-06-01,422921483,C013050,운동복,우먼스 ZNE 후디 2 LS 화이트 후드집업 트레이닝점퍼,152200,149160,-3040
2018-06-01,1284442139,C021020,구두,[토리버치] 토리버치 첼시 플랫슈즈 46882_009,305000,240950,-64050
2018-06-01,1778591385,L021020,장신구,[바보사랑]SINUOUS EARRING,39000,39000,0
2018-06-01,1778591384,L021020,장신구,[바보사랑]SINUOUS PEARL EARRING,68000,68000,0
2018-06-01,1732277007,C011050,남자내의,(평화)(여체크9부)특면 순면 체크무늬 여성파자마,10950,9750,-1200
2018-06-01,868001882,E031130,보온매트,전기요 KI-650Y [전자파안심 / 극세사 / 물세탁 / 전기요(싱글)],85900,85900,0
2018-06-01,868001883,E031130,보온매트,국일 전기요 KI-640Y [더블 / 전자파안심 / 면혼방 / 물세탁가능],59430,59430,0
2018-06-01,868001884,E031130,보온매트,국일 전기매트 KI-460 [싱글 / 참숯＋황토 / 3중 안전장치 / 전자파안심 ],179000,179000,0
2018-06-01,1778591389,L021020,장신구,[바보사랑]SINUOUS DROP RING EARRING,69000,69000,0
2018-06-01,1108086526,A011100,라면,오뚜기 알뜰당면1kg 옛날당면1kg/당면,3700,3700,0
2018-06-01,263985111,A016040,포도,햇 하우스 포도 캠벨2kg 거봉2kg 델라웨어2kg 특상품,29900,29900,0
2018-06-01,1778591387,L021020,장신구,[바보사랑]SINUOUS PENDANT DROP EARRING,75000,75000,0
2018-06-01,226708711,L012090,기초화장품,정여원의 발아현미 딥클렌징크림 1+1 저자극성 클렌징,12500,12500,0
2018-06-01,1778591382,L021020,장신구,[바보사랑]SINUOUS LINE PEARL RING,69000,69000,0
2018-06-01,1778591380,L021020,장신구,[바보사랑]SINUOUS BOLD PEARL RING,69000,69000,0
2018-06-01,989077870,E061020,섬유유연제,밀크코튼 고농축 섬유유연제 for baby 파우더향 10L분량(캡슐 10개입) 1SET+용기,15000,15000,0
2018-06-01,29337290,C011020,남자상의,메리노롱헤어 후드무스탕코트 남자무스탕코트,2889500,2889500,0
2018-06-01,989077873,E061020,섬유유연제,밀크코튼 고농축 섬유유연제 for baby 클린코튼향 10L분량(캡슐 10개입) 1SET+용기,30000,16900,-13100
2018-06-01,30485706,A019050,간장,홍게맛장소스 골드 1.8L/2개 무료배송/홍게간장,17500,17500,0
2018-06-01,868001876,E031130,보온매트,대웅모닝컴 극세사 전기요 DWM-T201B 더블 [온도조절 8단계 / 초극세사],82000,82000,0
2018-06-01,868001877,E031130,보온매트,대웅모닝컴 극세사 전기요 DWM-T101B 싱글 [온도조절 8단계 / 초극세사 ],75000,75000,0
2018-06-01,868001878,E031130,보온매트,대웅모닝컴 TP 전기요 DWM-P101S 싱글 [온도조절 8단계 / 3중안전장치 / 전자파차단],65000,65000,0
2018-06-01,868001879,E031130,보온매트,대웅모닝컴 TP 전기요 DWM-P201S 더블 [온도조절 8단계 / 3중안전장치 / 전자파차단],69000,69000,0
2018-06-01,378523843,C011020,남자상의,초특가 가을 코트 겨울 남자 분또 하프 롱 자켓 더플,52000,49800,-2200
2018-06-01,1145338967,C013050,운동복,우먼스 ZNE 플러스 후드 2 짚업트레이닝복 스포츠후드,140280,140280,0
2018-06-01,269262325,L021010,손목시계,국내산 난연 후드필터 소(520mmx220mm) 국내산 난연,19000,18810,-190
2018-06-01,937865162,E031070,에어컨,실링팬/흰색 검정색/식당 창고 축사 대형천장용선풍기,148000,148000,0
2018-06-01,1526360629,L021010,손목시계,군인시계 전자시계 모음/군입대시계/훈련소/군대/군용,20000,19000,-1000
2018-06-01,2067239386,C011030,남자학생복,그레이 카라 포인트 화이트셔츠 패션셔츠 남자셔츠 긴,29150,29150,0
2018-06-01,868001875,E031130,보온매트,전기4단 방석 DWM-C416F [ 4인용 / 15시간 타이머 내장 / 9단계 온도조절 ],56000,56000,0
2018-06-01,1738841608,C012060,여자내의,[제이블리]H라인 청 스커트 01173,38900,34240,-4660
2018-06-01,1804105517,C012060,여자내의,뤼드레노마new. CW16SK610 프린트 플리츠 스커트,18900,16070,-2830
2018-06-01,1164234191,F012010,종이기저귀,하기스매직기저귀1~5단계/매직팬티3~6단계/오버나이트,39900,39900,0
2018-06-01,819917578,A018010,초콜릿,엠앤엠즈 피라미드 밀크 초콜릿 945g / 앰앤앰 초콜렛,14970,14970,0
2018-06-01,956728721,L012040,치약,폴리덴트틀니 세정제,9500,9500,0
2018-06-01,393915216,C013050,운동복,오토컴 EXO스마트브라운 접이식 트렁크 콘솔박스 자동,30420,27720,-2700
2018-06-01,545777638,A014020,분유,[아이배냇] NEW 순 산양분유 1단계~4단계 800g 2캔,65800,65800,0
2018-06-01,1950472919,E011040,소파,퓨리하이백쇼파/소파/패브릭쇼파/1인용쇼파/2인용쇼파,89900,78210,-11690
2018-06-01,1924516195,E041070,밀폐용기,친환경 이태리 보르미올리 피도밀폐모음 유리병 술병,4500,4500,0
2018-06-01,2025984545,A017150,버섯,대용량 / 숙주나물 3.5kg 아이스박스쿨팩 무료배송,11500,11500,0
2018-06-01,1337186104,C012040,여자학생복,로사W 썸머 린넨 블랜딩 티셔츠 5종,59900,55110,-4790
2018-06-01,1341947669,E031040,전기레인지,미니바 자판기냉장고.무소음 냉장고 메가텍미니바 무,691570,691570,0
2018-06-01,1302776043,C012060,여자내의,와이드 밴딩 데님 팬츠-M1059 와이드 힙합청바지 데님스커트 멜빵청바지 데님팬츠,32190,28650,-3540
2018-06-01,1308637580,C013050,운동복,아디다스 여성 스타디움 후드자켓(BP7066) 아디다스긴,105570,105570,0
2018-06-01,891275960,A017050,미나리,[꼬레촌엽채]양배추 1통 최상품 2.5kg이상,4400,4400,0
2018-06-01,955740723,A015010,참기름,오뚜기 옛날참기름(캔) 500ML,10990,3990,-7000
2018-06-01,1317211903,A017200,토마토,말린가지 500g /건가지/경북봉화,9000,9000,0
2018-06-01,475744104,A011170,떡,100%찹쌀! 노릇노릇 구워먹는 일본 정통 찰떡 키리모찌 400g(8개입) x 1봉,7900,7550,-350
2018-06-01,1156831272,E031120,믹서,[강력추천]국산 유니콘 파워믹서/엔젤에코/대용량 믹서기/3500cc/소형믹서기/핸드믹서,16900,16900,0
2018-06-01,645087167,E011050,책상,[블루밍홈] 베이직책상40/테이블/사무용/학생/컴퓨터,29900,26910,-2990
2018-06-01,2083114858,C013010,점퍼,#NAME?,80000,70400,-9600
2018-06-01,1122653482,E041010,식기,루미낙 루미락 나뭇잎 화채볼/공기13x6.26p,38000,36100,-1900
2018-06-01,1344800913,C013050,운동복,성에제거기/스크래퍼/성에칼/눈제거/물기제거/김서림,2500,2290,-210
2018-06-01,334229657,E061020,섬유유연제,[왕대용량+한박스특가!]*피죤 섬유 유연제 4210mlx4개,16900,16900,0
2018-06-01,1106823757,E021010,침구,사계절 구스 이불/피그먼트 패드/이불 커버 모음,32900,30270,-2630
2018-06-01,1289676638,C012060,여자내의,슈퍼렉스 반바지 레깅스 요가복 치마레깅스 요가팬츠,17400,17400,0
2018-06-01,1067289294,A012010,국산쇠고기,축협 1등급 한우 갈비선물세트 2.4kg 한우세트 갈비,200000,198000,-2000
2018-06-01,986249769,E041040,프라이팬,초L) 셰프 그릴팬(24CM),17900,17900,0
2018-06-01,1948636827,I053010,공책,토닥토닥 하루하루 일기장 하루 일일가계부 하루하루,11770,11770,0
2018-06-01,1010194795,L012060,샴푸,[LG생활건강] 시즌세트 리엔 1호(C6)X 5입,149500,94500,-55000
2018-06-01,239559116,A022030,생수,초정탄산수 플레인 1.5L x 12펫 탄산수 음료,14500,14500,0
2018-06-01,895799429,A019120,혼합조미료,[CJ]CJ 쇠고기 다시다 (300g),5990,5990,0
2018-06-01,2135258318,C013050,운동복,차량용소화기 소방차250,30750,27680,-3070
2018-06-01,895799427,A019120,혼합조미료,[CJ]CJ 쇠고기 다시다 (1kg),12950,12950,0
2018-06-01,1317042686,I031040,생화,아오맥스 원투낚시대 3종풀 세트/TV쇼핑/바다낚시대,124000,117800,-6200
2018-06-01,1003667117,A017220,양파,꼬레촌조미 파(흙대파)최상품 1kg/단,4900,4900,0
2018-06-01,20109350,E011010,장롱,서랍형 키높이2100 갤러리장/장농/이불장/수납,89000,80100,-8900
2018-06-01,2087648152,C012030,여자상의,[하랑이플] 여름신상 쿨민소매원피스(W) 빅사이즈원피스잠옷,9900,9900,0
2018-06-01,94188017,E031010,전기밥솥,쿠쿠 내솥 [J102] CRP-HET1061SB 밥솥 교체용,54350,54350,0
2018-06-01,1252658763,C013060,등산복,m2 여름 추가 등산바지아웃도어작업복등산복남성,14380,14380,0
2018-06-01,829400363,G011070,자전거,[한정수량] 아메리칸이글 브라이튼RC 픽시자전거,89000,89000,0
2018-06-01,718994761,C012020,원피스,트랜디한체크롱자켓(N181MSF007)/ 나이스클랍,139650,125690,-13960
2018-06-01,504647345,L021010,손목시계,안틱라운드스퀘어 블랙 손목 시계 손목시계 선물용시,115580,115580,0
2018-06-01,766213774,C013050,운동복,여성 반바지트레이닝복세트/운동복/추리닝/여름/치마,26900,26900,0
2018-06-01,1112501046,C012040,여자학생복,망사티셔츠/망사티/시스루/시스루티/무지티/티셔츠/티,11500,11200,-300
2018-06-01,613241261,E031110,청소기,사은품 싹스 로봇 물걸레 청소기 ARW-C100,372000,296450,-75550
2018-06-01,2060646680,A014030,치즈,코리원/코다노 모짜렐라치즈 AR 2.5kg/피자/조흥/치즈,22300,22300,0
2018-06-01,990061812,F011150,건강기능식품,[종근당] 프로바이오틱스 유산균 19 (60포) - 2박스 (4개월분),60000,22900,-37100
2018-06-01,1004693072,A017200,토마토,싱싱한 가지1kg 실속구매찬스,4950,4950,0
2018-06-01,1852829982,C014010,아동복,무료배송)신상남아정장/여름정장/남아정장/아동정장,46400,46400,0
2018-06-01,1239534453,A019180,즉석식품,맛있는여행 6종 3팩 + 바싹불고기 골라담기,19900,19900,0
2018-06-01,165851317,A018010,초콜릿,킨더 크리스피 초코볼 T16 1+1기획 초콜릿/간식/미니,8500,8500,0
2018-06-01,1804357008,L021020,장신구,[바보사랑]두산 베어스 김재환 멀티실 팔찌 화이트,18000,18000,0
2018-06-01,616646686,D031010,주택수선재료,아이생각 수성바니쉬 우드바니쉬 4리터,35000,33950,-1050
2018-06-01,1804357007,L021020,장신구,[바보사랑]펄 위시 드롭 실버귀걸이,16900,16900,0
2018-06-01,717667531,L012090,기초화장품,[메디큐브] 레드라인 플러스 3종 세트(하남점),112000,112000,0
2018-06-01,1804357004,L021020,장신구,[바보사랑]엔틱 쿼터 컷팅 귀걸이,35000,35000,0
2018-06-01,1804357003,L021020,장신구,[바보사랑]엔틱 쿼터 해머링 귀걸이,40000,40000,0
2018-06-01,895799434,A012060,햄및베이컨,CJ 스팸 200G*3입,11950,11950,0
2018-06-01,448865086,A018020,사탕,무료배송롤리팝아이스(70개입)2통아이스크림막대사탕,19700,19700,0
2018-06-01,895799433,A012060,햄및베이컨,[CJ]CJ 스팸 200G,4150,4150,0
2018-06-01,1811437921,I031040,생화,LED라이트/자전거라이트/후레쉬/led후레쉬충전식랜턴,43000,39560,-3440
2018-06-01,173927245,A014030,치즈,모짜렐라콜비잭체다고다에멘탈슬라이스치즈1kg~ 2kg,16640,16640,0
2018-06-01,1847818589,E011050,책상,노트북 테이블/노트북 받침대/좌식책상/모니터 받침대,19800,19800,0
2018-06-01,924461254,E021020,커튼,세진아트 아로마향파리문발/대나무발/갈대발/커튼발/문발/비닐커튼/비즈발/출입문커튼,7870,7870,0
2018-06-01,1049550996,C013020,티셔츠,줄배색레이스반티 RI1705 라운드넥티 큐티레이스티 라,41550,41550,0
2018-06-01,817922554,A018060,스낵과자,추억의 불량식품부터 수입과자까지 - 추억의과자/간식,950,950,0
2018-06-01,891346735,C013040,청바지,주니어청바지/초등학생바지/여아/초등학생옷/주니어옷,35200,35200,0
2018-06-01,603624206,C013020,티셔츠,[하프클럽/디키즈]시즌오픈 후드티/바람막이 최종가 35종_DK98C726,15000,13950,-1050
2018-06-01,1377942899,C012040,여자학생복,여성 어깨숄 패션 겨울 자켓 머플러 망토 스타일 담요,16640,16640,0
2018-06-01,1884772682,E031090,공기청정기,위닉스 뽀송 제습기 DN2M160-HWK 16L,385000,385000,0
2018-06-01,1181673263,C013050,운동복,23_고구마베이비 아기옷-무형광 슬라브 그레이 민소매,19110,18540,-570
2018-06-01,525580863,A011050,콩,[가온애]스낵 콘 김말이콘 고추맛콘 파래맛스낵 옥수수콘 팝콘 강냉이 주전부리 견과,3900,3900,0
2018-06-01,986249742,E041040,프라이팬,초L) 셰프 프라이팬 26CM,16900,16900,0
2018-06-01,1536358266,A013090,전복,개조개살 800g 백합조개 1kg 조개모음 대합조개 육수,3850,3850,0
2018-06-01,1367806308,A017220,양파,꼬레촌조미 파(흙쪽파)최상품 1.3kg x 10단,56300,56300,0
2018-06-01,1636855449,L021050,우산,여성 남성 레인코트 판초우의 우비 우의 비옷 성인,11000,10700,-300
2018-06-01,1204681339,A015020,식용유,올리타리아 포도씨유 500ml 5병 (스티로폼)/ 올리타리아,29900,29900,0
2018-06-01,1838393204,I011010,TV,인켈 TV 43인치TV UHDTV LEDTV LG패널 돌비24W 직영AS,420000,399000,-21000
2018-06-01,539261140,C011020,남자상의,[무료배송]블랙 체크 밍크털 코트 남자코트 남성털코,103720,103720,0
2018-06-01,457481281,I012010,컴퓨터,삼성 데스크탑5 DM500S7A-A58A i5/8GB/SSD128GB/1T,1057140,999000,-58140
2018-06-01,982641129,F012020,생리대,바디피트 볼록맞춤 중형(16P*4),15900,11900,-4000
2018-06-01,982641128,A012060,햄및베이컨,롯데 그릴비엔나 300G*2,9580,7490,-2090
2018-06-01,960327578,A011080,밀가루,초이스L 중면 900g,2290,2290,0
2018-06-01,724383087,C013060,등산복,[케이투(K2)][역시즌/가격인하] 마조람 5 (MAJORAM 5) _KMW15513(강남점),116280,116280,0
2018-06-01,1823980989,E061020,섬유유연제,샤프란3100ml용기 샤프란2000ml(리필)×6 섬유유연제,13700,13700,0
2018-06-01,452550363,E011010,장롱,나비 4자세트/틈새수납/원룸옷장/주니어가구셋트,108000,108000,0
2018-06-01,2112240864,C013050,운동복,아이야/ 여름신상 여성/커플트레이닝복 세트,23800,23800,0
2018-06-01,662594870,I011030,사진기,정품 니콘 P900s 초망원 광학83배줌 카메라 4종사은품,637270,559150,-78120
2018-06-01,120149349,E031070,에어컨,파세코 DC타워선풍기 PTF-MP7500AW 타워팬 선풍기,68900,68900,0
2018-06-01,1423047328,E021020,커튼,3색코디/ 2장세트/ 국산 프리미엄 암막커튼/방한.방풍,46000,39560,-6440
2018-06-01,495580863,A013040,고등어,제주도 간고등어/순살/자반/선물세트/특산물/특산품,34000,34000,0
2018-06-01,981749233,E061020,섬유유연제,F C 베이비전용 세탁세제 refill 유아세정제 아기전용,23890,23890,0
2018-06-01,1916368361,A019090,카레,청정원 카레여왕 108g*8개입 치즈/마늘/해물/망고,15800,15800,0
2018-06-01,293472864,C014010,아동복,아동 긴팔셔츠/ 아동 긴팔남방/ 아동 옥스포드셔츠 다크에디션/ 도톰한소재 옥스포드셔,21800,21800,0
2018-06-01,2126161022,A013040,고등어,A급 노르웨이고등어 100-120gX10개 대박특가!,9900,9900,0
2018-06-01,79333011,I011020,영상음향기기,비비텍 DS262 DX263 밝기3500 고화질 HDMI 빔프로젝터,450000,437000,-13000
2018-06-01,1999968208,C014020,유아복,아둘 가족티 유아 옐로우 팔라스 반팔티셔츠 12,11100,11100,0
2018-06-01,712219756,C012040,여자학생복,오픈루즈털조끼 IR1712 털조끼 여성조끼 토끼퍼조끼,127510,113490,-14020
2018-06-01,380415591,D031010,주택수선재료,kcc 워터씰/수용성발수제//방수와 발수가 동시 외벽,40000,40000,0
2018-06-01,990061842,F011150,건강기능식품,[종근당] N-아세틸글루코사민( 600mgX90정) -2병(6개월분),70000,33300,-36700
2018-06-01,1236192973,C013040,청바지,[시크헤라] 베이직워싱데님팬츠.A,36900,36900,0
2018-06-01,352879687,E051020,건전지,[1000회충전]-ALLO 대용량 3050mAH 충전지 4알/건전지,6000,5900,-100
2018-06-01,1561239869,E061030,전구,[대한민국최저가]오스람 EL20W 필립스/GE/전구/삼파장,640,640,0
2018-06-01,1265652051,C021040,실내화,컨버스 척 70S 빈티지 4종모음 DJ 149448C 162059C 142338C 144,68530,68530,0
2018-06-01,1804357035,L021020,장신구,[바보사랑]les 진주포인트 레이스 드롭귀걸이,10150,10150,0
2018-06-01,1804357034,L021020,장신구,[바보사랑]lasa 실버 볼드 체인 파티귀걸이,17150,17150,0
2018-06-01,1804357033,L021020,장신구,[바보사랑]landa 골드 롱 드롭귀걸이,8750,8750,0
2018-06-01,1804357032,L021020,장신구,[바보사랑]lana 하트팬던트 귀찌귀걸이,11550,11550,0
2018-06-01,243511826,F012010,종이기저귀,하기스 매직팬티 4단계 5단계 기저귀 남아 여아 92p,33900,33900,0
2018-06-01,1804357031,L021020,장신구,[바보사랑]laia 하트 팬던트 볼드 링귀걸이,12250,12250,0
2018-06-01,990034222,A019010,고춧가루,초L 국물용고춧가루 120G,9900,9900,0
2018-06-01,2135258358,C013050,운동복,가정용소화기 소방차450,38290,34470,-3820
2018-06-01,1804357030,L021020,장신구,[바보사랑]큐빅진주언발드롭귀걸이,14000,14000,0
2018-06-01,1137502902,A019040,소금,해마루 함초 명품 천일염,12500,12500,0
2018-06-01,393942899,C012040,여자학생복,T185TS4Z001(/127비치니트)/ 토모톰스,19800,18810,-990
2018-06-01,503333149,C014010,아동복,폴로랄프로렌 아동용 옥스포드지 반팔 남방6-7세,22000,22000,0
2018-06-01,987319213,A013140,북어채,[바다원]꼴뚜기 100g,6200,6200,0
2018-06-01,987319215,A013140,북어채,[바다원]북어머리 200g,6000,6000,0
2018-06-01,1861673700,A016030,복숭아,황도캔(2절 화남820g)X12개/황도캔 복숭아캔 황도 과,42900,40330,-2570
2018-06-01,380679008,E011040,소파,크리스탈쇼파/3인용쇼파/거실쇼파/오피스텔/상가/,210000,210000,0
2018-06-01,1437404232,E061050,청소용세제,홈스타 락스와세제750mlX4개/유한락스2L특가/곰팡이싹,11900,11900,0
2018-06-01,1374597857,L021060,유모차,2018 뉴 세스토라이트 기내반입 절충 휴대용 유모차,328000,328000,0
2018-06-01,423531129,A011100,라면,당면(찰 낙타 1K)X10,132510,132510,0
2018-06-01,772241719,A012050,소시지,무료배송!! CJ 맥스봉치즈 560g x 2개 (32개입),12900,12900,0
2018-06-01,1409551512,I012010,컴퓨터,컴퓨존 삼성전자 DM500T7A-A34A,735780,699000,-36780
2018-06-01,446530835,C013020,티셔츠,[무료배송]빅사이즈 DWW018A 굵은 끈 심플 후디 802,45500,45500,0
2018-06-01,296285042,I053010,공책,GT 모닝 초등 한문노트 10칸 남 초등학교노트 초등한,5230,5230,0
2018-06-01,989910040,F012020,생리대,[LG]LG) 한결카테킨대형 16P,6300,6300,0
2018-06-01,1625649426,I031010,장난감,레고 장난감 블럭 블록 정리함 보관함,1800,1800,0
2018-06-01,429030310,A019070,양념소스,[샘표]닭갈비 불고기 낙지볶음 떡볶이 갈비소스양념장,1690,1690,0
2018-06-01,413108282,E011060,의자,[BC체어]뉴타이탄 사무용 컴퓨터 PC방 게이밍의자,74900,67410,-7490
2018-06-01,1297138285,C013010,점퍼,MJ-165 화이트 스티치 데님 자켓-흑청 캐주얼점퍼 남,52980,52980,0
2018-06-01,1010529938,D031010,주택수선재료,노루페인트 락카 신나(DR-170L) 17L,27200,27200,0
2018-06-01,1307809385,C012060,여자내의,물결 밴딩 프릴 스커트 밴딩치마 언발치마 언발스커트,38650,38650,0
2018-06-01,895775405,A019150,김치,[종가집]종가집 포기김치 (500G),6950,5290,-1660
2018-06-01,582110422,A013130,오징어채,정화 맥반석 진미오징어 ( 채 ) 30g x 5,21600,19230,-2370
2018-06-01,896770642,A016030,복숭아,영동 하우스 백도 복숭아 1kg,19900,19900,0
2018-06-01,895775408,A019070,양념소스,[진미]진미 춘장 300g,1300,1300,0
2018-06-01,1144687897,I031040,생화,2018 new샤이니 전기식4300루멘 캠핑랜턴 충전식랜턴,50500,50500,0
2018-06-01,304745542,E031080,선풍기,다이슨 핫앤쿨 AM-09 / 이벤트,548000,515120,-32880
2018-06-01,659649224,C013020,티셔츠,[에이비에프지] 여름특가 자켓/티셔츠/블라우스 9 000원~,29000,9000,-20000
2018-06-01,1098328906,E021010,침구,세미마이크로 차렵이불세트/이불패드세트/토퍼세트,49900,49900,0
2018-06-01,1609095937,C013020,티셔츠,뮤라스 여자 후드티 55~77까지 티셔츠 맨투맨 긴팔,7900,7900,0
2018-06-01,679711444,A022030,생수,골드메달애플주스 (100%주스 스파클링) (296ml*12병),18300,18300,0
2018-06-01,1356098674,C011030,남자학생복,남자상하의 포켓 린넨 조끼 상하의세트 / 참고 남자코,78300,66560,-11740
2018-06-01,952936615,A018060,스낵과자,[서울]서울 뻥이요 골드(140g*2입),2300,2300,0
2018-06-01,864333478,E061020,섬유유연제,(특가) 피죤 섬유유연제 2100mlx3개 피존/리필/용기,8900,8900,0
2018-06-01,1004778817,E031080,선풍기,FUJIKA 공기청정 온풍기히터 FU-408(3.5kw) 가정용전,630910,630910,0
2018-06-01,2135018863,C013020,티셔츠,[인디고키즈]앵커 그래픽 티셔츠_IKRA74G6,5900,3900,-2000
2018-06-01,1010407144,A014010,우유,빙그레 오디맛우유 240ML,1070,750,-320
2018-06-01,1463982185,A017140,콩나물,강화섬 백도라지 분말100g/엑기스/환/건도라지 차용/100% 강화산 도라지/강화군 산림조,22400,22400,0
2018-06-01,188955196,A013170,생선통조림,[사조] 살코기 참치 100g 10묶음 안심따개 참치캔 통조림,12500,12500,0
2018-06-01,568906976,C013020,티셔츠,[추가할인/3+1]엠블러 남녀 반팔티/티셔츠/에코백모자,9900,9900,0
2018-06-01,589126846,F011150,건강기능식품,RU21(6정) 6갑 알유21/알유/비타민씨/숙취해소,14900,14900,0
2018-06-01,1120722129,C012060,여자내의,여름신상 청미니스커트빅사이즈치마바지데님밴딩H라인,12900,12900,0
2018-06-01,1651505730,C012060,여자내의,푸조 여성 워테레깅스 (S26-2 ),29380,26150,-3230
2018-06-01,2124329627,I011030,사진기,소니 DSC-RX100M4 정품 명품,780780,780780,0
2018-06-01,693846471,C011030,남자학생복,여름신상 프린트 셔츠 남방 7부 반팔셔츠 솔리드 체크,14700,14700,0
2018-06-01,834337344,E011040,소파,1인쇼파 패브릭쇼파 리클라이너쇼파 각도조절가능,125000,125000,0
2018-06-01,347599375,I031010,장난감,소니 PS4 Pro/CUH-7117BB01/제트블랙/1TB,678530,678530,0
2018-06-01,990085866,A011010,쌀,L'grow 농부의미소 5KG,15900,15900,0
2018-06-01,464066607,C013010,점퍼,[나이스클랍][18년 여름]멋스러운 후드 점퍼(N182MSJ004),259000,209670,-49330
2018-06-01,1456160532,C012030,여자상의,[공구우먼] 비오타 플라워 원피스 29579 빅사이즈 여성의류,49000,49000,0
2018-06-01,1408505289,C013010,점퍼,[보니알렉스]소매밴딩 썸머간절기 바람막이점퍼(BBUB590C),49000,41650,-7350
2018-06-01,907424058,A017080,무,강화사자발쑥 쑥차 30개입_1개/발효 약쑥차 티백형,12800,12650,-150
2018-06-01,1908448633,A012040,닭고기,[아임닭] 부드러운 닭가슴살 15+1 특가 패키지,37500,37500,0
2018-06-01,610641056,A019090,카레,전품목 할인가/3분요리 /카레 짜장 스프 즉석밥 햇반,990,990,0
2018-06-01,274530649,E061100,습기제거제,물먹는코끼리 반영구 천연 제습제+탈취제+곰팡이/제습,7900,7900,0
2018-06-01,296285006,I053010,공책,GT 모닝 초등 한문노트 10칸 여 한문노트 어린이과목,5230,5230,0
2018-06-01,112374765,C012040,여자학생복,[클라이드] 여성 자수 집업 가디건_FIASW650F_NC아울렛,89800,44900,-44900
2018-06-01,480635765,C013010,점퍼,허리 스트링 후드 점퍼 RHJPHC970/ 리안뉴욕,30000,27000,-3000
2018-06-01,1458216972,E031110,청소기,[특가]일렉트로룩스 다이나미카 프로 청소기 EDYL35OR,79000,79000,0
2018-06-01,910751130,I031010,장난감,레고60141 경찰서/시티/국내빠른배송,126600,113940,-12660
2018-06-01,480635769,C012020,원피스,루즈핏 모직코트 SJAWAO010/ 리안뉴욕,79000,71100,-7900
2018-06-01,749323979,A014050,달걀,두레생협 올레길깐볼(250g/제주),17410,17410,0
2018-06-01,821004115,C013040,청바지,아둘 가족티 쥬니어 상하세트 시그니처 조던 21,25500,25500,0
2018-06-01,1282867144,C014010,아동복,[젤리스푼] 30%쿠폰할인 아동여름코디룩,8900,8900,0
2018-06-01,1376850743,C011030,남자학생복,멋진남자필수/실크셔츠/와이셔츠/맞춤셔츠/남성셔츠,68900,68900,0
2018-06-01,648539017,E031050,냉장고,인증 18년형 위니아딤채김치냉장고 WDQ47BLMTST 457L,1738540,1669000,-69540
2018-06-01,1859166764,C012040,여자학생복,(무료배송) (해외직배송)니트 베스트 여자니트 니트베,42520,37420,-5100
2018-06-01,1784167354,L021020,장신구,[바보사랑]동글진주 트라이앵글 귀걸이,11900,11900,0
2018-06-01,1784167356,L021020,장신구,[바보사랑]엔틱 데일리 귀걸이 세트,9900,9900,0
2018-06-01,321004583,C013040,청바지,빈티지 워싱 데미지 청반바지 데님반바지 멋진청반바,15730,15730,0
2018-06-01,1784167357,L021020,장신구,[바보사랑]엘프 비즈 드롭 귀걸이 (무니켈침),11900,11900,0
2018-06-01,1784167358,L021020,장신구,[바보사랑]제이로렌 M02452 플라워리본 로즈골드 하트귀걸이,12000,12000,0
2018-06-01,1784167359,L021020,장신구,[바보사랑]제이로렌 M02558 봄날 로즈골드 하트 자개꽃 귀걸이,24000,24000,0
2018-06-01,209843968,E011020,침대,한샘 샘베딩 클로즈 침대 하부서랍형 6종/택1,533110,533110,0
2018-06-01,1432292944,A022010,주스,[무료배송]웅진)초록매실(병) 180ml12개입 초록매실,14840,14840,0
2018-06-01,328608116,A018090,잼,허쉬 초코스프레드 368G 초코렛잼,14540,14540,0
2018-06-01,895799488,A013170,생선통조림,유동 골뱅이 140g,4400,4400,0
2018-06-01,794243660,E031080,선풍기,린나이 벽걸이형 가스스토브 RHS-650W (2단화력/46㎡),195300,195300,0
2018-06-01,195120490,C013020,티셔츠,늘어짐x 면스판 나시 민소매/쫄티/런닝/남자나시/남성,6900,6900,0
2018-06-01,1497053108,E021010,침구,굿몽 마이크로 기숙사이불 펜션 차렵이불 베개세트,19800,19800,0
2018-06-01,1468470674,A012010,국산쇠고기,[무항생제] 불고기 600g 1등급,30400,30400,0
2018-06-01,496987215,C012040,여자학생복,수지네 구제 나이키 블랙 덕다운 패딩조끼 여성 M 20-,42380,42380,0
2018-06-01,1685646447,C013020,티셔츠,[하프클럽/타미힐피거]타미힐피거 반팔 커스텀핏 폴로티셔츠,39900,39900,0
2018-06-01,1297584399,C013020,티셔츠,[행텐] 여성 레터링민소매 티셔츠 10120-133-404-05 NC아울렛,12800,5000,-7800
2018-06-01,1717186900,A014020,분유,[아이배냇] 순산양분유 2단계 400g,16900,16900,0
2018-06-01,1349251950,E031020,가스레인지,벽고정레인지후드 스테인리스 유리 060 마텔스카레/,297460,264740,-32720
2018-06-01,954816429,A016130,키위,데라웨어 (200G내외/팩),3990,3990,0
2018-06-01,1629413996,C013040,청바지,남자/남성/스판/블랙진/밴딩/배바지/일자/중년/청바지,26800,26800,0
2018-06-01,895799496,A015010,참기름,CJ 진한참기름 110ML,3990,3990,0
2018-06-01,895799497,A015010,참기름,백설 진한참기름 320ML,7990,7990,0
2018-06-01,1266073716,C012060,여자내의,jj42 꽈배기니트 미디스커트_블랙 스커트 미디스커트,14000,13860,-140
2018-06-01,895799494,A018080,설탕,[CJ]CJ 갈색설탕 1KG,2270,1990,-280
2018-06-01,895799495,A018080,설탕,CJ 갈색 설탕 (3kg),6270,5790,-480
2018-06-01,895799492,A018080,설탕,[CJ]CJ 하얀 설탕 (3kg),5090,4590,-500
2018-06-01,990085870,A011010,쌀,L'grow 씻어나온한끼톡고시히카리 150G*10입,8990,8990,0
2018-06-01,895799490,A013170,생선통조림,유동 자연산골뱅이 400G,9490,9490,0
2018-06-01,1416344403,F012020,생리대,위스퍼 후레쉬라이너 향 일반40P x 10팩 (총400P),29600,29600,0
2018-06-01,895799491,A018080,설탕,[CJ]CJ 백설 하얀설탕 (1kg),1790,1490,-300
2018-06-01,953984230,A011090,국수,팔도 짬뽕왕뚜껑 (110g),950,950,0
2018-06-01,61144861,I031040,생화,[마운틴컴퍼니] SOS 긴급 구호세트 캠핑용품 안전용품 캠핑장비 캠핑,23430,21350,-2080
2018-06-01,664813046,E041070,밀폐용기,젓갈병/젓갈통/된장/고추장/생수병/생맥주병/페트병/1,290,270,-20
2018-06-01,985387758,E061080,키친타월,스카트항균 빨아쓰는 타올_45매*2롤,7500,5990,-1510
2018-06-01,1214092210,A014030,치즈,크로네 모짜렐라치즈2.5kg/자연치즈 100%/아이스망고,20900,20900,0
2018-06-01,1032786954,F012020,생리대,[예지미인] 건강한 예지미인 늘 산뜻한 예지미인 롱라이너 40P,2100,2100,0
2018-06-01,2069957786,A018080,설탕,유기농 비정제 설탕 25kg/20kg/황설탕/매실/과일청,54900,54900,0
2018-06-01,1947336874,C011020,남자상의,고품격 봄 여름 자켓 정장 콤비 마이 블레이져 남성,59500,59500,0
2018-06-01,1183795146,C013010,점퍼,[보니알렉스](보니알렉스) 인디야상 짚업셔츠(BCUY201A),25500,22440,-3060
2018-06-01,1479830605,E031110,청소기,(디베아)국내AS/무선청소기/보증2년/C19B/원목거치대,169000,159000,-10000
2018-06-01,698562487,E041010,식기,광명유기 1인/2인 반상기 유기그릇 놋그릇 부모님선물,100000,91080,-8920
2018-06-01,1990836113,C013010,점퍼,YAN2166 양털집업자켓 겨울자켓 캐주얼집업 털집업 여,15790,15790,0
2018-06-01,1232874933,L012090,기초화장품,[동인비] 윤 2종 기획세트+사은품 증정(의정부점),100000,85360,-14640
2018-06-01,749323923,A014050,달걀,두레생협 올레길깐볼(700g/제주),32320,32320,0
2018-06-01,895799462,A015020,식용유,[CJ]CJ 옥배유 (1.8L),8810,8810,0
2018-06-01,1142978178,A013050,오징어,펭귄 꽁치캔 (400g) x24,70700,70700,0
2018-06-01,284408459,C012060,여자내의,비앙카 허리리본 통바지 DM 5861,17430,17430,0
2018-06-01,224371494,F012020,생리대,좋은느낌 코텍스 오버나이트 생리대 10매 외 구성,1400,1400,0
2018-06-01,833149021,C013010,점퍼,[앙팡] 앙팡 래쉬가드 집엎 (핑크) 핑크 아이옷 아동복 집엎,24780,24780,0
2018-06-01,4379843,A012040,닭고기,[아임닭] 맛있게 먹는 닭가슴살 큐브 5종 골라담기,1950,1950,0
2018-06-01,281208181,C012030,여자상의,[공구우먼] 가넷 언발 원피스 29699 빅사이즈 여성의류,29000,29000,0
2018-06-01,442908267,A013060,게,한치 마른화살오징어(2s 50미)1kg 2개,184320,184320,0
2018-06-01,1890450329,I031010,장난감,전동 오토바이 에버바이크 선물 유아 스쿠터 사이클,113200,109810,-3390
2018-06-01,582229623,F012020,생리대,예지미인 울트라슬림 날개 소형 16개입 x 40,179060,159370,-19690
2018-06-01,20810979,L012090,기초화장품,(1+1)슈퍼푸드 블루베리 대용량 스킨+로션/선크림,14500,14500,0
2018-06-01,83891191,A014020,분유,헤모틴틴베이비(1gx60포)2캔/비타민/철분제,25900,25900,0
2018-06-01,1278180048,F012010,종이기저귀,[공식]백조기저귀200p~300p 골드/산모패드/신생아,23900,23900,0
2018-06-01,1742346859,F012020,생리대,시크릿데이 생리대 러브 오버나이트10PX6팩,15500,14730,-770
2018-06-01,1266572712,C013020,티셔츠,쿨론 V넥 반팔(3XL)/냉감/단체티/티셔츠(쿨론티)/ 특,9940,9940,0
2018-06-01,1814468606,A019040,소금,자죽염알갱이250g 영평죽염 개암죽염 9회죽염 죽염수,65000,64350,-650
2018-06-01,925213266,C013020,티셔츠,베이직하우스 HRTS0101 순면라운드반팔오리지널팩3PCS,15900,14310,-1590
2018-06-01,1836578741,C011020,남자상의,남성 캐주얼자켓 정장 남자 자켓 빅사이즈,51800,49800,-2000
2018-06-01,1451525975,A018100,꿀,뉴질랜드 마누카꿀x1kg UMF5+ 마누카 수입꿀 천연벌꿀,138000,136620,-1380
2018-06-01,180525663,C012060,여자내의,와이드 밴딩 팬츠(8컬러) 44 77가능한 시원한 와이드,17040,16190,-850
2018-06-01,500015795,E041020,컵,리자인 무광 예쁜 커피잔세트 찻잔세트 모음,5500,5500,0
2018-06-01,826165603,I011010,TV,UHD-65F / 65인치UHDTV / 삼성정품패널 패널2년무상AS,699000,699000,0
2018-06-01,1806269301,E011030,거실장,[Joybee] 조이비 메쉬 모기장 텐트 몽시느 퀸 매트,65000,65000,0
2018-06-01,985410576,E041070,밀폐용기,PET)블루 원형 과실주병_20L,8900,8900,0
2018-06-01,462673869,C013010,점퍼,수퍼노바 스톰 자켓 화이트 트레이닝복 운동복 스톰자,141530,138700,-2830
2018-06-01,1806269300,E011030,거실장,[Joybee] 조이비 메쉬 모기장 텐트 몽시느 슈퍼싱글 매트,55000,55000,0
2018-06-01,1342207460,E061060,살충제,잡스에서 개발한 바퀴벌레 개미 좀벌레 벼룩 빈대에,12290,12290,0
2018-06-01,537476068,A022050,탄산음료,롯데칠성몰 트레비 300ml/355ml/500ml/1.2L,12000,12000,0
2018-06-01,1793204690,A019060,된장,신송 짠맛 줄인 된장(500G),2100,2100,0
2018-06-01,231791546,C015020,모자,[뉴에라]정품2017신상품특가세일/캐릭터힙합스냅백MLB,38000,38000,0
2018-06-01,441128396,C013030,스웨터,7부단가라니트(RMD_1603) 라운드 여성큰니트티 라운드,18820,18820,0
2018-06-01,1089691926,C013010,점퍼,걸크러쉬 슬림 가죽 자켓-m1071 (블랙) 가죽자켓 여성,55310,55310,0
2018-06-01,1637599816,L021020,장신구,은팔찌 925실버 체인 순은 남자 커플 각인 15 10 7 5,52900,52900,0
2018-06-01,450280537,A013150,어묵,금진 모듬어묵전골320g2개 전골 어묵전골 모듬어묵전,14710,13240,-1470
2018-06-01,1697395205,E031090,공기청정기,공식판매 위니아 공기청정기 에어캐스터 EPA16DAAP,209470,199000,-10470
2018-06-01,896637483,A014010,우유,[서울]서울목장저지방우유 (1L),3060,3060,0
2018-06-01,333931268,A017150,버섯,[제주푸드마씸]제주 건취나물 50gx3봉 / 무료배송,14700,13970,-730
2018-06-01,1448009675,A012050,소시지,사조오양 꼬마장사1000g/1300g/1400g(3종),6900,6900,0
2018-06-01,1138932065,C014020,유아복,[30%쿠폰]베베쥬 여름 특가+30%쿠폰+3%OK캐쉬백+무배,5900,5900,0
2018-06-01,124326552,A013160,맛살,올리브녹차 돌자반 70gx20개 입안에서 살살녹는 고,54690,54690,0
2018-06-01,1053303344,A022050,탄산음료,[코카콜라] 씨그램 라임 345ml x24,11400,11400,0
2018-06-01,986689998,E031020,가스레인지,동양매직 빌트인 가스 오븐 레인지/GOR-B5B01S ;,677500,677500,0
2018-06-01,988154502,F012020,생리대,[유한킴벌리]좋은느낌 울날중 36P,10900,10900,0
2018-06-01,1446940114,A016070,귤,2018년 하우스감귤 첫출하 3kg/5kg,19900,19900,0
2018-06-01,1419990346,I031040,생화,캠핑용품 100종/캠핑테이블 캠핑매트 랜턴 캠핑가방,590,590,0
2018-06-01,1239749365,C011030,남자학생복,봄신상 가디건 니트 집업 남자 남성 브이넥 스웨터 숄,17900,17900,0
2018-06-01,986249715,A017130,도라지,초L프레시)한끼간편손질야채3종(당근 감자 양파/팩),5990,2990,-3000
2018-06-01,1784167381,L021020,장신구,[바보사랑]제이로렌 M02557 로브하트 언발 크리스탈볼 귀걸이,43000,43000,0
2018-06-01,1784167383,L021010,손목시계,[바보사랑]젤리 전자시계,5000,5000,0
2018-06-01,247230519,A017250,고사리,18년 아스파라거스 1kg 무료배송 산지직송,22900,22900,0
2018-06-01,89845229,F012020,생리대,무료배송 템포 슈퍼 리뉴얼 10P X 3팩/ 템포,10900,10360,-540
2018-06-01,756349185,D031010,주택수선재료,뮤럴벽지 실크 합지벽지 포인트 시트지,12500,12500,0
2018-06-01,502713784,C021010,아동화,타이니 플라워 포인트 유아신발(120-140mm) 900042 유,26400,26400,0
2018-06-01,1752850291,E011030,거실장,아네트 스위트 수납장,320000,320000,0
2018-06-01,957495442,A011080,밀가루,[백설]백설 제일제면소 소면 900G,3490,3490,0
2018-06-01,232726934,C012040,여자학생복,여성 긴팔 하찌 언발 니트 폴라 티셔츠 목 티 터틀넥,23460,23460,0
2018-06-01,1143630175,I031040,생화,[감사특가+사은품+무배]에밀리온 프리미엄 동계 침낭,32800,29270,-3530
2018-06-01,1134539373,C012060,여자내의,신상 청스커트 3부/A라인/플레어/미니/청치마,9900,9900,0
2018-06-01,1743676281,A017220,양파,대파분말(중국산) 300g/대파/파/가루/선식/제빵/육수,7000,7000,0
2018-06-01,777754494,C013010,점퍼,아디다스 유소년 콘디보16 스타디움자켓 (AN9871 ),139540,124200,-15340
2018-06-01,1356218822,E021010,침구,(MSO나르는 양탄자40수 누비면 매트 커버(황토색-퀸),80500,80500,0
2018-06-01,1095816008,E021020,커튼,/벌집블라인드 베이지 호프발스 140x155 cm/ 롤스크린,71460,63600,-7860
2018-06-01,538984596,C012040,여자학생복,[아디다스] W studio ZHDY_nc아울렛,68000,34000,-34000
2018-06-01,899585613,A017180,호박,꽈리고추 (봉),1990,1000,-990
2018-06-01,494072282,C011030,남자학생복,국산 최고급 남성 가디건/니트가디건/울/니트자켓/110,39800,39800,0
2018-06-01,466369876,C012020,원피스,[모다아울렛][레노마레이디]체크 바바리 Q3C731BB800A,120000,114000,-6000
2018-06-01,991080656,E061040,부엌용세제,대용량 수입 고농축세제 2660ml 울트라조이/에이젝스,10490,10490,0
2018-06-01,353487177,E031030,전자레인지,SK매직 20L 고급형 전자렌지 MWO-20EC3[1년 무상A/S],72230,72230,0
2018-06-01,1108035246,A017280,김,(냉장)두원 꼬들슬라이스1kg 꼬들 식자재 슬라이스 식,8970,8970,0
2018-06-01,1685717541,C012060,여자내의,[TOP 10]여성 린넨코튼 미디 스커트MSY2RS2001(영등포점A),39900,36780,-3120
2018-06-01,2070006224,C012020,원피스,빅사이즈/테일/오픈/가디건 / 참고 테일오픈가디건 빅,48700,39940,-8760
2018-06-01,354403302,E031120,믹서,독일비앙코믹서기 MB6100J/JP 만능믹서기 파워블렌더,439000,424140,-14860
2018-06-01,1733988226,A012040,닭고기,[아임닭] 수제 닭가슴살 스테이크 15+1 특가 패키지,33500,33500,0
2018-06-01,266489843,L021020,장신구,[폭스타일] [실버] 빈스 반지,9000,8190,-810
2018-06-01,674672566,E021010,침구,굿몽 면 요 토퍼 침대토퍼 베개세트 사계절 토퍼,21800,21800,0
2018-06-01,1197645040,C011050,남자내의,지오다노 남 린넨 코튼 이지 팬츠 118529,31450,31450,0
2018-06-01,1409252912,L012060,샴푸,[아모레퍼시픽] 아모스 녹차실감 샴푸액 500g 2개(지성),37900,37900,0
2018-06-01,1034202986,A019080,고추장,[권기옥명인] 비빔밥 나물 고추장 60gx10팩,24900,24900,0
2018-06-01,1034202985,A019080,고추장,[권기옥명인] 비빔밥 나물 고추장 골라담기,8500,8500,0
2018-06-01,1691972998,A019160,밑반찬,스니커즈 미니스 1745G / 초콜릿 믹스바 초코바,19680,19680,0
2018-06-01,1034202988,A019080,고추장,[권기옥명인] 비빔밥 나물 고추장 60gx3팩,8500,8500,0
2018-06-01,1730377015,C011050,남자내의,인견나염8부바지 천연섬유인견 시원한 여성 8부파자마,10630,9470,-1160
2018-06-01,1034202987,A019080,고추장,[권기옥명인] 비빔밥 나물 고추장 60gx5팩,14200,14200,0
2018-06-01,228102186,C021020,구두,[스펠로](spello)남성 XL드레스 초경량화 EPDR7103DR(의정부점),254400,222100,-32300
2018-06-01,1732159674,C011050,남자내의,아로미 805/고무꽃 허리 고무밴딩 스프사 8부 파자마,10870,9680,-1190
2018-06-01,895895591,L012090,기초화장품,[보령]아토마일드모이스춰샴푸350ML,15300,15300,0
2018-06-01,1508116054,A019080,고추장,알찬고추장4.5kg / 순창궁고추장/쌈장/ 재래식된장6.5,11300,11300,0
2018-06-01,303984257,G011070,자전거,삼천리자전거/팀키즈SF22 /어린이자전거 캡틴SF22,138000,124000,-14000
2018-06-01,869600027,A017300,미역,대천참다온김/김/대천김/광천김/김선물세트,5500,5500,0
2018-06-01,1931679641,A021010,커피,400g 핸드드립 전문 로스팅/원두커피/원두,10900,10900,0
2018-06-01,243557570,C013050,운동복,현대모비스 그랜드카니발 전면범퍼가드/앞범퍼,160000,147200,-12800
2018-06-01,1601914126,E011020,침대,[동서가구]LV 스퀘어 LED통판침대 슈퍼싱글/퀸/조명,336000,299000,-37000
2018-06-01,2083924307,C011050,남자내의,(SR)MHA530 남자빅사이즈조거스판면바지 /(참고)벌룬,67800,59670,-8130
2018-06-01,388164600,C015030,넥타이,(색상 : 그린) BTIE_112 땡땡이 두꺼운 니트,15140,15140,0
2018-06-01,2092757643,L021030,가방,중고 삼성 노트북 가방 15.6,4900,4900,0
2018-06-01,1774891794,F011130,홍삼,굿베이스 홍삼담은 자연흑마늘(50ML*30입),51300,51300,0
2018-06-01,1782507064,C013010,점퍼,[지오다노] 롯데단독상품 377513 여 레인 코트/ 지오다노,25000,20250,-4750
2018-06-01,2013645448,E011040,소파,보니타빈백 SM05 북유럽스타일,119900,119900,0
2018-06-01,922040903,C012030,여자상의,원로즈 자수 데님원피스,18750,18750,0
2018-06-01,900475497,A011090,국수,[농심]농심 신라면 큰사발 (114G),1090,1090,0
2018-06-01,293119308,C013010,점퍼,DPG1517 소빅 포켓 야상 803S 여성야상점퍼 여성점퍼,150730,150730,0
2018-06-01,900475499,A011180,파스타면,[농심]농심 얼큰한 너구리 (120G),760,760,0
2018-06-01,989016524,A018010,초콜릿,초L 다크56.5% 초콜릿 35G,990,990,0
2018-06-01,2121019310,C015040,장갑,란체티 삼각퍼헤리 여성 순모장갑 TL-6503 여자장갑,26500,26500,0
2018-06-01,1589676558,A021020,차,커피파우더모음전 포모나/타코/세미/녹차/라떼 파우더,9800,9800,0
2018-06-01,367712331,C013040,청바지,여름 청반바지 5부 7부 밴딩 남자 남성 면 반바지,12900,12900,0
2018-06-01,1376064721,F012020,생리대,시크릿데이 입는 오버나이트2PX5팩/밤새 안심/생리대,9900,9900,0
2018-06-01,540129019,I012010,컴퓨터,기습초특가 7%추가할인! 최종650070원! NT500R3W-LD5A,735780,699000,-36780
2018-06-01,372627444,C014010,아동복,[젤리스푼][젤리스푼] 설레는야옹날개상하복_MO,12900,11610,-1290
2018-06-01,371555474,A011170,떡,(무)금성 쌀떡(떡국떡)3kgX4개 쌀떡 식자재 떡국 금성,31770,31770,0
2018-06-01,1216087650,C013010,점퍼,[제이블리]버클넥 라이더 무스탕 00034,141000,124080,-16920
2018-06-01,1731381381,L021050,우산,예쁜우산특가/3단자동/장우산 아동우산 2단/골프우산,6950,5750,-1200
2018-06-01,73199531,C014010,아동복,CCVABMCB01 첨이첨이 공룡세트 면 남아동 실내복 3종,21000,20580,-420
2018-06-01,29411423,A019030,생강,국산 햇 흙생강 3kg,23900,23900,0
2018-06-01,1432823247,C013020,티셔츠,[준옴므]골지 기본나시/사각나시/비치웨어/국산,6900,6900,0
2018-06-01,1495194888,C013010,점퍼,빅사이즈 DSM1044 빅 포인트 울 자켓 801 여성빅사이,89850,89850,0
2018-06-01,1986028081,A019040,소금,선운산 9회죽염 250g+휴대용8g 자죽염 알갱이분말선택,53800,53800,0
2018-06-01,907510464,I031040,생화,침낭 자충식 에어매트 자충 캠핑매트 캠핑용품 텐트,11900,10420,-1480
2018-06-01,1026583629,C013040,청바지,밴딩데님배기팬츠/청바지/스키티진/연청/진청/카고,9900,9900,0
2018-06-01,1967774067,C011030,남자학생복,레귤러 아워글래스 패턴 블루 셔츠 블루셔츠 슬림셔츠,26270,25490,-780
2018-06-01,340396037,C013050,운동복,55~88 루즈핏 훌나시 3부팬츠 세트 빅사이즈 비치웨어,15900,15900,0
2018-06-01,1828599970,C011020,남자상의,국내산 신상품 봄/여름 캐주얼/정장 자켓/콤비/마이,59500,59500,0
2018-06-01,1339984850,C015040,장갑,스퀘어 양피장갑(남성) 양가죽장갑 신사용가죽장갑 남,17550,17550,0
2018-06-01,1828587905,C011030,남자학생복,10% 추가할인[아메리칸트위스트] Twist Pelin 남성가디건/정장가디건/롱가디건/니트/울,43800,30660,-13140
2018-06-01,378415661,C013020,티셔츠,랄프로렌 폴로 반팔 기본 카라티 /남녀공용,39000,39000,0
2018-06-01,1265869580,L021010,손목시계,로제타 여성 손목시계 FW-22 시계 손목시계 팔찌 팔찌,14300,14300,0
2018-06-01,1308493554,C012040,여자학생복,MJ_1221 카키 양털 조끼 털조끼 캐주얼조끼 조끼 여성,29430,29430,0
2018-06-01,498275575,I011030,사진기,캐논총판 5DMARK IV+뱅가드 HAVANA 48 백팩증정UP,3958000,3641360,-316640
2018-06-01,983353168,A011010,쌀,[금과농협] 해로빚은쌀 백미 20kg,70900,70900,0
2018-06-01,385682046,E031110,청소기,파트너M 삼성모션싱크 진공청소기 VC33M7151LW,356220,319000,-37220
2018-06-01,673156715,I031040,생화,노스베어 아이스박스 4종 미니 캠핑 소형 휴대용 차량,13000,10950,-2050
2018-06-01,601689129,E061060,살충제,권연벌레 페르몬 끈끈이트랩,10000,8400,-1600
2018-06-01,922039941,C012030,여자상의,큐티 데님 미니 원피스,24470,24470,0
2018-06-01,334832650,C013010,점퍼,슈퍼렉스 남자 후드 자켓 가디건 봄 야상 후드집업,19800,19800,0
2018-06-01,189026948,E041020,컵,leah 엔틱 커피잔세트 5인조 / 찻잔 머그컵 머그잔,79010,79010,0
2018-06-01,1034951095,I031010,장난감,아하토이 붕붕카/키즈트레인/붕붕카/장난감,33900,33900,0
2018-06-01,2119416419,A019180,즉석식품,CJ 고메 특별할인/함박/미트볼/로제치킨/포테이토,19900,19900,0
2018-06-01,428621967,A011140,부침가루,[삼립] 삼립 뉴욕치즈 58g 3개 케이크 조각케익,6840,6840,0
2018-06-01,1493436701,C011030,남자학생복,남성용 40수코튼슬럽 윈도우 체크 7부 셔츠(FHMMCSS112)/ 흄,19900,17320,-2580
2018-06-01,449296597,C012020,원피스,벨라울싱글우븐코트(7156416203)/ 보브(의류),279000,237150,-41850
2018-06-01,1196127027,C011050,남자내의,[캘빈클라인진]남성 CK 로고 티셔츠(4AOKQ98),35100,29490,-5610
2018-06-01,528885370,C014020,유아복,[보니또] 보들보들 너구리 퍼코트_유아 밍크코트 유아동 패딩,35150,35150,0
2018-06-01,1010287141,A013070,굴,[인천]착한식당) 양념꽃게장 2kg 6-7마리,69500,59800,-9700
2018-06-01,1010287145,A013070,굴,[오늘의식탁] 활랍스터 400~500g 2마리,54900,49900,-5000
2018-06-01,1010287144,A011040,보리쌀,RF겉보리 4KG,9900,9900,0
2018-06-01,1731440277,C013010,점퍼,방한복 방한점퍼 야상 돕바 파카 라쿤털 후드 근무복,84800,84800,0
2018-06-01,1009347247,A012050,소시지,[오뗄]1+1 육즙가득 프리미엄 BIG핫도그 100gx5+5개,14900,14900,0
2018-06-01,1594110654,L012060,샴푸,려 화윤/ 화윤생 2종 기획세트/ 샴푸액 + 두피모발팩/,40100,39500,-600
2018-06-01,61042435,C011030,남자학생복,라이프스타일 레귤러핏 셔츠&남방 9종택1(선물포장가능)/ 닥스(셔츠),60000,50400,-9600
2018-06-01,382051203,L021020,장신구,[티르리르] 다즐링(라피스) 팔찌TBSSVW10636M-16,59000,50150,-8850
2018-06-01,1047831893,L021010,손목시계,로제타 여성 손목시계 FW-22 팔찌시계 티켓팅시계 손,15380,15380,0
2018-06-01,324757416,C012020,원피스,[땡처리 할인]_디데무 여성의류 S/S 트렌치코트/자켓,9900,5900,-4000
2018-06-01,1567843413,C012040,여자학생복,[세인트마리]V 단추 가디건(4col),36800,33120,-3680
2018-06-01,1659252530,C015020,모자,1+1 무지볼캡/대두볼캡/캡모자/야구 모자/여자/남자,5900,5900,0
2018-06-01,1104341672,C012020,원피스,후드폭스 A라인 코트 (SWWHCH41030)/ 쉬즈미스,199000,159200,-39800
2018-06-01,530478006,C012060,여자내의,백합주름치마 레드체크 전체 주름 교복치마 교복 예쁜,55060,53410,-1650
2018-06-01,1010287170,A013100,마른멸치,[산지직송][大사이즈] 완도참전복 700g 8~9미 (마리당 70~80g),37900,35900,-2000
2018-06-01,946231988,I031040,생화,[SHENFEI] 무릎 발목 손목 팔꿈치 어깨 허리 보호대,10000,9110,-890
2018-06-01,285816012,C013010,점퍼,[제이콤마]블루밍 집업 점퍼/ 제이콤마,49500,43070,-6430
2018-06-01,1305966345,C013010,점퍼,남자 바람막이 야상 JM09 WS바람막이점퍼야상남자 바,90210,90210,0
2018-06-01,1398959651,C012040,여자학생복,수지네 일본 구제 블랙 시스루조끼 여성 M 18-38,12580,12580,0
2018-06-01,1179732302,C011030,남자학생복,[메이드]셔츠/남방/반팔/7부/린넨/체크/남자남성/데님,9700,9700,0
2018-06-01,1950998594,E011060,의자,[1주일특가]국내최초발받침기능채택-시니프갤럭시의자5종시리즈/학생의자/사무용의자/,62000,55800,-6200
2018-06-01,1245395341,I012010,컴퓨터,LG데스크탑 B70EV-AR7506 코어i5 4G 1TB 윈도우10,839360,789000,-50360
2018-06-01,2138314749,E031070,에어컨,[스타리온] LG전자 스타리온 선풍기 SF-T4611RJ(타워팬) LG전자AS,169000,169000,0
2018-06-01,204070592,G011070,자전거,삼천리/하로GS20 접이식자전거 미니벨로 어린이자전거,118000,99900,-18100
2018-06-01,1212841498,C012030,여자상의,롱원피스 맥시원피스 면 나시원피스 빅사이즈여성의류,9900,9900,0
2018-06-01,2126486215,C013010,점퍼,빅사이즈 폴라폴리스 자켓 MC 1200 빅사이즈점퍼 빅사,83660,83660,0
2018-06-01,895738793,A019030,생강,깐양파 (2입/팩),2990,2990,0
2018-06-01,1027498736,C013020,티셔츠,RT6 빅사이즈 노카라클래식청반팔남방셔츠(남),72700,71250,-1450
2018-06-01,1431631822,A017080,무,가정의달 특가! 문영철 장성새싹삼 30뿌리,8900,8900,0
2018-06-01,1061619145,C013020,티셔츠,헤지스남성 OUTS7BH31N2 트임 면혼방 반팔카라티셔츠,74300,57960,-16340
2018-06-01,847677531,C013040,청바지,여성빅사이즈/28-40까지/청바지/반바지/원피스/츄리닝,18900,18900,0
2018-06-01,350527399,C011030,남자학생복,아이스 쿨스카프(색상램덤 발송) 매듭링포함 쿨넥워머,6830,6830,0
2018-06-01,863057763,A012010,국산쇠고기,(코엠) 도가니탕 3kgx6팩 도가니 수육 우건탕 식자재,218540,196690,-21850
2018-06-01,323687626,E031070,에어컨,JJH신일산업 천정용 선풍기 SIF-16CSH 가게선풍기 천,114320,114320,0
2018-06-01,350527393,C011030,남자학생복,트랜디 컬러 무지 포켓 반팔 셔츠 남자셔츠 남자반팔,26160,26160,0
2018-06-01,51533106,E031010,전기밥솥,CRP-AHXB1060FB/쿠쿠/10인용/IH압력/2중모션패킹/GH,313000,287870,-25130
2018-06-01,2104295761,C013040,청바지,바닐라스토리 아동 수술 숏 여아청바지,22800,22800,0
2018-06-01,323000707,C012040,여자학생복,[쟈스킨by혁비][쟈스킨by혁비] 로맨틱 leaves 집업 가디건_ZB2094910A-19,115200,103680,-11520
2018-06-01,657994896,F012020,생리대,애니데이수퍼롱/팬티라이너/화이트/좋은느낌/바디피트,8500,8500,0
2018-06-01,452069080,C013010,점퍼,WWS1814G 남여후드시보리롱패딩점퍼,53300,53300,0
2018-06-01,1604367633,E061050,청소용세제,스칼프 곰팡이제거제 베란다 벽지 욕실 곰팡이방지제,12500,12000,-500
2018-06-01,632956365,C011030,남자학생복,덕다운 빅사이즈 패딩점퍼 LM105 빅사이즈,112930,108420,-4510
2018-06-01,1743269879,A016040,포도,동원)황도 슬라이스 400g x 12개 사시사철 맛있는,41360,41360,0
2018-06-01,559082319,C013050,운동복,자동차 수리 세트(지렁이) 타이어 수리 줄송곳 귀송곳,13700,13700,0
2018-06-01,1297910833,C011030,남자학생복,MCD-902 스트라이프 페어아일패턴 브이넥 가디건 디자,21940,21940,0
2018-06-01,433159673,C013050,운동복,12개세트 총알 도어가드 문콕방지 자동차 차량,3310,3050,-260
2018-06-01,493144151,C013050,운동복,커스커즈 3D 루프백 대용량 수납공간 320L 자동차캠핑,220810,201130,-19680
2018-06-01,618030633,C013020,티셔츠,튜브탑/브라탑/나시탑/브라렛/노와이어/시스루/탱크탑,6900,6900,0
2018-06-01,690849372,E051030,디지털도어록,[삼성SDS/SHS-1321]번호키/디지털도어락/카드키4개,99000,88830,-10170
2018-06-01,1673914552,F012010,종이기저귀,(신상품)팸퍼스 베이비드라이 밴드 5단계 XL 28Px1팩,12900,12900,0
2018-06-01,579160008,F012020,생리대,위스퍼 보송보송 슈퍼롱 오버나이트10pX12개(총120개),48900,48900,0
2018-06-01,1466547966,E021010,침구,굿몽 국내산 순면 마이크로 기숙사 펜션 이불세트,45900,45900,0
2018-06-01,1437250689,A021010,커피,자판기커피믹스12봉1박스/무료배송/모카커피,32400,31900,-500
2018-06-01,892039261,C015030,넥타이,남자넥타이 면접용넥타이 20대 30대넥타이 캐주얼,13800,13800,0
2018-06-01,1236790162,A011130,시리얼,메쉬드포테이토(삼조 1k)X10 식자재 식자재용 식당용,116340,116340,0
2018-06-01,1348475158,A013170,생선통조림,골뱅이캔 (자연산 삼포400g) x24,211950,211950,0
2018-06-01,414819602,E011050,책상,310N/컴퓨터책상/책상/테이블/노트북테이블/데스크,26900,26900,0
2018-06-01,308232677,E031070,에어컨,실링팬 날개형 52인치 화이트 BIG THINK 천장,79000,79000,0
2018-06-01,1083754043,A018010,초콜릿,[크라운]키커초콜릿/400원X40개입1박스/티피TP초콜릿/1500원X10봉지1박스/천연색소/간,10900,10900,0
2018-06-01,321616378,C013010,점퍼,쌈지 여성 바람막이 후드 집업자켓 SWJ502,14900,14900,0
2018-06-01,955886881,A013130,오징어채,쥐포 (160g/봉),7490,7490,0
2018-06-01,1680620472,I011010,TV,(공식파트너)삼성 80cm FHD LED TV UN32M5500AFXKR,470000,409000,-61000
2018-06-01,490984176,A018050,비스킷,[크리스피롤]22곡 180g x 5봉 씨리얼 곡물 과자,15900,15900,0
2018-06-01,1021039979,C013020,티셔츠,클러프나염티 MN1709 롱티셔츠 여성면티 롱셔츠 여성,30290,30290,0
2018-06-01,479652667,C013040,청바지,DDO1567 이너밴 일자 데님 803 큰사이즈청바지 와이드,57690,57690,0
2018-06-01,691828777,A018090,잼,인기 수입잼모음/누텔라/카야잼/쨈/땅콩잼/딸기잼,4400,4400,0
2018-06-01,1185479630,I053010,공책,줄없는 종합장NO. 14501 76837 학용품 무선종합장 노,7000,7000,0
2018-06-01,1913589147,L021020,장신구,최신상 만자 옴자 3종 고급 실버반지 (open-svr8) 실버커플링 골드조아,55000,55000,0
2018-06-01,1185479635,L021020,장신구,ICU 블랙 반지/ 리타모니카,9500,8550,-950
2018-06-01,1095104807,C011050,남자내의,[MLB]엠엘비남여공용미니로고트레이닝숏팬츠(SPD1831),49000,41650,-7350
2018-06-01,1180970795,C014010,아동복,쥬쥬 아이언맨 번개맨 번걸 카봇 스파이더맨 콩순 옷,11500,11500,0
2018-06-01,370872011,C013010,점퍼,(냉동)오븐에꾸운 소막창420g2개,73560,73560,0
2018-06-01,324267750,F012020,생리대,[3+1증정]오드리선 생리대 중형3팩+팬티라이너1팩,16500,16500,0
2018-06-01,897504153,E061060,살충제,[헨켈]홈매트 리퀴드 기획(45일*3번들),15900,15900,0
2018-06-01,575252912,C012030,여자상의,[아뜨랑스]15%스토어쿠폰!러블리/로맨틱/원피스/티셔,13500,13500,0
2018-06-01,1300423771,E011040,소파,밸런스가구 도노 3인용소파 아이보리 좌식쇼파,179000,179000,0
2018-06-01,321616385,C013010,점퍼,쌈지 여성 바람막이 후드 집업자켓 SJ505,14900,14900,0
2018-06-01,238705702,A014040,발효유,밀크앤 퍼니스트로우 3.5g x50개/초코 바나나 딸기맛,13100,13100,0
2018-06-01,1257492480,L012030,칫솔,[오랄-비]스테이지스 행사팩 2개+미니 매직보드,15900,15900,0
2018-06-01,2001269300,L012030,칫솔,[콤비본사]유아칫솔시리즈_아기칫솔/치발기/치아관리,3900,3900,0
2018-06-01,266489806,L021020,장신구,[폭스타일] [실버] 테나 반지,12000,10920,-1080
2018-06-01,1158645450,E061050,청소용세제,향락스14L-락스14L/살균/표백/소독/세제/락스/대용량,8600,8600,0
2018-06-01,1479795481,L021030,가방,노트북 맥북 가방 파우치 캐주얼 크로스백 13 15 인치,9900,9900,0
2018-06-01,1797863728,I031040,생화,[마운틴컴퍼니] SOS 긴급 구호세트 캠핑공구 야외구호세트 캠핑용품,23390,21310,-2080
2018-06-01,1815152908,C013010,점퍼,[포에버21]버튼 프론트 유틸리티 자켓/FOREVER21/점퍼/누빔점퍼,65900,32950,-32950
2018-06-01,1069818722,C013010,점퍼,푸조 캐주얼 등산자켓 점퍼 야상 사파리점퍼,33000,31350,-1650
2018-06-01,381400806,L012110,색조화장품,2018년AHC 내추럴 퍼펙션 선스틱 시즌4 /14g+22g,20000,20000,0
2018-06-01,423531073,C013010,점퍼,남자아우터 항공 패딩 점퍼,58330,58330,0
2018-06-01,954877773,A022060,혼합음료,[롯데]롯데 게토레이+블루볼트 (1.5L*2),3280,3280,0
2018-06-01,293663395,A011170,떡,더미들래 구워먹는 꾸떡 245g x4봉 +양념소스 증정,10900,10900,0
2018-06-01,1662540226,C013040,청바지,여성일자청바지/여자일자/빅사이즈/밴딩팬츠/25-34,14900,14900,0
2018-06-01,496385097,C012060,여자내의,[앞머리]내츄럴 워싱 수술 데님 언발 롱 스커트,39900,39900,0
2018-06-01,2099737771,C013030,스웨터,MTSSF18013 지구촌 후드 캐주얼후드티 후드티 캐쥬얼,40580,40580,0
2018-06-01,1102166374,C015030,넥타이,아동넥타이/나비/보타이/유아/아동타이/리본/학생,3800,3800,0
2018-06-01,1209406853,C013040,청바지,[Blouson]주름 린넨 와이드 팬츠_[B1806PT058B],47000,41780,-5220
2018-06-01,1951177609,C014010,아동복,유아 아기 아동 어린이 키즈 흰색 티셔츠 흰색티 흰티,6300,6300,0
2018-06-01,589449046,C012060,여자내의,PBM8060 쎄무롱플레어스커트 스커트 니트스커트 9부스,16260,15780,-480
2018-06-01,1130933242,C012060,여자내의,[모다아울렛][코인코즈]프린지 미디 데님 스커트(MIJ8MS134),62400,59280,-3120
2018-06-01,1011061644,A017020,상추,초L프레시)양상추(통),5490,2490,-3000
2018-06-01,2095644898,C021040,실내화,나이키 코르테즈/에어맥스 외 스테디셀러 40종 택 1,24500,24500,0
2018-06-01,1904705929,E031110,청소기,[악팩+필터1증정]아이클레보 A3 로봇청소기YCR-M08-30,469000,469000,0
2018-06-01,1922858323,C013050,운동복,(1+1 EVENT) 16ss 첨이첨이 노랑세모3부유아복 슬럽사 유아동의류 아동의류 공용 상하,28220,28220,0
2018-06-01,768137838,A011010,쌀,신동진쌀 20kg / 밥맛좋은쌀/ 충남예산,50800,50800,0
2018-06-01,449296503,C012040,여자학생복,케시미어터틀넥니트(7156450102)/ 보브(의류),189000,160650,-28350
2018-06-01,202519903,E021010,침구,캐릭터 짱이 시어서커여름세트 이불+패드+베개커버1장,74000,72800,-1200
2018-06-01,503634388,L021010,손목시계,BELCARINO 슬림 라인시계 손목시계 패션시계 MV206161,75390,75390,0
2018-06-01,631945456,A016060,감,달콤샤르르 자연그대로 만든 아이스 왕 홍시 50개(컵),90400,79560,-10840
2018-06-01,1733699423,C021040,실내화,운동화/트레킹화/충격흡수/조깅화/빅사이즈/285-320mm,31800,31800,0
2018-06-01,1940938655,C011020,남자상의,(AGC패딩 코트 레이어드 PD05 WS패딩코트코트남자코트,176040,156680,-19360
2018-06-01,410024187,E061040,부엌용세제,락스 퐁퐁 유한락스/대용량/업소용/주방 세탁액체세제,6500,6500,0
2018-06-01,2135765641,C012040,여자학생복,시원한 거즈면 영문 포인트 나염 캐쥬얼 셔츠 남방,20900,20900,0
2018-06-01,2121020388,C015040,장갑,란체티 아이글러브 남성 니트장갑 I-Glove 겨울장갑,26500,26500,0
2018-06-01,783060161,F012050,의료측정기,브라운 써모스캔 귀체온계 IRT-6030 (총 필터 21개),70000,70000,0
2018-06-01,157238054,C011050,남자내의,남자 여름 아이스 트레이닝 빅사이즈 반바지 5부 7부,9900,9900,0
2018-06-01,517618396,A011030,찹쌀,보리쌀 (7K),37140,33060,-4080
2018-06-01,1468719257,A021010,커피,일리 캡슐 커피 9종,10900,10900,0
2018-06-01,499030888,C012060,여자내의,여성용 기모 바지 밴드 스판 밴딩 엄마 아줌마 팬츠,17900,17900,0
2018-06-01,639210688,L021030,가방,[여름신상]로자르 고급여성가방 크로스백 에코백 백팩,13900,13900,0
2018-06-01,1686383615,F011150,건강기능식품,[큐원] 상쾌환 3gx10포/숙취해소제/최신제조상품/우체국택배,16900,16900,0
2018-06-01,469988684,E031050,냉장고,[삼성전자]삼성 지펠아삭 M7000 스탠드형 김치냉장고 327L RQ33M7001W1,1110000,1110000,0
2018-06-01,999239970,C012030,여자상의,미니원피스클럽/쉬폰/나시/섹시/투피스/홀복/파티,15800,15800,0
2018-06-01,424287496,C012040,여자학생복,플라스틱아일랜드 (PJ2KG482)여름숏가디건,29000,23780,-5220
2018-06-01,1580186615,C011050,남자내의,아디다스 여성 에센셜 리니어 타이츠 ( BR2523 ),51730,46560,-5170
2018-06-01,1578882798,E031140,비데,18년형 블루밍 비데 ICON-1160TB 마사지 세정 건조,149000,129000,-20000
2018-06-01,267085170,C013050,운동복,야토 자동차 루프백 NW300L RV용 캠핑 가방 차량루프,85700,78070,-7630
2018-06-01,1774891700,F011130,홍삼,굿베이스 홍삼추출액순(70ML*30입),71100,71100,0
2018-06-01,1168553961,C013050,운동복,아디다스 여성 ZNE 후드자켓(CE4122)스포츠상의 남성,152460,152460,0
2018-06-01,2094540430,C015020,모자,스냅백 모자 야구모자 패션모자 힙합모자 여성모자,4900,4900,0
2018-06-01,1246443748,C013030,스웨터,아디다스 ZNE 스톰헤더 후드자켓(BQ5360) 남성후드자,179820,179820,0
2018-06-01,476449065,L012060,샴푸,(대용량구성) 려 자양윤모 지성 한방샴푸 8종샴푸린스,28800,28800,0
2018-06-01,417924723,C015040,장갑,아놀드파마_APGW-BY1212-1(가죽장갑_여성용) 여성겨울,27420,27420,0
2018-06-01,393376101,E031140,비데,[단독런칭]신제품 대림도비도스 방수비데 DLB-722,169000,169000,0
2018-06-01,1537719532,A017220,양파,[푸른들판]국내산/파뿌리 100g/총백탕 말린 대파뿌리,4300,4300,0
2018-06-01,1882059398,D031010,주택수선재료,친환경페인트도구모음 페인트 붓 로울러 테이프 공캔 실리콘 장갑,1000,1000,0
2018-06-01,1343965283,C012040,여자학생복,[대구백화점 I관] [유지아이지]메쉬 후드 집업 (UBNB760),31840,27390,-4450
2018-06-01,1223121572,I012060,저장장치,BOSSWIZ 6버튼 LED 게이밍마우스 앞뒤버튼/마우스모음,11400,11180,-220
2018-06-01,560215244,C012060,여자내의,[메이비베이비] Sparkling (sk),32000,32000,0
2018-06-01,336237489,C012040,여자학생복,[위쉬몰][위쉬몰]GO 아이스골지가디건(2191H805),22680,19280,-3400
2018-06-01,15581060,I011010,TV,UHD-55F / 55인치UHDTV / 삼성정품패널 패널2년무상AS,488550,469000,-19550
2018-06-01,287540835,C012060,여자내의,[지오다노][여성]벨트증정 코튼 버뮤다 팬츠(05408501)(408501)[갤러리아],19800,16830,-2970
2018-06-01,1779541104,L021020,장신구,[바보사랑][액세서리키친] 925실버 My planet 별자리 수호행성 체인팔찌,29900,29900,0
2018-06-01,2142833061,F012010,종이기저귀,하기스 기저귀 네이처메이드 밴드형 1~2단계/2팩/3팩,37900,37900,0
2018-06-01,1779541100,L021020,장신구,[바보사랑][액세서리키친] 925실버 My planet 별자리 수호행성 끈 팔찌,25900,25900,0
2018-06-01,566551988,C012030,여자상의,민소매 랩원피스,18900,18900,0
2018-06-01,2069318061,C012020,원피스,남여공용 기모골지 포켓 롱가디건 1개 여자가디건 여,47600,40460,-7140
2018-06-01,1262082309,C012060,여자내의,[화이트폭스]슬림핏부츠컷린넨슬랙스,29000,25240,-3760
2018-06-01,944607857,A013050,오징어,밀감캔(삼도 3k)X6 캔 식당 밀감캔 식당용 can 밀감통,63390,63390,0
2018-06-01,1717196405,E051030,디지털도어록,[자가설치] 밀레 MI-6000S MI-6000YS / 카드키 / 유니,87900,78210,-9690
2018-06-01,1717436633,A019080,고추장,맛다시 90g X10개 고추나라 산채비빔 비빔장,12290,12290,0
2018-06-01,2069296172,C012020,원피스,빅사이즈/옆/단추/롱/조끼 / 참고 옆단추롱조끼 빅사,55700,49020,-6680
2018-06-01,1159514323,A017300,미역,[대천김 본사직영몰] 대천김 재래김/파래김/돌김 10봉,13900,13900,0
2018-06-01,989090582,F012010,종이기저귀,슈베스 기저귀 밴드형 팬티형 2팩/슬림 전라인 모음,12500,11500,-1000
2018-06-01,314829391,C011050,남자내의,남성 데님 청 와이드팬츠 배기바지 통바지 9부 밴딩,44500,44500,0
2018-06-01,1068168387,C013040,청바지,[나나진]신상 일자진/밴딩/스판/헤짐/구제/밑단수술,19900,16800,-3100
2018-06-01,1054294770,C012040,여자학생복,사선니트롱조끼 RMD_1710 블랙조끼 보카시조끼 여성조,19130,19130,0
2018-06-01,699441042,A022010,주스,롯데 제주사랑감귤사랑175ml x 30캔/미니캔모음,5400,5400,0
2018-06-01,451903417,A018040,아이스크림,프리미엄/하겐다즈/끌레도르/나뚜루/매그넘,9500,9500,0
2018-06-01,954875048,A012060,햄및베이컨,CJ 더 건강한 그릴 비엔나 (360G),7680,4590,-3090
2018-06-01,1683736674,E031010,전기밥솥,쿠쿠밥솥패킹/CCP-06/CCP-08/CCP-10/분리형커버패킹모델/2중모션패킹,5000,4900,-100
2018-06-01,1464899366,F012010,종이기저귀,NEW 아가방 좋은기저귀 밴드형 x 3팩,26900,26900,0
2018-06-01,162347949,C013010,점퍼,아디다스 유소년 콘디보16 스타디움자켓 ( AN9871 ),120150,120150,0
2018-06-01,1279891442,C013020,티셔츠,라운드긴팔티/기본티/쫄티/무지티/V넥/스판티/반팔티,4900,4900,0
2018-06-01,396826183,C012040,여자학생복,[ZOOC] 넥선 포인트 오픈숄더 블라우스 Z181MSC017,153090,125540,-27550
2018-06-01,993090069,L021030,가방,쌈지정품 균일가 19000원 여성백팩 숄더백 크로스백,19000,19000,0
2018-06-01,1697295441,G011070,자전거,스마트 시마노7단 미니 로드자전거 2018 브리톤407A,110100,99000,-11100
2018-06-01,1087837555,L012110,색조화장품,[디렉터파이선정]착한썬스틱1+1/무기자차/썬크림,15900,15900,0
2018-06-01,1031362002,C013010,점퍼,[포에버21]Feel The Heat 바람막이/FOREVER21/점퍼/블루종,43900,21950,-21950
2018-06-01,1161565350,C013050,운동복,맥과이어스 에탄올 워셔액2L X 8개/천연발효/유리세정,52000,44720,-7280
2018-06-01,385816685,E011050,책상,[이스마트] 보급형/표준형 독서실책상,139000,124200,-14800
2018-06-01,961196353,E061040,부엌용세제,자연퐁 스마트 오렌지(1200+200ML),2990,2990,0
2018-06-01,961196352,E061040,부엌용세제,자연퐁 스마트 포레스트(1200+200ML),2990,2990,0
2018-06-01,119508604,C013040,청바지,봄신상~하이웨스트/여성청바지/스키니진/블랙진/멜빵,24900,24900,0
2018-06-01,1952017215,I031010,장난감,PS4 더 라스트 오브 어스 리마스터드 한글판 /빅히트,27800,27800,0
2018-06-01,821016082,C011050,남자내의,아로미 905/고무꽃 발목 고무밴딩 스프사 9부 파자마,11700,10420,-1280
2018-06-01,616717600,C013010,점퍼,남아화이트쿨메쉬집업점퍼(R1825J502_01)/ 레노마키즈,29500,26550,-2950
2018-06-01,544730735,C013010,점퍼,내구성좋고 100퍼센트방수 여성 슬림 코트형 우의우비,25840,25840,0
2018-06-01,1593762298,E051030,디지털도어록,EN-950/무타공주키/도어락/무타공도어락/마스타/원룸,75000,70000,-5000
2018-06-01,1583467289,C021040,실내화,패브릭 드라코 런닝 블랙/블랙,38000,38000,0
2018-06-01,1959803387,A022050,탄산음료,[롯데칠성] 사이다캔 190ml 30캔 탄산음료 캔사이다 탄산캔 사이다190,11500,11500,0
2018-06-01,1222697393,C013030,스웨터,MNT_117 체인 폴라 니트,51200,45570,-5630
2018-06-01,1930768486,C012040,여자학생복,루즈핏 77 사이즈 단가라 앞포켓 롱 남방 셔츠,19900,19900,0
2018-06-01,363356448,I011030,사진기,세기정품 리코 GR II 카메라 /+SD 32GB / RICOH GR2,780000,780000,0
2018-06-01,229644675,F011150,건강기능식품,담터 마가들어간 15곡 미숫가루 40T/다농원 검은콩,11200,11200,0
2018-06-01,1299910830,I031040,생화,에버라스트 USA 복싱 헤드기어,127100,124560,-2540
2018-06-01,1940723832,C013040,청바지,무릎고양이진/청바지/캐릭터바지/면바지/주니어스키니,9900,9900,0
2018-06-01,88572911,A018040,아이스크림,빵뚜르(10개)/ 서주,5000,5000,0
2018-06-01,367063178,C012040,여자학생복,FREE 브이포인트여자긴팔니트티,18020,18020,0
2018-06-01,1891499066,A017180,호박,(참살이식품)중국산 고춧가루1kg 김장용 양념용 고추,15830,14250,-1580
2018-06-01,163118669,C013010,점퍼,아디다스 유소년 콘디보16 스타디움자켓 ( AB3152 ),130740,130740,0
2018-06-01,1305462965,A019090,카레,오뚜기 쇠고기카레 200gx10곽 외 수입카레/즉석식품,9900,9900,0
2018-06-01,985446283,L012060,샴푸,LG 리엔 자윤 모근강화 지성샴푸 500ML,14990,3990,-11000
2018-06-01,961196348,A019040,소금,[CJ]백설 천일염 오천년의 신비 (3KG),7980,7980,0
2018-06-01,1299910825,I031040,생화,컨텐더 스파링헤드기어CHG-738-가죽,128600,126030,-2570
2018-06-01,240058532,E061030,전구,에스에스라이트 3구 LED모듈,260,260,0
2018-06-01,1129795370,C011050,남자내의,매장정품 반바지 110종 나이키 아디다스 운동복단체복,17900,17900,0
2018-06-01,1690273674,C014010,아동복,스파이더맨의류/아이언맨옷/유아 아동 상하복세트,27800,27800,0
2018-06-01,1451926934,L021030,가방,▶초특가한정[정품]LIVITY 히트디자인 3cm입체굽 프리미엄 누드젤리슈즈 샌들 슬리퍼,11700,11700,0
2018-06-01,1907689745,A017010,배추,곰보배추발효액 1500ml/1000ml 중 선택 /곰보배추즙/곰보배추진액/곰보배추액기스/곰보,35000,35000,0
2018-06-01,2011757596,C013040,청바지,남아/여아/청바지/팬츠/남아바지/여아바지/무료배송,20000,17900,-2100
2018-06-01,416078761,C013040,청바지,(남자옷도매) DP-270 노멀데님생지 팬츠 (S-XL) 진청,24730,24730,0
2018-06-01,242512025,I053010,공책,Bookstorage 독서기록장 중고등용 책의 숲을 거닐다,14950,14660,-290
2018-06-01,375923641,A011160,빵,햄버거빵/핫도그/빵납품/버거조인트/치아바타/바게트,630,630,0
2018-06-01,390044221,C015020,모자,(컬러:사이즈 : 블랙:FREE) ACC-CAP103 빈티,19630,19630,0
2018-06-01,208110962,C013050,운동복,에어워크 스판트레이닝복/츄리닝/운동복세트/단체복,49800,48800,-1000
2018-06-01,450568527,C013030,스웨터,MTSSF18013 지구촌 후드 남자후드티 남자후드 남성용,40400,40400,0
2018-06-01,546581993,A014020,분유,[아이배냇] NEW 순 산양분유 1단계~3단계(400gX2캔),33800,33800,0
2018-06-01,986249683,A019030,생강,초L프레시)한끼깐마늘(팩),1790,1790,0
2018-06-01,986249684,A017070,부추,초L프레시)한끼부추,1590,1590,0
2018-06-01,986249685,A017180,호박,초L프레시)한끼청양고추,1490,1490,0
2018-06-01,324111909,C012040,여자학생복,쭈리러플넥니트(7227250002)/ 지컷,70000,56000,-14000
2018-06-01,479135405,C013050,운동복,봄 신상 트레이닝복세트/운동복/츄리닝/후드티/집업,36900,36900,0
2018-06-01,532352096,C013010,점퍼,STYLEENTER 핸드메이드 스타일엔터 남자무스탕 메리노베이비 무스탕점퍼 주문제작,1169000,1169000,0
2018-06-01,1694978667,L021030,가방,[업타운홀릭]트렌디한 가방 모음,30600,30600,0
2018-06-01,441033449,A019060,된장,해찬들재래식된장골드14kg,46170,46170,0
2018-06-01,900475501,A011090,국수,[농심]농심 육개장사발면 (86G*6입),4820,4820,0
2018-06-01,1435249624,C013040,청바지,데님오브벌츄 리얼 데님 2종(여성용),99000,94050,-4950
2018-06-01,451235000,C013030,스웨터,ATS-023 (겨울-골프웨어) 반집업 목폴라 니트 (95-105,42830,42830,0
2018-06-01,763023372,A011110,당면,시골도토리묵400gX10개(BOX),14700,14700,0
2018-06-01,341236773,A019080,고추장,해찬들 태양초 알찬 고추장 6.5kg,19990,19990,0
2018-06-01,1133264693,F012050,의료측정기,시티즌 혈압계 CH-650 손목형/부정맥감지/혈압측정기,39800,37020,-2780
2018-06-01,319315231,I031040,생화,GDF 레전드R1 1-530 바다찌낚시대/1호대/갯바위낚시대,69000,69000,0
2018-06-01,483847732,C013030,스웨터,밀란시아 빅사이즈 니트폴라티 big12-no.40 빅사이즈,56360,55240,-1120
2018-06-01,1650119496,E061060,살충제,[시나몬이오] 시트로넬라 스프레이 250ml,15900,13520,-2380
2018-06-01,1469684344,C021010,아동화,캐릭터 유아동 운동화 발광 어린이 슬립온 남아 여아,21600,21600,0
2018-06-01,987322994,A019170,냉동식품,CJ 고메치킨 순살크리스피 550G,7990,6290,-1700
2018-06-01,851036545,C012020,원피스,요즘대세투피스/44~110/빅사이즈/린넨자켓/스커트,35800,31800,-4000
2018-06-01,449162107,I031010,장난감,2018 드림카/LED 폴리우레탄 바퀴/승용완구/번개카,29800,29800,0
2018-06-01,1694303692,C021040,실내화,[YJY Company]아디다스 갤럭시 4 / BB3563,63200,63200,0
2018-06-01,613050687,A015020,식용유,루비노 엑스트라 버진 올리브유 1L 이태리 올리브오일,17800,15800,-2000
2018-06-01,1369344193,A011010,쌀,엄마밥줘 7곡(귀리+렌틸)혼합곡10kg(5kgx2)진공포장,25900,25900,0
2018-06-01,441033451,C013010,점퍼,인조이 롱 점퍼 블랙 시보리롱점퍼 여성잠바 롱점퍼,28980,28980,0
2018-06-01,153298840,I011020,영상음향기기,비비텍 D55E DX263 또렷한화면 고화질HDMI 빔프로젝터,499000,499000,0
2018-06-01,1183903430,C013010,점퍼,아동 유아 후드 집업 점퍼 비치점퍼 여름점퍼,13900,13900,0
2018-06-01,1277120277,C013050,운동복,등산의류 반팔티 골프웨어 등산티셔츠 유니폼 단체복,10000,9900,-100
2018-06-01,152155990,A013090,전복,해성 냉동홍합(그린) 800g2개,52830,52830,0
2018-06-01,847376442,F012020,생리대,위스퍼 보송보송/ 리프레쉬+피부애 중형 30P 증정,13900,13900,0
2018-06-01,1129881798,A022020,두유,연세두유 아몬드 잣/검은콩 고칼슘 두유 200ml x 64팩,24730,24730,0
2018-06-01,1739884348,C013010,점퍼,[에이비에프지]캐쥬얼 배색 점퍼 Q4ZD04,69000,65550,-3450
2018-06-01,426826272,L021050,우산,MLB 정품 우산 초특가 3단자동 장우산 수동 아동우산,9800,9800,0
2018-06-01,1132788782,A022010,주스,스위트컵 농축액 자몽/오렌지/레몬/청포도/애플망고,21000,21000,0
2018-06-01,853512463,L012060,샴푸,댄트롤 샴푸린스 820mlx3개/딥클린/멘톨쿨링/비듬케어,13500,13500,0
2018-06-01,71385274,C013020,티셔츠,쿨론라운드 반팔티셔츠/남여공용/빅사이즈/무지티반티,4900,4900,0
2018-06-01,893944910,E031130,보온매트,[바보사랑]숯 황토볼쇼파형매트,370000,370000,0
2018-06-01,1726563322,L021020,장신구,최신상 고품격 실버정품 86종 실버반지+14k표면금(open-svr1)커플링 용반지 남자 여자,69000,69000,0
2018-06-01,40417601,E011040,소파,1인용쇼파/1인쇼파/1인용소파/1인소파/디자인/체어,86900,86900,0
2018-06-01,838634380,E061020,섬유유연제,F C 베이비전용 섬유유연제 refill 아기옷빨래 유아세,15450,15450,0
2018-06-01,1667759395,A021010,커피,(캡슐증정)휘카페 캡슐커피 +추가사은품 휘카페캡슐,15370,15370,0
2018-06-01,1806353001,L021020,장신구,[바보사랑]Spring n Summer bracelet,11000,11000,0
2018-06-01,1669721698,I031040,생화,2층 국산 초대형 파라솔 세트 야외 테이블 캠핑 용품,30300,27790,-2510
2018-06-01,503609469,L021010,손목시계,BELCARINO 듀얼타임 센스있는 패션션시계 MV2097024W,71950,71950,0
2018-06-01,1806353000,L021020,장신구,[바보사랑]black thin silver ring,13500,13500,0
2018-06-01,296102059,C011030,남자학생복,[프로젝트M]셔츠 남성 오픈카라 반팔셔츠(EPY2WC1382),49900,40920,-8980
2018-06-01,1406739457,E011060,의자,중역의자/게이밍의자/레이싱의자/책상의자/PC방 의자,75900,68310,-7590
2018-06-01,829876639,E021010,침구,굿몽 국산 먼지없는 이불세트 차렵이불세트 침구세트,19400,19400,0
2018-06-01,402542198,E061060,살충제,바이벅스 해충퇴치기 모기퇴치 벌레퇴치기,29800,29800,0
2018-06-01,1544560838,C011020,남자상의,패딩 코트 PD23 WS패딩코트코트남자코트트랜치코트남,154230,154230,0
2018-06-01,480635896,C012020,원피스,일자핏 모직 재킷 RJJWJK960/ 리안뉴욕,59000,53100,-5900
2018-06-01,2136463054,E061030,전구,[특가판매]오스람 삼파장 램프 전구 백열전구 형광등,500,500,0
2018-06-01,1951953826,F011150,건강기능식품,대한민국 대표 소화제 까스명수 골드 20병 탄산소화제,12000,12000,0
2018-06-01,418821391,E061030,전구,오스람 형광램프 13W 18W 24W 32W 36W 45W 55W,1500,1500,0
2018-06-01,595638049,A017280,김,초생강(적색 참존 1.2k),4560,4560,0
2018-06-01,1236348857,C013040,청바지,일자 슬림핏 연청바지,30900,30900,0
2018-06-01,2080675280,C014010,아동복,[앤디애플] NEW상큼한파스텔번아웃점퍼,14900,13410,-1490
2018-06-01,1010287231,A016050,밤,[중앙일보 농마드] 청도 감말랭이 1kg,21900,19900,-2000
2018-06-01,958602639,E031070,에어컨,SUPER COOL 스텐드 선풍기 (40CM),29900,29900,0
2018-06-01,451142804,A019100,식초,오뚜기 식당용케찹(파우치)3kg2개 케찹 식당용케찹 케,18560,16710,-1850
2018-06-01,1535213350,C014010,아동복,[아이러브제이] 여름 쿨 스윔 반팔 티 JPUTO36-DA1A,7840,7100,-740
2018-06-01,22646072,L021020,장신구,다이아반지/1.3mm 11ps/프로포즈/14K골드/dia ring,250000,250000,0
2018-06-01,451142800,A019010,고춧가루,A한식 고추가루 1kg2개 가루 고추가루 한식 한식고추,41520,37370,-4150
2018-06-01,877160057,C013020,티셔츠,[까르뜨블랑슈]솔리드 베이직 카라 티셔츠 4종 택1 CMM7KLL2(경기점),26650,26650,0
2018-06-01,262502396,E061030,전구,국산 히포 LED형광등 30W(6770원)~55W십자등(16770원),7400,7000,-400
2018-06-01,1398135450,A013020,명태,두레생협 대구토막(450g 러시아산) 찌개용대구 찌개용,29450,29450,0
2018-06-01,1188726452,A017300,미역,소문난오부자-도시락김 5gX72봉-재래김/대천김/파래김,18900,18900,0
2018-06-01,1989908489,A019170,냉동식품,비비고 왕교자 1.05kg+1.05kg 외 새우만두/감자만두,16900,16900,0
2018-06-01,1058539296,A014020,분유,아이배냇 순산양분유 1/2/3/4 800g 3캔,88500,88500,0
2018-06-01,25606463,A011100,라면,오뚜기 옛날 자른 당면 500g 1kg,3600,3600,0
2018-06-01,1393348403,C012030,여자상의,[바이데일리] 여름신상 루즈핏 롱원피스/티셔츠 특가,5900,5900,0
2018-06-01,1543338265,E031050,냉장고,삼성공식 M7000 김치냉장고 RQ28M6100S8 전국무료HS,837000,803520,-33480
2018-06-01,849227304,A019080,고추장,해찬들 태양초 고추장 (골드)(500G),8500,8500,0
2018-06-01,1473574354,A018110,물엿,블라제 발사믹 글레이즈 소스 366ml 코스트코 식초,8580,8580,0
2018-06-01,1527185372,C013040,청바지,스키니/빅사이즈/청바지/남자바지/블랙진/남성/스판,12800,12800,0
2018-06-01,1010290864,A011010,쌀,경기 안성쌀(포) 10KG,31900,31900,0
2018-06-01,1559827956,E041030,솥,독일 가이타이너 양수 압력밥솥/압력솥/인덕션,99000,99000,0
2018-06-01,900475535,A011090,국수,[농심]농심 짜파게티 큰사발 (123G),1090,1090,0
2018-06-01,900475536,A011090,국수,[농심]농심 튀김우동 컵 (62G),900,900,0
2018-06-01,900475530,A011180,파스타면,농심 얼큰한너구리 120G*5입,3790,3790,0
2018-06-01,435143351,E031130,보온매트,일월 온돌마루 카페트매트/전기장판 방석 전기매트,89000,83600,-5400
2018-06-01,1160914864,C012060,여자내의,[리스트] TWWSKI60070 허리밴딩 플레어 미디스커트,64000,52480,-11520
2018-06-01,234628494,C011030,남자학생복,당일발송 115/120 빅사이즈 와이셔츠 드레스 솔리드,14800,14800,0
2018-06-01,1807012488,A017090,열무,[우리가락]알타리 4kg,17800,17200,-600
2018-06-01,849227332,A019080,고추장,해찬들 태양초고추장(튜브)(290G),5750,5750,0
2018-06-01,1010290895,A011090,국수,농심 신라면블랙사발 101G,1390,1390,0
2018-06-01,1155313595,C013010,점퍼,바람막이/골프자켓/캐쥬얼점퍼/기모자켓/단체복/집업,40800,32800,-8000
2018-06-01,811652065,E011040,소파,아리아퍼니쳐 Lisiny4인카우치 천연가죽쇼파/면피소파,719000,719000,0
2018-06-01,1785612297,C021040,실내화,[리복] 퓨리라이트 GW AQ9673/ 리복,29510,29510,0
2018-06-01,2048692244,L012030,칫솔,비바텍 럭스360 케이스 아기칫솔 어린이칫솔 유아칫솔,16500,16500,0
2018-06-01,1830766143,I031010,장난감,붕붕카모음전/붕붕카/순수국내생산/kc인증상품,30500,30500,0
2018-06-01,600642191,C011030,남자학생복,[탑텐]남성) 리넨/코튼 버튼다운 셔츠_MSY2WC1901,19000,16150,-2850
2018-06-01,1010289898,A018100,꿀,[백화농원] 스위트 허니 국내산 벌꿀 550g ×2개,16900,13100,-3800
2018-06-01,115826699,C011030,남자학생복,오마샤리프 윈드페인 체크셔츠 보라컬러 셔츠/30506VI,18800,18800,0
2018-06-01,798008213,E031080,선풍기,[캐로스] 가스 온풍기 CAH-665GB 사무실온풍기 히터 난로 난방,2297000,2297000,0
2018-06-01,1899102526,E031120,믹서,정품.필립스 믹서기 HR-2100 필립스믹서기/미니믹서기,39100,39100,0
2018-06-01,987084911,A013110,마른오징어,햇살담은 멸치 (볶음조림) 600G/박스,12900,12900,0
2018-06-01,987084910,A013110,마른오징어,햇살담은 멸치(볶음용) 700G/박스,13900,13900,0
2018-06-01,4840369,A017230,마늘,[남도장터]자연식품 무안양파즙(일반/빨강/함초)100팩,18900,18900,0
2018-06-01,1250915741,A011170,떡,현미쑥인절미 6호(60개/6.9kg/개당115g),89100,89100,0
2018-06-01,1623275439,A016150,아몬드,햇 프리미엄 스튜어트앤제스퍼 아몬드 1kg 견과류,12900,12900,0
2018-06-01,2094804605,A017140,콩나물,도라지가루 200g 도라지가루효능 약도라지 도라지효능,18310,18310,0
2018-06-01,1296029584,A022030,생수,롯데 트레비(라임.자몽) 300ml x 20펫/탄산음료,9900,9900,0
2018-06-01,64728515,C012030,여자상의,[핫핑] 원피스 빅사이즈 쉬폰 플라워 패턴 롱원피스,32800,21800,-11000
2018-06-01,369771597,A014030,치즈,코리원/썬리취자연치즈 9UK 2.5kg/모짜렐라/치즈/피자,19900,19900,0
2018-06-01,1225812294,C012060,여자내의,[꼼빠니아][꼼빠니아] 지퍼장식 점프슈트 CA7U6-WPL240_415 (P000336730),66700,60030,-6670
2018-06-01,1304803939,A013090,전복,다인 키조개관자 소 800g(게아지살/가이바시),26000,26000,0
2018-06-01,1310483733,A012010,국산쇠고기,홍성한우 한우선물세트 2.4kg 등심+안심+채끝+특수부,380000,376200,-3800
2018-06-01,645858963,C012020,원피스,[SI]랩벨티드코트(제천벨트)SPHAY2628(SK BEL)(마산점),75000,69000,-6000
2018-06-01,561371006,C013020,티셔츠,[블루독베이비]스트라이프티셔츠(PK)48319332010,42000,33600,-8400
2018-06-01,1597907150,C012060,여자내의,[ME by] A라인 미니 스커트_GR (MIWWH8431L)/ 미쏘,25900,23310,-2590
2018-06-01,1698573834,F012010,종이기저귀,보솜이 리얼코튼 밴드 소형 50매 (남녀선택),12900,9900,-3000
2018-06-01,1222181013,I012010,컴퓨터,맥프로 헥사코어 MD878KH/A PC 애플 MacPro 데스크탑,4650000,4650000,0
2018-06-01,1265977001,C013020,티셔츠,봄.여름 등산복 등산티 골프티 작업티 단체복 전문,18900,16760,-2140
2018-06-01,1958047279,A016100,수박,농촌이야기 맛있는 수박 4~8kg,7900,7700,-200
2018-06-01,1892826959,L021010,손목시계,Paop-u_스포츠시계 손목시계 스포츠용품 스포츠시계,12260,12260,0
2018-06-01,1269735762,C012060,여자내의,jj42 꽈배기니트 미디스커트_블랙 스커트 여성스커트,14830,14830,0
2018-06-01,1385827981,A011160,빵,안흥찐빵마을 우리밀우리팥 수제 안흥찐빵 3종세트 손,35950,35950,0
2018-06-01,1114598034,C012060,여자내의,[하프클럽/SI]씨 플레어 배색 치마 팬츠 (SMPAE2248),19900,19900,0
2018-06-01,1337365037,C012030,여자상의,여성 단가라 박스 원피스박스 원피스원피스단가라 원,67620,67620,0
2018-06-01,1525383284,C013020,티셔츠,MRBOB 신상 기모 후드티 후드집업 빅사이즈 M~3XL,24800,24800,0
2018-06-01,1439603157,A019020,참깨,(볶음깨1kg 모음) 들깨가루 참깨 박피들깨가루,7500,7500,0
2018-06-01,477007897,C012040,여자학생복,지나블리스 큰 체크 롤업 카라 셔츠 남방 1804100,19800,19800,0
2018-06-01,1127401018,C012040,여자학생복,빅사이즈 DWW001A 편한 데님 롱 셔츠 802 빅사이즈 여,60990,54900,-6090
2018-06-01,899402193,A018010,초콜릿,[대진]대진 본오본 화이트 초콜렛 (17G),300,300,0
2018-06-01,802493226,A016070,귤,밀감캔(화남 850g)/밀감통조림 밀감캔 밀감 과일통조,4550,4280,-270
2018-06-01,2126329337,F011150,건강기능식품,CJ NEW 헛개컨디션 100ml10병/헛개파워/여명808,20900,20900,0
2018-06-01,770284716,C012060,여자내의,[나이스크랍] 언발란스 골지니트 스커트 a182ksd001 [nc중계점],149000,89400,-59600
2018-06-01,1112527925,C021040,실내화,[리복Reebok] 여성 패스트플렉스위브 런닝화 - CN1404,73100,61950,-11150
2018-06-01,2007224241,A022050,탄산음료,[한정판매]씨그램&어벤져스 패키지 탄산수 탄산음료,13570,12900,-670
2018-06-01,1779541128,L021020,장신구,[바보사랑][액세서리키친] 925실버 My planet 별자리 수호행성 목걸이,29900,29900,0
2018-06-01,108026422,E011050,책상,베스트리빙 베이직 H형 1200 책상(그레이),35900,35900,0
2018-06-01,1331268849,A012050,소시지,코리원/남부 페파로니 1kg/소시지/햄/토핑/피자,9600,9500,-100
2018-06-01,221036124,L021030,가방,[기획]Elegance 크로스겸 숄더백 SHSH019 (블랙/오렌지/핑크/브라운)/ 엘레강스,59000,47200,-11800
2018-06-01,1205038528,A011020,현미,삼원농산 2017년 찹쌀 10kg (5kg*2개) 100% 국내산,29900,29900,0
2018-06-01,1010287206,A013020,명태,[오늘의식탁] 노르웨이 연어필렛(슬라이스) 300g x 1팩,26900,24500,-2400
2018-06-01,1010287208,A013060,게,[오늘의식탁] 노르웨이 연어필렛(슬라이스) 1kg x 1팩,58900,53000,-5900
2018-06-01,1010287207,A013060,게,[오늘의식탁] 노르웨이 연어필렛(슬라이스) 500g x 1팩,35900,32500,-3400
2018-06-01,630440334,C014020,유아복,[데님인더박스]빅스타숏팬츠(78411-413-03)[갤러리아],68000,52360,-15640
2018-06-01,1307810647,I031040,생화,[웰라이프 3단 특대형 침대의자]접이식침대의자/캠핑/,32900,29450,-3450
2018-06-01,471929775,C012030,여자상의,절개나시벨벳원피스 PG1710 벨벳원피스 나시벨벳원피,73660,73660,0
2018-06-01,410824467,C013010,점퍼,빅사이즈 반하이롱패딩조끼 BR1712 미시옷 빅사이즈,80390,72360,-8030
2018-06-01,393978525,C011030,남자학생복,교복몰 기본 후드집업 5컬러 남자후드 교복 교복쇼핑,23650,21290,-2360
2018-06-01,1046418149,E061030,전구,국산 LED형광등/프리커프리/일주일특가/LG이노텍칩,9800,9800,0
2018-06-01,1647611700,L012090,기초화장품,아이오페 플랜트스템셀화이트젠히아루로닉더마트러블,20600,20600,0
2018-06-01,2084931244,C013010,점퍼,WWS1814G 남여후드시보리롱패딩점퍼 /(참고)롱패딩점,69700,61340,-8360
2018-06-01,1860510921,E061100,습기제거제,물먹는코끼리 참숯습기제거제 대용량525ml 20개,14900,14900,0
2018-06-01,1779541131,L021020,장신구,[바보사랑][액세서리키친] 925실버 My planet 별자리 수호행성 반지,15900,15900,0
2018-06-01,2120448666,A012010,국산쇠고기,[무항생제]안심 이유식 다짐육 300g 1등급(6구),34900,34900,0
2018-06-01,231233684,C015040,장갑,실버D 통기성이 좋은 성인용 매쉬 손싸게 실버용품 할,53870,53870,0
2018-06-01,89845358,F012020,생리대,무료배송 템포 레귤러 리뉴얼 20P X 2팩/ 템포,13800,13110,-690
2018-06-01,900475559,A011090,국수,[농심]농심 육개장 사발면 (86G),810,810,0
2018-06-01,629389332,D031010,주택수선재료,뿌리는방수다 550ml 스프레이 방수코팅제,5390,5390,0
2018-06-01,728057639,A013140,북어채,명식품/북어채(러시아산) 1kg,27000,27000,0
2018-06-01,1792449260,E061020,섬유유연제,인퓨전 보타니칼 미스트 드라이시트 105매/빨래건조기,9900,9900,0
2018-06-01,1244376471,I031010,장난감,뽀로로 첨벙첨벙 수영하는 뽀로로 목욕 장난감,13860,12200,-1660
2018-06-01,606623856,C011030,남자학생복,국내제조 남성 폴리마셔츠 나염 프린트 체크 110까지,20800,20800,0
2018-06-01,434927338,C012060,여자내의,지오 와이드 팬츠 LRP011 통바지 와이드팬츠 (YA02004,33760,29710,-4050
2018-06-01,123374044,A013020,명태,광림 대구포450g 2개,62550,62550,0
2018-06-01,1117750111,C013060,등산복,남성 빅사이즈 등산바지 등산복 작업복 아웃도어 여름,17110,17110,0
2018-06-01,382051145,L021020,장신구,[티르리르] 다즐링(R아케이드) 팔찌TBSSVW10636M-15,59000,50150,-8850
2018-06-01,1010287079,A013070,굴,[오늘의식탁] 활 랍스터 900~1100g 1마리,67900,62000,-5900
2018-06-01,1453523017,L021060,유모차,버기가드유모차 다기능 스포츠 가방-아쿠아,56650,56650,0
2018-06-01,1978390214,A013050,오징어,오뚜기 꽁치 280g X 24EA 꽁치 통조림 캔꽁치 고등어,81360,81360,0
2018-06-01,849227398,A019080,고추장,ⓒ 해찬들우리쌀태양초고추장(200G),1950,1950,0
2018-06-01,1876500150,A019160,밑반찬,[거시기장터]맛있는 화촌엄마손 남원추어탕500g*5,26500,26500,0
2018-06-01,284709126,A013170,생선통조림,자연산골뱅이 400gX3개 유동골뱅이 동원골뱅이 통조림,21900,21900,0
2018-06-01,836107947,A018090,잼,복음자리 딸기쨈 640g/380gx2병/포도잼/사과잼/땅콩쨈,8600,8600,0
2018-06-01,985387567,A019030,생강,초L프레시)한끼간편양파 (100G/팩),1790,1790,0
2018-06-01,985387568,A017020,상추,초L프레시)한끼간편샐러리(팩),1090,1090,0
2018-06-01,1574732393,C012020,원피스,셀렙샵 에디션 셋업 수트,98000,98000,0
2018-06-01,1235237615,C011020,남자상의,MJ_1135 블랙 더블트렌치 겨울자켓 겨울트렌치코트 자,216140,216140,0
2018-06-01,21808324,A019180,즉석식품,천일볶음밥 6봉 15가지 내맘대로 골라담기,9900,9900,0
2018-06-01,1536253972,A011120,두부,오그래 현미 가바현미 그래놀라 12종 시리얼 2만무배,990,990,0
2018-06-01,1909286048,C012060,여자내의,반바지 숏팬츠 PT1311-세미 클래식 숏 팬츠 핫팬츠 세,15650,15650,0
2018-06-01,1262501873,A013070,굴,건해삼(채 러시아 600g)X3 자숙해삼 해삼내장 해삼 건,281180,281180,0
2018-06-01,1331848250,L012060,샴푸,[제이숲] 레드제이 샴푸 500ml,32900,32900,0
2018-06-01,574806412,L021010,손목시계,알마니 시계 남/녀 18ss 국내재고 백화점 동일구성,98000,98000,0
2018-06-01,305849832,C011050,남자내의,시원한 면소재의 스트라이프 프린트 숏팬츠 BEY2PH1604/ 에디션앤드지,79200,71280,-7920
2018-06-01,1269613537,C021010,아동화,쥬쥬 레몬 셔벗 운동화 아동운동화 어린이운동화 여아,48840,48840,0
2018-06-01,2005757193,F012010,종이기저귀,리베로기저귀 밴드형/팬티형 2팩 모음전,31600,31600,0
2018-06-01,1019999625,E011020,침대,르메르침대/싱글/슈퍼/더블/퀸/[침대 + 매트리스포함],184000,184000,0
2018-06-01,551132436,A011010,쌀,경기미 추청아끼바레 20kg,52200,52200,0
2018-06-01,1289928675,L021030,가방,세인트스코트 롤리 토트 겸 숄더백 RCRG1567 크림 그,169000,143650,-25350
2018-06-01,383375288,C013020,티셔츠,[지오지아][지오지아] 코끼리 그레이 브이넥 티(ABT2TP1121),5000,4750,-250
2018-06-01,1623554860,F012010,종이기저귀,[GOO.N]군 기저귀 프리미엄 마시멜로 밴드 공용 3팩,41900,41900,0
2018-06-01,1475875401,F012020,생리대,시크릿데이 NEW센스팬티라이너10+1,9900,9900,0
2018-06-01,321616413,C013010,점퍼,쌈지 남성 바람막이 하프넥 집업자켓 SJ501,14900,14900,0
2018-06-01,124338829,C011020,남자상의,물세탁 가능 봄/여름 신상품 남성 정장바지 슬랙스,17800,17800,0
2018-06-01,145976435,C014010,아동복,한국생산 포켓 포인트 꽃게 상하복(9-24개월)800019,30160,29560,-600
2018-06-01,631945302,A016060,감,달콤샤르르 자연그대로 만든 아이스 왕 홍시 100개(컵,164400,144680,-19720
2018-06-01,989936911,C015040,장갑,초L)반코팅장갑기획(20켤레),9900,9900,0
2018-06-01,415011866,C011030,남자학생복,그레이 카라 포인트 화이트셔츠 남성남방 남자긴팔셔,29440,29440,0
2018-06-01,213845928,E031050,냉장고,[삼성전자] 인증점 삼성 김치냉장고 김치 플러스 RQ47M92K37L,2208900,2208900,0
2018-06-01,1648681187,E021010,침구,까사미아까사온 팰리스 인견 서커 침구 이불+패드+베개커버2종 세트 킹(K),89900,89900,0
2018-06-01,819291086,C011050,남자내의,(805/레이스자수호피)밑단레이스 스프사 8부파자마,11700,10420,-1280
2018-06-01,373056192,F012020,생리대,[릴리안] The건강한 탐폰 x 5팩 / 오버나이트 x 5팩,15000,15000,0
2018-06-01,1753310985,C021040,실내화,아동운동화 다이얼운동화 아동샌들,17000,17000,0
2018-06-01,985387543,A017070,부추,초L프레시)한끼절단대파,1590,1590,0
2018-06-01,989912954,F011150,건강기능식품,동아제약박카스F120ML*10입(박스),8000,8000,0
2018-06-01,462888207,E011040,소파,아로미가구 2017년 천연 라텍스 3인용소파 특가모음전,249000,249000,0
2018-06-01,1101562393,A013160,맛살,건맛살(차오름 1K)X10/rjsakttkf/건맛살,159420,159420,0
2018-06-01,631140237,C011030,남자학생복,패딩점퍼 빅사이즈 2073 MK 2071 빅사이즈,72190,70030,-2160
2018-06-01,1525682290,A011130,시리얼,오뚜기 부침가루 500g X 20EA 바삭한튀김가루 튀김분,36230,35150,-1080
2018-06-01,238788177,C015020,모자,(COLOR : 블랙) MC-019 투버튼 포인트 군모,12740,12740,0
2018-06-01,240431964,C013050,운동복,특가9900~냉장고바지.조거 팬츠.트레이닝팬츠,28000,19800,-8200
2018-06-01,812366693,E061080,키친타월,업소용 흡수패드 10*15 /절약형 500매/드라이록,16900,16900,0
2018-06-01,1599809522,F012050,의료측정기,브라운 정품 체온계 IRT-6520+필터21개포함,86160,80000,-6160
2018-06-01,124808717,A014030,치즈,미국 메세나 파마산 치즈 분말 가루 파우더 227g,8390,8390,0
2018-06-01,185539223,C013050,운동복,여름신상 트레이닝바지/츄리닝/커플추리닝남자옷,13800,13800,0
2018-06-01,3141099,L021010,손목시계,해외정품 버버리시계 남성 시계 bu9350/bu9381/bu9354,155000,155000,0
2018-06-01,2016280385,I012060,저장장치,3점사/게이밍마우스/HKCNC/HK-M1/FPS/게이밍/게임용,7800,7800,0
2018-06-01,1010287081,A013070,굴,[오늘의식탁] 활 랍스터 900~1100g 2마리,130000,119000,-11000
2018-06-01,435979865,A018080,설탕,백설 / 설탕 2종 / 하얀설탕3kg / 갈색설탕3kg,3550,3550,0
2018-06-01,214512168,C011050,남자내의,[휴아이지옴므][무료배송] 울트라스판 인생팬츠 리턴-2,15900,15900,0
2018-06-01,606200623,A018040,아이스크림,이태리 아이스크림/파브리 업소용 젤라또 5L/7L/9.5L,36000,35640,-360
2018-06-01,277255150,A011160,빵,우리가찾던 통밀빵 모음선택1식사대용 우리밀빵 식빵,3000,3000,0
2018-06-01,1240863985,C013050,운동복,스쿼드 15 사이드라인 우븐 자켓(645476463) 자켓 남,74270,74270,0
2018-06-01,700434322,C013010,점퍼,[대구백화점 I관] [베이직코데즈]네오프렌롱점퍼(BZA-JPC26W1),50000,46000,-4000
2018-06-01,1324372241,C012040,여자학생복,(239) 마혼방롱조끼 여름기본롱조끼 롱조끼,20800,20800,0
2018-06-01,988032463,A016160,과일가공품,스위트 마운틴 바나나 (특/봉/1.2kg내외)_에콰도르산,3990,2990,-1000
2018-06-01,1451442901,A019070,양념소스,엔젤라미아 스파게티소스 2.95kg,8900,8900,0
2018-06-01,144133293,A022050,탄산음료,롯데 제주감귤 175ml x 30캔 음료수,5210,4900,-310
2018-06-01,1061911401,A019080,고추장,[우리명가]자연송이고추장 2호,49900,49900,0
2018-06-01,1061911402,A019080,고추장,[우리명가]자연송이고추장 3호,68800,68800,0
2018-06-01,189026822,E041020,컵,leah 엔틱 커피잔세트 2인조 / 찻잔 머그컵 머그잔,32180,32180,0
2018-06-01,268708043,A019110,드레싱,일본간장/쯔유/된장/데리야끼/와사비/후리가케/카레/혼다시/가쓰오부시/소바/우동스프,4500,4500,0
2018-06-01,1061911405,A019080,고추장,[우리명가]능이고추장 2호,49900,49900,0
2018-06-01,1061911406,A019080,고추장,[우리명가]능이고추장 3호,68800,68800,0
2018-06-01,1061911403,A019080,고추장,[우리명가]자연송이고추장 4호,138000,138000,0
2018-06-01,1061911404,A019080,고추장,[우리명가]능이고추장 1호,24800,24800,0
2018-06-01,689038436,E011050,책상,위드모던 인테리어 가구 모음전/선반/책상/의자/행거,43900,43900,0
2018-06-01,1061911409,A019080,고추장,[우리명가]자연송이 + 능이고추장 2호,138000,138000,0
2018-06-01,1800337612,C013040,청바지,[블루독](BL)5부 데님팬츠(27325-414-03),49000,37730,-11270
2018-06-01,1859260104,C012020,원피스,(무료배송) (해외직배송)여성 꽃프린트 트렌치 코트,80920,71210,-9710
2018-06-01,1061911407,A019080,고추장,[우리명가]능이고추장 4호,138000,138000,0
2018-06-01,1343894539,I011020,영상음향기기,LG미니빔TV 시네빔프로젝터 PH550 스마트빔,546310,519000,-27310
2018-06-01,1061911408,A019080,고추장,[우리명가]자연송이 + 능이고추장 1호,49900,49900,0
2018-06-01,988095888,E061060,살충제,초L)수성에어졸(무향)500ML,3500,2990,-510
2018-06-01,1269554665,C013010,점퍼,빅사이즈 패딩 점퍼 MC 1300 빅사이즈 패딩점퍼 패딩,117210,105490,-11720
2018-06-01,988095889,E061060,살충제,초L)수성에어졸(무향)500ML*2,5950,5850,-100
2018-06-01,1269794198,C012040,여자학생복,bb83 언발 니트조끼 연두 니트베스트 여자겨울니트조,14830,14830,0
2018-06-01,1482867543,A019070,양념소스,청우 캡사이신 매운맛소스 550g,4500,4500,0
2018-06-01,1545324636,C013040,청바지,[게스][18SS] YI2D9089 ICE 여 ICE 구제 보이프렌드,47900,45990,-1910
2018-06-01,281316018,A018030,껌,[롯데]자일리톨 껌 리필구매시 5000X3개+증정3개/무배,9900,9900,0
2018-06-01,1995816234,C013040,청바지,[PLAC Jeans][PLAC]KURZ 42U WSHD (PJOE3KU42U542U),79000,76630,-2370
2018-06-01,2127723520,C013060,등산복,남성 여성 공용 보웰 벤치코트 다운 (MVMWD404_2)/ 밀레(ML),149000,126650,-22350
2018-06-01,766512245,F011130,홍삼,[한일인삼]_6년근 고려홍삼액골드 70ml*60포,29900,29900,0
2018-06-01,987261673,E061080,키친타월,초L)뽑아쓰고 빨아쓰는 키친타올 40매*3입,7490,7490,0
2018-06-01,364071918,C011050,남자내의,[인간적으로 너무싸다]심플한 무지 냉장고바지/배기,5900,5900,0
2018-06-01,1010287016,A011160,빵,[델리만쥬]델리만쥬 9개입x4봉(총520g)+호두과자 3봉,17900,13500,-4400
2018-06-01,288402837,A019040,소금,생활죽염 개암염 250gX5개/ 개암죽염 생활 죽염 양치 다용도 죽염 소금 조리용 양치용,30000,30000,0
2018-06-01,766512243,F011130,홍삼,[한일인삼]_6년근 명품홍삼진액 80ml*30포,21900,21900,0
2018-06-01,1246683175,C011050,남자내의,마이크로 조직 스판 면팬츠 ZPY2PP1501ALL/ 올젠,45000,35100,-9900
2018-06-01,766512244,F011130,홍삼,[한일인삼]_[1+1]_6년근 고려홍삼액골드 70ml*60포,56900,56900,0
2018-06-01,1726685646,E061020,섬유유연제,다우니 퍼퓸 콜렉션 8.5L 엘레강스 / 어도러블,19900,19900,0
2018-06-01,2115883076,E061030,전구,전구/형광등/램프/삼파장전구/직관형광등/삼파장형광등/오스람/필립스/형광램프/식물재,54000,54000,0
2018-06-01,766512241,F011130,홍삼,[고려인삼]_6년근 고려홍삼액 70ml*20포,11500,11500,0
2018-06-01,766512242,F011130,홍삼,[한일인삼]_[1+1]_6년근 명품홍삼진액 80ml*30포,39900,39900,0
2018-06-01,766512240,F011130,홍삼,[고려인삼]_[1+1]_6년근 고려홍삼액 70ml*20포,19900,19900,0
2018-06-01,1020861751,A013100,마른멸치,특가! 완도전복 횟감용 중 대 특대 1kg,36900,36900,0
2018-06-01,833152838,C013010,점퍼,[앙팡] 앙팡 래쉬가드 집엎 (네이비) 물놀이옷 아동복 네이비,24780,24780,0
2018-06-01,453624705,A016160,과일가공품,블루베리안주 (소울 350g) X6,130520,116170,-14350
2018-06-01,979304899,C012030,여자상의,냉장고 치마/원피스 여름엔 냉장고바지!필수아이템,6900,6900,0
2018-06-01,1113514008,E061020,섬유유연제,(FC 베이비전용 섬유유연제 bottle) 아기의류빨래 유,19720,19720,0
2018-06-01,2121820654,C013010,점퍼,[앤디애플키즈]NEW상큼한파스텔번아웃점퍼,16900,15380,-1520
2018-06-01,1881547710,A011080,밀가루,칠갑농산18개/컵라면/라면/똑쌀떡국/쌀국수/떡국,18800,18800,0
2018-06-01,1261345511,A017220,양파,대파가루 1kg,28000,28000,0
2018-06-01,1699559277,A013030,조기,영광굴비/법성포/조기/말린/국산/명절/선물세트/오가/,195400,195400,0
2018-06-01,1553185566,C011030,남자학생복,[제이브로스]헨리넥 버튼 니트 조끼,20800,19760,-1040
2018-06-01,325988578,C012040,여자학생복,[에잇세컨즈] 블랙 골지 5부 니트 풀오버 (118451SYA5),35900,34110,-1790
2018-06-01,293628927,C013060,등산복,스카티 카라 남성반팔 티셔츠 (MUNUT481)/ 밀레(ML),33000,29040,-3960
2018-06-01,2007405539,F012020,생리대,예지미인 36.5 팬티라이너 15Px12팩 180매 특가상품,8600,8600,0
2018-06-01,1967558455,C013060,등산복,[디스커버리]남 여 스트라이프 샤크 티셔츠 택 (DMRT7I731 DWRT7J731 DMRT97731 DWRT9,29400,24990,-4410
2018-06-01,991342107,C014010,아동복,여아 디즈니공주원피스 수면잠옷 엘사드레스 아동,9900,9900,0
2018-06-01,634112519,C013020,티셔츠,어깨트임태슬티/오프숄더티/섹시티셔츠/셔링티셔츠,7900,7900,0
2018-06-01,838213078,C013020,티셔츠,소매두줄후드롱티/후드티셔츠/후드반팔티/여름후드티,9900,9900,0
2018-06-01,1411528554,A017210,파,탱글한 완숙 토마토10kg (못난이/쥬스용),18800,16800,-2000
2018-06-01,1435321388,I031040,생화,유니앤유 캠핑침낭 모음 동계/이불/4계절/초경량/군용,17900,16030,-1870
2018-06-01,1054402856,E011050,책상,미자크 로맨틱책상/h형책상/컴퓨터책상/학생책상,164900,159900,-5000
2018-06-01,109226417,C014020,유아복,여름/아동/아동옷/아동의류/아동복/상하복/여아반팔,14400,14400,0
2018-06-01,69647279,I031040,생화,정품 오리털침낭 거위털100% 거위털침낭 사계절침낭,59500,47930,-11570
2018-06-01,662626373,C012060,여자내의,[PL_홈쇼핑][페리젠슨]쿨 스트레치 절개라인 정장팬츠 블랙.GPD15606,4400,4180,-220
2018-06-01,530481784,C012060,여자내의,백합주름치마 차콜(전체 주름 교복치마) 교복 예쁜교,55060,53410,-1650
2018-06-01,551793388,C012060,여자내의,미즈라인 렛츠핫 밍크퍼 페브릭 레깅스 보정레깅스 편안한 착용감,36400,36400,0
2018-06-01,1661634059,C013010,점퍼,패치항공점퍼/집업/봄점퍼/간절기/코치자켓/숏자켓...,16900,16900,0
2018-06-01,408920698,C011030,남자학생복,셀린 배색 롱가디건 KD 롱 A라인 롱니트 롱배색원피스,65000,64350,-650
2018-06-01,315427335,C012060,여자내의,[밸리걸]라인 포인트 벨티드 점프슈트(978000),12450,10590,-1860
2018-06-01,1858131958,C012060,여자내의,튤립라인린넨스커트(RMWH737RQ4)/ 로엠,19000,17100,-1900
2018-06-01,1483940385,C012030,여자상의,주름쉬폰롱원피스/허리셔링/여신원피스/나시롱/무지,7900,7900,0
2018-06-01,1941294019,C011020,남자상의,아스터 남자 스판 슬랙스 모음,17900,17900,0
2018-06-01,1478749202,E061080,키친타월,크리넥스 깨끗한나라 키친타올 빨아쓰는 행주타올,7900,7900,0
2018-06-01,1278481226,E041020,컵,머그컵/답례품 개업선물 커피 머그잔 찻잔 판촉물,1000,990,-10
2018-06-01,736771701,C011030,남자학생복,STCO 外 한정 여름 특가 기획전!,10000,10000,0
2018-06-01,579955271,C021040,실내화,[나이키][정품] 나이키 에어 맥스 시퀀트 3 (921694-011),89000,85440,-3560
2018-06-01,1353354857,C013020,티셔츠,베이직 후드티 LTT0036 여성티셔츠 여성후드티,26120,25600,-520
2018-06-01,488500310,A019110,드레싱,다빈치 카라멜소스/초코소스/화이트소스/포모나/모닝,21500,21500,0
2018-06-01,42161396,F012050,의료측정기,마이크로라이프 10초측정 전자체온계/겨드랑이 아기,8500,8500,0
2018-06-01,480232353,E021010,침구,마이크로 차렵이불+베개커버 세트/이불세트/침구세트,12900,12900,0
2018-06-01,451117718,A019010,고춧가루,C김치 고추가루 1kg2개 가루 고추가루 김치고추가루,32780,29510,-3270
2018-06-01,1823918783,A022010,주스,무배 탕 오렌지 쥬스 분말 가루 파우더 350g 4봉,34150,34150,0
2018-06-01,590888099,C014010,아동복,[GAP kids]갭키즈 토들러 여아 반팔 그래픽 티셔츠(인천점),19000,17510,-1490
2018-06-01,1525021368,A012010,국산쇠고기,한우갈비혼합세트 4호 2kg 찜갈비+국거리 소고기선물,263400,263400,0
2018-06-01,1070376617,E011040,소파,[룸앤홈] 패브릭 2인 쇼파 모음,80100,80100,0
2018-06-01,314359109,A021010,커피,[맥널티]핸드드립 원두커피 7개입x3세트 골라담기,9890,9890,0
2018-06-01,1765593093,C012040,여자학생복,[포에버21]골지 후드 니트/FOREVER21/니트/스웨터/후드니트,44900,22450,-22450
2018-06-01,161831042,C021040,실내화,행텐 / 니코보코 / 런닝화 / 에어조깅화/트래킹화,25800,25800,0
2018-06-01,1551946337,C011030,남자학생복,자라 패딩 조끼/size S/자켓/베스트/세일/중고/구제,19900,19900,0
2018-06-01,1111699183,A018080,설탕,백설 하얀 설탕 3kg,3000,3000,0
2018-06-01,1261406882,E061050,청소용세제,곰팡이제거제 한번애/곰팡이/욕실곰팡이/실리콘,19700,19700,0
2018-06-01,985204115,A017180,호박,초L프라임)얼굴이보이는 삼색파프리카,6990,4990,-2000
2018-06-01,61815121,I031070,애완동물관리비,테니-스 라켓 테니-스용품 테니스훈련채 구기종목 스,123950,123950,0
2018-06-01,1598039345,E031050,냉장고,인증점M 삼성 김치냉장고 NEW M9000 RQ51N92D07Z,1821870,1749000,-72870
2018-06-01,722448566,C011050,남자내의,린넨반바지/마바지반바지/여름반바지/냉장고바지 특가,7900,7900,0
2018-06-01,988007470,A013130,오징어채,쥐치포 (25장/기획),10900,10900,0
2018-06-01,988007473,A014030,치즈,초이스L 트리플 피자치즈 200G,4700,4200,-500
2018-06-01,1179732298,C013010,점퍼,[메이드]야상점퍼/자켓/아웃도어/바람막이/남성/남자,29800,29800,0
2018-06-01,125998066,E011040,소파,플로바움 나르본 3인용 쇼파,237000,237000,0
2018-06-01,1253643090,C011030,남자학생복,FS-78 카모 패턴 데님 셔츠 데님셔츠 캐주얼셔츠 캐쥬,18670,18670,0
2018-06-01,2105615070,E011070,식탁,[할인중]모카 광파오븐수납렌지대/아일랜드식탁/홈바,178000,178000,0
2018-06-01,988007475,A019150,김치,초L)한끼 맛김치 80G,1100,1100,0
2018-06-01,1600557807,C013010,점퍼,[홈쇼핑히트]티나쉐 시퀸 블루종 점퍼 2종,29000,27550,-1450
2018-06-01,1665390626,C012020,원피스,김발(속대 에브리홈)X2,2290,2290,0
2018-06-01,1127307701,E061050,청소용세제,두꺼비 블랙스파이더 곰팡이젤 8통 곰팡이제거제,39800,39800,0
2018-06-01,327970271,A022030,생수,페리에(330mlx24병/box) (탄산수/수입생수/에비앙),27000,26700,-300
2018-06-01,1912118519,I031010,장난감,스텝2 사파리웨곤 new 대형완구 자동차완구 유아붕붕,565440,565440,0
2018-06-01,1671456266,F012010,종이기저귀,[혜택가22900원]하기스 오버나이트 팬티 2팩/밴드 2팩,27900,27900,0
2018-06-01,308256569,I053010,공책,모닝)초등 1-2 무제노트(남)-팩(10권입) 캐릭터노트,11650,11650,0
2018-06-01,208024783,L012090,기초화장품,[라로슈포제] 라로슈포제 에빠끌라 딥 클렌징 포밍 크림,15200,15200,0
2018-06-01,2054046425,E031010,전기밥솥,CRP-M112FG/쿠쿠/압력/10인용/음성/GH,176000,151250,-24750
2018-06-01,117364390,I031040,생화,대형 2층 팔각 파라솔/꺾임형/비치/파라솔/받침대/해,27500,25300,-2200
2018-06-01,949225531,A022010,주스,썬라이트 1박스(180mlX24개) 4가지맛 여름간식,8400,8400,0
2018-06-01,1784814037,A011010,쌀,쌀 4kg 창녕 농협 우포햇살 무료 배송 백미,12900,12900,0
2018-06-01,321439683,C013010,점퍼,쌈지 남성 바람막이 후드 집업자켓 SJ502,9900,9900,0
2018-06-01,570272856,A017140,콩나물,일송정 도라지배즙 기침 기관지 임신중배즙/배즙원액,45900,45900,0
2018-06-01,201998119,L021020,장신구,로켓목걸이/소원을이루는목걸이/페리도트(부부애),35000,33950,-1050
2018-06-01,486367032,F011130,홍삼,초이스엘프라임 데일리 홍삼정(10ML*30포),48000,48000,0
2018-06-01,456968310,E061040,부엌용세제,커피머신세정제 어넥스카피자 - 커피머신세정제 커피,41780,37190,-4590
2018-06-01,450688491,C011050,남자내의,기모바지 622 등산바지 남성등산바지 남성바지 남자등,67140,67140,0
2018-06-01,114017171,C011030,남자학생복,빅사이즈 스트라이프 가디건ii911-001 / 라운드넥니트 빅사이즈가디건 남성가디건 남자,70360,54890,-15470
2018-06-01,1990309768,I012010,컴퓨터,[삼성전자]삼성아트PC DM700C6A-A79,1893680,1799000,-94680
2018-06-01,1597263818,F011130,홍삼,정관장 홍삼정진 기프트세트,210000,210000,0
2018-06-01,1130717606,A013040,고등어,[여수고기]고등어 1.5kg + 삼치 1.5kg 세트,32900,32900,0
2018-06-01,1090207790,I031010,장난감,Step2 이인용 밴 승용완구 지붕차유아자동차 장난감,261770,261770,0
2018-06-01,2070069774,C012040,여자학생복,빅사이즈/도토리/리본/블라우스 / 참고 미시옷 임부복,76400,64940,-11460
2018-06-01,37980218,C012040,여자학생복,롱셔츠/체크남방/린넨/빅사이즈/여성/여자/청,15900,14900,-1000
2018-06-01,786453155,A013120,낙지,[건어물천국]신선한 당일바리 마른오징어20마리,61900,61900,0
2018-06-01,1561129693,L021030,가방,[메트로시티(metrocity)]숄더 겸 토트백 M72MF408Z(본점),451620,381130,-70490
2018-06-01,1707065703,I031040,생화,휴몬트접이식물병700ml.물통.등산용물병.등산용품.,2500,2240,-260
2018-06-01,441033319,A019060,된장,신송재래된장14kg,47100,47100,0
2018-06-01,971234588,A011080,밀가루,[푸드모닝]웰빙칼국수/웰빙수제비/생면칼국수 모음전,2600,2600,0
2018-06-01,578344910,A018080,설탕,CJ 백설 설탕/백설탕/하얀설탕 15kg 대용량,14800,14800,0
2018-06-01,1152788674,C012060,여자내의,[제쉬나인][제쉬나인]시스루 쉬폰 롱스커트랩스커트트임롱,29800,26820,-2980
2018-06-01,117293480,E011030,거실장,[PookShuim] 푹쉼 체스키 PU가죽 3인용 소파,550000,550000,0
2018-06-01,815261291,L021010,손목시계,TEVISE BENYAR 해외브랜드 특가 메탈 가죽 손목 시계,42000,39000,-3000
2018-06-01,266490919,L021020,장신구,[폭스타일] [실버] 지니퍼 반지,11000,10010,-990
2018-06-01,297561213,C012020,원피스,[대구백화점 I관] [SOUP](기존가:229 000원)더블단추루즈핏트렌치코트(SU4BB81A),99000,84150,-14850
2018-06-01,452070163,C021020,구두,로하 샌들 LKR272 여자샌들 여성샌들(YA02004),53230,53230,0
2018-06-01,117293479,E011030,거실장,[PookShuim] 푹쉼 체스키 PU가죽 4인용 소파세트,830000,830000,0
2018-06-01,117293478,E011030,거실장,[PookShuim] 푹쉼 베른 라탄 흔들의자,129000,129000,0
2018-06-01,59125694,E021010,침구,SESA 세사! 여름 침구 사커/인견/패드/알러지케어,29700,29700,0
2018-06-01,1717894182,C013050,운동복,차량용 멀티트레이/식사테이블/장거리 여행 필수품/YKM,15000,13800,-1200
2018-06-01,77291080,A012060,햄및베이컨,(초특가) 스팸200g 8개/런천미트 15개 햄 통조림,13900,13900,0
2018-06-01,1998475250,C012020,원피스,[쥬크]귀공녀 스타일 폭스 퍼 롱코트(Z174MSG012),303600,242880,-60720
2018-06-01,117293477,E011030,거실장,[PookShuim] 푹쉼 베른 라탄 테이블 (유리포함),90000,90000,0
2018-06-01,559912367,C014010,아동복,[모다아울렛][페리미츠]클래식 데님팬츠 P1821Q201,39900,37910,-1990
2018-06-01,1545094045,C021040,실내화,아디다스 운동화/런닝화/스니커즈 모음(무료배송),44000,39300,-4700
2018-06-01,751105580,C012020,원피스,[로엠][로엠] 체크 코트 RMJH811RS1,69300,60300,-9000
2018-06-01,321616442,C013010,점퍼,쌈지 남성 바람막이 후드 집업자켓 SJ502,9900,9900,0
2018-06-01,993501960,A014010,우유,홍초(석류 마시는홍초 대상 900ml) X 12 마시는식초,87890,87890,0
2018-06-01,988007438,A018050,비스킷,롯데 요하이 그릭요거트샌드 222G,3600,3290,-310
2018-06-01,383926272,C013050,운동복,BE036 Coms 타이어 밸브 캡. 4ea - 공기압 측정 밸브,12860,12860,0
2018-06-01,1444041967,A012050,소시지,[롯데햄] 롯데 키스틱1200(60gx20개),11900,11900,0
2018-06-01,303046494,E041020,컵,도자기 커피잔-커피잔세트/찻잔/머그컵/머그잔/부부잔,22500,21800,-700
2018-06-01,1825503181,E021010,침구,돌체 순면100%고밀도 60수샤틴 차렵이불,88000,80960,-7040
2018-06-01,121738131,E011030,거실장,2x5책장 월넛화이트 (배송),89000,89000,0
2018-06-01,121738132,E011030,거실장,1x5책장 월넛화이트 (배송),69000,69000,0
2018-06-01,1200046640,I011030,사진기,[사은품증정][파나소닉]루믹스 디카 DC-GX9 바디킷,938150,863100,-75050
2018-06-01,2018659550,A013100,마른멸치,완도활전복/건강/보양/감사선물13~14미크기1kg/1.5kg,39800,38800,-1000
2018-06-01,1709930811,E011030,거실장,이노크아든 모던 1500 거실장 TV장식장 인테리어,64900,64900,0
2018-06-01,2099737618,C013030,스웨터,MTSSF18014 크랙 후드 후드 남성후드티 캐쥬얼후드티,40580,40580,0
2018-06-01,438115725,C013020,티셔츠,베이직셔링티(DG_16B) 여성셔링티셔츠 빅사이즈티셔츠,15700,15700,0
2018-06-01,2099678958,E031020,가스레인지,벽고정레인지후드 스테인리스 060 뤼트미스크 060/ 벽,297460,264740,-32720
2018-06-01,504309227,E041030,솥,풍년 압력밥솥 베르니나 압력솥 세트 3L+4.5L,119000,119000,0
2018-06-01,1639683781,I011030,사진기,-정품 니콘 P900s 광학 83배줌 카메라 4종사은품증정,637270,583460,-53810
2018-06-01,1880788933,A017080,무,통째 달인 진한맛! 무안 황토양파즙 60포 (선물추천),13900,13900,0
2018-06-01,320135178,C013050,운동복,카테크 CT-726CD-C 울트라 파워 차량용 무선광택기 광택융1매 왁스융1매포함 무선광택,64000,58880,-5120
2018-06-01,1159984864,C013010,점퍼,브랜드특가 골프자켓/초경량자켓/스판자켓/윈드자켓,42500,39000,-3500
2018-06-01,434787561,F012020,생리대,순 슈퍼롱 오버나이트 5p/ 예지미인,1150,1150,0
2018-06-01,1790466562,C013010,점퍼,[제쉬나인][제쉬나인]플라워 믹스 레더 점퍼항공점퍼야구점퍼,39800,35820,-3980
2018-06-01,1457360571,E061040,부엌용세제,팜올리브 주방세제 라벤다향 591mL,5900,5900,0
2018-06-01,1942971876,C013040,청바지,[신디키즈]데님사선트윌 트레깅스,8000,8000,0
2018-06-01,704289880,A013070,굴,산직직송 독도사랑 살이좋은 싱싱한홍게 85% 5마리,85900,85900,0
2018-06-01,584579361,E061040,부엌용세제,P&G 코스트코 울트라조이 고농축 주방세제,9890,9890,0
2018-06-01,1065585972,G011070,자전거,시애틀레이디7+무료배송 18년 페밀리자전거 7단26인치,138000,138000,0
2018-06-01,244644657,L021050,우산,사랑스토어 장마철 우산 4000원부터 최다종류 모음전!,8500,8500,0
2018-06-01,814665937,A017040,양배추,[강화약쑥100] 강화약쑥 건쑥 사자발약쑥 쑥미스트 쑥,12000,11880,-120
2018-06-01,1193182234,D031010,주택수선재료,아이생각결로텍스 4L 결로방지전용 곰팡이방지 베란다,32000,29500,-2500
2018-06-01,1815042548,L012060,샴푸,아로마티카 로즈마리 티트리 샴푸 모음+미니샴푸50ml,17100,17100,0
2018-06-01,1526333277,L012090,기초화장품,트리플에멀젼 건조 민감 아기 순한보습,92000,92000,0
2018-06-01,1136961198,A013090,전복,두레생협 생홍합살(300g 국산) 탕용홍합 탕용생홍합살,25900,25900,0
2018-06-01,439413265,A013120,낙지,[가온애] 최고인기상품 오징어 당일바리 마른오징어,14800,14800,0
2018-06-01,445572845,C013010,점퍼,윈드 에디션 지퍼 점퍼 (아이보리) 봄가을용,17290,17290,0
2018-06-01,1894014732,L021020,장신구,14k 라피스 쥬얼체인지 피어싱(1개)/ 도로시(쥬얼리),77000,69300,-7700
2018-06-01,2064184330,C012060,여자내의,SK1635-피츠 밴딩 플레어 스커트 FREE(44~66) 플레어,26520,26520,0
2018-06-01,437253808,C012040,여자학생복,BL228-반오픈 스트라이프 블라우스 여성셔츠 패션블라,22100,22100,0
2018-06-01,1265737669,C012040,여자학생복,아이우먼 꼬임 랩 소매 조끼 HM2218M805 빅사이즈,52000,45890,-6110
2018-06-01,1618036400,A014040,발효유,요거베리 요거트스타터 플레인 2BOX,17900,17900,0
2018-06-01,1684879420,L021060,유모차,제이엘차일드리스 유모차 보관함 외출용품 신생아,63760,63760,0
2018-06-01,374165616,E041070,밀폐용기,스텐 밀폐용기 반찬통 김치통 국산 320ml~3800ml,8300,8300,0
2018-06-01,1439725448,C012020,원피스,[하랑이플] 여름신상 반팔티+통바지세트 와이드팬츠 냉장고바지,14900,14900,0
2018-06-01,986249524,A018060,스낵과자,[오리온]오리온 고래밥 볶음34G,560,560,0
2018-06-01,36329247,C013010,점퍼,[Propper] PROPPER N3B-프로퍼 야상-밀리터리 점퍼-야상 점퍼,155000,155000,0
2018-06-01,2112083900,C012040,여자학생복,[일라일(ILAIL)][17F/W]캐시미어100% 라운드넥니트티(BWKT-17804-BL)[갤러리아],199000,189050,-9950
2018-06-01,1177329861,A012050,소시지,간식/안주/천하장사/코주부/징기스칸소시지/70g/10개,5500,5500,0
2018-06-01,1789216130,E031070,에어컨,fc11-90 천장형선풍기 천정형선풍기 천장용 실링팬,26000,26000,0
2018-06-01,1546311678,C012030,여자상의,야스타 섹시 미니원피스 섹시원피스 홀복 클럽의상,18900,18900,0
2018-06-01,797599408,A019080,고추장,해찬들 태양초 고추장(500G),8500,8500,0
2018-06-01,955886948,E061020,섬유유연제,[아토세이프] 섬유유연제 2.5L 4개(후리지아향)+(증정)밀크코튼 50ml 2개,14900,7900,-7000
2018-06-01,121738108,E011030,거실장,3x5책장 월넛화이트 (배송),99000,99000,0
2018-06-01,958516116,A013060,게,원양 오징어(냉동/마리),2790,2790,0
2018-06-01,477693061,C011020,남자상의,MJ-979 세인트안 코트 남성하프코트 캐주얼코트 남성,58840,58840,0
2018-06-01,1023688867,C013010,점퍼,아르크네 양털 무스탕 DM-4044-양털무스탕자켓 양털,102690,102690,0
2018-06-01,768965356,I031040,생화,뮬러 보호대 모음전/무릎보호대/손목/발목/보호대,15000,13710,-1290
2018-06-01,1671458923,A016020,배,자연농부 고냉지나주배 선물세트 1호 3.75kg(6과),27400,27400,0
2018-06-01,1903591825,C013020,티셔츠,[대구백화점 II관] [코오롱스포츠]여성 플라워 자카드 반팔 카라티셔츠 (JKTAM17722),46800,44460,-2340
2018-06-01,532352184,C013010,점퍼,styleenter 무스탕점퍼 라이더무스탕점퍼 남자무스탕점퍼 남자라이더무스탕추천 주문제,1080000,1080000,0
2018-06-01,1282786794,I031010,장난감,(Step2)이인용밴 (2016.4.1 소비자가인상) 지붕차 자,227800,227800,0
2018-06-01,314915619,A011090,국수,팔도 비빔면 130g*20입 (무료배송),17400,12900,-4500
2018-06-01,1495828752,E011060,의자,접이식의자/접의자/학원/교회의자/회의용/캠핑/사무용,15900,15900,0
2018-06-01,454413424,C013050,운동복,카본 범퍼윙 가드 대 중 소 중 택1 도어가드 자동차가,20010,18230,-1780
2018-06-01,632895046,A011170,떡,전북고창 울어매 복분자송편 100개(25개 4팩) / 삼경,84000,73920,-10080
2018-06-01,463633112,C015040,장갑,밍크 방울 모직 장갑 캐주얼장갑 여성장갑 방울장갑,21390,21390,0
2018-06-01,712474601,C012030,여자상의,여름인기 원피스/44-110/빅사이즈/비치웨어/롱원피스,33800,27800,-6000
2018-06-01,955886918,E061020,섬유유연제,[아토세이프] 집먼지진드기 액상세제 2.5L 4개+(증정)밀크코튼 50ml 2개,47700,11900,-35800
2018-06-01,37896382,A016090,참외,성주참외 10kg~ 맛있는 꿀참외[산지직송],15900,15900,0
2018-06-01,1894014755,L021020,장신구,14k 펄 쥬얼체인지 피어싱(1개)/ 도로시(쥬얼리),63000,56700,-6300
2018-06-01,2002775453,A019130,스프,나가사끼짬뽕소스 (초담원 2K),32260,28720,-3540
2018-06-01,51684719,C013040,청바지,[바지킹] 여름신상 반바지 프리미엄 청바지 당일출고,14900,14900,0
2018-06-01,738115540,F011150,건강기능식품,오양식품 21곡 미숫가루/블랙자연선식/아침/식사대용,14000,14000,0
2018-06-01,2058629103,A022010,주스,상쾌한 맛 해태) 코코팜 포도 238ml x 72캔 착한가격 좋은 음료(묶음가능:1개) 포도주,58510,58510,0
2018-06-01,2002775447,A019130,스프,일본 미소라면소스 (유타카 1.8L) X6,190270,169350,-20920
2018-06-01,2084040371,C013040,청바지,(SR)MHA702남자빅사이즈스판청바지 /(참고)남자빅사이,52900,44970,-7930
2018-06-01,2002775445,A019020,참깨,검정깨가루 (한1K),24950,22210,-2740
2018-06-01,2123817813,C012060,여자내의,[토모톰스]마8부 팬츠(TT184SL5Z003),39000,37830,-1170
2018-06-01,1195672811,A017180,호박,(참살이식품)중국산 고춧가루1kg 김장용 양념용 고추,16400,15910,-490
2018-06-01,1231716668,L012110,색조화장품,단독1+1 라네즈 안티폴루션 미세먼지방어 투톤 선스틱,27000,27000,0
2018-06-01,427514376,C012020,원피스,진도 Klever 휘메일 밍크 자켓(K1W2EJ21),1890000,1795500,-94500
2018-06-01,1421678347,C013050,운동복,카로스 쌍용수출형로고 타이어 밸브캡 4PCS(크롬+블랙) 쌍용밸브캡 쌍용타이어밸브캡,12000,12000,0
2018-06-01,602770430,E061050,청소용세제,곰팡이제거제(500g+500g)x2개 욕실청소 유한양행 주방,10900,10900,0
2018-06-01,2073935636,C013010,점퍼,남자청자켓 기획 차이나 워싱 데님자켓 아우터 남성자,37840,37840,0
2018-06-01,448082754,E041020,컵,한국도자기 2인조 커피잔 모음 부부찻잔  선물세트,33600,33600,0
2018-06-01,135713936,A013080,조개,왕중왕 해물나라 900g2개,33280,33280,0
2018-06-01,826674203,A011110,당면,국산콩으로 만든 반찬용 무소포제 포두부 건두부,28800,28800,0
2018-06-01,606209077,D031010,주택수선재료,미앤미 멀티 조립식마루 9p세트 다크그레이 바닥재,29400,27930,-1470
2018-06-01,1211707134,A017160,오이,유기농인증노루궁뎅이버섯 / 생버섯  건조  분말 판매,31900,31900,0
2018-06-01,1124144882,A013080,조개,국내산 새꼬막 1.5kg (상) 새벽조업후 발송 산지,30060,30060,0
2018-06-01,562445194,E061030,전구,오스람 FDX FDL 삼파장 램프 주광색 13W 18W 26W,2450,2450,0
2018-06-01,670255387,A012010,국산쇠고기,축협 1+등급 정육 갈비세트 3.4kg 갈비 한우선물세트,240000,237600,-2400
2018-06-01,444652150,C012020,원피스,H라인 버튼 코트(Z174MSG007)/ 쥬크,179000,152150,-26850
2018-06-01,1562792623,A016110,딸기,세미원 냉동 딸기 1kg 2개,25480,25480,0
2018-06-01,1326377047,E021010,침구,무독성 PE놀이방매트 알파보카 200×180 모서리보호대/ 어린이집놀이방매트 놀이방매트,58700,53000,-5700
2018-06-01,1263913925,L021030,가방,"타거스 Targus TSB280AP 17.3"" 배낭형 노트북 가방 HC",110000,99000,-11000
2018-06-01,639452638,C011030,남자학생복,6온스 빅사이즈 시보리밑단패딩항공조끼,98670,95710,-2960
2018-06-01,119450676,D031010,주택수선재료,[슈퍼데이 세일+사은품증정]인기폭발 포인트스티커/벽지/시트지/그래픽/까페/매장/가게,11600,7340,-4260
2018-06-01,1631340249,C013010,점퍼,[어스앤뎀] 남성 가슴배색쿨린넨JP TBUB601(영등포점A),62100,54220,-7880
2018-06-01,1042616567,A014040,발효유,[CJ 제일제당][무료배송][+1개 더] CJ 투썸 요거트 파우더 320g×2+1 (총3개),14800,14800,0
2018-06-01,1240777587,C013020,티셔츠,아스토레 JSG-LSTW10006 골프 캐주얼 카라티셔츠(ORG),64950,64950,0
2018-06-01,442908421,A013060,게,한치 마른화살오징어(S 35미)1kg 2개,224970,224970,0
2018-06-01,1318873973,C012060,여자내의,미시옷 분또롱스커트_MN_1709 빅사이즈 여성의류 임부,25900,25900,0
2018-06-01,644629602,L021030,가방,노트북 가방 파우치 맥북 삼성 13 14 15 15.6 인치,8400,8400,0
2018-06-01,1329531582,E061030,전구,LED볼전구 LED램프 에디슨전구 PAR30 LED전구 LED조명,3800,3800,0
2018-06-01,1826734937,A018010,초콜릿,롯데6000 미니 크런키가나밀크마일드초콜릿3봉 허쉬,14500,14500,0
2018-06-01,476887988,C013050,운동복,DYT 오픈져지(GLS-636) 자전거져지 운동복 남성져지,85720,85720,0
2018-06-01,2104173525,C013010,점퍼,남자 바람막이 야상 JM03 WS바람막이점퍼야상남자 바,80560,80560,0
2018-06-01,896578837,A012060,햄및베이컨,[동원]동원 리챔 (200G*3),10910,10910,0
2018-06-01,1390836894,G011070,자전거,[옐로우콘]모던한 도시감성/하이브리드자전거 S21,109000,79000,-30000
2018-06-01,117293510,E011030,거실장,[PookShuim] 푹쉼 크룸 PU가죽 3인용 소파 (오리털내장),570000,570000,0
2018-06-01,1231197196,C013020,티셔츠,[MLB] 남여공용 고딕 워딩 반팔 티셔츠(31TSD9831),39000,32370,-6630
2018-06-01,534570283,C011030,남자학생복,K/빈폴/폴로/라코스테/버버리/니트/가디건/조은구제,19900,19900,0
2018-06-01,989051058,A013170,생선통조림,[정기배송]오뚜기 마일드참치 150G*5캔*2묶음,23000,13980,-9020
2018-06-01,112398916,C013010,점퍼,[시에로][18S/S]밑단 플레어 실루엣 롱 야상점퍼(SE2JPF166)[갤러리아],369000,284130,-84870
2018-06-01,1892014755,C013020,티셔츠,타미힐피거 티셔츠 맨투맨 후드티,35900,35900,0
2018-06-01,1177065832,A017180,호박,청양고추(상)10kg 1박스 두리반농산,31000,31000,0
2018-06-01,1684238818,E011040,소파,[우아미ON]페드로 4인용 라텍스 가죽소파/쇼파,399000,399000,0
2018-06-01,1459286217,F011120,인삼,Big Hit 삼바이 산양산삼 5년근10뿌리 산양삼 장뇌삼,46500,46500,0
2018-06-01,1452605021,A016120,바나나,[농협6번]부드럽고 달콤한 멕시코바나나 3봉지,11900,11900,0
2018-06-01,922328670,I011030,사진기,소니 미러리스 알파 A6500 (렌즈미포함)/공식대리점,1486000,1367120,-118880
2018-06-01,117293509,E011030,거실장,[PookShuim] 푹쉼 크룸 PU가죽 3인용 카우치소파 (오리털내장),930000,930000,0
2018-06-01,257157102,C012020,원피스,[드넬]여름향기바바리DJ81035A,19800,17820,-1980
2018-06-01,2069296082,C012020,원피스,빅사이즈/디어/니트/롱/조끼 / 참고 디어니트롱조끼,52700,46380,-6320
2018-06-01,1899702438,C013020,티셔츠,[필골드] MD857n856 반목폴라 니트 9종중택일,32800,32800,0
2018-06-01,300257885,E021020,커튼,[까르데코]레이스커튼2장/시즌맞이행사/속지커튼,9900,9900,0
2018-06-01,1405523306,F012020,생리대,좋은느낌/화이트생리대/팬티라이너/탐폰/수퍼롱/특가,19900,19900,0
2018-06-01,896816203,A011180,파스타면,오뚜기 프레스코 마카로니 페네(500G),2790,2790,0
2018-06-01,502806162,L021010,손목시계,BELCARINO 깔끔한 남성시계 듀얼타임 가죽시계 MG-807,68500,68500,0
2018-06-01,1979602482,A019060,된장,동해촌된장14kg /찌개된장/합동된장/옛날된장,50000,50000,0
2018-06-01,1787811389,A018110,물엿,명인 쌀조청 1.3kg/꿀 조청 물엿/국가지정명인 강봉석,8800,8800,0
2018-06-01,2067313959,E011050,책상,[블루밍홈] 베이직입식책상1200/테이블/컴퓨터/사무용,29900,23850,-6050
2018-06-01,809894835,L021030,가방,[루즈앤라운지][여성] 카프리 라지 숄더백 RAMS2HCS49000 BKX (BLACK)(본점),685000,598010,-86990
2018-06-01,353139217,A014010,우유,멸균우유 상하목장유기농우유 125ml 200ml 24팩,21170,19900,-1270
2018-06-01,1534774758,A017140,콩나물,영주 안국봉 농부의 약도라지 선물세트 1kg,27000,27000,0
2018-06-01,1879521538,A013090,전복,신일수산 서해안 자연산 왕 삐뚤이소라 1kg(5~8마리),15000,15000,0
2018-06-01,1896009356,A019110,드레싱,폰타나 골드키위드레싱(230G),2580,2580,0
2018-06-01,1624457332,A016070,귤,하우스 감귤 5kg 지금이 제철이라 맛이 좋아요,23900,23900,0
2018-06-01,1806235729,A019080,고추장,[식품명인 권기옥] 전통장(난) 선물세트(매실청+한우볶음고추장+쌈장+청장),43000,43000,0
2018-06-01,1806235728,A019080,고추장,[식품명인 권기옥] 전통장(청풍) 선물세트(어육된장+덧된장+약고추장+어육청장),39000,39000,0
2018-06-01,1160513073,C013010,점퍼,[로플러 하드쉘 아웃도어자켓] 아웃도어/ 야상자켓,91900,91900,0
2018-06-01,1167409205,C013010,점퍼,가죽/패딩점퍼/패딩무스탕/무스탕/가죽자켓/가죽점퍼,127900,127900,0
2018-06-01,1354788411,C013020,티셔츠,그렌에코 핫썸머 남성 반팔티셔츠모음/여름신상/세일,26090,26090,0
2018-06-01,1806235730,A019080,고추장,[식품명인 권기옥] 전통장(지순) 선물세트(된장+찹쌀고추장+청장),50000,50000,0
2018-06-01,959375444,A018070,파이,[크라운]크라운 그레이스(298G),4200,2100,-2100
2018-06-01,1806235732,A019080,고추장,[식품명인 권기옥] 궁중장(왕) 선물세트(어육된장+덧된장+약고추장),99000,99000,0
2018-06-01,1806235731,A019080,고추장,[식품명인 권기옥] 전통장(지고) 선물세트(된장+쌈장+매실고추장+한우볶음고추장),78000,78000,0
2018-06-01,66710462,C013010,점퍼,[포에버21]컨템포러리 스트라이프 새틴 봄버 자켓/FOREVER21/점퍼/블루종,43900,21950,-21950
2018-06-01,102108884,A019040,소금,(10%할인) 9회 인산자죽염 240g (고체) / 인산죽염,75600,75600,0
2018-06-01,1791886352,C013010,점퍼,[모다아울렛][오조크]점퍼 (715-49495),89700,83430,-6270
2018-06-01,1229012669,C014020,유아복,아기 아동 모기슈트/모기퇴치/모기장옷,19600,19600,0
2018-06-01,1083646371,E011060,의자,에이디의자 식탁의자/간이/보조/인테리어/이케아,9810,9810,0
2018-06-01,1230152782,C012020,원피스,[마담4060]엄마옷 마담4060 원버튼롱카라코트-XCO805001-,142900,135760,-7140
2018-06-01,1140320173,C021020,구두,남성구두 M6452 에나멜 키높이구두 7cm 슬림디자인 에,55980,50390,-5590
2018-06-01,574759708,A012060,햄및베이컨,국산 독일식 수제 전통소시지 렉커 스페셜세트 3.4kg,86800,86800,0
2018-06-01,684834757,C013010,점퍼,무스탕 라이더 가죽자켓 WS PU 09 - 무스탕 가죽자켓,235390,209500,-25890
2018-06-01,1030441863,A018090,잼,18년산 하우스베리 생잼 골드 600g 2병,28000,27000,-1000
2018-06-01,326999554,A013080,조개,두레생협 농어스테이크(300g/자연산) 농어스테이크 농,30450,30450,0
2018-06-01,955886977,A018040,아이스크림,월드콘 바닐라 (10개),12000,7000,-5000
2018-06-01,390154758,C021010,아동화,W월드컵 아동화 운동화 부츠 하이탑 농구,21800,21800,0
2018-06-01,1916393133,A011130,시리얼,오뚜기 부침가루 500g X 20EA 볶음쌀가루 튀김분말 튀,37340,37340,0
2018-06-01,478401992,C013050,운동복,REARVIZ 자전거 후사경 백미러 블랙 자전거 거울 미,58940,58940,0
2018-06-01,1089003964,C012060,여자내의,(해외직배송) 여성 브이넥 랩 와이드 통 팬츠 리본 허,77220,67960,-9260
2018-06-01,1274088039,A011030,찹쌀,2018년 햇찰보리20kg/통보리(현미보리도가능,41500,41500,0
2018-06-01,1258529857,C013020,티셔츠,[행텐] 여성 솔리드민소매 티셔츠 10120-133-401-05 NC아울렛,14800,5000,-9800
2018-06-01,548892379,L021010,손목시계,손목시계모음/메탈/가죽/남성/남자/여성/스포츠/정장,15200,15200,0
2018-06-01,415179699,C012060,여자내의,멜빵 데님원피스 SU5OP03/ 숲,69000,62100,-6900
2018-06-01,1639960780,C013010,점퍼,[대구백화점 I관] [록시]SCALE 숏 자켓(R641PK236),159200,138510,-20690
2018-06-01,687670545,A013120,낙지,자갈치시장 서울상회 최진성님의 마른오징어 5마리 (마리당 약 70~75g),25000,17900,-7100
2018-06-01,1250709736,E051020,건전지,라이칸 18650 배터리 3500용량 리튬이온 충전건전지,15000,15000,0
2018-06-01,2056494739,A017280,김,(냉장)이엔 슬라이스단무지1kg,16540,16540,0
2018-06-01,2058629168,A022010,주스,상쾌한 맛 해태) 포도봉봉 238ml x 72캔 착한가격 좋은 음료(묶음가능:1개) 음료 과즙,58510,58510,0
2018-06-01,1849513061,C013010,점퍼,아디다스 유소년 콘디보16 스타디움자켓 ( AB3152 ),149030,134130,-14900
2018-06-01,1224719079,E011060,의자,사무용 컴퓨터 책상 인테리어 식탁 보조 스툴 의자,17900,17900,0
2018-06-01,1280639494,F011150,건강기능식품,웅진 드링크 홍삼꿀D/헛개꿀D 100ml x 10병,4000,4000,0
2018-06-01,1806235754,A019080,고추장,[식품명인 권기옥] 궁중어육장 선물세트(어육된장+어육청장+간장종지),115000,115000,0
2018-06-01,167702422,C012060,여자내의,H라인 언발란스 스커트 (GH6A0SK77)[예약상품 2018.06.01 부터 발송]/ 제이제이 지고트,39000,32370,-6630
2018-06-01,1352998988,I011030,사진기,[정품]니콘 쿨픽스w100방수디카 낙하 이너줌+8기가+,179000,179000,0
2018-06-01,957740560,A019180,즉석식품,[CJ]CJ 햇반 흑미밥 기획 (210G*4입+2입),6990,6990,0
2018-06-01,1779232739,E031050,냉장고,트윈스 LG전자 디오스 김치냉장고 K412SS13,1745720,1665720,-80000
2018-06-01,1010263145,A011170,떡,우정본가)생수제비 275G,2380,1790,-590
2018-06-01,1010263144,A011170,떡,우정본가)국내산떡국떡 1KG,4490,3490,-1000
2018-06-01,989851416,A022060,혼합음료,[동서식품] 맑은티엔 둥굴레수 410ml x20펫트,15900,15900,0
2018-06-01,1891032972,A017210,파,나나푸드 전라도 달콤토마토4kg 8kg,11900,11900,0
2018-06-01,40983141,C013010,점퍼,아디다스 여성 K 스트레치 덕 다운 패딩 (B10322 ),188480,167750,-20730
2018-06-01,190803556,A011140,부침가루,프레디 부온돌체 스트로베리 & 요거트 25g X 80개,17670,17670,0
2018-06-01,259008889,I031070,애완동물관리비,에버라스트 전자 호루라기 휘슬 호각 심판용품 호신용,27930,24720,-3210
2018-06-01,1176062330,E061020,섬유유연제,통큰섬유유연제 정전기방지 부드러운옷 20kg 대용량,10400,9900,-500
2018-06-01,590891726,C014010,아동복,[GAP kids]갭키즈 토들러 여아 반팔 그래픽 티셔츠(인천점),19000,17510,-1490
2018-06-01,1806235756,A019080,고추장,[식품명인 권기옥] 궁중장(궁) 선물세트(어육된장+약고추장+어육청장+진장),125000,125000,0
2018-06-01,1502369591,C011030,남자학생복,잔스트라이프 린넨 오픈카라 반팔셔츠,25840,25840,0
2018-06-01,1806235755,A019080,고추장,[식품명인 권기옥] 궁중장(제) 선물세트(어육된장+약고추장+어육청장),120000,120000,0
2018-06-01,849227426,A019080,고추장,ⓒ 해찬들 여행용 고추장(60G*3입),5880,5880,0
2018-06-01,1806235757,A019080,고추장,[식품명인 권기옥] 궁중장(황) 선물세트(어육된장+덧된장+약고추장+어육청장),195000,195000,0
2018-06-01,762239708,C013020,티셔츠,봄신상 라운드티/남자옷기본무지브이넥프린트티셔츠,9900,9900,0
2018-06-01,1010407328,A011140,부침가루,대광 오븐에구운도넛 20입,9900,9900,0
2018-06-01,922039759,C012030,여자상의,크러쉬 멜빵 데님스커트,23030,23030,0
2018-06-01,1298064651,C013010,점퍼,MJ-211 유니크 카모플라쥬 패턴 투버튼 자켓- 카키 남,68660,68660,0
2018-06-01,1980548419,E011020,침대,(다이룸 평상) 평상/원목가구/diy/diy평상/평상형침대,128000,128000,0
2018-06-01,1530617197,C012020,원피스,MELODY F118 핑크/코트/여자코트/겨울코디/겨울코트/자켓/점퍼 미국 여성토탈브랜드 멜,54700,54700,0
2018-06-01,1065461011,G011070,자전거,시애틀GS20+삼천리킥보드 18년 접이식자전거 7단20인,159000,159000,0
2018-06-01,1859477255,G011070,자전거,알톤 로드마스터 램블 21 하이브리드형,248000,218740,-29260
2018-06-01,1125452510,E031080,선풍기,[한솔일렉트로닉스] 한솔 벽걸이 PTC온풍기(2500W) NC-FA2500,81900,81900,0
2018-06-01,985446313,A013130,오징어채,허니버터 오징어 봉/120G*2,16900,16900,0
2018-06-01,2141596751,A016150,아몬드,산과들에 17년 캘리포니아산 당일가공 볶음 햇 아몬드,10900,10900,0
2018-06-01,1234520894,C013030,스웨터,폴라티 반팔 MJ7610_7613 마르잔 빅사이즈 반팔티,30610,30000,-610
2018-06-01,2138593714,C012030,여자상의,리본디테일원피스 RI1710 리본디테일 원피스 고급원피,44650,44650,0
2018-06-01,2061187071,A021010,커피,탐앤탐스 에티오피아 예가체프 핸드드립커피 8gx36개,13990,13990,0
2018-06-01,1057734425,C013050,운동복,dd98 슬림핏 트레이닝복 네이비 여자트레이닝복 트레,19560,19560,0
2018-06-01,1754231271,E011030,거실장,철제 거실장 TV선반 티브장 TV다이 거실장식장 TV장,70000,66500,-3500
2018-06-01,854429420,E031080,선풍기,[기본배송비무료][신일금속] 연탄난로 2구 6탄 SL-26/연탄난로/보일러/장작난로/주물난로/벽난로,61800,61800,0
2018-06-01,399607875,F012010,종이기저귀,킨도 독일 프리미엄 슬림 밴드형 4단계 (44매x3팩),53700,53700,0
2018-06-01,1238689062,D031010,주택수선재료,자연황토/힐링페인트/흙미장재/황토페인트/클레이맥스,21900,21900,0
2018-06-01,1047053036,C012060,여자내의,융털안감 착시스타킹 SD-5954 밍크레깅스 기모레깅스 스타킹 융털레깅스 기모스타킹,9060,8070,-990
2018-06-01,937743011,E011040,소파,아리아퍼니쳐 그레이 소파/쇼파BEST(패브릭/가죽),399000,299000,-100000
2018-06-01,2116505449,C013040,청바지,[제이알주니어] 남아 팬츠/기능성/상하복,10900,8900,-2000
2018-06-01,1010287115,A013180,젓갈,[인천]착한식당) 간장꽃게장 2kg 4~5마리(알배기 암꽃게장),69500,59800,-9700
2018-06-01,1675828809,A011010,쌀,한입만 국산 백미10kg 현미/찹쌀,19400,19400,0
2018-06-01,654540969,A018100,꿀,동서벌꿀 아카시아 (600g),15500,15500,0
2018-06-01,733860753,A018080,설탕,[무료배송] CJ 하얀설탕3kg×4개 (총 12kg)/ 씨제이제일제당,15500,15500,0
2018-06-01,696892987,A014020,분유,베비언스 킨더밀쉬 200ml 6입 영양밸런스UP,9900,9900,0
2018-06-01,112359363,E041030,솥,[휘슬러코리아]프리미엄 블루 압력솥 4.5L,188000,188000,0
2018-06-01,715035683,A017080,무,오뚜기 고소한 참기름1000ML 옛날참기름1000ML/참기름,12900,12900,0
2018-06-01,1960204670,E021010,침구,겨울왕국 면기모 패드 - 뷰티선샤인 (064187) 요이불,64300,58570,-5730
2018-06-01,532352125,C013010,점퍼,핸드메이드 STYLEENTER 스타일엔터 남자무스탕 메리노베이비 무스탕점퍼 주문제작,1169000,1169000,0
2018-06-01,1278963244,A017020,상추,쌈채소 1kg 모둠쌈채소 10여종류,10900,10900,0
2018-06-01,1048186502,A022030,생수,트레비 500ml x 20 페트/초정탄산수/음료수,15420,14500,-920
2018-06-01,1672195831,A014020,분유,[일동후디스]24개+니플4개/트루맘 프리미엄 액상분유,28900,28900,0
2018-06-01,900475470,A011090,국수,농심 신라면 (120G*5입),3380,3380,0
2018-06-01,900475471,A011090,국수,[농심]농심 신라면 컵 (65G),850,850,0
2018-06-01,883990408,A021010,커피,맥심 화이트골드320T(160Tx2개),30500,30500,0
2018-06-01,900475472,A011090,국수,[농심]농심 튀김우동 큰사발 (111G),1090,1090,0
2018-06-01,822247797,E031120,믹서,월풀 블렌더 ACB130/BL 1.5L 다용도 믹서기,56400,56400,0
2018-06-01,1862936516,C012060,여자내의,시크폭스 여우진10탄 워너핏 세미부츠컷팬츠/ 시크폭스,31700,24730,-6970
2018-06-01,729695683,A019180,즉석식품,들깨+얼큰양념장 증정 남순남순대국 10인분세트,32900,32900,0
2018-06-01,1189432185,I031040,생화,[카르닉] 접이식 야전침대/캠핑침대/간이침대/스틸,32800,32800,0
2018-06-01,2042485580,C011030,남자학생복,여름/와이셔츠/빅사이즈/스판/긴팔/반팔/남자/남성,14800,14800,0
2018-06-01,1645904960,A022030,생수,토닉워터 프리미엄 하이드로 카린스 클럽소다 진저엘,13900,13900,0
2018-06-01,2071850293,C012040,여자학생복,체크 노버튼 코트 LRT025 가디건 여성코트(YA02004) /,58400,51400,-7000
2018-06-01,90511544,E041070,밀폐용기,글라스락 전자렌지 밥용기/쿠킹볼/밀폐용기,4400,3590,-810
2018-06-01,2122322862,A012010,국산쇠고기,[무항생제] 장조림 300g 1등급,16100,16100,0
2018-06-01,1444954993,A013050,오징어,오뚜기 고등어 280g X 24EA 요리재료 고등어 가공음식,66050,66050,0
2018-06-01,530564459,A018110,물엿,9번구운 분말개암자죽염250g(15g사은품) 황토죽염 천,87130,84520,-2610
2018-06-01,900475466,A011090,국수,농심 안성탕면 125G*5+1입 증정입고,3150,2990,-160
2018-06-01,1356566716,F011150,건강기능식품,알유21 6정 6갑 /총36정/RU/여명/모닝케어/컨디션/숙,12540,12540,0
2018-06-01,983979123,C013010,점퍼,[모다아울렛][에이비에프지]퀄팅 누빔 점퍼,99000,91080,-7920
2018-06-01,2089105739,C013040,청바지,프리미엄 남자청바지 남성 바이커진 스판 일자 블랙진,39000,39000,0
2018-06-01,1903493471,A012030,돼지고기,정직한 왕목살(목전지)500g 볶음/구이/찌개/수육,3300,3300,0
2018-06-01,2137608868,E011050,책상,탁상용 각도조절 보조책상 TBT-M3,143100,135950,-7150
2018-06-01,1851253806,C013060,등산복,봄여름 등산바지 등산복 남성 작업복 남자 작업바지,14290,14290,0
2018-06-01,270989299,C012040,여자학생복,[악녀일기]타이로즈블라우스,47040,43280,-3760
2018-06-01,279316635,A016090,참외,2018 성주 꿀 참외 2.5kg,9900,7900,-2000
2018-06-01,1451513737,A013090,전복,[유진수산] 홍합살 / 자숙 홍합살 /바지락 생굴  조개,2580,2580,0
2018-06-01,2144011463,C013040,청바지,피핀 르미벤 슬림 일자진 #73529/ 피핀,35600,28130,-7470
2018-06-01,1078363383,A018010,초콜릿,[해태]기획특가 자유시간 36g x 12개입,5800,5800,0
2018-06-01,570392581,A011010,쌀,[철원오대쌀] 동송농협 철원오대쌀 10kg,32800,32800,0
2018-06-01,305272142,C013040,청바지,코코얀 남아 데님롤업 제깅스/아동 롤업청바지,26250,25750,-500
2018-06-01,989851419,A022060,혼합음료,[동서식품] 맑은티엔 옥수수 410ml x20펫트,15900,15900,0
2018-06-01,1827812495,F011150,건강기능식품,울트라플로라 프로바이오틱스 60캡슐 6병/여에스더유,170400,170400,0
2018-06-01,1830443767,A011020,현미,[농협] 철원 찹쌀 10kg [산지직송] 자연선생,39500,39500,0
2018-06-01,960883757,A017020,상추,F/양상추 1통 중국산,3190,3190,0
2018-06-01,893944884,E031130,보온매트,[바보사랑](신)숯황토볼특대찜질매트,240000,240000,0
2018-06-01,893944879,E031130,보온매트,[바보사랑]숯 황토볼 대형찜질매트,180000,180000,0
2018-06-01,2106538093,C013010,점퍼,(SIZE : M) MJ-164 옐로우 스티치 데님 자,53010,53010,0
2018-06-01,579060048,C013020,티셔츠,[셀덴]셀덴 PNC02 스트라이프골지반팔티 EDRA18FG2,12900,12650,-250
2018-06-01,169771823,C012030,여자상의,nn66 스트랩 베이직 린넨원피스 - 소라 원피스 여성패,35550,34490,-1060
2018-06-01,337802391,C012040,여자학생복,심플버튼가디건 (J11PCD078)/ 매그제이(MAGJAY),33900,30510,-3390
2018-06-01,1048874733,C013030,스웨터,KD 꽈배기애리 니트 여성 니트,73580,72110,-1470
2018-06-01,1319999455,C012060,여자내의,압축 기모 레깅스 방한레깅스 남성레깅스 방한용품 기,12950,12950,0
2018-06-01,2144804695,C012020,원피스,[코인코즈]하늘하늘 시폰 플라워 원피스 (SIW8MO336)(의정부점),55200,49270,-5930
2018-06-01,1270242171,E061020,섬유유연제,(특가)피죤섬유유연제2100mlx4개(블루2개+핑크+옐로),9900,8800,-1100
2018-06-01,233605234,E011030,거실장,윌리 1인용 좌식의자 하트쇼파,200000,200000,0
2018-06-01,233605235,E011030,거실장,윌리 회전식 좌식쇼파 에이스체어,180000,180000,0
2018-06-01,391224639,G022020,자동차타이어,제커 타이어 빅데이터 기반 승용차 SUV IoT 무료배송,69700,68700,-1000
2018-06-01,233605233,E011030,거실장,윌리 프리미엄 좌식의자 솔리드쇼파,150000,150000,0
2018-06-01,233605236,E011030,거실장,윌리 접이식 안락의자 포레스트체어,150000,150000,0
2018-06-01,1325515507,A021010,커피,NEW 까페리얼 230mlx20팩/시그니처/아이스커피/커피,13900,13900,0
2018-06-01,427852256,A011170,떡,떡국떡 송학 1.87kg,6540,6540,0
2018-06-01,454248984,A014010,우유,서울우유 200ml x 96팩/매일우유/멸균우유,45900,45900,0
2018-06-01,208643918,C012040,여자학생복,시크라인 베스트 블라우스 남방 티셔츠 XL까지 OCLOCK,29800,29800,0
2018-06-01,14439709,A013090,전복,(KBS 6시내고향 방영) 통영싱싱(활)가리비 1KG 초특가,3500,3500,0
2018-06-01,1242205003,E061010,세탁세제,1+1 애경 스파크 5.5kgx2 (리필),17800,17800,0
2018-06-01,386384856,C015020,모자,(컬러:사이즈 : 카키:FREE) ACC-CAP106 찡군,26080,26080,0
2018-06-01,559045540,C013020,티셔츠,프린트스타 17수 무지 라운드 반팔티셔츠 00085-CVT,6000,5400,-600
2018-06-01,1675273686,A013040,고등어,노르웨이고등어(특대)150g-180gx20팩,29900,29900,0
2018-06-01,656873610,F012020,생리대,예지미인 슈퍼롱 오버나이트 10개입 x 24,90390,90390,0
2018-06-01,594196844,A011110,당면,국내산 도토리전분 도토리 묵말랭이 250g,35130,35130,0
2018-06-01,284349806,A017210,파,[해와수]정품 완숙토마토 5kg특가 당일수확 산지직송,10900,10900,0
2018-06-01,656197603,E061020,섬유유연제,다우니 건조기용 드라이시트 120매 x2 에이프릴프레시,30900,30900,0
2018-06-01,837143313,A016150,아몬드,[넛츠피아] 하루한줌견과 100봉+10봉 낱봉/무료배송,29900,29900,0
2018-06-01,1323072457,C011050,남자내의,[냉장고배기] 아이스/냉장고배기/슬림핏/스키니/쿨,12700,12700,0
2018-06-01,1889377789,C013010,점퍼,[에어워크]바람막이/윈드자켓/골프웨어/골프자켓/점퍼,40800,32800,-8000
2018-06-01,665224955,C013010,점퍼,[버커루]남성용 메쉬 소재 스타디움 점퍼(B162JP390P),39000,31200,-7800
2018-06-01,611157244,A019050,간장,진간장 S 1.8L 2개/930ml/금F3/국간장/양조식초/샘표,8900,8900,0
2018-06-01,385505816,C011030,남자학생복,오투아이스_쿨링타올 중형2개,33510,31500,-2010
2018-06-01,321812623,C012030,여자상의,메인넥원피스 MN1804 프릴원피스 여성긴팔원피스 여성,41730,41730,0
2018-06-01,1897963947,C011050,남자내의,슬랙스 밴드바지 마바지 정장 리넨 린넨 바지 PT01,10200,9900,-300
2018-06-01,980767738,A015010,참기름,온바이오테라푸드 저온로스팅 명품 참기름,19500,19500,0
2018-06-01,538514358,I031040,생화,카즈미 감성 캠핑테이블+캐리백 모음전 접이식테이블,63480,63480,0
2018-06-01,368784040,L021020,장신구,초커목걸이 체인초커 가죽초커 레이스초커 태슬초커 F,14280,14280,0
2018-06-01,1832206475,C014010,아동복,[블루독] 밴딩5부우븐팬츠 (27315-412-03),46000,37720,-8280
2018-06-01,1216704688,A016060,감,달콤샤르르 자연그대로 만든 아이스 왕 홍시 100개(컵,139690,125730,-13960
2018-06-01,752855776,A017170,풋고추,[여주열매/1kg대용량]여주/건여주/여주환/고야/고야차/고과/비터멜론/여주차/건/여주열,30000,30000,0
2018-06-01,1881085110,C013020,티셔츠,[세컨스킨] 세컨스킨 인기상품 1+1(브라/팬츠/레깅스외)[갤러리아],39800,31840,-7960
2018-06-01,1280015438,I031040,생화,에버라스트 EL안면보호 헤드기어,240100,235300,-4800
2018-06-01,1663455905,E011060,의자,에프오디 味(미)식탁 원목의자  식탁의자  카페의자,29900,29900,0
2018-06-01,581774159,F012010,종이기저귀,[토디앙] 핑크퐁 밴드기저귀 중형 공용 60매X3팩,33500,33500,0
2018-06-01,1063671650,G022020,자동차타이어,넥센타이어 고급형 CP672 225/50R17 정품 무료배송,66300,55930,-10370
2018-06-01,1814429541,A013130,오징어채,[죽도시장] 오징어 / 정화 오징어 진미 선물세트 3호,59000,59000,0
2018-06-01,642007865,C013010,점퍼,여자 경량다운패딩 러블리 자켓 핑크 다운점퍼 경량점퍼 패딩점퍼 패딩 초경량패딩 겨,40880,36390,-4490
2018-06-01,1930524693,C012030,여자상의,드레스제이 신상특가! 빅사이즈/티셔츠,9900,9900,0
2018-06-01,117327053,E011030,거실장,[PookShuim] 푹쉼 디종 가죽 4인용 소파세트 (오리털 내장),1250000,1250000,0
2018-06-01,1262234150,C012040,여자학생복,로디에(RODIER) 보헤미안 아사 블라우스 3종,59000,58000,-1000
2018-06-01,1997297472,A017150,버섯,꼬불꼬불 곱슬이콩나물 1kg,2810,2810,0
2018-06-01,1458033457,C015040,장갑,두꺼비 예식장갑 기사장갑 53g 10켤레 장례장갑 다용,20580,20580,0
2018-06-01,1116897309,C012040,여자학생복,[블루종][블루종]소매주름 라운드 린넨 블라우스_[B1805BL086B],17700,15930,-1770
2018-06-01,193317,E041050,냄비,(공식)쿠첸 IH전기레인지 인덕션전용용기 스텐냄비,33800,33800,0
2018-06-01,1829968536,E041010,식기,라면그릇 우동그릇 우동기 멜라민접시 공기 대접 면기,1950,1770,-180
2018-06-01,65664394,E031090,공기청정기,[위니아] T 위니아 공기청정기 에어캐스터 EPA16DAAP 무료배송,209470,199000,-10470
2018-06-01,1404500532,F012020,생리대,좋은느낌 순수 생리대 중형 72매/대형 64매,11200,11200,0
2018-06-01,853648991,E011040,소파,[에보니아] 모던 2인소파/피코/파브/카우치/2인쇼파,129000,102000,-27000
2018-06-01,373058499,C013020,티셔츠,[30%쿠폰][섀르반] 여름오픈! 반팔티7800원/나들이룩,8800,8800,0
2018-06-01,732899612,F011150,건강기능식품,최다리뷰! 멀티프로 비타민 멘+우먼 외 2개,15100,15100,0
2018-06-01,714815001,C013050,운동복,차량용 LED 경광등 비상등,14460,14460,0
2018-06-01,715212020,C012030,여자상의,(킷슨네)프린트원피스/플라워/쉬폰/루즈핏/빅사이즈,29800,29800,0
2018-06-01,1282938217,A014030,치즈,코리원 모짜렐라치즈 1kg/델리치/피자치즈/치즈/분쇄,8600,8500,-100
2018-06-01,943586417,D031010,주택수선재료,KCC우레탄방수제 (하도 중도 상도),55000,55000,0
2018-06-01,1097631340,C013020,티셔츠,[마르조] [5종]여성스텔라모던블라우스,49800,41340,-8460
2018-06-01,1554064525,E031120,믹서,[NUC] [냄비3종증정]3000CC 엔유씨 스마트 블렌더 NPM-691KC,195000,175000,-20000
2018-06-01,719726312,C012060,여자내의,여름슬랙스 슬림 9부 슬랙스 보라색 화이트 정장바지,17500,17500,0
2018-06-01,1657496731,A015020,식용유,[사조해표/기획] 포도씨유 500ml × 4개,11900,11900,0
2018-06-01,1854752101,E061020,섬유유연제,[다우니]퍼퓸 초고농축 섬유유연제 2Lx2개,19900,17900,-2000
2018-06-01,513578616,C021040,실내화,L치어걸 여성키높이운동화스니커즈 치어리더 에어로빅,29500,28500,-1000
2018-06-01,958543153,A015010,참기름,해표 고소한 참기름 (320ml),6990,6990,0
2018-06-01,1355291303,C014020,유아복,큐티 해마 상하복(0-12개월) 203051 옷 신생아상하복,23670,23670,0
2018-06-01,509300317,C012040,여자학생복,왕단추 포인트 롱 니트 가디건 니트코트 니트롱코트,15450,14990,-460
2018-06-01,1258598050,E041060,수저,el 스텐27종 2벌 수저세트 (선택) 숟가락 젓가락,10900,10900,0
2018-06-01,898454642,A018060,스낵과자,[오리온]오리온 오감자 50G,1000,1000,0
2018-06-01,666296466,C014010,아동복,게스키즈 G65KBT080/091 타이거 슬럽 / 뎅깡 스트라이프 티셔츠 M 상의 남아동 여름 기,23000,19090,-3910
2018-06-01,1890537872,I031010,장난감,경찰 전동 오토바이 유아 스쿠터 바이크 사이클 선물,84800,80560,-4240
2018-06-01,1011061805,L012040,치약,[LG]LG)히말라야핑크솔트치약100G*2,10900,6990,-3910
2018-06-01,325626984,C012040,여자학생복,[로즈맘]줄무늬망사가디건,19370,17440,-1930
2018-06-01,1364981163,E011040,소파,보니타 대형사이즈 빈백 아울렛제품 소파/쇼파베드,52000,52000,0
2018-06-01,1368614614,L021030,가방,[Macknite정품]15.6인치노트북가방/전면패드삽입/서류,29800,29800,0
2018-06-01,410618790,A012060,햄및베이컨,햄(런천미트 대상 340g)X5,33710,33710,0
2018-06-01,1253449649,A011170,떡,[하늘뜰]디딜향 영양찰떡 외 5종 골라담기,8900,8900,0
2018-06-01,120292002,A015020,식용유,올레오칸탈 팔라시오 엑스트라버진 올리브오일 500ml,37000,37000,0
2018-06-01,1711506644,C013010,점퍼,[크록스키즈][크록스키즈] 듀크솔리드매쉬집업(CBG2TJ003P),26900,25560,-1340
2018-06-01,1528813737,C013020,티셔츠,여름 여성 등산복 반팔 등산티셔츠 등산조끼 등산복,9000,7880,-1120
2018-06-01,989971637,A019180,즉석식품,CJ 햇반컵반 고추장제육덮밥 250G,2580,2380,-200
2018-06-01,107426992,C013020,티셔츠,[아띠벗] 초특가/~2XL/티셔츠/니트/빅사이즈여성의류,11800,11800,0
2018-06-01,988127416,E041070,밀폐용기,초L) 3색 컬러 종이컵 260ML*20P,1490,990,-500
2018-06-01,1057372559,F012020,생리대,생리대/순수한면/릴리안/팬티라이너/오버나이트/특가,7900,7900,0
2018-06-01,1018988166,C021040,실내화,윌슨 엠플리필 amplifeel 테니스화 (WRS322840 ) 차콜,203980,181550,-22430
2018-06-01,807184285,E061040,부엌용세제,메소드 핸드워시 다목적 주방세제 핸드워시 친환경,2900,2900,0
2018-06-01,2068310894,C011020,남자상의,(티티뱅크) JK540W 캐주얼 방한 자켓 / 참고 방한 캐,69600,61250,-8350
2018-06-01,1003802642,C013050,운동복,다용도 비상망치 후레쉬 차량용품 손전등 차량용품 차,13230,13230,0
2018-06-01,1978389396,C012030,여자상의,섹시 원피스/클럽/홀복/미니/쉬폰/레이스/나시/하객룩,19900,19900,0
2018-06-01,1476076619,C013020,티셔츠,[챔피온] 나그랑/반팔티/맨투맨/후드티 총알무료배송,24900,24400,-500
2018-06-01,221690332,C011050,남자내의,5XL 빅사이즈 면바지 청바지 밴딩팬츠 남자 남성 바지,19800,19800,0
2018-06-01,1746097567,A019180,즉석식품,CJ 비비고 사골곰탕 500g 12개/16개 즉석국 탕 찌개,15200,15200,0
2018-06-01,494931569,A019110,드레싱,(참소당 우동쯔유1.8L) 프리미엄 일본식 우동간장,14900,14900,0
2018-06-01,1651503741,C012060,여자내의,푸조 여성 워테레깅스 (S26-1 ),29380,26150,-3230
2018-06-01,1541729981,L021030,가방,2018 여름신상 백팩 여성가방 숄더백 미니백 여행가,19800,19800,0
2018-06-01,127908374,A012030,돼지고기,[이베리코 베요타 100%] 명품선물 세트 - 꽃목살 2kg,96000,86400,-9600
2018-06-01,2071852402,C012040,여자학생복,빅사이즈/심플/단추/블라우스 / 참고 심플단추블라우,57000,50160,-6840
2018-06-01,577534442,E031140,비데,{사은품증정} 노비타 탈취 비데 BD-H350,158900,158900,0
2018-06-01,2045382443,A015020,식용유,시아스 기름 500ml/파/마늘양파/화유불맛/식용유,6900,6900,0
2018-06-01,2018804316,A013080,조개,두레생협 냉동굴(400g) 냉동굴 굴 두레생협냉동굴 두,16360,16040,-320
2018-06-01,965889624,C013010,점퍼,시즌특가 29800원 무료배송 인조 가죽 자켓/레더 누빔,29800,19800,-10000
2018-06-01,1733073303,C021040,실내화,[아디다스본사][상설제품] 슈퍼스타 360 C (BA7114),39000,39000,0
2018-06-01,1761046514,A021010,커피,네스카페 마일드 커피믹스 900g 네슬레 자판기용 커피,4140,3900,-240
2018-06-01,851783008,C013010,점퍼,앨빈클로 코디 세트! 추가 할인 혜택까지!,24900,19900,-5000
2018-06-01,1049706926,I031040,생화,[BUCK703] 편안한 해먹스탠드/나무바해먹/모기장해먹,14900,14900,0
2018-06-01,18881564,C013020,티셔츠,보카시티셔츠 보카시반팔티 긴팔티 라운드티 브이넥티,5900,5900,0
2018-06-01,1804742513,E031040,전기레인지,데이킵스 냉장고정리 12P,35450,35450,0
2018-06-01,1188638046,E061060,살충제,[바이엘 크롭사이언스]맥스포스셀렉트겔 230g+먹이통,25700,16970,-8730
2018-06-01,264216,C012060,여자내의,쿨젠배기바지면바지와이드팬츠밴딩팬츠치마바지린넨,25800,23800,-2000
2018-06-01,1202298987,C013020,티셔츠,루니 끈 런닝 AS311501/ 압소바,7700,7700,0
2018-06-01,392039256,C012040,여자학생복,[톰앤래빗] 미니브이가디건 /가디건/기본가디건/베이직가디건/미니가디건,12000,10800,-1200
2018-06-01,1597236788,F011130,홍삼,정관장 홍삼진황(50ML*20포),67680,67680,0
2018-06-01,1777641171,L021020,장신구,[바보사랑]제이로렌 B0777 더크라운 테라헤르츠 실버팔찌,48000,48000,0
2018-06-01,1777641170,L021020,장신구,[바보사랑]제이로렌 B0776 메탈리프 테라헤르츠 실버팔찌,48000,48000,0
2018-06-01,820367467,A019080,고추장,[산지직송/예약배송][ORGA] 성가정 전통 찹쌀고추장 3kg,55000,53770,-1230
2018-06-01,394084360,C012060,여자내의,[레코브]린넨 기본 스커트(LU1185SK003X)(의정부점),39800,32820,-6980
2018-06-01,1446854217,E021010,침구,이불 + 베개 세트 사계절 기숙사 펜션 침구세트 커버,19800,19800,0
2018-06-01,2083175498,C012060,여자내의,KAA 8879 여자린넨통8부바지 /(참고)와이드바지 통팬,29500,25960,-3540
2018-06-01,1777641169,L021020,장신구,[바보사랑]퓨어플라워 티타늄침 귀걸이,16900,16900,0
2018-06-01,1777641168,L021020,장신구,[바보사랑]솔라 써클 드롭 귀걸이,15900,15900,0
2018-06-01,302471850,C021040,실내화,[아디다스]UNISEX ORIGINALS 운동화 4종 [CQ2207][CQ2208][DB0377][DB0378](광주신세계,65000,55490,-9510
2018-06-01,1741404268,C012060,여자내의,세븐데이 멜빵청미니-스커트 SD-9101 여자청치마 롱치,28370,27520,-850
2018-06-01,989971666,L012030,칫솔,[LG]LG)페리오슬림앤클린(부드러운모)3+3,7900,2990,-4910
2018-06-01,989971667,L012030,칫솔,[LG]LG)페리오슬림앤클린(미세모)3+3,7900,2990,-4910
2018-06-01,666357974,C012060,여자내의,[PL_홈쇼핑][페리젠슨]스트레칭 쿨져지 밴딩팬츠 네이비.NPD13216,4400,4180,-220
2018-06-01,862589214,C013020,티셔츠,아동티/아동면티/아동라운드티/아동흰티/반티/아동반팔/아동긴팔티/아동티셔츠/아동단,1000,1000,0
2018-06-01,739393679,A019080,고추장,[농협] 우리땅우리찹쌀 전통식 찹쌀고추장 500g,10900,9900,-1000
2018-06-01,1982483405,C012020,원피스,빅사이즈 울 코트 DB 97번 울코트 트랜치코트 빅사이즈코트 모직코트 패딩코트 코트,147380,131170,-16210
2018-06-01,1367965422,C012060,여자내의,[로엠(ROEM)]단추포인트 롱스커트 (세트) (3colors) RMWH82601A,39900,39900,0
2018-06-01,1089613344,E031070,에어컨,전시품-/한일/18인지/벽걸이선풍기/업소용/FW-Z801,49800,49800,0
2018-06-01,1586102667,A011110,당면,국내생산 포두부 1kg 건두부 두부국수,10000,10000,0
2018-06-01,1209710957,C013020,티셔츠,끈조절 왕뽕 캡나시 SD-6707 나시 뽕나시 끈나시 롱끈,12050,12050,0
2018-06-01,895773302,A019090,카레,[오뚜기]오뚜기 카레 매운맛 100g,1990,1990,0
2018-06-01,1145831281,E061020,섬유유연제,샤프란 3100mlx4개/피죤 3100mlX4개/섬유유연제 세제,12200,12200,0
2018-06-01,907510280,E011060,의자,접이식 의자 식탁의자 빠텐 홈바 스툴 간이보조,5900,5900,0
2018-06-01,480755891,A019040,소금,안동 볶음천일염 100% 차가버섯 소금 320g /구이용,14900,14900,0
2018-06-01,989102825,A018020,사탕,[롯데]롯데 아이스브레이커스듀오 스트로베리 36G,2800,2800,0
2018-06-01,1176451904,A022050,탄산음료,일화/탑씨1.5LX12pet/오렌지/파인/포도/과즙/탄산음료,12500,12500,0
2018-06-01,1323857954,C013050,운동복,[아스토레] (SIZE : 110) 본딩 히트자켓(ABL) - 우븐+,110640,110640,0
2018-06-01,603589613,E011060,의자,학생의자/사무실의자/메쉬의자/공부방의자/회전의자,56000,54880,-1120
2018-06-01,412641692,C013050,운동복,올포카/(독일산)타이어 공기 주입구/주입기/바람/바퀴/무시/공기압/공기주입/스페어/에,5800,5800,0
2018-06-01,382459070,E011020,침대,[평상형 침대프레임]SBS;우리아이가 달라졌어요;협찬,100000,99000,-1000
2018-06-01,316054354,A018060,스낵과자,대용량 스낵 모음전/고구마/오란다/소라/김맛/번데기,9900,9900,0
2018-06-01,1473804861,C013050,운동복,휴대용 간이소화기 차량용 가정용 화재 초기진화YKM,13500,9700,-3800
2018-06-01,895773333,A019100,식초,[오뚜기]오뚜기 케찹 (500g),2400,2400,0
2018-06-01,46071819,A013040,고등어,국내산 햇 고등어 20팩 / 대박특가,14900,14900,0
2018-06-01,895773332,A019100,식초,[오뚜기]오뚜기 토마토 케찹 (300g),1690,1690,0
2018-06-01,537444903,A015010,참기름,해정원 고소한 참기름(병) 350ml 2개,24440,24440,0
2018-06-01,2137452836,C013050,운동복,dd98 슬림핏 트레이닝복 네이비 트레이닝복 츄리닝상,18810,18810,0
2018-06-01,1373045852,C012060,여자내의,서머리 냉감 통바지 DM-6358,8700,8600,-100
2018-06-01,627115158,C013020,티셔츠,[캘빈클라인진]남여 티셔츠 모음 6종 택1(J307543외5종)(강남점),39000,34050,-4950
2018-06-01,1506642416,C011030,남자학생복,(ACCMD852 3G 롱가디건 가디건 롱가디건 남자가디건,59700,59700,0
2018-06-01,2144782061,E031040,전기레인지,고급형제과쇼케이스 케익쇼케이스 SCW-130L SCW-160L,759000,759000,0
2018-06-01,162406503,I031010,장난감,[시즌특가]-배트카/무소음/붕붕카/LED불바퀴/KC인증,49800,44820,-4980
2018-06-01,1738909237,L012040,치약,추가금없음/시린메드치약 검케어 125gX5개+30gX5개,23900,23900,0
2018-06-01,899587603,G022010,자동차용품,불스원) 레인OK 유리발수코팅 SPEED (380ml),11900,11900,0
2018-06-01,1639436110,A015010,참기름,꼬손 참기름 들기름 2병 묶음할인 볶음참깨 무료배송,8900,8900,0
2018-06-01,895773328,A019100,식초,[오뚜기]오뚜기 케찹 (800g),3690,3690,0
2018-06-01,1349787083,C015020,모자,빅사이즈 스냅백 볼캡 모자 대두모자 큰모자 큰사이즈,17000,15900,-1100
2018-06-01,1065747015,I012010,컴퓨터,슈퍼특가125만원+오피스+무료퀵 삼성 NT900X3T-K58A,1450530,1349000,-101530
2018-06-01,895773325,A019090,카레,[오뚜기]오뚜기 카레 약간매운맛 100g,1990,1990,0
2018-06-01,1172923169,C014020,유아복,아둘 패밀리룩 유아 시그니처 로고 조던 반팔티 11,11100,11100,0
2018-06-01,895773324,A019090,카레,[오뚜기]오뚜기 카레 순한맛 100g,1990,1990,0
2018-06-01,989079949,A013050,오징어,참숯 갈치구이 70G/팩,3490,3490,0
2018-06-01,298718804,E021010,침구,뱀부시어서커 여름이불(홑/양겹/누빔)+패드 세트,34000,32900,-1100
2018-06-01,386489044,E021020,커튼,베이직커튼봉 4단 25mm 길이조절450cm,30890,30890,0
2018-06-01,1018337654,C011050,남자내의,아디다스 여성 우븐 슬릿 쇼트 (BP9307 ),43070,38340,-4730
2018-06-01,412122933,L021030,가방,크로스백/캐쥬얼가방/힙쌕/숄더백/백팩/여행가방/FR04,9900,9900,0
2018-06-01,494314401,E031010,전기밥솥,CRP-AHXB1060FD/쿠쿠/10인용/IH압력/음성/GH,306400,281710,-24690
2018-06-01,2061523321,C013020,티셔츠,[시크헤라] 자체제작 막강 팬츠 군단,14900,14900,0
2018-06-01,507979586,C013050,운동복,벤츠 타이어 밸브캡 에어캡 4P 1Set 크롬 블랙 선택,6000,5820,-180
2018-06-01,1322230449,E061010,세탁세제,울샴푸 후레쉬 퍼플 라일락 1.3L파우치x3개/ 애경,9400,9400,0
2018-06-01,985265677,A011170,떡,CJ 밀당의고수 매콤달콤 쫄볶이 470G,4680,4680,0
2018-06-01,1483406431,I031040,생화,폴스타 파워캠핑테이블/미니테이블/간이테이블,7800,7800,0
2018-06-01,1005724226,C013040,청바지,(SR)MHA535 남자기모빅사이즈스판기모본딩청바지 남성,64580,64580,0
2018-06-01,1876754969,L021050,우산,국산 형광우의 작업용 낚시 등산용우의 비옷 판초우의,25000,25000,0
2018-06-01,1817691493,F012030,안경,클래식 안경테/메탈 안경/콤비,20000,19800,-200
2018-06-01,1478931874,E041070,밀폐용기,락앤락 비스프리 모듈러 밀폐용기 반찬통 세트 모음전,10900,10030,-870
2018-06-01,989102861,A011120,두부,포스트 오레오오즈 250G,3990,3990,0
2018-06-01,1185607465,A013150,어묵,삼진어묵 모듬어묵 3종세트(야채맛+해물맛+매운맛)/ 삼진어묵,30000,28500,-1500
2018-06-01,989080907,L012040,치약,[LG]LG)리치컴플리트치약(오리지널)120G*3,9900,5490,-4410
2018-06-01,989080908,L012040,치약,[LG]LG)리치컴플리트치약(후레쉬)120G*3,9900,5490,-4410
2018-06-01,1808845212,C014010,아동복,[래핑차일드] 투칸 나시 티 (87425-331-02),9000,8100,-900
2018-06-01,321063192,C013020,티셔츠,하트그물짜임니트/비치웨어/망사니트/시스루니트,17900,17900,0
2018-06-01,1020026658,L021030,가방,백팩 책가방 여자 소풍 기저귀 학생 여성 가방 모음,14500,14500,0
2018-06-01,1864826731,A021010,커피,카누 미니 다크 마일드 150T/아메리카노/원두/스틱,26480,24900,-1580
2018-06-01,987287532,A022060,혼합음료,[대웅] 블루베리(블루베리 6.5Brix 이상 70mlX30포) -1세트,43000,18900,-24100
2018-06-01,240479456,C011030,남자학생복,MCD-901 유니크 잉카패턴 브이넥 가디건/봄 가을 겨울,16000,16000,0
2018-06-01,1894714983,A017010,배추,무청시래기20kg/배추우거지/국산/삶아 급냉,27000,27000,0
2018-06-01,201193390,A013070,굴,특산 동해 홍게 5kg 고급붉은 대게/당일조업 선주직송,31900,28800,-3100
2018-06-01,987287526,A022060,혼합음료,[대웅] 산삼배양근 (국산 산삼배양근추출액+당귀+오가피 함유 70mlX30포) -3세트,95000,46600,-48400
2018-06-01,1057565850,C015020,모자,야구모자 군모 여성 남자 볼캡 캡모자 여름 신상 모자,9900,6900,-3000
2018-06-01,1207217555,C013010,점퍼,[데일리스트] 하이넥 시스루 점퍼MDBCLTM3511,87000,81780,-5220
2018-06-01,1900807578,E061020,섬유유연제,다우니 레노 섬유유연제 2.8L X 2개 /8.5L,14800,14800,0
2018-06-01,2088157625,C013020,티셔츠,반팔 라운드 브이넥 민소매 자수 호일 티셔츠 최저가,1980,1980,0
2018-06-01,1728561866,F012050,의료측정기,아크레이 팔뚝형 혈압계 HL-858NA+아답터 혈압측정기,42000,39000,-3000
2018-06-01,1339945899,A013040,고등어,[여수 순살고등어 20마리]국내산/노르웨이 고등어/조기/안동 간고등어/갈치/굴비/반찬,15900,12900,-3000
2018-06-01,1061911375,A019060,된장,[CJ직배송] 그대로 끓여먹는 된장찌개전용(청양초) 450g X2개,9900,9900,0
2018-06-01,1061911376,A019060,된장,[CJ직배송] 그대로 끓여먹는 된장찌개전용(쇠고기) 450g X2개,9900,9900,0
2018-06-01,1061911379,A019080,고추장,[우리명가]자연송이고추장 1호,24800,24800,0
2018-06-01,1043605512,F012010,종이기저귀,군기저귀 스마일 베이비 남녀공용 팬티형 XL 26매x1팩,7900,7900,0
2018-06-01,1179276281,A019050,간장,홈메이드냉모밀/냉소바/다시마간장+소바+생와사비,20900,20900,0
2018-06-01,1541984461,C013050,운동복,인기 트레이닝세트 ~3XL 운동복 트레이닝복 빅사이즈,34000,29900,-4100
2018-06-01,188233258,C013010,점퍼,[앨빈클로]신상 포근한 양기모후드집업 후드티 맨투맨,21900,19900,-2000
2018-06-01,989102887,A014010,우유,매일 커피우유 250ML,850,850,0
2018-06-01,441899282,A015020,식용유,식자재 해표 요리백미 고추맛기름 1.8L,13700,13700,0
2018-06-01,2024848501,C011030,남자학생복,빅사이즈 성조기 가디건 STJ 빅사이즈 빅사이즈가디건,99320,88400,-10920
2018-06-01,870149325,I031040,생화,[콜럼버스]사계절 침낭 오리털 거위털 100% 국내생산,39800,39800,0
2018-06-01,1784116163,L021030,가방,비지니스맨 서류가방/남자가방/토드백/크로스백,33900,33900,0
2018-06-01,1230341456,C012040,여자학생복,피오나 퍼플향기 blouse/m6312/블라우스/ 피오나,34300,26420,-7880
2018-06-01,1011215531,E031070,에어컨,나오테크LED핸디선풍기,9900,9900,0
2018-06-01,717572069,E051020,건전지,국산정품-페어맨 3500mAh 18650 배터리 건전지 충전기,9800,9800,0
2018-06-01,113659204,A017210,파,못난이 찰토마토 (쥬스용) 반짝특가~5kg(9900원),9900,9900,0
2018-06-01,1777641146,L021020,장신구,[바보사랑]P6289 스퀘어 큐빅 귀걸이 팔찌세트(케이스포함),34800,34800,0
2018-06-01,1777641145,L021020,장신구,[바보사랑]P6300 언발란스 드롭 라운드 큐빅 귀걸이(케이스포함),24800,24800,0
2018-06-01,390996662,C013050,운동복,푸조 남녀공용 니트 트레이닝 세트(FZ131-3) 긴팔트레,67040,67040,0
2018-06-01,459804286,C013010,점퍼,[인디안][인디안(INDIAN)]스트라이프패턴집업점퍼_MITCLRM2411_53,41400,39330,-2070
2018-06-01,514083568,C013010,점퍼,퍼즐KC 여름바람막이점퍼 3색/아동바람막이,28700,28700,0
2018-06-01,1156916434,C011020,남자상의,180수/최고급 캐주얼/신사정장세트/여름정장,147000,147000,0
2018-06-01,770788519,C014010,아동복,다이노코어 카봇 터닝메카드 번개맨 파워레인저/옷,19900,19900,0
2018-06-01,197984074,C021020,구두,[디씨엘로]가성비 좋은 남성구두 DMM8710 흑/밤 중택1,79000,78000,-1000
2018-06-01,386587564,C015020,모자,(컬러:사이즈 : 블랙:FREE) ACC-CAP101 찡절,19630,19630,0
2018-06-01,1873708754,A019160,밑반찬,속초중앙시장 명물 명태네 코다리강정 1팩,16800,16800,0
2018-06-01,1752732792,E011030,거실장,에쉬원목 카르텔 거실장세트,830000,830000,0
2018-06-01,1752732794,E011030,거실장,마리타 에쉬투톤 거실장세트,955000,955000,0
2018-06-01,1752732793,E011030,거실장,카르텔 에쉬투톤 거실장세트,945000,945000,0
2018-06-01,45672289,C013010,점퍼,여성패딩 패딩점퍼 롱패딩 후드패딩 숏패딩 세일~,35600,35600,0
2018-06-01,987287502,A022060,혼합음료,[대웅] 산삼배양근 (국산 산삼배양근추출액+당귀+오가피 함유 70mlX30포) -1세트,35000,16900,-18100
2018-06-01,1395564806,L021030,가방,늘푸른백화점 제노바 y488 노트북서류 남성사무용가방,48320,48320,0
2018-06-01,780246191,C013050,운동복,남성 트레이닝바지 추성훈바지 냉장고바지 운동복w020,13000,12800,-200
2018-06-01,701496155,I031040,생화,멀티기능 야전삽 정글의법칙야전삽 캠핑용품,25000,22910,-2090
2018-06-01,2120664877,C013050,운동복,윌슨 스판츄리닝세트/트레이닝/츄리닝/추리닝/단체복,59800,59800,0
2018-06-01,1545554633,I031040,생화,낚시대 가이드 모음 수리 보수용 낚시부품 낚시가이드,990,920,-70
2018-06-01,664345417,F012020,생리대,동아제약 체내형 생리대 뉴 템포 레귤러 20개입 1개,6000,6000,0
2018-06-01,456339139,A013170,생선통조림,삼포 자연산 골뱅이 400g 배꼽골뱅이,6340,6340,0
2018-06-01,1691798017,A016120,바나나,[농협6번]멕시코바나나10봉지 필리핀바나나 9손 6손,29800,29800,0
2018-06-01,1495880825,E031010,전기밥솥,쿠첸 WM-3503 //35인용/대용량.업소용 전기밥솥,103000,103000,0
2018-06-01,1411347139,A012060,햄및베이컨,사조 불고기구이햄 1kg/슬라이스햄/샌드위치/토스트,5600,5600,0
2018-06-01,499269392,C013050,운동복,귀여운 캐릭터 안전벨트 클립 전차종공용 경고음 차단,5000,4850,-150
2018-06-01,1122504589,C013040,청바지,{G2_18S0429}남아까뮤4부데님바지/ 소이,7900,7430,-470
2018-06-01,1303200649,C013030,스웨터,민자 니트 반폴라 티셔트 MRO반폴라니트 목폴라목폴라,48660,48660,0
2018-06-01,1275997902,A017050,미나리,한끼 샐러드 양배추(소) 60g,1100,1100,0
2018-06-01,1211469289,C021040,실내화,[노베스타/내추럴월드] 남녀스니커즈 39종,19900,19900,0
2018-06-01,1998874324,C012020,원피스,MSG (대원미 대원 3K) x4,63730,63730,0
2018-06-01,85923488,C013010,점퍼,[톰키드]스노우다운점퍼(92174-14-102)01,49000,44100,-4900
2018-06-01,1430548728,A019030,생강,리얼편강 (국산 200gX2통) 선물세트,32800,29200,-3600
2018-06-01,1372034492,A017280,김,일가집 김밥용 치자 단무지 240g X 20EA_1BOX 절임반,64580,64580,0
2018-06-01,820208002,C011050,남자내의,(905/레이스자수꽃)밑단레이스 스프사 9부 파자마,12640,11250,-1390
2018-06-01,608966148,C012060,여자내의,SKI241 튤립절개 머메이드라인 스커트/ 오드,33800,33800,0
2018-06-01,1721703863,C013020,티셔츠,[제이디엑스][JDX] 여성 컬러블러킹요꼬티셔츠(X2NMTSW93DN),29000,27550,-1450
2018-06-01,1229437968,C021040,실내화,[나이키]운동화 에어 맥스 90 에센셜 6종 택1 616730-023 537384-111 537384-090 6167,123500,104980,-18520
2018-06-01,1153258763,C021040,실내화,[아디다스][MENS RUNNING/ORIGINALS] 엘레먼트/코스믹/니짜/아딜렛샌들 (DB1459 DB146,39500,33340,-6160
2018-06-01,2137968631,C011030,남자학생복,크리스찬오자르 S/S 반팔/긴팔/셔츠/와이셔츠/남방,9900,9900,0
2018-06-01,2146466689,C013050,운동복,100%에탄올 친환경 워셔액1.8L x 12개 1박스 불스원,20800,19800,-1000
2018-06-01,2006856920,A017100,당근,열무4kg(1box),16590,16590,0
2018-06-01,1518616417,I031070,애완동물관리비,프로스펙스/훼르자 육상 스파이크화 육상화 최저가,33000,28920,-4080
2018-06-01,2073935727,C013010,점퍼,남자청자켓 기획 빈티지 워싱 데님자켓 아우터 남성자,37840,37840,0
2018-06-01,918017936,A018100,꿀,생로얄젤리 로얄제리 로알제리 밀랍 왕유 로열제리,46900,46900,0
2018-06-01,1657626424,I011030,사진기,명품마을 정품 소니 A6000+16-50 새상품 색상보유,596000,596000,0
2018-06-01,811160225,A019130,스프,보노스프 컵스프 10종 골라담기 스프 보노 죽 간식,2250,2250,0
2018-06-01,118859704,C012040,여자학생복,[공구우먼] 미쇼 7부 스트라이프 린넨 남방 28919 여성빅사이즈,25000,25000,0
2018-06-01,895773391,A019100,식초,[오뚜기]오뚜기 1/2 하프마요네즈 (525g),4180,4180,0
2018-06-01,1752732796,E011030,거실장,브레타 엘다원목 오픈형 5단 장식장,545000,545000,0
2018-06-01,1752732795,E011030,거실장,브레타 엘다원목 서랍형 5단 장식장,585000,585000,0
2018-06-01,346184822,I012010,컴퓨터,단3일!! 20만원즉시할인+MSoffice증정! NT950QAA-X58A,1841050,1749000,-92050
2018-06-01,1752732798,E011030,거실장,마로니 엘다원목 거실장세트D,940000,940000,0
2018-06-01,288908410,I011030,사진기,[사은품증정][파나소닉]루믹스 디카 DMC-LX10,679000,624680,-54320
2018-06-01,1752732797,E011030,거실장,로지 고무나무원목 익스텐션 거실장,650000,650000,0
2018-06-01,1752732799,E011030,거실장,마로니 엘다원목 거실장세트C,940000,940000,0
2018-06-01,635796592,L021030,가방,투카노 WORKOUT3 워크아웃3 13인치 노트북가방,69000,69000,0
2018-06-01,1010172872,A019180,즉석식품,청정원 큰컵 매운짬뽕밥 95G,2380,2380,0
2018-06-01,87353299,I053010,공책,(추천)옥스포드 리갈패드 A4/ 옥스포드노트 리갈패드,4100,2900,-1200
2018-06-01,1385323883,C012040,여자학생복,SOUP 숲 (SU6VE40) 하프기장 베스트,39000,31980,-7020
2018-06-01,847689809,C012060,여자내의,봄신상 슬랙스 정장 밴딩팬츠/S~3XL/9부/빅사이즈,27800,27800,0
2018-06-01,699522008,A019110,드레싱,청정원 콜슬로 드레싱(315G),2000,2000,0
2018-06-01,1419375469,C013050,운동복,요가복.휘트니스복.트레이닝복.요가바지.헬스복,15800,14800,-1000
2018-06-01,899622454,A013030,조기,[영광굴비] 굴비/영광굴비/법성포굴비/참조기/말린/조기/명절선물,182900,182900,0
2018-06-01,1010196869,A016090,참외,밀양 얼음골고냉지사과10kg 40과,65000,50000,-15000
2018-06-01,597382151,C013020,티셔츠,아디다스 골프 SS 여성 반팔 폴로 셔츠 CI7925 CI7926 CI7927 골프웨어 필드웨어 골프,36300,34850,-1450
2018-06-01,565452467,C014010,아동복,[노스페이스] 키즈 베이직 라운지 웨어 세트 NT7UJ14 3종 택1,34400,29590,-4810
2018-06-01,1010196867,A016090,참외,밀양 얼음골고냉지사과10kg 36과,79500,61000,-18500
2018-06-01,350251355,C012060,여자내의,SK1028-데일리 20대 30대 예쁜스커트 스티치 절개 니,20480,20480,0
2018-06-01,1840199068,C012040,여자학생복,총110종 반팔 긴팔 롱 배색 스트라이프 유니폼 체크셔츠 교복셔츠 롱블라우스 남방셔츠,12800,12800,0
2018-06-01,465848482,C013020,티셔츠,폴라티 골지 나시 베이직 롱 기본 폴라티셔츠 폴라나,6440,6440,0
2018-06-01,571073030,A016030,복숭아,건포도(비앤지월넛 1K)X5개 /포도 건과 안주 반찬 간,35290,35290,0
2018-06-01,1021086909,A021010,커피,[초특가] 갓 볶은 신선한 원두커피 500g+500g=1kg,7900,7900,0
2018-06-01,854466901,E031130,보온매트,2017년 이매텍 프리미엄 전기요 1인용(ITH-386) & 2인용(ITH-387),73470,73470,0
2018-06-01,1353633832,F011150,건강기능식품,삼성제약 까스명수GOLD 75mlx50병 건강음료 소화제,47640,47640,0
2018-06-01,739647553,C013040,청바지,리바이스/511-0408/슬림핏/청바지/남성/여름진/스키니,78000,68640,-9360
2018-06-01,597213419,A011010,쌀,2017년 오뚜기 씻어나온 쌀 20kg/박스포장,51900,51900,0
2018-06-01,1038342865,A016070,귤,[제철에만난]베트남 용과 5kg(9수),41500,40090,-1410
2018-06-01,1010196871,A016090,참외,밀양 얼음골고냉지사과10kg 42과,66000,50000,-16000
2018-06-01,1005881085,A021010,커피,카누 미니 다크/마일드 아메리카노 120T(30TX4EA),17100,17100,0
2018-06-01,623449934,G011070,자전거,GIFT 2018 삼천리 26 프림로즈7 여성용 시티 자전거,225000,225000,0
2018-06-01,578413183,C013020,티셔츠,[르피타]러브 롱 티셔츠 C182CTS602,19800,19800,0
2018-06-01,114707189,C015040,장갑,스포츠 반장갑/자전거/등산/낚시/레저/바이크/운동,6500,5980,-520
2018-06-01,1210387816,C013010,점퍼,[트레몰로][TREMOLO] 남성 배색 점퍼_TRBCLTM3311,109000,103550,-5450
2018-06-01,987287432,A022060,혼합음료,[대웅] 녹용홍삼 (국산 생녹용추출액+6년근홍삼+당귀+천궁 함유 70mlX30포) -3세트,95000,46600,-48400
2018-06-01,2030435599,C012060,여자내의,[바비수아]럭키 여성 린넨 와이드팬츠,22000,20900,-1100
2018-06-01,987287433,A022060,혼합음료,[대웅] 녹용홍삼 (국산 생녹용추출액+6년근홍삼+당귀+천궁 함유  70mlX30포) -5세트,148000,72200,-75800
2018-06-01,1810957768,A021010,커피,일리커피 미디움 다크 파드 18개입,14000,14000,0
2018-06-01,1869529930,E031120,믹서,한일 다용도 쿠킹 믹서기 HMF-1275,47650,47650,0
2018-06-01,2049520007,C013040,청바지,[모다아울렛][에프알제이]스키니진F72F-DP371A,29000,29000,0
2018-06-01,1857939157,I031070,애완동물관리비,림보 뺑뺑이 대형다트 명랑운동회 체육대회 게임 용품,55000,55000,0
2018-06-01,1152898832,E031020,가스레인지,SK매직 2구 가스렌지 GRA-811SR 메탈실버/당일발송,150000,142550,-7450
2018-06-01,860026565,A011090,국수,오뚜기 라면사리 48개입 40개입/사리면/라면,10800,10800,0
2018-06-01,985290699,A013060,게,대구(중/국산/냉동),6990,5990,-1000
2018-06-01,269469139,G011070,자전거,밀레니엄 2018년신상품 20인치 미니벨로 접이식자전거,119000,93060,-25940
2018-06-01,570847169,C012060,여자내의,헤이즈 기모 가죽바지 SD 5049,16000,15840,-160
2018-06-01,360408105,A019110,드레싱,발사믹식초/파스타소스/바베큐소스/쌀국수소스/굴소스,4000,4000,0
2018-06-01,1265678114,I012010,컴퓨터,LG데스크탑 B70EV-AR7716 코어i7 4G 1TB 윈도우10,1030850,969000,-61850
2018-06-01,988213842,A011080,밀가루,초L 소면 500G,1690,1690,0
2018-06-01,2020784676,A013170,생선통조림,동원 자연산 골뱅이 400g/230g/통조림,5800,5800,0
2018-06-01,1312625329,E011020,침대,상일리베가구 마들렌 원목 벙커침대,257520,257520,0
2018-06-01,1367774668,C013050,운동복,파보니 접이식 안전콘 사고 방지 안전 용품 안전깰대,22030,21370,-660
2018-06-01,895797357,A019110,드레싱,풀무원 매콤쌈장 450G,5980,5980,0
2018-06-01,1651501080,A012060,햄및베이컨,[동원]리챔 200g*10+우유리챔200g*3캔 증정,19900,19110,-790
2018-06-01,895832102,A012050,소시지,[CJ]CJ 알찬 소세지 (300G),1590,1590,0
2018-06-01,895797355,A019110,드레싱,풀무원 정통순두부 찌개양념 3-4인 (140G),2190,2190,0
2018-06-01,507392826,C012040,여자학생복,[대구백화점 I관] [애녹]산수화쉬폰배색가디건(AU516G),49000,43610,-5390
2018-06-01,895797350,A011170,떡,풀무원 바로조리순쌀떡볶이 2인(480G),4700,4700,0
2018-06-01,82035456,C012060,여자내의,[물건팜] 해외직배송 봄 신상 ins 유행 점프 슈트,73260,73260,0
2018-06-01,1480267463,F011150,건강기능식품,뚜레반 검은콩미숫가루1kg,2900,2900,0
2018-06-01,491535546,C012040,여자학생복,8B-VE008 싸개단추포인조끼/ 데드라,50400,37800,-12600
2018-06-01,895773358,A019130,스프,[오뚜기]오뚜기 크림스프 80g,1690,1490,-200
2018-06-01,895797324,A019110,드레싱,풀무원 중화마파두부 양념소스 3-4인 (130G),2190,2190,0
2018-06-01,1545642906,C021020,구두,[금강제화] 리갈 201 신규 라인 MMX5029FG11(본점),250200,218430,-31770
2018-06-01,895797320,A019110,드레싱,풀무원 다진마늘 (150G),4800,4800,0
2018-06-01,322507258,C013010,점퍼,시크폭스 바이원 린넨야상자켓/ 시크폭스,59800,46650,-13150
2018-06-01,895797322,A011170,떡,[풀무원]한입 떡국 떡 400G,2500,2500,0
2018-06-01,534244917,A014010,우유,헬리코박터 프로젝트 윌 150ml X 30개 (1개월)/ 한국야쿠르트,42000,42000,0
2018-06-01,1999449190,C013020,티셔츠,빅사이즈민짱/무료배송/예쁘잖아 티셔츠모음,16900,16900,0
2018-06-01,986154476,A019110,드레싱,풀무원 유자샐러드드레싱 240G,3780,3780,0
2018-06-01,1313984299,A019180,즉석식품,무료배송/오뚜기/사골곰탕 350gx18개/육개장 300gx18,16900,16900,0
2018-06-01,534606837,C013020,티셔츠,S/빈폴폴로라코스테버버리헤지스카라티남자/조은구제,19900,19900,0
2018-06-01,636504574,A011090,국수,농심 신라면 + 안성탕면 + 너구리 + 찰비빔면/외 선택,13720,13720,0
2018-06-01,1292303671,C014010,아동복,[휠라키즈] 플리스상의 K2RSZ101~8X(GRY.SBU.LYE.PNK),20000,15800,-4200
2018-06-01,533898761,A013120,낙지,[가온애]동해안 오징어 건오징어10마리 마른오징어,33800,33800,0
2018-06-01,1630392680,L012060,샴푸,닥터방기원 미세먼지전용샴푸 1000ml 1+1+토닉,25800,25800,0
2018-06-01,1894193130,C012040,여자학생복,아사프릴NB(N18NS8208R)/ 나인스텝,30000,28500,-1500
2018-06-01,990032176,E061070,가정용비닐용품,Onlyprice)위생백(대)30CM*45CM*70매,1000,1000,0
2018-06-01,956690127,A018070,파이,[롯데]롯데 초코파이 2번들 (840G),5000,4290,-710
2018-06-01,990032178,E061070,가정용비닐용품,Onlyprice)지퍼백(대)25CM*30CM*20매,2000,2000,0
2018-06-01,1124357161,A013010,갈치,제주어가 모듬세트 08호 갈치 대 4마리와 옥돔 대 1kg,170100,165000,-5100
2018-06-01,1762214352,A021010,커피,[쿠폰가36 900/당일출고]화이트골드400T/모카골드420T,40900,40900,0
2018-06-01,990032177,E061070,가정용비닐용품,Onlyprice)위생백(소)17CM*25CM*200매,1000,1000,0
2018-06-01,990032179,E061070,가정용비닐용품,Onlyprice)지퍼백(중)20CM*25CM*15매,1000,1000,0
2018-06-01,672556752,F012020,생리대,특가 좋은느낌 입는오버나이트 중형16매/대형16매,17800,17800,0
2018-06-01,125286190,E031010,전기밥솥,정품쿠쿠압력밥솥고무패킹 6/8/10인 쿠쿠패킹 2중모션,4700,4700,0
2018-06-01,990032172,E061070,가정용비닐용품,Onlyprice)랩(25CM*50M),2000,2000,0
2018-06-01,990032173,E061070,가정용비닐용품,Onlyprice)롤백(대)30CM*40CM*150매,2000,2000,0
2018-06-01,1478194306,A019140,이유식,루솔 프리미엄 이유식 1팩 선택 구매,2650,2650,0
2018-06-01,544955453,C013050,운동복,비상 경고등,11600,11260,-340
2018-06-01,958449871,A019090,카레,[청정원]청정원 카레여왕(분말) 치즈&코코넛 108G,3650,3650,0
2018-06-01,1094622124,A011110,당면,국내산 도토리전분 도토리 묵말랭이 250g,35130,35130,0
2018-06-01,1821558726,F012010,종이기저귀,보솜이 프리미엄 천연코튼(남/여) 팬티 기저귀 2팩,26900,21900,-5000
2018-06-01,1597598113,C011030,남자학생복,MCD-917 빈티지 스타일 롱가디건 남성후드가디건 남자,48010,48010,0
2018-06-01,1730957391,A017120,고구마,햇감자 5kg/10kg 찜용/요리용 업소용 왕특,22000,22000,0
2018-06-01,526650675,L021010,손목시계,[내츄럴파크정품]남성 패션 가죽 메탈시계 시계줄,36900,36900,0
2018-06-01,1314800098,C013020,티셔츠,균일가 티셔츠 13종 택1/ 르샵,25000,20500,-4500
2018-06-01,1538922814,C013040,청바지,여름신상 남성 청바지 조거팬츠 스판/밴딩팬츠/린넨,9900,9900,0
2018-06-01,18689769,I053030,복사용지,하이브라이트 A4용지 80g 2BOX(5000매),41370,35580,-5790
2018-06-01,1808870231,C014010,아동복,[래핑차일드] 쿨 배기 데님 팬츠 (87325-401-50),19000,15580,-3420
2018-06-01,752708341,E061010,세탁세제,퍼실 파워젤 2.7L x2개/리필x4개/세탁세제/액체세제,23900,23900,0
2018-06-01,659806386,A011040,보리쌀,2018년 햇 병아리콩 4kg/2세트구매 사은품,9600,9600,0
2018-06-01,21698164,C013050,운동복,뉴코란도C/코란도C 프런트/리어 스키드 플레이트,139300,125370,-13930
2018-06-01,436795692,A017230,마늘,(소포장 야채 골라담기)양파/당근/감자/고추/고구마,3900,3900,0
2018-06-01,1618232676,C012060,여자내의,세미 A라인 미니스커트 MIWWH8421A/ 미쏘,29900,28410,-1490
2018-06-01,1936011724,L012010,면도기,도루코 페이스 7 II 페이스 + 면도날 4개,11100,11100,0
2018-06-01,966389018,A018030,껌,스낵팡/쥬시후레쉬/자일리톨/후라보노/아이디 껌 50종,6800,6800,0
2018-06-01,1712011525,E041020,컵,한국도자기 2인조 커피잔 모음 /티스픈증정,33600,33600,0
2018-06-01,1288435432,E041020,컵,유리찻잔 커피잔 유리 숙우 잔 컵 다기 머그 찻잔,6000,5400,-600
2018-06-01,895773361,A011130,시리얼,[오뚜기]오뚜기 튀김가루 500g,1650,1650,0
2018-06-01,895773360,A011130,시리얼,[오뚜기]오뚜기 튀김가루 (1KG),2790,2790,0
2018-06-01,1254463703,A011180,파스타면,자라 링귀니 11호 500g 스파케티 파스타 링귀네,1380,1380,0
2018-06-01,907113278,A019060,된장,[무배]화인식초13L/사과식초/대용량 업소용 식초/발효식초/빙초산/도매가/식당,10000,9900,-100
2018-06-01,824422046,F012020,생리대,에리에르 엘리스 생리대 골라담기 고쿠수이 슬림,3900,3900,0
2018-06-01,38799227,C013020,티셔츠,[디즈니]신상특가 미키 반팔티 반바지 우산,9900,9900,0
2018-06-01,794603299,F012020,생리대,템포 레귤라/슈퍼 10Px4개(물티슈10매 증정),12900,12900,0
2018-06-01,1258961621,E031130,보온매트,한일참숯황토 전기매트더블(원난방) 전기매트 전기,130110,130110,0
2018-06-01,900475715,A011180,파스타면,[농심]농심 생생우동 용기 (276G),1880,1880,0
2018-06-01,900475716,A011180,파스타면,[농심]농심 생생 우동 봉지 (253G),1780,1780,0
2018-06-01,1350888224,L021050,우산,EVA 레인코트/방풍기능/우비/우의/비옷/판쵸우의,4000,3900,-100
2018-06-01,494676602,I031040,생화,캠핑테이블 이동식카트 접이식테이블 주방테이블,175000,175000,0
2018-06-01,23383606,A011010,쌀,2017년햅쌀 보성농협 보성다향미10kg/쌀10kg/백미현미,25900,25900,0
2018-06-01,754417839,A011170,떡,현미쑥가래떡 1kg/ 국산생쑥 사용/쑥내음이 가득,10800,10800,0
2018-06-01,488801708,C012040,여자학생복,여성용 숄 패션 머플러 스카프 목도리 스타일 내츄럴,15600,15600,0
2018-06-01,2084042254,C012060,여자내의,#NAME?,76600,65110,-11490
2018-06-01,655522397,C013020,티셔츠,하딘골프H-39 hardinGOLF 카라티셔츠 코오롱ATB100-UV,19800,18800,-1000
2018-06-01,589559348,C011050,남자내의,여름 밴딩바지/린넨/마바지/슬랙스/9부바지/남성/남자,15800,15800,0
2018-06-01,1577051246,C011030,남자학생복,남여)린넨셔츠 8종 MSX2WC1003외/ 탑텐,12000,10800,-1200
2018-06-01,412797401,G011070,자전거,700C 레브 7 자전거용품 여성용자전거 휠라 자전거 커,274370,249900,-24470
2018-06-01,1138716825,C021040,실내화,스티유 18 S S 81341bk-81342be 수에뇨샌들,48790,48790,0
2018-06-01,175384969,A019060,된장,[1+1]청정원 순창 제주보리된장 900g+900g,14200,14200,0
2018-06-01,1540079563,I012060,저장장치,[벤큐] [벤큐 조위 정품] e-sports 게이밍 마우스 EC2-A,76590,72000,-4590
2018-06-01,1033110728,C013050,운동복,카렉스 에탄올 사계절 워셔액 1.8L 자동차 워셔액,7500,7500,0
2018-06-01,305994410,F012020,생리대,예지미인 365 라이너 15p x10팩 외 라이너 모음전,10500,10500,0
2018-06-01,895832166,A019100,식초,[대상]대상 우리아이 케찹 410G,2500,2500,0
2018-06-01,986154421,A011170,떡,풀무원 국물짜장 떡복이423.5G,4700,4700,0
2018-06-01,757666876,F012050,의료측정기,VT 카스/휴비딕 적외선 체온계 모음/비접촉/뽀로로,60000,27300,-32700
2018-06-01,1751780497,I031010,장난감,더뻔뻔 34종 레고놀이판 듀플로 옥스포드 블럭 레고판,900,900,0
2018-06-01,2139337453,F012010,종이기저귀,[보솜이] 디오가닉 밴드 M 중형 공용 42매 4팩,41900,41900,0
2018-06-01,1121088879,C013050,운동복,반팔 티 7부 밴딩 팬츠 바지 봄 여름 트레이닝 세트,23900,23900,0
2018-06-01,1770185609,C011020,남자상의,빅사이즈 패딩점퍼 웰론 남 WC 경량 JK014M 패딩점퍼/,106900,106900,0
2018-06-01,954814377,A018020,사탕,[롯데]롯데 스카치 세가지 (126G),1990,1990,0
2018-06-01,1266663021,C011030,남자학생복,라피스 린넨셔츠 BTT0185 셔츠 여름셔츠(YA02004) 남,26160,26160,0
2018-06-01,2079780686,E031130,보온매트,싱글사이즈 COTTON 전기요(180 68) /(참고)전기매트,110800,94180,-16620
2018-06-01,1318966427,C013060,등산복,[밀레(MILLET)][남성용](이월상품)[여름]타시랍차라 티셔츠( MMLUT256 )(경기점),19000,15350,-3650
2018-06-01,1516777965,F012010,종이기저귀,하기스 에어솔솔 썸머팬티 2팩 / 썸머밴드 3팩,39900,39900,0
2018-06-01,1242680427,C012030,여자상의,[무료배송]DWW052A 셔츠 레이어드 원피스 802 긴팔원,53030,53030,0
2018-06-01,1803393291,D031010,주택수선재료,블럭아이 10M 스티커형폼블럭 셀프인테리어 벽돌시트,64700,64700,0
2018-06-01,1955352070,C015030,넥타이,나비넥타이 리본타이,2700,2700,0
2018-06-01,385530737,C012030,여자상의,레이스 배색 원피스 NN2188M805 빅사이즈,38350,36050,-2300
2018-06-01,1546687642,C013020,티셔츠,[NEPA]TRIPLE PACK ROUND TEE - 7DG5300,34000,28220,-5780
2018-06-01,1075738052,C013010,점퍼,웰론 하프 패딩 코트 MC 1900 빅사이즈패딩 점퍼 패딩점퍼 빅사이즈 패딩,164970,146830,-18140
2018-06-01,1312214484,C012030,여자상의,nn66 스트랩 베이직 린넨원피스 - 소라 베이직원피스,34970,34970,0
2018-06-01,462685300,C013010,점퍼,[특가] 알파인더스트리 MA 1 SKYMASTER MJM45510C1,75000,75000,0
2018-06-01,439608462,A013160,맛살,(냉장)한성식품 통통맛살H(1kg)X6개통통맛살 식품 식,48600,41310,-7290
2018-06-01,2068310990,C011020,남자상의,남자아우터 프리미엄 포켓 하프코트 / 참고 남자아우,172900,152160,-20740
2018-06-01,1156818795,C012040,여자학생복,[화이트폭스]루즈핏그물니트가디건,16500,15020,-1480
2018-06-01,248936188,E041050,냄비,경산세라믹내열냄비/뚝배기/찜접시/전골/구이판/11,16800,16800,0
2018-06-01,1251623990,L012010,면도기,도루코 터치3 x 32개/일회용면도기 페이스6,8900,8900,0
2018-06-01,1244472783,C012040,여자학생복,[리스트][리스트] 롱로브가디건 TWWJKH20090 (P000363492),59000,51920,-7080
2018-06-01,232596840,F011120,인삼,(장생농산장수산삼 7년근 3주(3뿌리) 선물 건강식품,137360,133240,-4120
2018-06-01,696831283,A011030,찹쌀,국산 볶은 찰보리 1kg 보리 귀리 오트밀 볶은귀리,8200,8200,0
2018-06-01,1742728876,C014010,아동복,[여아양복]여아정장 연주복 턱시도 연미복 드레스 합,69900,69900,0
2018-06-01,478702111,C012020,원피스,[엄마옷 데드라] 8B-PT127 핀터크린넨팬츠,41200,34610,-6590
2018-06-01,234413928,A021020,차,라빼르슈 앵무새설탕/라빠르쉐각설탕스테비아나트비아,5700,5700,0
2018-06-01,1194311758,C012040,여자학생복,[로로텐]멜딩린넨남방,31000,29780,-1220
2018-06-01,416054552,C011030,남자학생복,슬림 체크포인트 블루 셔츠 남자남방 남자긴팔셔츠 긴,28160,28160,0
2018-06-01,175384998,A019060,된장,[1+1]청정원 순창 재래식生된장 2kg+2kg(사각),19800,19800,0
2018-06-01,2067541701,C013010,점퍼,여아 레이스 점퍼 (R1721J006_01)/ 레노마키즈,18600,16740,-1860
2018-06-01,540178689,C015040,장갑,[지맥스] 지맥스 첼린지 등산장갑/아웃도어 시원한 남성 여성,9510,9510,0
2018-06-01,446289318,C015040,장갑,핑거 스노우 벙어리 장갑 벙어리방갑 포근한장갑 핑거,11050,11050,0
2018-06-01,1685565763,C013010,점퍼,[TOP 10]남성 윈드브레이커 자켓MSY2JJ1201(영등포점A),29900,27560,-2340
2018-06-01,175384996,A019060,된장,[1+1]청정원 순창 메주 콩된장 900g+900g(사각),13200,13200,0
2018-06-01,1249185387,C012060,여자내의,쥬크(ZOOC) (Z181MSD005) 브로치 H라인 스커트,89000,73870,-15130
2018-06-01,1807413733,C013010,점퍼,후드티/후드집업/후리스/폴라폴리스맨투맨/무지맨투맨,10000,9900,-100
2018-06-01,1131919820,C013050,운동복,프론트 리어 범퍼 가드 보호대 몰딩 화이트 자동차범,20890,19040,-1850
2018-06-01,954814351,A018020,사탕,[롯데]롯데 애니타임 밀크74G,1990,1990,0
2018-06-01,382048323,L021030,가방,니플패치/니플스티커/남성니플/여성니플5쌍추가금없음,2000,1900,-100
2018-06-01,608930154,A022030,생수,풀무원샘물500mlX40개/특가/무료배송/생수,5400,5400,0
2018-06-01,749227694,A013060,게,피문어 대 1마리 문어 건문어 건조문어 말린문어,39780,39780,0
2018-06-01,231823086,F011120,인삼,(장생농산장수산삼 7년근 10주(10뿌리) 7년근 명절설,336230,326150,-10080
2018-06-01,1230091832,F012020,생리대,{무료배송}동아제약 템포 총50p 레귤러/슈퍼/탑폰/,23800,23800,0
2018-06-01,472759284,F011150,건강기능식품,센트룸 멀티종합비타민 실버포맨/실버포우먼/실버프로,34500,32430,-2070
2018-06-01,1353356747,C013020,티셔츠,베이직 후드티 LTT0034 여성티셔츠 여성후드티,26120,25600,-520
2018-06-01,1746301806,C013010,점퍼,[코코애비뉴][코코애비뉴]지퍼레더숏자켓_71101,57200,54920,-2280
2018-06-01,205017465,E031120,믹서,스토밍 핸드 믹서 /6단계속도/홈베이킹/거품기/반죽기,32000,32000,0
2018-06-01,553142999,L021020,장신구,실버 엥게이지 은반지 8900원부터~/평반지/실버반지,17900,17900,0
2018-06-01,2039710429,E051030,디지털도어록,[무료설치] 삼성 푸시풀 도어락 SHP-DP710/카드키2개,202500,182160,-20340
2018-06-01,954814345,A018020,사탕,[롯데]롯데 청포도 (298G),4300,4300,0
2018-06-01,1237294130,C013020,티셔츠,공용_후드 반팔 티셔츠(PHY2TH3020)/ 폴햄,39900,33920,-5980
2018-06-01,954814346,A018020,사탕,[롯데]롯데 청포도 (119G),1990,1990,0
2018-06-01,1332074194,C014010,아동복,하라 HARA 여름신상입고 편하고 스타일나는 상하복,24900,24900,0
2018-06-01,954814349,A018030,껌,[롯데]롯데 애니타임 밀크(185G),4300,4300,0
2018-06-01,1601432694,C012040,여자학생복,[MLB]엠엘비 3종택1 남여공용 빅로고 MLB 후드집업(31TRD2811),49000,41650,-7350
2018-06-01,732851720,C014020,유아복,쁘띠뮤 삠뽀요 봄마감 실내복/우주복 득템찬스,10000,8900,-1100
2018-06-01,755328188,E061030,전구,꼬마전구 파이롯트 램프 E10 12V 24V 6.3V,200,200,0
2018-06-01,1892907759,I031010,장난감,레고10704 크리에이티브 박스/클래식,46460,46460,0
2018-06-01,749201076,A011140,부침가루,[삼립] 삼립 까망베르치즈 조각케익 (75g 5입) 케이크,13000,12870,-130
2018-06-01,570823141,I031040,생화,파라솔 시멘트 물통 받침대 업소용 세트 야외 낚시,21000,19230,-1770
2018-06-01,461192392,C013020,티셔츠,[제이디엑스][JDX] 여성 앞마이포인트제에리티셔츠 4종 택1 (X2NMTSW92),29000,27550,-1450
2018-06-01,1903180641,L021030,가방,30%쿠폰! 홀리지/여성가방/숄더백/미니백/크로스백,10800,10800,0
2018-06-01,2068310965,C013010,점퍼,남자아우터 연카키 후드 롱 패딩 / 참고 남자아우터,100900,85770,-15130
2018-06-01,1127271484,A019170,냉동식품,사조 만두 포자 찐만두5종 고기만두 물만두 전자렌지,730,730,0
2018-06-01,853646365,E031070,에어컨,유니맥스 타워형선풍기/리모컨 타워팬/스탠드선풍기,56900,56900,0
2018-06-01,1580037284,I031040,생화,포켓 돗자리/켐핑/등산 스포츠 레저 ROMIX,9500,8740,-760
2018-06-01,1210387855,C013010,점퍼,[트레몰로][TREMOLO] 남성 프린트 배색 점퍼_TRBCLTM3331,109000,103550,-5450
2018-06-01,2083175503,C012060,여자내의,길런 멜빵마바지 DM-6739 /(참고)치마바지 청반바지,22800,20070,-2730
2018-06-01,175384971,A019060,된장,[1+1]청정원 순창 제주보리된장 450g+450g,8400,8400,0
2018-06-01,175384973,A019060,된장,[1+1]청정원 순창 재래식 집된장 2kg+2kg,24800,24800,0
2018-06-01,39546801,F012020,생리대,릴리안 초흡수 중형 16P x 6팩 (총 96P),15300,15300,0
2018-06-01,329894026,A016100,수박,[신세계몰]하우스 햇 수박8~10kg(4~5kgx2통),16900,16900,0
2018-06-01,1994484349,E051020,건전지,세상 모든 충전지 모음전!!! AA/AAA/건전지/충전지/배터리/충전기 모음전(파나소닉 에,12900,12900,0
2018-06-01,917234180,E021010,침구,특별가 100%순면 두툼한 차렵이불/이불/침구/세트,20900,19230,-1670
2018-06-01,1364283872,A011170,떡,아산맑은에프엔비의 오색떡국떡 (500g),5500,5500,0
2018-06-01,1915536171,A015020,식용유,청정원 올리브유 900ml X 12EA(Hanworld),228000,193800,-34200
2018-06-01,636553560,I031040,생화,비상담요 생존배낭 용품 담요 캠핑 체온유지용품,5800,5500,-300
2018-06-01,1476499493,A021010,커피,[로스터스빈]주문후 당일 로스팅 원두커피 200g 2팩,9900,9900,0
2018-06-01,83771902,C011050,남자내의,하이퀄리티 카고바지 M~XXL 남여공용 건빵바지 작업복,42800,37800,-5000
2018-06-01,1523471417,A013140,북어채,[가온애]자연건조 특품 황태채 400g/200g 대관령 황태,6900,6900,0
2018-06-01,368448512,C021040,실내화,남성신발 운동화 런닝화 러닝화 러닝슈즈 조깅화,9900,9900,0
2018-06-01,982704678,A018080,설탕,백설 자일로스 하얀설탕 5KG,13380,11200,-2180
2018-06-01,899404115,A018010,초콜릿,[롯데]롯데 크런키(34G),800,800,0
2018-06-01,1010196842,A016090,참외,밀양 얼음골고냉지사과5kg 18~19과,42000,32000,-10000
2018-06-01,1010196843,A016090,참외,밀양 얼음골고냉지사과10kg 26과,105000,79000,-26000
2018-06-01,80409543,E061040,부엌용세제,참그린 석류 식초설거지 470mlx2개+900mlx3개+300ml,13900,13900,0
2018-06-01,1010196841,A016090,참외,밀양 얼음골고냉지사과5kg( 20과내외),39000,27000,-12000
2018-06-01,2083151568,C013010,점퍼,스테판조셉 레인코트 유니콘 (택1) /(참고)어린이우비,86800,76390,-10410
2018-06-01,1030282341,A017300,미역,동원 양반김 도시락김120봉 들기름/올리브유/참기름,29900,26900,-3000
2018-06-01,1010196844,A016090,참외,밀양 얼음골고냉지사과10kg 30과,99000,76000,-23000
2018-06-01,1397080915,C013020,티셔츠,포켓맘 포켓수유티,28500,27650,-850
2018-06-01,495406060,C013050,운동복,에이몬 V756 반사광 도어가드 레드 리플렉터 4P,8500,8400,-100
2018-06-01,151553546,I031010,장난감,총알배송/조이트론 EX3 프리미엄 조이패드/PS3/PC호환,25000,25000,0
2018-06-01,1173669394,C011030,남자학생복,[에잇세컨즈]애쉬 브이넥 롱 카디건 (32825ASYK4),39900,35910,-3990
2018-06-01,1329217155,C013050,운동복,무료/믿고삼 7900원~ 요가복 요가바지/필라테스/헬스,12900,12900,0
2018-06-01,1141198136,I031010,장난감,레고 손목시계/ 알람시계 닌자고 유아동 어린이 시계,24900,24900,0
2018-06-01,202936024,E061050,청소용세제,홈스타 락스 세제 750mlx2 유한락스 세정제 소독제,9000,8900,-100
2018-06-01,252716141,E031140,비데,{신제품} 노비타 테라피비데 BD-TE80M {탈취+방수},399000,379000,-20000
2018-06-01,2012250644,I053020,스케치북,캔숀 스케치북 200G/캔손/8절/5절/4절/크로키북/파스텔/스케치,5400,5400,0
2018-06-01,1610869388,F012010,종이기저귀,[보솜이] 프리미엄 천연코튼 밴드 (남/여) 3팩,34900,34900,0
2018-06-01,522544439,L021020,장신구,남자 여자 커플 실버 은팔찌 체인 925 정품 법정순은,39000,39000,0
2018-06-01,1274467825,C013010,점퍼,바람막이 발수제 세탁세제 고어텍스 발수스프레이 레인점퍼 여성 의류 바람막이,38000,38000,0
2018-06-01,238668056,C015040,장갑,(옵션 : 블루) 낫소 성인용 니트장갑(NWT-V1,8270,8270,0
2018-06-01,194145403,I011030,사진기,정품 니콘 D5600 + AF-P18-55mm VR DSLR 4종사은품,654670,583720,-70950
2018-06-01,1718834336,C013010,점퍼,신상/캐주얼자켓/남성자켓/트러커자켓/정장/블레이져,29800,29800,0
2018-06-01,806080529,I012060,저장장치,(정품)ABKO K640 한영 이중사출 LED 기계식키보드,44900,44900,0
2018-06-01,1065691891,E011030,거실장,[채우리] 카라멜 600 거실장,64000,64000,0
2018-06-01,1269346164,C012020,원피스,데일리 여성 여름신상 빅사이즈 가디건 상의 세트,55480,55480,0
2018-06-01,1426044796,A019170,냉동식품,동원 개성왕만두 3종 감자/왕/김치 5.7kg(3봉),26900,26900,0
2018-06-01,1525660251,C021040,실내화,정품 리복운동화 푸마 50종 파격가/당일출고/무료배송,59000,59000,0
2018-06-01,370870123,C013040,청바지,(SR)MHA535 남자기모빅사이즈스판기모본딩청바지 기모,64580,64580,0
2018-06-01,379605645,C014020,유아복,삐삐롱 여자 아이 아동 여아 상하 반팔 실내복 순면,12470,12470,0
2018-06-01,1882157036,A017050,미나리,양배추분태(국산) 300g/말린/건조/양배추/분태/후레이크/분말/가루/파우더/생식/선식/,8400,8400,0
2018-06-01,1065691889,E011030,거실장,[채우리] 모모코 600 거실장,64000,64000,0
2018-06-01,1065691888,E011030,거실장,[채우리] 카라멜 1200 확장형 거실장,138000,138000,0
2018-06-01,859890019,C012020,원피스,[탱커스]TANKUS 탱커스 어번 시그니처 수트 2SET (자켓2종+팬츠2종),119000,119000,0
2018-06-01,1065691887,E011030,거실장,[채우리] 모모코 1200 거실장,83000,83000,0
2018-06-01,1020002759,A013100,마른멸치,바다소풍 고급선물세트 9~10미 1kg 선물포장,52000,49400,-2600
2018-06-01,1065691886,E011030,거실장,[채우리] 모모코 1200 확장형 거실장,138000,138000,0
2018-06-01,631201736,A016060,감,경북청도 껍질없는 아이스 홍시 20개(컵)/개당80 100g,74000,62900,-11100
2018-06-01,375103117,C013020,티셔츠,빅프렌즈/빅사이즈120(4XL)전용카라티셔츠,14000,14000,0
2018-06-01,1065691890,E011030,거실장,[채우리] 카라멜 1200 거실장,83000,83000,0
2018-06-01,245761238,C012040,여자학생복,(예사랑)여성 인견 조끼 17YB11,59000,58410,-590
2018-06-01,1541862089,C013040,청바지,아둘 패밀리룩 메쉬 조던 민소매 상하의 나시세트 39,15900,15900,0
2018-06-01,1398103926,C013050,운동복,ARA 맨 이모션 7부 팬츠/국내제작/ 마운틴리서치,10500,8610,-1890
2018-06-01,428621831,C013050,운동복,국산 에어게이지 타이어게이지 공기주입기 압력측정,12000,12000,0
2018-06-01,774214137,A017180,호박,(맛나)#오이고추(특.경매)10kg,124600,112140,-12460
2018-06-01,428621830,C013050,운동복,국산 에어게이지 타이어게이지 공기주입기 압력측정,9600,9500,-100
2018-06-01,986130644,A013100,마른멸치,[보성수산]자숙 골뱅이살 160g×2,29800,17500,-12300
2018-06-01,543995854,I031040,생화,싸파 침낭 모음전/국내산/오리털/거위털/레저 캠핑,27000,23930,-3070
2018-06-01,367897875,C013040,청바지,레깅스 원버튼 오리지날 기모 가죽 치마레깅스 치마워,42760,42760,0
2018-06-01,1827501509,C012060,여자내의,샤론 글리터 브이넥 뷔스티에- 글리터뷔스티에 유니크,25280,25280,0
2018-06-01,501014800,A016100,수박,농촌이야기 맛있는 수박 4~8kg,7900,7700,-200
2018-06-01,1117290049,E011030,거실장,에스엠 1330 TV수납장 tv장식장 tv거실장,149000,149000,0
2018-06-01,80409511,E061040,부엌용세제,참그린[모과] 식초설거지 용기 470ml x 4개 주방 세제,9900,9900,0
2018-06-01,1988814920,E031070,에어컨,FC-62LB 한일천장용선풍기 3엽/강약풍속조절/국내생산,58900,58900,0
2018-06-01,1273987945,C013040,청바지,[레코브]챔피언 팬츠 LU3186PT537X,47800,43980,-3820
2018-06-01,1743159048,E061020,섬유유연제,라벤다 베이비전용 섬유유연제 bottle 아기 세탁 유아,21730,21300,-430
2018-06-01,558470088,C012040,여자학생복,하얀비3000원쿠폰/조끼/레이스쉬폰나시/반팔블라우스,13800,10800,-3000
2018-06-01,952082458,A019080,고추장,㉭ 사조해표 태양초고추장(14KG),23480,23480,0
2018-06-01,1712772324,L012060,샴푸,팬틴 샴푸 린스 트리트먼트 극손상 기능성 비듬 샴푸,4000,4000,0
2018-06-01,1117290054,E011030,거실장,은목 삼나무원목 하이 1200 거실장 원목거실장,160000,160000,0
2018-06-01,1117290055,E011030,거실장,자연둥이 삼나무 1500 원목거실장/tv다이/티비다이/tv대/tv장식장,199000,199000,0
2018-06-01,1117290056,E011030,거실장,자연둥이 삼나무 1200 원목거실장/tv다이/티비다이/tv대/tv장식장,167000,167000,0
2018-06-01,1117290057,E011030,거실장,자연둥이 삼나무 600 원목거실장/tv다이/티비다이/tv장식장/협탁,84000,84000,0
2018-06-01,1117290050,E011030,거실장,은목 삼나무원목 로우 1200 거실장 원목거실장,133000,133000,0
2018-06-01,1117290051,E011030,거실장,은목 삼나무원목 하이 1200 거실장+2단협탁 원목거실장,268000,268000,0
2018-06-01,1117290052,E011030,거실장,은목 삼나무원목 하이 1800 거실장세트 tv거실장,249000,249000,0
2018-06-01,1117290053,E011030,거실장,은목 삼나무원목 하이 600 거실장 보조장 협탁,100000,100000,0
2018-06-01,938093279,A016020,배,자연농부 달콤시원 나주배 선물세트 9호 15kg(25과내),122430,118760,-3670
2018-06-01,1117290058,E011030,거실장,자연둥이 삼나무 TV 높은책장/tv장식장/5단책장/거실책장/원목책장,138000,138000,0
2018-06-01,344522963,A019050,간장,마산 몽고진간장13L 몽고간장 간장 마산몽고간장 진간,44260,39400,-4860
2018-06-01,2146586328,A014010,우유,서울우유 1000ml x 10팩/멸균우유,16800,16800,0
2018-06-01,895714832,A019070,양념소스,CJ 다담 청국장 찌개양념 (130G),1590,1590,0
2018-06-01,30845161,E061020,섬유유연제,1+1/샹떼클레어 섬유유연제 화이트머스크 3000ml/무배,19800,19800,0
2018-06-01,1225757919,C013010,점퍼,남성 롱가디건 롱자켓 롱점퍼 봄가디건 후드가디건 숄,67500,67500,0
2018-06-01,1116411029,C012060,여자내의,[이사베이]허리 밴딩 투턱 와이드 팬츠 (VQPAE6228)_V3G9,31000,29450,-1550
2018-06-01,670233846,A011080,밀가루,면마루 즉석쌀국수 24개/36개 친환경펄프용기 멸치맛,30800,30800,0
2018-06-01,582677577,E021020,커튼,유니크한 멋이 있는 100%면 디자인 커튼 창 거실 안방,20000,18220,-1780
2018-06-01,1485813228,C013020,티셔츠,수술v넥쉬폰티/브이넥티/쉬폰블라우스/오피스블라우스,9900,9900,0
2018-06-01,1607787627,A011010,쌀,집밥10kg(1kgx10봉)혼합곡 혼합쌀 쌀/쌀눈쌀(5kgx2),21900,21900,0
2018-06-01,973518846,C012030,여자상의,노옵션 한정판매/원피스 모음/44-110/빅사이즈/플라워,9800,9800,0
2018-06-01,1705063048,I031010,장난감,레고 미니피규어 블럭판 조립판 테이블 레고판 밑판,1500,1300,-200
2018-06-01,85487243,A018080,설탕,비정제설탕/원당(지대)15kg/매실 천연당 과일청,21900,21900,0
2018-06-01,348745416,E011060,의자,사무 용 의자 모음 컴퓨터 책상 회의 실 학생 업소,15300,15300,0
2018-06-01,812915002,F012010,종이기저귀,LG 토디앙 자운보 순 밴드기저귀 3팩,31900,31900,0
2018-06-01,464673811,E031110,청소기,LG 슈퍼 싸이킹3 주니어 K73SG (샤이니 실버),190100,174900,-15200
2018-06-01,605370929,C012060,여자내의,피핀 메이 뒷밴딩 린넨와이드팬츠 #72962/ 피핀,22900,18100,-4800
2018-06-01,1447887042,A019180,즉석식품,코리원/심플로트 감자튀김 2kg/감자/간식/냉동감자,3300,3200,-100
2018-06-01,1343762091,E011050,책상,내맘대로 서랍형 좌식책상/ 컴퓨터책상/공장직판/책상,12900,12900,0
2018-06-01,16858588,A016100,수박,[명가일품][진용식농가의] 고흥 무농약 매실 (대) 10kg,26900,26900,0
2018-06-01,545567128,C013010,점퍼,[흄]남녀공용 롱 덕다운 후드 베스트(H174H260),89000,77430,-11570
2018-06-01,1789294629,C011050,남자내의,[폴햄] 남성 슬림핏 브러쉬 데님 팬츠(PHY1DP1032),29900,24820,-5080
2018-06-01,409133325,C013010,점퍼,가죽점퍼 레쟈점퍼 라이더자켓 PU14 WS 남성점퍼 남성,145020,145020,0
2018-06-01,420091618,F012020,생리대,뉴 템포 레귤러/슈퍼/100P~사은품증정,29900,29900,0
2018-06-01,529500635,C012060,여자내의,스판 그레이 교복치마 교복 예쁜교복 교복쇼핑몰 중학,37070,35960,-1110
2018-06-01,753683083,C013020,티셔츠,빅사이즈민짱/무료배송/넘나예쁜 후드모음/맨투맨,19900,19900,0
2018-06-01,79457508,L021050,우산,초특가 고급 투명 비닐우산 / 파스텔 장우산 비닐우산 / 땡땡이 투명우산 /개업선물,1450,1450,0
2018-06-01,505152457,C013040,청바지,[메이드]일자청바지/데님/워싱/슬림/밴딩/남자/남성,12800,12800,0
2018-06-01,2125906170,C012020,원피스,[에고이스트][정상가:398 000] 시크 슬림 코트 EH4WC961,199000,155220,-43780
2018-06-01,1320616492,L012010,면도기,어린이 양치세트/어린이날/양치컵/단체/선물/어린이집,2200,2200,0
2018-06-01,743476631,C013010,점퍼,남녀공용야구잠바/야구점퍼/오버핏야구잠바/검정점퍼,97600,97600,0
2018-06-01,312819318,C013020,티셔츠,쿨론 나시티 냉감 기능성 런닝 티셔츠 운동복 헬스복,10800,10800,0
2018-06-01,1117290080,E011030,거실장,매직 확장형 비디오 거실장/tv거실장/tv장식장,278000,278000,0
2018-06-01,1117290081,E011030,거실장,매직 확장형 거실장/tv거실장/tv장식장,278000,278000,0
2018-06-01,2055782585,A015020,식용유,오뚜기 카놀라유 900ml x 3개 포도씨유 식용유 참기름,9900,9900,0
2018-06-01,1117290082,E011030,거실장,파란나무 아담 600 높은 거실장협탁/TV거실장/tv장식장/tv대/거실장,34000,34000,0
2018-06-01,1183829703,L012060,샴푸,려샴푸 자양윤모 샴푸 400ml 3개/민감성 중건성,13900,13900,0
2018-06-01,1989172481,F012020,생리대,좋은느낌 울트라 날개 오버나이트 14px5팩/좋은느낌오버나이트/좋은느낌울트라날개오버,27900,27900,0
2018-06-01,253284606,L021030,가방,[러브캣](샤르망)숄더백 (LISHS212IVLC01)(영등포점B),367200,331260,-35940
2018-06-01,1117290087,E011030,거실장,(수도권 무료배송)자연둥이 편백나무 원목 1500 TV거실장/tv장식장,738000,738000,0
2018-06-01,1235239625,C011020,남자상의,MJ_1137 보카시 더블트렌치 남성자켓 남성코트 하프트,216140,216140,0
2018-06-01,1117290083,E011030,거실장,파란나무 아담 1200 높은 TV거실장/tv장식장/tv대/거실장,62000,62000,0
2018-06-01,1117290084,E011030,거실장,파란나무 아담 800 TV대/TV거실장/tv장식장,29000,29000,0
2018-06-01,1117290085,E011030,거실장,파란나무 아담 1200 tv대/TV거실장/tv장식장,43000,43000,0
2018-06-01,1117290086,E011030,거실장,(수도권 무료배송)자연둥이 편백나무 원목 600 tv대/거실장협탁/침대협탁/TV거실장,338000,338000,0
2018-06-01,1254304438,L021030,가방,[타거스 정품] TSB705AP 16인치 Legend IQ Backpack,52000,51000,-1000
2018-06-01,361468338,I031040,생화,MSR 스테이크 해머 비박 텐트망치 백패킹 케이스증정,46500,41390,-5110
2018-06-01,1153848468,C012060,여자내의,[더미니][1color]임부-에어핏 7부팬츠임부바지,20240,19440,-800
2018-06-01,723834379,A012030,돼지고기,(고기천국)쫄깃고소한 삼겹살500g+500g/목살/1+1행사,9900,9900,0
2018-06-01,502951026,L021010,손목시계,BELCARINO 유로스타일 깔끔한 패션시계 MV2097028W 선,75390,75390,0
2018-06-01,1778593519,L021010,손목시계,[바보사랑]Gc Structura 남성시계(가죽)_Y23009G4,478000,478000,0
2018-06-01,1743884237,A022010,주스,(맛나)망고.180ml*12병/델몬트,17400,15660,-1740
2018-06-01,1296404488,A012030,돼지고기,두레생협 돼지양념편육(300g),21000,20370,-630
2018-06-01,1037791994,E031020,가스레인지,린나이 RT-1004J 가스렌지 2구,119800,113620,-6180
2018-06-01,346735559,C012060,여자내의,[미센스]링포인트 포켓 스커트_M75SKM207Z,21600,18360,-3240
2018-06-01,389283715,A017250,고사리,냉동브로컬리1kg/재호,3120,3120,0
2018-06-01,1179205971,E031130,보온매트,[베스타] 데스크히터 발히터 난방 온열 히터 사무실,89800,89800,0
2018-06-01,766113290,A019060,된장,해찬들 그대로 끓여먹는 된장찌개(180G),1980,1980,0
2018-06-01,247129044,C012060,여자내의,레턴즈 후드 멜빵 청반바지 SD-4086 청반바지 멜빵바지 청바지 멜빵청바지 스키니진,25360,22580,-2780
2018-06-01,1451126151,A021020,차,이태리 페르니고띠 요거트 파우더 1kg(1세트 6개)/파,99000,99000,0
2018-06-01,1318991220,C012060,여자내의,미시옷 롱치마레깅스-SK_WW_1708 빅사이즈 여성의류,34200,34200,0
2018-06-01,282700070,A018010,초콜릿,허쉬/롯데/해태/초코렛40종/가나초콜릿/크런키자유시간미니어처ABC드림카카오초코바발,2690,2690,0
2018-06-01,341623509,C012060,여자내의,3버튼 스판포켓 기모팬츠 여성 밴드 팬츠,19510,19510,0
2018-06-01,1822362233,I012010,컴퓨터,초특가 최강가성비 Win7/Win10 삼성 LG 듀얼 쿼드,174000,124000,-50000
2018-06-01,394485651,F011150,건강기능식품,종근당 락토핏 코어 유산균 60포 x 5통,107000,107000,0
2018-06-01,404430387,C011030,남자학생복,탈부착후드집업 SM1711 컬러집업후드 면후드집업 후드,58320,58320,0
2018-06-01,1019517402,C013020,티셔츠,[크루클린] 오버핏 후드티/레이어드/기모/맨투맨,19800,13800,-6000
2018-06-01,1058841446,E061060,살충제,1+1바퀴벌레약 페스트세븐겔40g+맥스포스셀렉트겔30g,26000,23900,-2100
2018-06-01,1315211818,E031040,전기레인지,헨켈 퍼실 파워젤 드럼용 용기 2.7L 1개 (SH-1004),25440,25440,0
2018-06-01,752060814,A014020,분유,[일동후디스]프리미엄 산양분유 1단계 800g 3캔,120000,120000,0
2018-06-01,1964900608,L021050,우산,마블 어벤저스 스타워즈 미키 키티 캐릭터 아동 우산,8000,8000,0
2018-06-01,80436511,L012040,치약,아이스민트치약 100gx10개+레귤러 칫솔 1개,11900,11900,0
2018-06-01,1265740555,C011030,남자학생복,남성블랙니트(131-81-19-903)/ 디젤(진),149000,134100,-14900
2018-06-01,1005787713,C021020,구두,VA-130 남성 워킹화 등산화 효도신발 스니커즈 캐주얼,67740,67740,0
2018-06-01,1817282546,A021010,커피,카누 미니 150T 다크/마일드로스트/블랙커피,18900,18900,0
2018-06-01,94528948,A022020,두유,삼육두유 검은콩 칼슘 두유 195ml X 40팩,19900,19900,0
2018-06-01,2033513075,A018050,비스킷,[테일러] 말린 통크랜베리 130g,4000,3600,-400
2018-06-01,1407582603,C021040,실내화,[리복(Reebok)]남 여FITNESS & TRAINING EEBOK TRAINFUSION NINE 3.0 리복 트레인퓨전,45000,37980,-7020
2018-06-01,1352054257,C012060,여자내의,[모다아울렛][발렌시아]하이웨스트 스커트(V6AMS51),59200,52690,-6510
2018-06-01,272326614,C013020,티셔츠,[쿠비코][쿠비코]슬림핏 골지폴라티 MGB083,17800,14240,-3560
2018-06-01,822629436,A019080,고추장,진미 청양초 매실고추장(2KG),6900,6900,0
2018-06-01,318520268,A019170,냉동식품,소문난 수제 호떡쌀군만두 1.2kg+1.2kg (총 2.4kg),20000,15900,-4100
2018-06-01,2029760698,A011160,빵,츄러스+계피설탕/추러스 스타츄 고구마 초코 종이봉투,11900,11900,0
2018-06-01,1285742067,A017300,미역,[특가]재래도시락김16봉x4개 총64봉/광천김/대천김,15500,15500,0
2018-06-01,1092954825,C015030,넥타이,검정넥타이 조문용넥타이 검은넥타이 자동넥타이,1490,1490,0
2018-06-01,2029769042,E031120,믹서,아로나 후드믹서/양념분쇄기/야채마늘커터다지기 미니,51900,49310,-2590
2018-06-01,1778593521,L021010,손목시계,[바보사랑]Gc CableForce 남성시계(가죽)_Y24001G7,488000,488000,0
2018-06-01,989016496,L012010,면도기,질레트 퓨전 프로쉴드 옐로우면도기,19900,14900,-5000
2018-06-01,1778593522,L021010,손목시계,[바보사랑]Gc CableForce 남성시계(실리콘)_Y24006G7,498000,498000,0
2018-06-01,989016497,L012010,면도기,질레트퓨전프로쉴드칠면도기2UP,19900,14900,-5000
2018-06-01,1959622068,C012020,원피스,여성정장 투피스 자켓 치마 바지 유니폼 오피스4,90000,90000,0
2018-06-01,1778593523,L021010,손목시계,[바보사랑]Gc Structura 여성시계(메탈)_Y29001L1,398000,398000,0
2018-06-01,1778593524,L021010,손목시계,[바보사랑]Gc PureChic 여성시계(메탈)_Y31001L7,298000,298000,0
2018-06-01,1368638534,A011040,보리쌀,백태 2kg/대두/국내산/콩국수콩/두유콩/두부,12900,12900,0
2018-06-01,92663023,C011030,남자학생복,가볍게 걸치는 가디건/간절기점퍼/후리스 모든 소화,17700,17700,0
2018-06-01,1159620210,E061010,세탁세제,에이노멀 노멀 홈케어 스프레이,19900,19900,0
2018-06-01,1778593520,L021010,손목시계,[바보사랑]Gc Structura 남성시계(가죽)_Y23012G2,478000,478000,0
2018-06-01,866152732,A019080,고추장,빅마마의 만능 매운장,8500,8500,0
2018-06-01,330383651,E031110,청소기,한경희생활과학 SC-2000WT 스팀청소기/1.7kg 울트라라이트/초경량/스틱형/예열센서/살,69000,58850,-10150
2018-06-01,866152733,A019060,된장,빅마마 이혜정의 프리미엄 된장,10500,10500,0
2018-06-01,2045998496,C013050,운동복,보이즈 NK 드라이 스쿼드 팬츠 KP(859297011) 남자아,84680,82990,-1690
2018-06-01,1311942846,C013040,청바지,뱅뱅(BANGBANG) 여성 스트레치 팬츠 4종(여),39900,36710,-3190
2018-06-01,984459459,A021010,커피,칸타타 콜롬비아 수프레모 (226G),12000,12000,0
2018-06-01,866365030,L012030,칫솔,민들레종/360도칫솔/3P/유아칫솔/어린이칫솔/미세모,16800,15960,-840
2018-06-01,667004688,C012060,여자내의,[PL_홈쇼핑][페리젠슨]코튼혼방 베이지 플리츠 스트레치 팬츠.SPD10115,4400,4180,-220
2018-06-01,1124443498,A013010,갈치,제주 은갈치(대) 8마리(1마리당350g내외 선물포장) 싱,220100,213500,-6600
2018-06-01,1452489437,A022010,주스,보해 매원 디럭스 1.5L /매실원액,6600,6600,0
2018-06-01,2142060237,E031020,가스레인지,[SK매직] 동양매직 빌트인 스팀 복합오븐 EON-B401SM 컨벡션,1197200,1197200,0
2018-06-01,960271867,A014050,달걀,CJ 건강한계란 (25입/대란),7770,6990,-780
2018-06-01,1851297271,C011030,남자학생복,남자셔츠/기본남방/스트라이프체크남방/청남방/헨리넥,13900,13900,0
2018-06-01,2076303883,C021040,실내화,LF공식수입원 버켄스탁 취리히 여성슬리퍼 8E151W3 모카,102590,102590,0
2018-06-01,1265206324,C013040,청바지,[밀라] MILLA 썸머쿨데님 3종,58000,58000,0
2018-06-01,1778593525,L021010,손목시계,[바보사랑]Gc PureChic 여성시계(메탈)_Y31002L1,358000,358000,0
2018-06-01,282435683,C011030,남자학생복,일반 화이트 기본셔츠 하얀색와이셔츠 흰색와이셔츠,11690,11690,0
2018-06-01,1778593526,L021010,손목시계,[바보사랑]Gc PureChic 여성시계(메탈)_Y31003L1,328000,328000,0
2018-06-01,2123105792,A017090,열무,[익산원예농협] 붉은속살 뿌리채소  비트 5kg,26900,25990,-910
2018-06-01,2049774181,L012010,면도기,도루코 3중날 대용량 3종택1 터치쓰리100개 TOUCH3,28000,28000,0
2018-06-01,1778593527,L021020,장신구,[바보사랑]scenuerdo 향수팔찌 white edition,42000,42000,0
2018-06-01,1632957870,C012040,여자학생복,밑단 인타 니트(EKPOHE07)/ 케네스 레이디,32000,28800,-3200
2018-06-01,1778593550,L021020,장신구,[바보사랑]scenuerdo 향수팔찌 light silver edition,42000,42000,0
2018-06-01,2051729943,C013040,청바지,가성비 좋은 진우드 청바지 스판 신상 남성 청바지,14800,14800,0
2018-06-01,1827873254,F011150,건강기능식품,[1+1]울트라플로라 프로바이오틱스 2병/여에스더프로,55590,55590,0
2018-06-01,1123468323,L021020,장신구,순은이니셜반지 실버커플링/백일우정반지/생일선물,18800,18800,0
2018-06-01,1303224521,C013030,스웨터,목폴라 RTR 테이프 폴라남자 폴라니트 목폴라목폴라폴,54700,54700,0
2018-06-01,2066118754,C013050,운동복,K-345 스타렉스 2004후사경 차량용후사경 후사경 자동,25470,23210,-2260
2018-06-01,243344990,C013020,티셔츠,[테이트](남) 스트라이프 카라 티셔츠 KA8U4-MKS200[갤러리아],49900,38430,-11470
2018-06-01,2144576420,C012030,여자상의,나토스트랩데님ops/데님스커트/청치마/뷔스티에...,9900,9900,0
2018-06-01,2125111276,A013070,굴,다인 붉은대게살/파지 홍게살/3단 파지살/홍게다리살,18500,18500,0
2018-06-01,191920018,E031130,보온매트,주식회사 한일의료기 병원용매트 병원매트 전기매트 병원침대 접이식침대 간이침대 전,89000,86000,-3000
2018-06-01,319508474,E031030,전자레인지,[LG전자] LG전자 MW22CD 전자레인지 22L LG공식인증(주)대명,119900,119900,0
2018-06-01,906537542,C012060,여자내의,로엠 린넨 랩스커트 RMWH737RQA.,29950,28460,-1490
2018-06-01,1908603179,C021040,실내화,핏플랍正品 여성화 티아샌들프린지 2색 택1 8E116 BK P4,146870,146870,0
2018-06-01,1089760040,E031130,보온매트,한일의료기 황토매트/슈퍼싱글/1인용,64800,64800,0
2018-06-01,1543872822,A019010,고춧가루,전남영광 태양초 고춧가루 양념용 보통맛 500g(한근),16900,16900,0
2018-06-01,866152756,A019080,고추장,빅마마 이혜정의 프리미엄 고추장,10500,10500,0
2018-06-01,866152757,A019060,된장,빅마마의 만능 된장,8500,8500,0
2018-06-01,866152758,A019080,고추장,빅마마 이혜정의 프리미엄 장류 선물세트,28000,28000,0
2018-06-01,866152759,A019080,고추장,빅마마의 만능장 세트(매운장 된장 간장),22000,22000,0
2018-06-01,1011061743,A018070,파이,타타와 초콜릿쿠키 70G,1500,990,-510
2018-06-01,598659480,C012030,여자상의,11900원부터~원피스모음/캐주얼/플라워/롱원피스/조끼,22800,22800,0
2018-06-01,2050848044,E061030,전구,두영조명 20W 삼파장 전구 장수 램프 11W 15W 형광등,1400,1400,0
2018-06-01,99628304,A012050,소시지,[아임닭] 간편 꼬치형 닭가슴살 소시지 70g 20+2 특가,32500,32500,0
2018-06-01,432511382,A019030,생강,하지카미 (생강순 605g),33930,30200,-3730
2018-06-01,1426732980,C013020,티셔츠,[까멜리아] 토킹나염레터링반팔티셔츠,16500,16500,0
2018-06-01,389978163,A012040,닭고기,발효 훈제닭가슴살3kg/5kg 닭가슴살훈제단백질식품,27000,27000,0
2018-06-01,1805838646,C013050,운동복,세이코 EE-7 1mm 초슬림 실리콘 논슬립 패드,5900,5800,-100
2018-06-01,1121446448,E031070,에어컨,[한일] 한일선풍기 16인치 벽걸이선풍기 FW-602,45000,42750,-2250
2018-06-01,750639478,C013010,점퍼,주니어패딩점퍼 주니어야상점퍼 남아겨울옷 남아패딩,28500,26800,-1700
2018-06-01,1117290021,E011030,거실장,파란나무 2칸서랍 1200 거실장 서랍장 거실장 TV장,79000,79000,0
2018-06-01,1117290022,E011030,거실장,파란나무1칸서랍 1200 거실장 서랍장 거실장 TV장,70000,70000,0
2018-06-01,309686322,C013010,점퍼,초경량 바람막이/여름용 윈드자켓/등산점퍼 아웃도어,17800,15800,-2000
2018-06-01,1117290023,E011030,거실장,파란나무 2서랍 800 거실장 서랍장 거실장 TV장,62000,62000,0
2018-06-01,623819217,I011020,영상음향기기,LG미니빔TV HF85JA 스마트빔 프로젝터 사은품 증정,1989470,1890000,-99470
2018-06-01,1117290024,E011030,거실장,파란나무 1서랍 400 협탁 서랍장 거실장,45000,45000,0
2018-06-01,443716497,C013030,스웨터,BIGWM-WN 0730 (남) 빅사이즈투톤지퍼긴팔니트자켓(-3,76530,76530,0
2018-06-01,1453271406,A013090,전복,[유진수산] 참소라 / 청정 자연산 참소라살  조개  죽,18000,17820,-180
2018-06-01,1117290020,E011030,거실장,럭셔리 SM 하이그로시 1500 TV거실장 고광택거실장,138000,138000,0
2018-06-01,1117290026,E011030,거실장,자연둥이 멀바우 철다리 600 TV거실장 멀바우거실장,84000,84000,0
2018-06-01,1759612420,C013010,점퍼,아디다스 여성 ZNE 2 후드집업 자켓 점퍼 스포츠,119800,119800,0
2018-06-01,1117290027,E011030,거실장,자연둥이 멀바우 철다리 1200 TV거실장 멀바우거실장,142000,142000,0
2018-06-01,1387705962,C011030,남자학생복,AGC빅사이즈 바투스 청남방 BW청남방데님남방청카바청,73840,73840,0
2018-06-01,1753067982,C021020,구두,FERRAGAMO 플랫슈즈 VARINASTRI 0654170 NERO,545000,545000,0
2018-06-01,1120425665,F011150,건강기능식품,[KS] 참이맛 콩가루 5봉,20300,20300,0
2018-06-01,2063846494,E021010,침구,겨울왕국 면기모 패드 - 뷰티선샤인 (064187) 패드 까,64090,58380,-5710
2018-06-01,1296428498,G011070,자전거,시애틀모던D 하이브리드21단 하이림적용 삼천리자전거,149000,149000,0
2018-06-01,589993191,C013010,점퍼,(도도한걸)야상점퍼/바람막이/집업/후드자켓/정장,14900,14900,0
2018-06-01,1520099397,L021030,가방,러블리 여성백팩 여성가방 학생 여자 미니백팩,17800,17800,0
2018-06-01,1096984647,A012030,돼지고기,(두메촌) 국내산 한돈 냉장 돼지 목살 500g / 생목살,9500,9500,0
2018-06-01,1138449013,C011050,남자내의,테이트 남성 사이즈 밴딩 시원시원 반바지 KA7U4-MPH710,14000,11340,-2660
2018-06-01,1621668969,C012020,원피스,SJSJ 모직 코트/여성 S/하프/자켓/세일/중고/구제,35000,35000,0
2018-06-01,387934057,A017170,풋고추,오이 10kg/무료배송,16900,16900,0
2018-06-01,1936312908,I031040,생화,캠핑장비 캠핑 카즈미 NEW 필드야전삽 L,22050,20090,-1960
2018-06-01,2124692135,L012030,칫솔,마시마로 칫솔 20개 /어린이 /금 /은 / 숯 / 미세모 /,11500,11500,0
2018-06-01,1115416702,A019070,양념소스,진조미식품 매운탕양념 60g 매운탕 생선찌개,300,300,0
2018-06-01,1830668201,A019130,스프,[무배] 보노스프 5종류10각 즉석콘스프 식사대용 간식,27800,27800,0
2018-06-01,1510289130,A022050,탄산음료,스프라이트500/스프라이트1.5/스프라이트355 업소용,14800,14800,0
2018-06-01,1974577780,E031010,전기밥솥,쿠쿠 고무 패킹 [DH10] CRP-P1010FD 밥솥교체용,7990,7990,0
2018-06-01,1970171315,C014010,아동복,[에어워크주니어]에어워크 주니어 PNC02 트레이닝 세트 w182b5225b19,59900,57510,-2390
2018-06-01,1011061773,E041040,프라이팬,라체나블랙펄세라믹쿡웨어3종SET,29900,29900,0
2018-06-01,446603865,E061040,부엌용세제,자연퐁 주방세제 리필 1.4kg x 3개 외,9900,9900,0
2018-06-01,1579229456,C013010,점퍼,아디다스 롱 다운 파카 ( M64172 ),183580,163390,-20190
2018-06-01,2053591143,C013020,티셔츠,T1934-전사나염 넥프릴 오버핏 티셔츠 셔링티셔츠 반,44500,42280,-2220
2018-06-01,1379154122,A016120,바나나,[무배] 정품 Dole 바나나 / 부드럽고 달콤한 맛이일품,19900,19500,-400
2018-06-01,707519047,A019160,밑반찬,[거시기장터]무항생제 친환경 오리훈제200g*5/200g*8,18900,18900,0
2018-06-01,866152730,A019060,된장,빅마마의 만능 된장,24500,24500,0
2018-06-01,866152731,A019080,고추장,빅마마의 만능 매운장,24500,24500,0
2018-06-01,1002876342,I031040,생화,LED 줌라이트/후레쉬/손전등/헤드 랜턴/휴대용/전조등,2500,2300,-200
2018-06-01,2091242930,A017170,풋고추,동서 리치스 피클 슬라이스 오이피클 3kg,11000,10890,-110
2018-06-01,325105507,E011060,의자,인기 초인백V101 컴퓨터 학생 책상 기능성 의자,67000,65000,-2000
2018-06-01,176332537,C012020,원피스,[브룬스바자][BRUUNS BAZAAR] 브룬스바자 타임리스 린넨 블렌디드 수트 3PCS,99000,99000,0
2018-06-01,1339316699,F012050,의료측정기,브라운 체온계 IRT-6520/6510/6030+필터21개/귀체온계,72500,72500,0
2018-06-01,774214168,A017180,호박,(맛나)#청양고추(특)10kg,142600,128340,-14260
2018-06-01,517256011,C013040,청바지,[보리보리/클랜씨]클랜씨 히꼬리 데님바지 C744S230-NY,17550,12290,-5260
2018-06-01,1280808467,C012060,여자내의,여름 청치마 데님 스커트 롱 단추 플레어 A라인 린넨,20000,19800,-200
2018-06-01,716103641,F011150,건강기능식품,[BYO] CJ(냉장) BYO 피부유산균 2.5g 30포 X 3박스(90일분),53600,53600,0
2018-06-01,191271872,F012050,의료측정기,브라운 체온계 IRT-6520| IRT-6510| IRT-6030,75260,70000,-5260
2018-06-01,1740114065,I031040,생화,[무배]편안한 나무바 해먹 1.2.3인용/해먹스탠드/용품,14800,14800,0
2018-06-01,850292579,C012060,여자내의,[예쎄]7부 와이드팬츠,25900,24610,-1290
2018-06-01,1988330690,A011130,시리얼,오뚜기 부침가루 500g X 20EA 튀김분말 쌀튀김분말 볶,36040,36040,0
2018-06-01,897502292,A011090,국수,[오뚜기]오뚜기 메밀비빔면 130G*5입,3390,1990,-1400
2018-06-01,897502293,A019130,스프,[오뚜기]오뚜기 옛날 사골곰탕 (350G),1350,1290,-60
2018-06-01,897502290,A011180,파스타면,[오뚜기]오뚜기 마카로니 (500g),2790,2200,-590
2018-06-01,128031915,A018030,껌,[롯데 자일리톨 츄잉껌(+보너스25g) x 3개],9900,9900,0
2018-06-01,694194252,F012020,생리대,위스퍼 슈퍼롱 오버나이트 10P,3480,3480,0
2018-06-01,313104010,E011040,소파,3인용 거실쇼파 4종/쇼파/소파/3인용쇼파/3인쇼파,259000,228910,-30090
2018-06-01,874855487,F012050,의료측정기,오토첵 혈당측정기 세트(혈당계+시험지60매),20000,20000,0
2018-06-01,1778593495,L021010,손목시계,[바보사랑]Gc LadyChic 여성시계(메탈)_Y21002L3,408000,408000,0
2018-06-01,1778593497,L021010,손목시계,[바보사랑]Gc Structura 남성시계(가죽)_Y23006G7,478000,478000,0
2018-06-01,768715883,E061080,키친타월,천연펄프 키친타올 130매 6롤X3팩(총18롤 2340매),14900,14900,0
2018-06-01,1778593491,L021010,손목시계,[바보사랑]Gc CableChic 여성시계(실리콘)_Y18006L5,298000,298000,0
2018-06-01,1778593492,L021010,손목시계,[바보사랑]Gc LadyBelle 여성시계(메탈)_Y19001L1,368000,368000,0
2018-06-01,1778593493,L021010,손목시계,[바보사랑]Gc LadyBelle 여성시계(메탈)_Y19002L1,408000,408000,0
2018-06-01,1304693164,C021040,실내화,아키클래식 정품 특가 브랜드 정품 운동화/런닝/워킹/,39800,39800,0
2018-06-01,1778593494,L021010,손목시계,[바보사랑]Gc LadyBelle 여성시계(메탈)_Y19003L1,408000,408000,0
2018-06-01,1153971827,A017280,김,(냉장)이엔 슬라이스단무지1kg 단무지 슬라이스단무지,17760,17760,0
2018-06-01,167655879,A013140,북어채,찢어 만든 손질먹태130g 먹태채 명태 먹태 황태,3990,3990,0
2018-06-01,1778593490,L021010,손목시계,[바보사랑]Gc B1-Class 여성시계(가죽)_Y17013L1,288000,288000,0
2018-06-01,2141543161,F011150,건강기능식품,컬처렐 다이제스티브 헬스 400mg x 30캡슐 x 2박스 (2개월분),69420,69420,0
2018-06-01,187934797,A019130,스프,[샘표] 폰타나수프 골라 담기/컵수프/스프,1100,1100,0
2018-06-01,465909712,I031040,생화,서빙트레이 무빙 웨곤 무빙카 운반카트,371260,307410,-63850
2018-06-01,300568701,C012040,여자학생복,[모다아울렛][지컷]블라우스 7217360018,84500,80280,-4220
2018-06-01,1649779941,F012010,종이기저귀,마미포코 쿨 썸머그린/에어핏 팬티기저귀 대형/특대형,36400,36400,0
2018-06-01,1148235257,C015030,넥타이,블랙 심플 넥타이/슬림넥타이/정장넥타이/넥타이추천/20대넥타이,6000,4800,-1200
2018-06-01,1778593488,L021010,손목시계,[바보사랑]Gc CableChic 여성시계(실리콘)_Y16004L1,348000,348000,0
2018-06-01,987287560,A022060,혼합음료,[대웅] 블루베리 (블루베리 6.5Brix 이상 70mlX30포) -3세트,105000,44900,-60100
2018-06-01,990032019,A011100,라면,[CJ직배송]백설 제일제면소 메밀소바 400g X4개,16580,16580,0
2018-06-01,1778593489,L021010,손목시계,[바보사랑]Gc CableChic 여성시계(실리콘)_Y16006L5,348000,348000,0
2018-06-01,2057672661,C013010,점퍼,[올젠] 역시즌 특가! 초경량 구스다운 하이넥점퍼 2종,59000,49560,-9440
2018-06-01,1643933625,C013010,점퍼,[포에버21]시어 스냅 버튼 자켓/FOREVER21/점퍼/블루종,43900,21950,-21950
2018-06-01,1095067219,A022010,주스,롯데 제주감귤 1.2LX12펫/주스/음료수,14500,14500,0
2018-06-01,1934642876,C012060,여자내의,빅사이즈 DSS0024R 밴딩 니트 미디 스커트 801 큰옷치,19680,19680,0
2018-06-01,1439666399,C015040,장갑,봄 여름 등산장갑 반장갑 멀티 마스크 쿨토시 단체,7800,7800,0
2018-06-01,1169659126,C013010,점퍼,빅사이즈 여성 패딩점퍼 점퍼 WC 내피 탈부착 하드자,148530,132200,-16330
2018-06-01,1678798783,A018080,설탕,비정제설탕/원당(천연당)15kg/과일청 효소 매실,14500,14500,0
2018-06-01,1067615621,A013090,전복,부경 냉동반가리비 2.1kg(210gx10),56170,56170,0
2018-06-01,2077527213,L021030,가방,늘푸른백화점 제노바 y328 남성가방 노트북서류가방,32480,32480,0
2018-06-01,493584829,C013010,점퍼,(더아이잗컬렉션) 페미닌 셔링 점퍼 CH5A0JP32/ 아이잗컬렉션,249000,236550,-12450
2018-06-01,1286381559,C013020,티셔츠,남성 여름 카라넥 반팔 티셔츠 스판티 시원한 모음전,17700,17700,0
2018-06-01,450094001,A022030,생수,빅토리아 500mlx40펫 350mlx48캔 탄산수,16900,16900,0
2018-06-01,580319546,C015040,장갑,스마트폰 터치 눈꽃 니트 여성장갑 캐주얼장갑 다용도,11840,11840,0
2018-06-01,2089203979,C014010,아동복,한국생산 야구 상하복 모자 레드(0-24개월) 800025,64130,57080,-7050
2018-06-01,1083771698,C012060,여자내의,[악녀일기]롤린스커트,44580,38340,-6240
2018-06-01,1711773790,E011070,식탁,로라 아일랜드 식탁겸 렌지대/식탁/렌지대/아일랜드,79000,79000,0
2018-06-01,1472783473,E011020,침대,온누리가구 삼나무에덴침대 더블 + 매트리스포함,499000,499000,0
2018-06-01,793789714,C012040,여자학생복,[즉할2천원]여름신상 셔츠모음 체크/롱/박시핏/오버핏,12900,12900,0
2018-06-01,1185453774,L021020,장신구,슈팅스타 나이트 퍼 이어링/ 리타모니카,36000,32400,-3600
2018-06-01,577365161,C012040,여자학생복,엄마옷 마담4060 C링여름조끼-XVE805004-,34900,28970,-5930
2018-06-01,245858578,C013010,점퍼,빅사이즈 팝을로 잠바 pan174-001 남성캐쥬얼.캐쥬얼,73430,71970,-1460
2018-06-01,386514775,C012030,여자상의,소녀 원피스 세트 0307_1993 빅사이즈,89640,84270,-5370
2018-06-01,1451415194,A013170,생선통조림,단미마트 유동골뱅이140g,2800,2800,0
2018-06-01,358036592,C013050,운동복,SM6 리무진 콘솔박스 팔걸이 쿠션 자동차쿠션 콘솔쿠,61430,55960,-5470
2018-06-01,545809381,A014020,분유,[아이배냇] NEW 순 산양분유 1단계~4단계 800g 1캔,32900,32900,0
2018-06-01,1260782489,A019030,생강,적초생강 (참존 1.2k) X10,41760,37170,-4590
2018-06-01,1981077703,C014010,아동복,[카파] KITK281JO-3종1선택 17년S/S 주니어 5부 반바지/트렁크팬츠,19000,16530,-2470
2018-06-01,918908655,E031130,보온매트,[바보사랑]스냅케이스 매트골드 맥북케이스 슬림무광 맥북5기종,11000,11000,0
2018-06-01,1348661975,C012040,여자학생복,여성 옆트임 롱 니트 티셔츠 박스 티 스웨터 캐주얼,20070,20070,0
2018-06-01,1045540344,E041050,냄비,샤브샤브냄비 경질냄비 전골냄비 업소용 오뎅탕냄비,16300,16300,0
2018-06-01,1596587611,E041070,밀폐용기,락앤락 클래식 밀폐용기 직사각 정사각 반찬통,1400,1290,-110
2018-06-01,971584649,C021040,실내화,FG천연소가죽오리지널드라이빙슈즈/모카신/빅사이즈,29500,29500,0
2018-06-01,218365347,G011070,자전거,삼천리 힙합스타 16/18 아동자전거 어린이자전거,96000,96000,0
2018-06-01,125636805,A017300,미역,지도표성경김 초특가 식탁 전장 도시락 녹차 다시마,22300,22300,0
2018-06-01,311532694,I031040,생화,지진용품/지진배낭/생존용품/생존배낭/EDC/멀티툴,2200,2200,0
2018-06-01,1047104844,C012060,여자내의,고급밍크 융털레깅스 밍크레깅스 따뜻한레깅스 레깅스 기모레깅스 융털레깅스,8260,7360,-900
2018-06-01,1036261354,F011130,홍삼,[종근당건강] 홍삼정 마일드 1세트 (2개월분),39800,39800,0
2018-06-01,747107564,A016110,딸기,세미원 냉동 딸기 1kg 2개,22560,22560,0
2018-06-01,1036261351,F011130,홍삼,[종근당건강] 어린이홍삼 1세트 (1개월분),29900,29900,0
2018-06-01,1036261352,F011130,홍삼,[종근당건강] 홍삼정100 1병 (1개월분),36900,36900,0
2018-06-01,1036261355,F011130,홍삼,[종근당건강] 홍삼녹용 프리미엄 1세트 (1개월분),17900,17900,0
2018-06-01,1638692056,E061080,키친타월,크리넥스 안심 클래식 키친타올 140매 12롤,10500,10500,0
2018-06-01,578087324,E041020,컵,BEST 예쁜 머그컵/커피잔/머그잔/쌍화차잔/홍차잔,9000,8900,-100
2018-06-01,701641486,A016100,수박,맛있는 꿀수박 4~7kg / 1+1 / 착한가격,12900,12900,0
2018-06-01,57250124,C013020,티셔츠,안녕조이 WS - 마블티,15300,15300,0
2018-06-01,901930291,C013050,운동복,SM5 PCD114.3 5홀 66.1 허브스페이스/2개한세트,74900,74900,0
2018-06-01,1177570958,A016120,바나나,[홈플러스][행사상품]바나나 필리핀 _송이,4500,4280,-220
2018-06-01,481823698,C013040,청바지,여성스키니진 반하이웨스트 기모청바지 밴딩팬츠,15900,15900,0
2018-06-01,1636938660,L021030,가방,여성가방 숄더백 쇼퍼백 핸드백 빅백 여자가방 큰가방,10000,9900,-100
2018-06-01,1520895282,C011020,남자상의,남자 여름 마자켓 리넨자켓 AC보카시7부자켓,52800,52800,0
2018-06-01,1411311156,C011030,남자학생복,30%쿠폰할인/남자셔츠코디/티셔츠/헨리넥남방/슬랙스,9800,9800,0
2018-06-01,2143288030,E041020,컵,오슬로 카페 머그컵 10종/커피잔/머그잔/텀블러/물컵,2400,2300,-100
2018-06-01,1217509683,E041070,밀폐용기,락앤락 이유식 용기세트/ 햇쌀밥용기 계란찜기 반찬통,9900,7900,-2000
2018-06-01,2141075287,E061020,섬유유연제,샤프란 아로마시트 섬유유연제 50매 3개/테크/시트형,11700,11700,0
2018-06-01,650879009,C012020,원피스,브로치장식 심플자켓 Z181MSF002/ 쥬크,209400,167520,-41880
2018-06-01,1395275727,C013030,스웨터,AGCMRO 부클사 폴라 니트 세터 넥니트 남성니트폴라티,61380,61380,0
2018-06-01,1760833683,L021020,장신구,쥬골드/14k 피어싱 9900원~귀걸이 진주 링귀걸이 귀찌,10000,9900,-100
2018-06-01,2021915698,A013140,북어채,북어머리 500g 1kg/ 명태껍질 300g/ 북어대가리 껍질,11900,10900,-1000
2018-06-01,1900614376,E031130,보온매트,#TV홈쇼핑정품#뉴 조선황실 숨쉬는 황토보료 (수퍼싱글)황토매트/참숯/카펫트매트/전기,128000,126720,-1280
2018-06-01,570475920,C013050,운동복,AXEMEN 소프트 접이식 루프백 - 스포츠 레저 낚시 여,102980,84330,-18650
2018-06-01,2002521106,C012030,여자상의,요시아나/안개꽃데님 SET/블라우스 스커트 투피스세트,28900,28900,0
2018-06-01,187919116,C011050,남자내의,봄 카고바지 작업복 등산바지 등산티 남성 남자,9900,9900,0
2018-06-01,1356300417,C011020,남자상의,남자아우터 클래식 체크 코트 D0217008 / 참고 남자아,236700,201200,-35500
2018-06-01,1314275924,C013030,스웨터,밀란시아 꽈배기 폴라티셔츠 is171-003 남성캐쥬얼 캐,42400,41560,-840
2018-06-01,600507589,I053040,기타문구,메모지 8종/떡메모지/메모패드/미니 편지지,1600,1600,0
2018-06-01,467787379,I011020,영상음향기기,비비텍 D55BA D55E DS262 DX263 인기 빔프로젝터,400000,344000,-56000
2018-06-01,308518080,A013170,생선통조림,유동 번데기캔 280g X 24EA_1BOX 캔통조림 간식번데기,50880,50880,0
2018-06-01,70183921,A021010,커피,프렌치카페 커피믹스 300T 무료배송 커피믹스 라떼,28510,26800,-1710
2018-06-01,1122504402,C012060,여자내의,피핀 로즈미 투버튼 팬츠 #73666/ 피핀,19500,15410,-4090
2018-06-01,1048960978,C012030,여자상의,V넥 언발롱 조끼 원피스 KD 여성조끼,54660,53570,-1090
2018-06-01,285358530,C014020,유아복,도트골지 레깅스 유아레깅스 유아레깅스 유아바지 아,6850,6650,-200
2018-06-01,1200651968,C011050,남자내의,아스토레 와이드 디렉션 팬츠(GRY)-기모,65960,58710,-7250
2018-06-01,1723517605,A017050,미나리,무농약 적양배추(적채) 5kg 친환경농산물(친환경인증),30500,30500,0
2018-06-01,468316822,C013020,티셔츠,딱하루▶무료배송◀국내생산 골지나시티▶나시 티셔츠/나시티/반팔티/롱나시/면티/런닝,3900,3900,0
2018-06-01,987287593,A011060,땅콩,[우리마을]잡곡 5종세트(찰흑미 찰보리쌀 현미찹쌀 찹쌀 혼합8곡),34000,21900,-12100
2018-06-01,1309480475,C013050,운동복,아디다스 여성 아디제로 트랙자켓(CE0330) 여성자켓,139780,139780,0
2018-06-01,1220712280,E011050,책상,/1번가단독특가/모던라인책상/1인용책상/2인용책상/책상의자/테이블/의자/책상/컴퓨터,79010,79010,0
2018-06-01,987106864,A014050,달걀,초이스L 깐메추리알 1KG,6990,6990,0
2018-06-01,1112277841,A013100,마른멸치,[순천만수산] 완도 전복 1kg 13-15미 선물포장 선택,29900,29900,0
2018-06-01,1831584181,A019140,이유식,[아이배냇] 베베 햅쌀 이유식(7종택1),2240,2240,0
2018-06-01,1265713031,A019180,즉석식품,[산과들에] 냉동)볶음밥6종세트x1,13900,13900,0
2018-06-01,638286330,C012060,여자내의,아디다스 여성 스테디움 팬츠 (S97134 ),85240,75870,-9370
2018-06-01,244749485,C013010,점퍼,AGC빅사이즈 폴라폴리스 자켓 MC 1200 빅자켓 빅사이,80630,80630,0
2018-06-01,252670295,C012040,여자학생복,심플라운드5부니트 (J11PNT183)/ 매그제이(MAGJAY),13900,12510,-1390
2018-06-01,441094923,C012020,원피스,엄마옷 마담4060 체크패턴트임롱자켓-XJK805020-,54900,46540,-8360
2018-06-01,1297258409,C013030,스웨터,MNT-906 배색 스트라이프 니트 라운드니트 니트티 남,16780,16780,0
2018-06-01,898660297,A019080,고추장,해찬들 태양초고추장골드 500G,8650,8650,0
2018-06-01,449793895,C014020,유아복,아동바지 매화 미니쥬리 팬츠 KIDBOK-26 아동바지 바,10980,10980,0
2018-06-01,2020556829,A016160,과일가공품,푸드야 냉동 블루베리 3kg (1kgx3봉),16900,16900,0
2018-06-01,1164789964,E011050,책상,무인도접이식테이블/컴퓨터/사무용/회의용/책상/탁자,65000,64000,-1000
2018-06-01,903286065,A022030,생수,롯데칠성몰 생수 아이시스8.0/산림수/백두산하늘샘,7900,7900,0
2018-06-01,898513328,A017300,미역,동원 들기름김 (20봉),8990,8990,0
2018-06-01,1324081378,E021020,커튼,에쿠스 암막 콤비블라인드 중형 1 플러스 1 암막커튼,131260,127330,-3930
2018-06-01,1184588911,C013040,청바지,[루미씨] 마법 9부 쿨링 중청 데님 ver.181,24000,21870,-2130
2018-06-01,2112575985,I031070,애완동물관리비,2018 퓨어드라이브 110 (255g) 16x19 테니스라켓 바볼,211250,181360,-29890
2018-06-01,999575913,F012030,안경,안경테/학생안경/남녀안경/멋내기용안경,9000,9000,0
2018-06-01,1903623630,F011130,홍삼,한삼인 뽀로로 아이홍삼(20ML*30입),31490,31490,0
2018-06-01,828031244,E031040,전기레인지,고급형 케익쇼케이스/제과쇼케이스 SCW-130L/SCW-160L,868000,868000,0
2018-06-01,466294541,L012090,기초화장품,진설 아이 에센스 20ml 1개 아이케어 눈가케어 기초케,351390,337340,-14050
2018-06-01,333872895,L021050,우산,피에르 아놀드 당일발송 기념품 인쇄 박스 배송 무료,5300,4900,-400
2018-06-01,630405634,C013020,티셔츠,챔피온 신상품 후드집업 모음_S0891,41900,36880,-5020
2018-06-01,1179144460,L012060,샴푸,네이처리퍼블릭 아르간에센셜 대용량/샴푸/헤어팩/택1,18900,18900,0
2018-06-01,1062320166,E031120,믹서,[사은품증정] 리큅 RPM Cube 블렌더 BS5/그린스무디,241050,187010,-54040
2018-06-01,164996808,G011070,자전거,라니아 22인치 남여공용 클래식자전거,149000,132970,-16030
2018-06-01,207292010,E061010,세탁세제,비트 가루세제 4kg/3.6kg/1.8kg/1.5kg (일반/드럼),9900,9900,0
2018-06-01,718727625,E061010,세탁세제,향기품은 세탁세제10KG+10KG/10KG/슈퍼워시/가루세제,7800,6800,-1000
2018-06-01,351350938,I031040,생화,구급함 소중대 구급상자 구급낭 구급가방 약품세트,10000,9900,-100
2018-06-01,556920586,C011030,남자학생복,AG 빅사이즈 바투스 청남방 BW 남성용셔츠 남성용데님,71470,71470,0
2018-06-01,106968631,C011050,남자내의,[웰메이드]웰메이드[인디안모드] 16여름캐주얼바지 기지바지  정장바지 [MITDLTM3109],45000,40500,-4500
2018-06-01,896542218,A018050,비스킷,[해태]해태 에이스(121G),1300,1300,0
2018-06-01,1195177585,C013010,점퍼,잠뱅이 남녀 역시즌 다운롱점퍼/파카 초특가 세일,13500,13500,0
2018-06-01,1025718936,C012040,여자학생복,오조크면7부프릴블라우스 715-84380,33150,33150,0
2018-06-01,1935061958,E021010,침구,[코튼렛]호텔침구 순면60수 광폭이불커버세트(Q/SS),69900,69900,0
2018-06-01,986130579,A012020,수입쇠고기,E-호주산 냉장우 와규 윗등심(100G),5990,4988,-1002
2018-06-01,789163621,D031010,주택수선재료,삼화페인트 기와/슬레이트 ksm6020 4종 아크릴도료 4L,30000,30000,0
2018-06-01,1631871099,C013010,점퍼,푸조 바라막이 레인점퍼 스판바지 상하별도판,18800,18430,-370
2018-06-01,1353631140,E041070,밀폐용기,메탈락 원형 스텐 밀폐용기 직사각형 스텐 밀폐용기,8000,7360,-640
2018-06-01,1080086519,L021020,장신구,은(silver) 볼 팔찌 종합,20000,20000,0
2018-06-01,1571118292,E041010,식기,쉬즈홈 밥공기/밥그릇/국그릇/홈세트/그릇 세트/식기,19900,18310,-1590
2018-06-01,1210387786,C013010,점퍼,[트레몰로][TREMOLO] 남성 아티보 프린트 점퍼_TRSCLTM3431,109000,103550,-5450
2018-06-01,1097449169,A013080,조개,국내산 새꼬막 1.5kg (상) 새벽조업후 발송 산지,32970,32970,0
2018-06-01,631113294,C011030,남자학생복,아웃도어 빅사이즈 패딩점퍼 JK530 빅사이즈,69470,67390,-2080
2018-06-01,143207459,A019080,고추장,해찬들&청정원 장류,3880,3880,0
2018-06-01,357882818,I053010,공책,초등용 1000 2000 스케치북 아트모아 모닝글로리,500,440,-60
2018-06-01,1180475948,C013050,운동복,[세진아트] 안전삼각대/LED안전삼각대/차량필수품/안전용품/긴급상황/반사판/비상용/안,14900,14900,0
2018-06-01,780537998,F011120,인삼,(장생농산장수산삼 8년근 3주(3뿌리) 명절선물 스승의,145270,145270,0
2018-06-01,1340442970,L021020,장신구,(실버) 함싸 가죽 초커 목걸이 10대 20대 30대 기념일,22810,20530,-2280
2018-06-01,200855115,A018030,껌,껌 40종류 자일리톨 목캔디 터닝메카드 은단 금연껌,4600,4600,0
2018-06-01,1804742613,E031040,전기레인지,데이킵스 간편냉장고정리9P,32780,32780,0
2018-06-01,415008982,C013040,청바지,(남자옷도매) DP-271 노멀데님생지 팬츠 (S-XL) 중청,24730,24730,0
2018-06-01,961399115,A018090,잼,리고 땅콩쨈 크리미(462G),6900,6900,0
2018-06-01,80409475,E061040,부엌용세제,참그린 석류식초 470mlx1개+900mlx2개 리필 설거지,8900,8900,0
2018-06-01,2042639358,C013040,청바지,1+1이벤트 남자청바지밴딩청바지빅사이즈/DF1000/1100,14900,12900,-2000
2018-06-01,417114530,C013020,티셔츠,[대구백화점 I관] [헌트키즈]스트라이프티셔츠(HKLW81201C),9900,9210,-690
2018-06-01,321401678,A011010,쌀,전남 장흥 남외정미소 2017년 햅쌀/찹쌀/현미 20kg,43900,43900,0
2018-06-01,559290659,I031040,생화,라텍스/메쉬 무릎보호대-관절보호대/재활/등산보호대,7900,7080,-820
2018-06-01,954814251,L012030,칫솔,[LG]LG페리오 슬림터치 초극세모 칫솔(1입),1000,1000,0
2018-06-01,1294878510,C014010,아동복,네파키즈 아이아스 컬러블럭 자켓 KED0608,37730,37730,0
2018-06-01,1497057945,E021010,침구,굿몽 마이크로 이불패드세트 기숙사 신학기 이불세트,36900,36900,0
2018-06-01,1299968457,I031040,생화,KSD 헤드기어,39600,38810,-790
2018-06-01,463961055,C011050,남자내의,[TBJ]남성 면스판 5부 팬츠(T182PT580P),29900,24220,-5680
2018-06-01,2008935042,E061050,청소용세제,[무균무때]욕실500ml용기3개 곰팡이 주방청소 욕실청,8000,6900,-1100
2018-06-01,1280233707,G011070,자전거,삼천리 17년포인트 외 알미늄7단 24 26인치 100%조립,149000,137080,-11920
2018-06-01,388389187,A011120,두부,[켈로그] 농심켈로그 첵스초코 1200g 대용량 시리얼 식사대용,12800,12290,-510
2018-06-01,1981327483,E061020,섬유유연제,컨센서스 섬유유연제 20L 베이비파우더/대용량/말통,16900,16900,0
2018-06-01,438379041,C013050,운동복,스쿼드 15 사이드라인 우븐 자켓(645476463) 트레이닝,77990,77990,0
2018-06-01,1527187421,C013040,청바지,블랙진/청바지/남자청바지/슬림/빅사이즈/남성/스판,12800,12800,0
2018-06-01,578450213,L021030,가방,쌈지 s/s 공용백팩 균일가 무료배송,12900,9900,-3000
2018-06-01,230936614,C012060,여자내의,[다바걸]바닐라언발스컷,28000,26600,-1400
2018-06-01,1469456787,A012010,국산쇠고기,{TV홈쇼핑정품}명장 꼬리반골 한우 세트1+1/사태/사골,196000,194040,-1960
2018-06-01,1421676325,A018050,비스킷,과자/빅파이/참ing/에이스/뽀또/국희/쿠크다스/오예스,33000,33000,0
2018-06-01,1191338291,C011030,남자학생복,정품☆ 나이키후드 집업☆티셔츠 V넥☆리복 보스 봄자켓 바람막이 점퍼☆ 나이키 후드,39900,34900,-5000
2018-06-01,1531486061,I031040,생화,캠프홀릭 스텐레스 해머/스텐 펙 해머/망치/오토캠핑,39000,35880,-3120
2018-06-01,1212420793,E021020,커튼,[윈홈스] 어썸 화이트 맞춤 암막커튼 (핀형),22900,21070,-1830
2018-06-01,24467651,I011030,사진기,니콘 정품 D500 4종사은품증정/최신품/DSLR/카메라,1841640,1811520,-30120
2018-06-01,1994242767,D031010,주택수선재료,[칠만표]강력접착방수제/침투성방수재/모체강화제,25500,25500,0
2018-06-01,647433570,E031070,에어컨,천장형 캠핑용 타프팬 가정용 절약형 8W s-fan 50,18800,18500,-300
2018-06-01,986215922,A011060,땅콩,[우리마을] 잡곡 3종세트(찰흑미 찰보리쌀 혼합8곡),26000,14900,-11100
2018-06-01,986215923,A011060,땅콩,[우리마을]잡곡 5종세트(찰흑미 찰보리쌀 현미찹쌀 찹쌀 혼합8곡),36000,21900,-14100
2018-06-01,1579470424,C012060,여자내의,푸조 여성 워테레깅스 ( S26-1 ),28540,25690,-2850
2018-06-01,691684881,E011010,장롱,마켓비 MKB 캐비넷 옷장 7601690,151000,151000,0
2018-06-01,2116434495,I012010,컴퓨터,LG전자 데스크탑 Z70EV-AR7P16 LG 컴퓨터 WIN10탑재,576280,559000,-17280
2018-06-01,1456218765,E061030,전구,장수/두영 EL 램프 박스판매/ 25W/30W/45W/75W/100W /,88500,88500,0
2018-06-01,897734977,A019030,생강,양파(1.5KG/망),4990,3990,-1000
2018-06-01,1010196930,A016050,밤,[유기농팔도]친환경 효도 견과세트 3호(100%국산),78000,60000,-18000
2018-06-01,1314562611,I012060,저장장치,OGN-K770GC GENESIS II 엔투스 CJ광축 다크그레이 DC,72000,72000,0
2018-06-01,1010196933,A016050,밤,[유기농팔도]친환경 효도 견과세트 6호(100%국산),76000,54000,-22000
2018-06-01,511546680,C011030,남자학생복,w/빈폴로라코스테버버리해지스셔츠남방카라티조은구제,19900,19900,0
2018-06-01,1205244594,C012030,여자상의,봄신상 정장원피스/레이스/쉬폰/나시/결혼식/하객,29800,29800,0
2018-06-01,1609181474,A011090,국수,[삼양]불닭볶음면x10개 까르보/치즈불닭/컵라면/커리,8900,8900,0
2018-06-01,349262456,C012060,여자내의,스판 기모 밴드팬츠 레깅스 여성 팬츠스키니,20400,20400,0
2018-06-01,1118964306,I031040,생화,아오맥스 카본 원투낚시대 3종세트/TV쇼핑/바다낚시대,149000,137310,-11690
2018-06-01,993246504,I011030,사진기,정품 니콘 A100 2005만화소 디카 카메라 사은품 증정,112960,97950,-15010
2018-06-01,988925971,F012020,생리대,[엘지생활건강] 바디피트 순간흡수 소형16P x2,5500,5500,0
2018-06-01,275514556,I031010,장난감,Step2 멜로디 지붕차 유아용완구 유아자동차 유아완구,234360,234360,0
2018-06-01,734220460,I012010,컴퓨터,[E]B70EV-AR75S2/7세대/i5/8G/256G+1TB/키보드+마우스,940000,893000,-47000
2018-06-01,412569862,E041020,컵,머그컵 커피잔 모음 / 유리컵 물컵 도자기컵 찻잔,9000,8910,-90
2018-06-01,342935922,A011140,부침가루,삼립빵 쫄깃한 잉글리쉬 머핀 (60g 4입),1200,1200,0
2018-06-01,1370388620,C013050,운동복,루젠성에방지커버/자동차커버/앞유리커버/햇빛가리개,15900,14630,-1270
2018-06-01,1011024730,C013050,운동복,dd98 슬림핏 트레이닝복 그레이 트레이닝복 트레이닝,19560,19560,0
2018-06-01,466766865,D031010,주택수선재료,숲으로 에이스 외부용 18L 무광/담장/수성/외벽/조색,57000,57000,0
2018-06-01,1073586133,A018050,비스킷,로아커웨하스 콰드라티니 7종 125gx6개/수입과자/간식,12900,12900,0
2018-06-01,1667566106,F012050,의료측정기,젠울티메이트 50매/원터치 울트라 호환 혈당시험지,16900,15720,-1180
2018-06-01,1530619173,C012020,원피스,MELODY F131 블루/코트/여자코트/겨울코디/겨울코트/자켓/점퍼 미국 여성토탈브랜드 멜,68700,68700,0
2018-06-01,1775669137,I031040,생화,헤리티지 /7발 /8400루멘 /L2 /외장형/ 헤드랜턴 3종/,56900,50900,-6000
2018-06-01,982682906,L012090,기초화장품,숨37 워터풀 씨씨 쿠션 퍼펙트 피니쉬-본품+리필 CC쿠,34700,34700,0
2018-06-01,900475692,A011180,파스타면,[농심]농심 순한 너구리 (120G),720,720,0
2018-06-01,477414647,C015040,장갑,레이스운전장갑/레이스장갑/운전장갑/롱장갑/망사...,4500,4500,0
2018-06-01,1299883083,E021020,커튼,인테리어 캔버스액자 벽걸이소품 그림액자 집들이선물,28500,27930,-570
2018-06-01,815843777,A014050,달걀,HACCP인증 계란 무항생제 대란/특란/40구,8900,8900,0
2018-06-01,988127382,E041040,프라이팬,플라워 뚝배기 11CM,8400,8400,0
2018-06-01,170654897,C013040,청바지,리리앤코팬츠/S~36/빅사이즈/슬랙스/면/일자핏/밴딩,30800,22800,-8000
2018-06-01,1597236816,F011130,홍삼,정관장 홍삼진본(40ML*20포),33120,33120,0
2018-06-01,986129582,A011080,밀가루,샘표 쌀소면_800G,4800,4800,0
2018-06-01,895895627,A011120,두부,[농심]농심 켈로그 스페셜K (270G),4800,4800,0
2018-06-01,2042701734,C013050,운동복,전차량용 벨트클립 차량용품 렉서스 랜드로버 폭스바,5000,4850,-150
2018-06-01,986130576,A012020,수입쇠고기,E-호주산 냉장우 와규 설도 100G,3500,1887,-1613
2018-06-01,986130577,A012020,수입쇠고기,E-호주산 냉장우 와규 (앞다리/국거리용) 100G,4500,1887,-2613
2018-06-01,1231799669,C013010,점퍼,[K2]케이투 KIDS GHOST(RDS)키즈 다운점퍼(KXW17509),149000,131120,-17880
2018-06-01,345183679,E061040,부엌용세제,애경 향균트리오 400g 1kg 2kg 3kg 주방세제 무료배송,15900,15900,0
2018-06-01,944788494,C012060,여자내의,(해외직배송) 여성 브이넥 랩 와이드 통 팬츠 리본 허,77220,67960,-9260
2018-06-01,667161339,C011050,남자내의,[폴햄]남성용 이지핏 5부 밴딩슬랙스(PHY2PH1033,29900,24520,-5380
2018-06-01,1199981987,E031050,냉장고,[삼성전자] 인증점 삼성 스탠드 김치냉장고 RQ33M7001S8 무료배송,1459900,1459900,0
2018-06-01,988127381,E041040,프라이팬,플라워 뚝배기 19CM,18900,18900,0
2018-06-01,1286535446,I031010,장난감,Step2 멜로디 지붕차 타고다니는승용완구 유아용완구,237350,237350,0
2018-06-01,342935794,A011140,부침가루,삼립빵 조각케익 5가지맛 3개 소프트 케이크 50g 10개,5500,5500,0
2018-06-01,1917198509,C012040,여자학생복,[이사베이]배색 포인트 쉬폰 블라우스 (VMBAE3447)_E5A5,19900,18910,-990
2018-06-01,811519131,L012060,샴푸,신제품 빅그린23 내츄럴샴푸 대용량1000ml+트리트먼트,27800,27800,0
2018-06-01,914518737,A019080,고추장,고추장  된장 쌈장  참기름 모음전,2600,2600,0
2018-06-01,914518736,A019060,된장,고추장  된장  쌈장  참기름 모음전,2600,2600,0
2018-06-01,1492978239,C012060,여자내의,[대구백화점 I관] [VIKI]브이넥 와이드 점프수트(TQOAC2503),49000,42140,-6860
2018-06-01,1144604862,C011030,남자학생복,[카운테스마라]도비 일반핏 반팔[CDCQ2B1205A0[화이트],40000,33600,-6400
2018-06-01,317258405,A013060,게,[여수고기]국내산 손질 오징어 1팩(3-4마리)/500g내외,7900,7900,0
2018-06-01,2069235593,C012040,여자학생복,빅사이즈/사다리/블라우스 / 참고 사다리블라우스 빅,67800,59670,-8130
2018-06-01,985410788,A014030,치즈,동원 모짜렐라 치즈_270G,6680,3340,-3340
2018-06-01,1122504399,C013040,청바지,{G2_18S0317}여아오비포인트데님/ 소이,7900,7430,-470
2018-06-01,1054170162,C013020,티셔츠,클라비 M~4XL 반팔티 티셔츠 반팔 빅사이즈 남자,8900,8900,0
2018-06-01,2052846492,C012020,원피스,[VOV]체크 패턴 더블 롱코트(17416912)(본점),549000,489930,-59070
2018-06-01,226621140,F011120,인삼,건도라지 200g x 10 말린도라지 산지직송,73840,73840,0
2018-06-01,749252975,A011140,부침가루,[삼립] 삼립 케이크 소프트 모카 치즈케익 50g,650,650,0
2018-06-01,370184435,A018090,잼,[복음자리]과일잼 1+1_사은품2종증정_무료배송,9900,9900,0
2018-06-01,2093191625,C013020,티셔츠,오픈프릴티 BG1709 여자상의 여성라운드티셔츠 레드오,39730,39730,0
2018-06-01,1565849905,C015020,모자,군모/빈티지/무지군모/볼캡/빅사이즈/남녀공용,11900,9900,-2000
2018-06-01,44132626,A021010,커피,[특가]남양 루카스나인 라떼60T,17600,17600,0
2018-06-01,1221011005,C011020,남자상의,여름정장바지 남자슬랙스 신사마린넨기지쿨스판바지,19800,19800,0
2018-06-01,1047890639,C013060,등산복,[역시즌 미리준비하는 롱패딩] 남여 공용 커플 롱 벤치 다운 [5217OD446]/ 머렐(레저),168000,139440,-28560
2018-06-01,1207303805,L012040,치약,애터미치약 200g X 5개,18500,18500,0
2018-06-01,208858887,C012060,여자내의,SG 313 건빵스판면3부핫팬츠 여성반바지 3부 면바지,35880,29070,-6810
2018-06-01,1788641006,A017300,미역,[1+1]재래도시락김32봉(2개이상구매시 전장1봉 증정),9200,8900,-300
2018-06-01,1994614271,C012020,원피스,말표구두약 이코노 갈색 40g,1990,1990,0
2018-06-01,2012766356,A022010,주스,망고원액(참존835ml)X12개/망고 원액 스무디 망고스틴 젤라또 아이스크림 재료 푸딩 버,45540,44180,-1360
2018-06-01,2112416314,F012050,의료측정기,VT 인포피아 미래 3.3G+ 혈당계+시험지50+침200+솜100,20500,15280,-5220
2018-06-01,2134492729,L021030,가방,INTC-107X 노트북파우치 가방 케이스 11/13/14/15인치,9500,8500,-1000
2018-06-01,861471268,E061010,세탁세제,식소다 식용베이킹소다 미국로얄 프리미엄 1Kg-5개,11800,11800,0
2018-06-01,447482325,C013010,점퍼,[무료배송]스트릿후드티 캐주얼후드티 긴팔티셔츠 레,22570,22570,0
2018-06-01,1130908656,E041070,밀폐용기,락앤락 냉장고 문짝정리 인터락 20개세트,38900,35790,-3110
2018-06-01,484675659,C013050,운동복,여름 7부트레이닝복세트 반팔반바지세트 츄리닝 남성,17800,17800,0
2018-06-01,1509710749,A011170,떡,웰빙즉석 사골국물 백제家 즉석 햅쌀 떡국(16개입),32000,31680,-320
2018-06-01,514467317,C021010,아동화,NB다이얼운동화-1094 아동운동화 아동화,29900,29900,0
2018-06-01,1394687668,C012040,여자학생복,빅포켓 박시 청 롱남방 여성 셔츠 DM-4050,56700,53870,-2830
2018-06-01,1191159480,A017010,배추,강화 순무 10kg 2018 햇순무 강화도 순무김치 동치미,28900,28900,0
2018-06-01,1096984584,A012030,돼지고기,(두메촌) 국내산 한돈 생삼겹살 500g / 생고기 삼겹살,9900,9900,0
2018-06-01,1806522342,A018020,사탕,무배 대용량캔디/벌크사탕모음/홍보용/업소용/카라멜,30900,30900,0
2018-06-01,1743859318,A022010,주스,(맛나)삼화잣호두율무18g*50포/오뚜기,21700,19530,-2170
2018-06-01,1122504373,C013040,청바지,{G2_18S0307}남아6부노말엠보바지/ 소이,7900,7430,-470
2018-06-01,1499677190,I031040,생화,SOS긴급구호세트 야외구호세트 안전용품 캠핑장비 캠,21190,19310,-1880
2018-06-01,673504357,A019070,양념소스,빅마마 이혜정 간단조리 비법양념 다시팩 세트,16500,16500,0
2018-06-01,1004235849,A019040,소금,(면)백설 꽃소금500g,1440,1260,-180
2018-06-01,338176449,A015010,참기름,[1+1 득템찬스] CJ제일제당 백설 진한참기름 500ml (총 2캔),9900,9900,0
2018-06-01,2069260525,C012040,여자학생복,빅사이즈/린넨/배색/띠/블라우스 / 참고 린넨배색띠-B,55700,49020,-6680
2018-06-01,605524116,A022010,주스,[마켓앤홈] 돌핀 폴라레티 400mlx3개 2종 /후르트/트,11900,11900,0
2018-06-01,1274597356,I031070,애완동물관리비,당구대 미니당구대 탁구대 하키 미니탁구대 포켓볼,115000,115000,0
2018-06-01,1171216835,A018080,설탕,백설하얀설탕15kg/갈색설탕15kg/흑설탕15kg/CJ설탕,17200,17200,0
2018-06-01,392461044,A017140,콩나물,도라지 250g (경북 영주 재배산) 도라지 도라지말린것,18420,18060,-360
2018-06-01,2072163180,C013030,스웨터,골지 반폴라 티셔츠 MRO 반폴라티 남성반폴라 반폴라,55140,55140,0
2018-06-01,1782556450,A022010,주스,스위트코리아 액상음료 희석음료 과일음료 농축액,3740,3740,0
2018-06-01,18229829,C013040,청바지,여름 청바지 여성 여자 스키니진 밴딩 스판 찢어진,17800,17800,0
2018-06-01,317028506,C012040,여자학생복,체크 숄 스카프 머플러 여성 패션 보온 사무실 담요,17890,17890,0
2018-06-01,898635340,A021010,커피,[동서]동서 아라비카 리필 (270G),12900,12900,0
2018-06-01,320947945,C013010,점퍼,[대구백화점 I관] [탑걸]7부꽃자수점퍼(TIZ4JP714F),29000,24940,-4060
2018-06-01,1041788297,A022010,주스,1박스특가 보해 매원디럭스 1.5L 8ea,48000,48000,0
2018-06-01,1997285256,E011020,침대,[골든잼]슈퍼싱글 보료/흙침대 돌침대 보료매트,917800,890270,-27530
2018-06-01,667004743,E041010,식기,국내산 스텐밥공기/업소용합식기/밥공기/국대접/물컵,990,920,-70
2018-06-01,1153848534,C012060,여자내의,[위쉬몰]RIN 언발헤짐스커트(0369RH805),50400,42840,-7560
2018-06-01,1134493515,C015030,넥타이,나비넥타이 보타이 아동/여자넥타이 리본/교복/학생,3800,3800,0
2018-06-01,271229556,I031010,장난감,(스플래쉬대셔) 블루상어 물놀이소품 목욕완구 작동완,24130,24130,0
2018-06-01,1976465708,C013050,운동복,미키정품/쿨바지/쿨팬츠/여름바지/냉장고/남자,7900,7900,0
2018-06-01,312736555,C013060,등산복,쿨냉감바지 남성등산바지 추성훈바지 여름바지w020,12900,12900,0
2018-06-01,1830223530,E031030,전자레인지,[인증점] 삼성 23L 세라믹 전자레인지 MS23K3513AK,104900,95710,-9190
2018-06-01,1573263820,C021040,실내화,[아디다스오리지널스]스탠스미스/슈퍼스타 (CQ2469 DA9145 CQ2201 CQ2206 CQ2207 CQ22,57900,48870,-9030
2018-06-01,293761020,E061020,섬유유연제,(FC 베이비전용 섬유유연제 bottle) 빨레세제 아기의,20690,20690,0
2018-06-01,1550019113,A015020,식용유,[백설] 백설 바삭한 요리유 900ml x 6병 식용유 더욱바삭하게,18740,18740,0
2018-06-01,1180833191,C013050,운동복,3_고구마베이비 아기옷-진그린 악어코끼리 민소매 상,6580,6390,-190
2018-06-01,1415068913,I053020,스케치북,스케치북 10권 8절 대용량 아동용 스케치북,6000,6000,0
2018-06-01,423447655,F012030,안경,국산 가벼운 원형 뿔테/블루라이트차단안경/청광렌즈,17500,17500,0
2018-06-01,1622362008,C012040,여자학생복,스트라이프 줄무늬셔츠 꼼데남방블라우스,19900,19900,0
2018-06-01,1891835179,L021030,가방,백팩 책가방 여자 소풍 기저귀 학생 여성 가방 모음,14500,14500,0
2018-06-01,1011215348,F011150,건강기능식품,[올즙]올바른 루테인12 500mg x 30캡슐 x 5박스,60000,22800,-37200
2018-06-01,552069620,C011050,남자내의,팀 클럽 커프 팬츠(658679010) 트레이닝팬츠 하의바지,61010,61010,0
2018-06-01,2026053921,C021040,실내화,테슬라 남여 패션 운동화 런닝화 스니커즈 트레킹화,19900,19900,0
2018-06-01,368593564,E011020,침대,인쏘노 젤로시아 GELOSIA 가죽 침대 + 매트리스 포함,339000,339000,0
2018-06-01,536940432,C014010,아동복,[아디다스키즈/adidaskid] CF7269 YG 3S 3/4 타이츠 YG 3S 3/4 TGT 여아용타이즈,31200,27460,-3740
2018-06-01,888972707,L012090,기초화장품,(최신상품) 아이오페 모이스트젠 스킨/에멀젼 택1,17820,17820,0
2018-06-01,2083718851,C013020,티셔츠,짱짱한스판골지나시/나시/망고나시/쫄나시/민소매,9400,9400,0
2018-06-01,1153848565,C012040,여자학생복,[위쉬몰]BG 시스루 소매 가디건(2051H805),42840,36420,-6420
2018-06-01,1010292974,F012020,생리대,유기농본오버나이트10P,5500,3300,-2200
2018-06-01,1465101824,A019050,간장,샘표 진간장S 5L 양조간장5L 금F3 진간장,16450,16450,0
2018-06-01,1765245239,A011170,떡,궁중 두텁떡/찹쌀떡 인절미 쑥떡 송편 모시떡 바람떡,4900,4900,0
2018-06-01,1879543518,E061060,살충제,1+1 화랑곡나방트랩 외6종 권연벌레 명나방 곡나방,1980,1980,0
2018-06-01,715926882,E041070,밀폐용기,유리병 담금주 술병 주병 담금술병 약초병 과실주병,18900,17390,-1510
2018-06-01,1280970952,L012060,샴푸,청미정 트리트먼트 두피케어샴푸 EM발효샴푸 천연샴푸,28500,28500,0
2018-06-01,1970846443,C013020,티셔츠,딥지그재그v넥크롭티/브이넥티/섹시티/숏티셔츠/클럽,7900,7900,0
2018-06-01,766705908,C012030,여자상의,옵션가No 홀복/니트/섹시/클럽/롱/미니/하객원피스,61800,61800,0
2018-06-01,1011215344,F011150,건강기능식품,[올즙]올바른 밀크씨슬 900mg x 30정 x 5박스,60000,22800,-37200
2018-06-01,1254835650,C013020,티셔츠,[타요][타요] 우븐 믹스티(TYC116MGTS04-MPK),7000,6650,-350
2018-06-01,1011215346,F011150,건강기능식품,[올즙]올바른 프로바이오틱스 250mg x 30캡슐 x 5박스,60000,22800,-37200
2018-06-01,1011215347,F011150,건강기능식품,[올즙]올바른 칼슘 마그네슘 비타민D 아연 x 30정 x 5박스,60000,22800,-37200
2018-06-01,1775102184,F011130,홍삼,정관장 홍삼담은 참꿀,37000,37000,0
2018-06-01,416886134,E011040,소파,아리아퍼니쳐 쇼파/패브릭소파/소파베드/가죽소파모음,168900,168900,0
2018-06-01,1213587263,E011050,책상,카멜책상 사무용 컴퓨터 수강용 회의용 포밍 테이블,59900,59900,0
2018-06-01,13191996,A018090,잼,트라피스트수녀원 유기농 포도쨈x410g 포도잼 유기포,14360,14360,0
2018-06-01,2019730029,C012040,여자학생복,kk34 헨리넥st 하프버튼 데님셔츠_블루청 여성셔츠 여,16090,16090,0
2018-06-01,510679626,C011030,남자학생복,[레노마셔츠](18년신상/반소매) 직장인을 위한 반소매 베스트셀러 22종 RIUSL0302WH 외,30000,22200,-7800
2018-06-01,505876788,A013140,북어채,하늘갓 특상품 황태껍질 북어껍질 1kg,23700,23700,0
2018-06-01,1940192783,A017150,버섯,Q아람/평창-곤드레나물세트/고사리/곤드레/취나물,33100,33100,0
2018-06-01,2035767708,C012060,여자내의,[화이트폭스][화이트폭스]텐션하이웨스트롱스커트,17000,15470,-1530
2018-06-01,344328542,C012060,여자내의,[조이너스][조이너스] 옆주름랩 스커트 JA6U5-WQS210_410 (P000342753),31800,28620,-3180
2018-06-01,1214236427,I011030,사진기,-정품 니콘 J5+10-30mm 사은품 미러리스 카메라 디카,359000,325440,-33560
2018-06-01,1993328789,C013050,운동복,헬스.트레이닝 운동복/쿨론기능성티셔츠/단체복상하,6000,5900,-100
2018-06-01,599260449,A016040,포도,머루포도즙 100ml X 30포 머루포도100%,16000,14900,-1100
2018-06-01,899524206,A018100,꿀,슈퍼스타 사양벌꿀 750G 1+1기획,12990,12990,0
2018-06-01,1376872174,C012020,원피스,[CC콜렉트]노카라홑겹트렌치코트@벨트(C182MSI033),244300,190560,-53740
2018-06-01,1910906559,E041020,컵,[보덤] new코로나 유리머그잔 6P,42000,42000,0
2018-06-01,768833068,A012010,국산쇠고기,가평잣 3단세트(고품격 웰빙 선물세트)사은품 답례품,88430,88430,0
2018-06-01,402493121,C013040,청바지,로로텐 청바지/슬림핏/스키니/밴딩/팬츠 빅사이즈,21900,21900,0
2018-06-01,555042918,C012040,여자학생복,빅사이즈 DBN1387 플레아 뷔스티에 803S 여성용뷔스티,44190,44190,0
2018-06-01,729150357,F012020,생리대,좋은느낌/화이트/입는오버나이트/8매/생리대/수퍼롱,9900,9900,0
2018-06-01,1367806190,A017220,양파,꼬레촌조미 파(흙쪽파)최상품 1.3kg x 5단,30600,30600,0
2018-06-01,960450642,A018060,스낵과자,크리스피롤 12그레인 플러스(180G),2990,1990,-1000
2018-06-01,1608436919,A022010,주스,[초록마을] 통째로짜낸사과(1000mL),6150,6150,0
2018-06-01,1367806184,A017220,양파,꼬레촌조미 파(흙쪽파)최상품 1.3kg/단,7200,7200,0
2018-06-01,1573383267,A022030,생수,[풀무원샘물] 2Lx12펫 특가/생수/무료배송/한정수량,3900,3900,0
2018-06-01,53148661,C011030,남자학생복,[모던브릭]MJ-1028 [가을-겨울] 맨인블 조끼 (L-2XL) 밀리터리,43000,36550,-6450
2018-06-01,89627909,C012040,여자학생복,[MLB]엠엘비 2종택1 여성 등판엠보로고 MLB 후드집업(31TRC5811),104300,88660,-15640
2018-06-01,564044746,E021010,침구,[잇츠유]트렌디한 17컬러 순면이불커버 / 맞춤가능,23900,23900,0
2018-06-01,1658179588,E061020,섬유유연제,드라이시트 250매 빨래 의류 건조기 유연제 코스트코,9220,9220,0
2018-06-01,332604013,C013040,청바지,[버커루]남성 밑단 데미지 스키니 데님팬츠 (B175Z0262P),39000,33150,-5850
2018-06-01,1091654865,C013010,점퍼,여성 라운드 니트 KKS 힐래리 피셔 맨니트 니트 여성,57130,57130,0
2018-06-01,1663392052,I011030,사진기,(컴온탑)캐논정품 5D Mark4 BODY(18년4월/가이드북),3824990,3519000,-305990
2018-06-01,281206350,E041070,밀폐용기,쿨맥시2 밀폐용기 김치통 전자렌지사용가능 국내제작1,3300,2960,-340
2018-06-01,952879850,A021010,커피,[동서]아라비카 100 부드러운 블랙믹스 56g(2.8g x 20개),3990,3990,0
2018-06-01,1998888723,C013020,티셔츠,시즌특가-타미힐피거 여름신상 반팔 PK카라티 정품,41800,38800,-3000
2018-06-01,2112078042,C012040,여자학생복,[일라일(ILAIL)][17F/W]언발란스반폴라티(BWKT-17801-DN)[갤러리아],134000,127300,-6700
2018-06-01,82309264,C013020,티셔츠,[DUCLY] 신상 맨투맨/후드티/후드집업/기모/빅사이즈,27900,27900,0
2018-06-01,1783119643,L021010,손목시계,[공식  백화점AS] Gc LadyBelle 여성시계(가죽)_Y22005L3,219300,219300,0
2018-06-01,376067539,C013010,점퍼,써스데이아일랜드 (T184MCT231) 린넨 체크 홑겹 코트,329000,263200,-65800
2018-06-01,1783119644,L021010,손목시계,[공식  백화점AS] Gc LadyBelle 여성시계(가죽)_Y22001L3,295800,295800,0
2018-06-01,1783119645,L021010,손목시계,[공식  백화점AS] Gc LadyChic 여성시계(메탈)_Y21004L3,270300,270300,0
2018-06-01,1780617025,C021040,실내화,[뉴발란스/아디다스/나이키]운동화 런닝화 스니커즈,48900,48900,0
2018-06-01,935196925,E011010,장롱,로즈모던장롱/핫신상/고급스러운방분위기연출,47900,47900,0
2018-06-01,1372563177,F012050,의료측정기,아답터증정 아케소혈압계 TMB-986 혈압측정기 혈압기,89900,89900,0
2018-06-01,705298641,A018100,꿀,스페인 벌화분 1kg 유기농 비폴렌 꿀벌화분 꽃가루,29900,29900,0
2018-06-01,18472731,C011050,남자내의,체크9부/주머니 착용감 좋은 체크 9부 주머니파자마,13900,12380,-1520
2018-06-01,1831956225,C013010,점퍼,[예시카]YA1MJP480. 유니크 오버핏 항공 점퍼,31700,30120,-1580
2018-06-01,1987742627,I031040,생화,국산/나스켐/충전식 캡라이트G3/후레쉬/헤드랜턴/랜턴,24000,19880,-4120
2018-06-01,663564562,C021010,아동화,꼬꼬마슈 신상 유아동샌들/여아구두/유아동운동화kd51,9800,9800,0
2018-06-01,1881545600,L021030,가방,무료배송! 맥끌라니 데일리 인기가방 90종 택,27500,27500,0
2018-06-01,1778593401,L021010,손목시계,[바보사랑]Gc Bold 남성시계(메탈)(Swiss made)_X56008G2S,828000,828000,0
2018-06-01,1778593402,L021010,손목시계,[바보사랑]Gc Bold 남성시계(메탈)(Swiss made)_X56010G5S,828000,828000,0
2018-06-01,1778593403,L021010,손목시계,[바보사랑]Gc-3 남성시계(가죽)(Swiss made)_X72025G7S,788000,788000,0
2018-06-01,1326632243,C021040,실내화,[푸마] (SIZE : 275) 플레어 2(18951701) 신발 러닝,85190,85190,0
2018-06-01,986213160,F011150,건강기능식품,[풍기][풍기인삼농협][황풍정] 6년근 봉밀홍삼절편 20g*10p,68000,60000,-8000
2018-06-01,895797537,A019010,고춧가루,[하선정]하선정 멸치액젓 800G,4390,4390,0
2018-06-01,1096198061,L021010,손목시계,BABY-G 베이비지 BGA-240L-7A 여성용 디지털 시계,164000,164000,0
2018-06-01,1096198060,L021010,손목시계,BABY-G 베이비지 BGS-100-1A 여성용 디지털 시계,179000,179000,0
2018-06-01,1048933259,C011020,남자상의,KD 바바리 트랜치코트 롱코트,162470,159230,-3240
2018-06-01,895797535,A019010,고춧가루,[하선정]하선정 까나리액젓 800G,4390,4390,0
2018-06-01,1783119646,L021010,손목시계,[공식  백화점AS] Gc CableChic 여성시계(메탈)_Y18114L1,414800,414800,0
2018-06-01,1783119647,L021010,손목시계,[공식  백화점AS] Gc CableChic 여성시계(실리콘)_Y18011L1,253300,253300,0
2018-06-01,977140509,A018090,잼,앤드로스 망고잼/딸기잼/블루베리잼/사과잼/리플잼/1k,8400,8400,0
2018-06-01,1783119648,L021010,손목시계,[공식  백화점AS] B1-Class Lady 여성시계(가죽)_Y17001L1,219300,219300,0
2018-06-01,1783119649,L021010,손목시계,[공식  백화점AS] Gc LadyChic 여성시계(가죽)_Y12002L3,295800,295800,0
2018-06-01,363430155,C013040,청바지,밑단헤짐라인청바지/나팔청바지/여아스판청바지,22900,17900,-5000
2018-06-01,1096198059,L021010,손목시계,BABY-G 베이비지 BGS-100-7A1 여성용 디지털 시계,179000,179000,0
2018-06-01,985409700,A019040,소금,샘표 한여름 눈꽃 굵은소금 500G,2200,2200,0
2018-06-01,2092711807,C012030,여자상의,데일리앤 데님원피스 청 멜빵 빅사이즈 원피스,23400,23400,0
2018-06-01,1783119650,L021010,손목시계,[공식  백화점AS] Gc LadyChic 여성시계(가죽)_Y10001L1,295800,295800,0
2018-06-01,1783119651,L021010,손목시계,[공식  백화점AS] Gc LadyChic 여성시계(메탈)_Y06004L1,389300,389300,0
2018-06-01,1783119652,L021010,손목시계,[공식  백화점AS] Gc LadyChic 여성시계(메탈)_Y05005M2,465800,465800,0
2018-06-01,1383479032,A017210,파,정품 완숙토마토 5kg 100박스 특가행사 - 8900원,8900,8900,0
2018-06-01,1778593404,L021010,손목시계,[바보사랑]Gc-3 남성시계(가죽)(Swiss made)_X72035G1S,728000,728000,0
2018-06-01,1925192598,E061060,살충제,피톤치드원액x4L+500ml 피톤치드 수액 100%편백증류액,86000,85140,-860
2018-06-01,1690899909,A017110,감자,건고사리_100g x 3EA 버섯/나물/건나물/말린나물/말린,62300,62300,0
2018-06-01,1778593433,L021010,손목시계,[바보사랑]Gc SportRacer 남성시계(실리콘)_Y02010G7,498000,498000,0
2018-06-01,584349643,A013170,생선통조림,동원 라이트85g*17캔+고추참치85g*3캔+과일파우치*4봉,23500,23500,0
2018-06-01,1778593434,L021010,손목시계,[바보사랑]Gc LadyChic 여성시계(가죽)_Y05011M3,488000,488000,0
2018-06-01,1778593435,L021010,손목시계,[바보사랑]Gc LadyChic 여성시계(메탈)_Y06003L1,428000,428000,0
2018-06-01,986213194,F011150,건강기능식품,[풍기][풍기인삼농협][황풍정] 6년근 봉밀홍삼절편 20g*5p,35000,35000,0
2018-06-01,1032300012,C013040,청바지,초이샵 청바지 부츠컷 일자 스키니 코팅 배기,24900,24900,0
2018-06-01,1778593430,L021010,손목시계,[바보사랑]Gc-1 Class 남성시계(가죽)(Swiss made)_X90015G7S,698000,698000,0
2018-06-01,1301755046,C013030,스웨터,세이틴 니트 BTT0293 남자니트 가을니트 / 참고 니트,35100,30890,-4210
2018-06-01,808846472,C012040,여자학생복,롱 남방 블라우스 루즈핏셔츠 데님 청원피스 빅사이즈,32700,32700,0
2018-06-01,1778593431,L021010,손목시계,[바보사랑]Gc ClassicChic 여성시계(메탈)(Swiss made)_X98003L1S,488000,488000,0
2018-06-01,1778593432,L021010,손목시계,[바보사랑]Gc SportRacer 남성시계(메탈)_Y02002G7,628000,628000,0
2018-06-01,607147221,I012010,컴퓨터,삼성 등 3세대 i7/i5 게이밍 노트북/1년AS/정품OS,399000,349000,-50000
2018-06-01,952131446,F011130,홍삼,[김포파주인삼농협/산지직송]홍삼정과 450g,80300,80300,0
2018-06-01,952131445,F011130,홍삼,[김포파주인삼농협/산지직송]홍삼정과 900g,145600,145600,0
2018-06-01,952131448,F011130,홍삼,[김포파주인삼농협/산지직송] 봉밀홍삼절편 200g,48200,48200,0
2018-06-01,1783119619,L021010,손목시계,[공식  백화점AS가능]델리아 여성시계(가죽)_W0888L6,117300,117300,0
2018-06-01,952131447,F011130,홍삼,[김포파주인삼농협/산지직송] 순수홍삼 80ml*30,83300,83300,0
2018-06-01,1530561705,C012020,원피스,MELODY F1 그레이/코트/여자코트/겨울코디/겨울코트/자켓/점퍼 미국 여성토탈브랜드 멜,69700,69700,0
2018-06-01,952131444,F011130,홍삼,[김포파주인삼농협/산지직송]6년근홍삼절편 200g,62300,62300,0
2018-06-01,1096198058,L021010,손목시계,BABY-G 베이비지 BGS-100-7A2 여성용 디지털 시계,179000,179000,0
2018-06-01,1982546983,A019060,된장,잘익은 집된장 800g 전통의 재래식 장담그는 방법,9000,9000,0
2018-06-01,1640598125,L012040,치약,[2080]치약150gx18개/청은차/페리오/진지발리스/칫솔,8000,7800,-200
2018-06-01,282256804,A011010,쌀,2017찹쌀20kg/ 찹쌀선별해서보냄니다,56500,56500,0
2018-06-01,833979143,C012060,여자내의,부루앤쥬디[WGKD3DP002]부츠컷청바지,34900,31410,-3490
2018-06-01,2048232475,L021060,유모차,크라운s 에스/블랙 에디션/유모차/양대면 핑크베이지,498000,498000,0
2018-06-01,319002875,C013050,운동복,[모비스] 모비스 크루저 루프백 차량용캠핑용품 차량루프백 캠,257360,234410,-22950
2018-06-01,1844966246,A018040,아이스크림,(2통이상무료배송)업소용/아이스크림/코니/10리터,15500,15500,0
2018-06-01,798165537,A022030,생수,박스+당일출고)네슬레 퓨어라이프 2L x12 / 500ml x40,8840,8840,0
2018-06-01,735845517,L012060,샴푸,680mlX3개 미장센 샴푸 /데미지/퍼펙트/미쟝센,13500,13500,0
2018-06-01,1011181836,F011130,홍삼,고려홍삼절편삼로얄 (20gX10갑) - 2세트+선물쇼핑백,100000,37900,-62100
2018-06-01,875034653,C013050,운동복,(F~XL)겨을신상/기모/밍크/양털/패션트레이닝복세트,32900,32900,0
2018-06-01,1652754542,A011040,보리쌀,캐나다 흰강낭콩(네이비빈) 2kg(500gx4) / 4kg,6100,6100,0
2018-06-01,989079704,A011040,보리쌀,[월드그린] 한드레 흰강낭콩 500g,3500,1900,-1600
2018-06-01,174212033,L021020,장신구,은 볼팔찌3mm~5m 전체순은,15000,15000,0
2018-06-01,1011181831,F011130,홍삼,6년근 고려홍삼정 로얄 플러스(240gX4병)-2세트 + 선물쇼핑백 포함,400000,189000,-211000
2018-06-01,952131449,F011130,홍삼,[김포파주인삼농협/산지직송] 순수홍삼 80ml*60,160600,160600,0
2018-06-01,1011181834,F011130,홍삼,고려홍삼절편삼로얄 (20gX10갑) - 1세트+선물쇼핑백,50000,19900,-30100
2018-06-01,2024043690,C011050,남자내의,따뜻한 기모 골프팬츠 경량패딩조끼 16종 무료배송,26900,26900,0
2018-06-01,1257577512,E021020,커튼,하늘하늘 시폰 거실커튼 창 안방 소창 여름 커튼 롤업,19900,18310,-1590
2018-06-01,1778593426,L021010,손목시계,[바보사랑]Gc Sport Class XXL 남성시계(메탈)(Swiss made)_X76004G2S,858000,858000,0
2018-06-01,2054335019,E041010,식기,대나무 키세트/3P/2P/5P/키채반/키/고리버들키/전통장,26200,25420,-780
2018-06-01,1778593427,L021010,손목시계,[바보사랑]Gc TechnoClass 남성시계(메탈)(Swiss made)_X81010G7S,728000,728000,0
2018-06-01,1896020284,I012060,저장장치,로지텍코리아 G502 RGB PROTEUS 마우스 A/S 3년 정품,90310,84900,-5410
2018-06-01,1778593428,L021010,손목시계,[바보사랑]Gc TechnoClass 남성시계(가죽)(Swiss made)_X81011G5S,668000,668000,0
2018-06-01,1778593429,L021010,손목시계,[바보사랑]Gc-1 Sport 남성시계(메탈)(Swiss made)_X90009G5S,858000,858000,0
2018-06-01,687200562,L021030,가방,에일리언웨어 AWV17BP 17인치 게이밍 노트북백팩/가방,135000,129000,-6000
2018-06-01,1356300388,C011020,남자상의,프리미엄 이중카라 울코트 / 참고 남자아우터 남자코,312800,265880,-46920
2018-06-01,1778593457,L021010,손목시계,[바보사랑]Gc LadyChic 여성시계(메탈)_Y06009L7,458000,458000,0
2018-06-01,1778593458,L021010,손목시계,[바보사랑]Gc LadyChic 여성시계(메탈)_Y07002L1,338000,338000,0
2018-06-01,1266545966,C013020,티셔츠,쿨론 라운드넥 긴팔(3XL)/냉감/단체티/티셔츠(쿨론티),10170,10170,0
2018-06-01,983448490,A019180,즉석식품,[CJ]CJ햇반100% 현미밥(130G),1750,1750,0
2018-06-01,1830620124,L012040,치약,페리오 펌핑치약 285g 4개/대용량 젤타입 펌프치약,19900,19900,0
2018-06-01,737397777,C013040,청바지,남녀 데님팬츠 10종택1 CHCDP311외 9종/ 클라이드,13900,11820,-2080
2018-06-01,2044493702,E011060,의자,[무료배송]시니프/단독only-실용특허/의자바퀴고정캡/5개1세트/이동의자를고정의자로/,8900,8010,-890
2018-06-01,2029495866,C011020,남자상의,패딩 코트 레이어드 PD05 WS 패딩코트 코트 남자코트,167340,148940,-18400
2018-06-01,987106926,A011180,파스타면,도나베라 푸실리 450G,1590,1590,0
2018-06-01,987106927,A011180,파스타면,도나베라 펜네 450G,1690,1690,0
2018-06-01,456425749,C012040,여자학생복,[바바라옷장]레이스 하프 로브 가디건,19800,18810,-990
2018-06-01,1143870132,C012040,여자학생복,[에잇컨셉]썸머 기본가디건(C8E7FCD035),23900,23190,-710
2018-06-01,496892656,A012060,햄및베이컨,(냉동)청정원고소하고바삭한베이컨 1kgX5개식자재 식,119800,105430,-14370
2018-06-01,1893182098,A017090,열무,[e-fresh] 아삭아삭 비트 10kg / 개당 400g 내외,63900,61720,-2180
2018-06-01,2139484747,C013030,스웨터,MNT_117 체인 폴라 니트 겨울옷 남성겨울옷 겨울니트,45640,45640,0
2018-06-01,2123105885,A017090,열무,[익산원예농협] 붉은속살 뿌리채소  비트 2kg,13900,13430,-470
2018-06-01,983390579,E061090,방향제,[불스원]불스원)부동액 보충용1L,8500,8500,0
2018-06-01,986276711,A011170,떡,칠갑 쫄면 야채 떡볶이 588G,3280,3280,0
2018-06-01,2081539190,A017050,미나리,방울양배추 미니양배추 1kg 지퍼팩포장,12800,12800,0
2018-06-01,820984362,C011050,남자내의,(905/레이스자수꽃)밑단레이스 스프사 9부 파자마,12640,11250,-1390
2018-06-01,1835543803,G011070,자전거,GIFT 2018 삼천리 22 루시아 여성용 시티 자전거,283000,283000,0
2018-06-01,243317484,E031120,믹서,[필립스 정품]HR-1393/다지기/믹서기/미니분쇄기/HR1393 야채다지기/마늘다지기/음식물,32900,32900,0
2018-06-01,559202230,A014030,치즈,DS091 코다노 체다치즈 주황색 2.5kg 가공식품 조미료,53100,53100,0
2018-06-01,63380660,A019110,드레싱,차오코 코코넛밀크 크림 150~500ml 3팩,5800,5800,0
2018-06-01,43581466,L021060,유모차,쿨키즈 CK플러스 유모차/휴대용유모차/기내반입,69000,69000,0
2018-06-01,870512793,C013040,청바지,[게스]GUESS 여성_[기획] 노브러쉬 울트라 앵클스키니(YH1D9048),49000,41160,-7840
2018-06-01,1365776577,E041070,밀폐용기,식품용기/양념통/단지/젓갈통/젓갈단지/액젓통//된장단지/된장통/고추장통/양념단지/플,350,330,-20
2018-06-01,631632221,E031040,전기레인지,아이엠냉장고KD-138F(138L) 미니냉장고 사무실/원룸,219000,219000,0
2018-06-01,1823461967,C013040,청바지,[게스][18SS] YI1D9031 BLK 여 블랙블랙 앵클스키니,47900,45990,-1910
2018-06-01,2070310163,A018030,껌,tvn문제적남자 방영 뇌섹껌 100g/뇌섹캔디/집중력향상,9900,9900,0
2018-06-01,988284478,E031070,에어컨,클리나 타워형선풍기/리모컨 타워팬/스탠드선풍기,29900,29900,0
2018-06-01,987973558,A011180,파스타면,[폰타나]이탈리아 캄파니아 스파게티 500G,2500,2500,0
2018-06-01,1522700547,F012050,의료측정기,오므론 일제 자동혈압계 JPN601+수첩 혈압측정기,129500,118000,-11500
2018-06-01,379517040,C014020,유아복,여자 아이 아동 어린이 상하 실내복 여름 반팔 순면,10730,10730,0
2018-06-01,1259705139,D031010,주택수선재료,[테라코코리아]핸디코트25kg/핸디텍스20kg/워셔블25kg,15500,15500,0
2018-06-01,152429570,E061040,부엌용세제,EM 발효 주방 세제/식기 과일 채소 겸용/친환경/천연,9950,9950,0
2018-06-01,185779259,A011120,두부,퀘이커 오츠 오트밀 1.19kg 그래놀라 시리얼 간편식사,6300,6300,0
2018-06-01,2027399459,L021060,유모차,[Harvey][어댑터+신생아패드 증정!][Harvey] 하비 유모차 - 럭셔리 블랙 (블랙 스타일,965000,820250,-144750
2018-06-01,1199919972,C011030,남자학생복,남자 바람막이 점퍼 블루종 자켓가디건 스타일 좋은,27700,27700,0
2018-06-01,783135853,D031010,주택수선재료,연두하우스 _ 현관문 시트지 100x210 /접착_ 물시트지,34900,34900,0
2018-06-01,990032300,A019050,간장,청정원 양조간장 깊고풍부한맛 1.7L,13990,7990,-6000
2018-06-01,108545976,C012040,여자학생복,2018신상 상큼발랄~베스트 조끼 롱조끼/니트조끼/셔츠,12900,12900,0
2018-06-01,990032303,A019050,간장,청정원 양조진간장 진한맛플러스 1.7L,9900,6490,-3410
2018-06-01,1773226314,C013050,운동복,상하세트 유아상하세트 핑크상하세트/상하복세트 맨투,47200,40120,-7080
2018-06-01,1027474341,C013030,스웨터,BIG39 남자빅사이즈V라인니트티 큰옷니트 니트 남자큰,52850,52850,0
2018-06-01,1394685059,C013010,점퍼,안감양털 박시 오버사이즈 코트 예쁜여성코트 DM-4043,78180,74280,-3900
2018-06-01,120039121,F011130,홍삼,CJ 6년근 홍삼진 골드 70mlx30포,29800,29800,0
2018-06-01,447484954,C013020,티셔츠,[무료배송]파이럿후드티 후드티셔츠 후드긴팔티 스타,22570,22570,0
2018-06-01,1018580362,I031040,생화,사계절 동계용후드침낭 트윈연결 기능 캠핑침낭,36000,30180,-5820
2018-06-01,952082392,A019080,고추장,㉭ 사조해표 순창궁 태양초 고추장(6.5KG),12480,12480,0
2018-06-01,1778593466,L021010,손목시계,[바보사랑]Gc Twist 여성시계(가죽)_Y13007L1,318000,318000,0
2018-06-01,583593553,F011150,건강기능식품,국내산 미숫가루 선식 아침 식사대용 곡물가루 죽,12000,11800,-200
2018-06-01,1778593462,L021010,손목시계,[바보사랑]Gc LadyChic 여성시계(가죽)_Y11001L1,318000,318000,0
2018-06-01,1778593463,L021010,손목시계,[바보사랑]Gc LadyChic 여성시계(가죽)_Y11002L1,318000,318000,0
2018-06-01,1778593464,L021010,손목시계,[바보사랑]Gc LadyChic 여성시계(가죽)_Y11003L1,318000,318000,0
2018-06-01,559853127,A022010,주스,(무료배송)미닛메이드 알로에 175ml x30can,9500,9500,0
2018-06-01,1778593465,L021010,손목시계,[바보사랑]Gc Twist 여성시계(가죽)_Y13006L1,288000,288000,0
2018-06-01,1841778283,I031040,생화,캠핑 쿨러백 5~30리터 보냉가방 아이스백,8500,7820,-680
2018-06-01,2088769150,E041050,냄비,무료배송[클레디움 샤브샤브 전골냄비]스텐 통3중 냄비 양수냄비 편수냄비 스텐냄비 샤,32600,32600,0
2018-06-01,461072333,C021040,실내화,[아디다스오리지널스]UNISEX ORIGINALS 니짜 슬립온2종 [CQ3103][CQ3104](광주신세계),44800,37380,-7420
2018-06-01,1890476176,I031010,장난감,경찰 전동 오토바이 유아 스쿠터 바이크 사이클 선물,82770,82770,0
2018-06-01,1778593460,L021010,손목시계,[바보사랑]Gc Esquire 남성시계(가죽)_Y08006G1,488000,488000,0
2018-06-01,1778593461,L021010,손목시계,[바보사랑]Gc LadyChic 여성시계(가죽)_Y10002L1,348000,348000,0
2018-06-01,1122504341,C013040,청바지,{G2_18S0305}남아체크배색7부팬츠/ 소이,7900,7430,-470
2018-06-01,1783119675,L021010,손목시계,[공식  백화점AS] Gc Femme Bijou 여성시계(메탈)_X52003L1S,448800,448800,0
2018-06-01,2139484710,C013030,스웨터,MNT_114 더블체인 폴라 니트 겨울니트 니트폴라 겨울,45640,45640,0
2018-06-01,1783119676,L021010,손목시계,[공식  백화점AS] Diver Chic 여성시계(가죽)_X35006L1S,593300,593300,0
2018-06-01,1903743151,A015020,식용유,스페인 커클랜드 올리브오일 3L/올리브유100%코스트코,25980,25980,0
2018-06-01,1096984554,A012030,돼지고기,(두메촌) 돼지 목살 / 수입 냉동 목전지 왕목살 500g,2900,2900,0
2018-06-01,650336217,A017050,미나리,미니 방울 양배추 제주방울양배추 1kg,890000,890000,0
2018-06-01,1783119674,L021010,손목시계,[공식  백화점AS] Gc SlimClass 여성시계(가죽)_X60016G1S,295800,295800,0
2018-06-01,2058451130,E031130,보온매트,비비스_ 스누피 전기요(더블) SM-2012 /(참고)전기요,91500,77780,-13720
2018-06-01,1981110163,A018100,꿀,커클랜드 시그니처 허니 벌꿀 100% 2.26kg,37580,37580,0
2018-06-01,61717075,C015040,장갑,학생 장갑 이중장갑 남성장갑 여성장갑 벙어리장갑 수면양말 털장갑 니트장갑 요술장갑,5000,4900,-100
2018-06-01,485999744,I031010,장난감,(5개묶음)n14801/5000 디즈니 캐릭터 나노블럭/미키마우스 미니마우스 구피 도날드덕,22280,22280,0
2018-06-01,627308625,I011030,사진기,캐논 Powershot G9X Mark II 정품 + 정품 파우치 명품,414400,381160,-33240
2018-06-01,1345650094,C013040,청바지,퍼트 데님멜빵팬츠/ 핑크시슬리,49900,39920,-9980
2018-06-01,1778593370,L021010,손목시계,[바보사랑]Gc CableChic 여성시계(메탈)_Y18114L1,488000,488000,0
2018-06-01,423293859,C013010,점퍼,남자아우터 뽀글이 카라 항공 패딩,61490,61490,0
2018-06-01,1778593371,L021010,손목시계,[바보사랑]Gc LadyBelle 여성시계(가죽)_Y22005L3,258000,258000,0
2018-06-01,1404101490,C012030,여자상의,레이스펀칭원피스/화이트롱원피스/화이트원피스,29800,29800,0
2018-06-01,1872435958,C014020,유아복,[플레이몰]아동반바지3부 냉장고자동차,4900,4660,-240
2018-06-01,1778593372,L021010,손목시계,[바보사랑]Gc Structura 남성시계(가죽)_Y23006G7,478000,478000,0
2018-06-01,1778593373,L021010,손목시계,[바보사랑]Gc Structura 남성시계(가죽)_Y23009G4,478000,478000,0
2018-06-01,1048874487,C012060,여자내의,[나무그림][MD추천]시원한_B린넨치마반바지/C18MIV6P064S5,19000,15580,-3420
2018-06-01,820211410,I031040,생화,LED 손전등 후레쉬 줌라이트 충전식 다용도 랜턴 V6,25000,23000,-2000
2018-06-01,822365190,C013050,운동복,롤리핏/요가복/헬스복/필라테스/운동복/레깅스/탱크탑,9900,9900,0
2018-06-01,347288335,E031040,전기레인지,RT9 (Coms) DC 12V 시가전원 7.5L 차량용 냉온장고,68500,67130,-1370
2018-06-01,1261240839,C012060,여자내의,빅사이즈/벨리/레이스/스커트 벨리레이스스커트 빅사,27980,27150,-830
2018-06-01,1404813447,F011150,건강기능식품,여명 808 숙취 해소 음료 그래미 119ml 24캔 컨디션,77000,77000,0
2018-06-01,1308772558,C013020,티셔츠,작시 아동 리본샌들 ZXK182GBB011-JS,33800,33800,0
2018-06-01,1366726918,C013030,스웨터,[공구우먼] 케미 오픈카라 니트티 29058 빅사이즈여성의류 루즈핏,27000,27000,0
2018-06-01,932175324,E031010,전기밥솥,위즈웰 DRC-1 나만의 미니밥솥1인용/전기밥솥,24900,21900,-3000
2018-06-01,2040150983,L021050,우산,[태광] 우의 비옷 우비 판초우의 낚시 등산 오토바이,32000,29900,-2100
2018-06-01,1433195528,A012010,국산쇠고기,[무항생제] 국거리 400g 1등급,21500,21500,0
2018-06-01,1860265328,A011010,쌀,7분도 흑백미 10kg /무료배송,24500,24500,0
2018-06-01,1855932588,C013020,티셔츠,패션24시 30% 할인 나나살롱 원피스/반팔티/린넨셔츠,19000,19000,0
2018-06-01,177343872,E031090,공기청정기,특가 다이슨 공기청정 선풍기 TP03 /이벤트,673000,631210,-41790
2018-06-01,293388354,C013050,운동복,[알파] (옵션 : (5416040)옵션없음) (975629)(),10460,9540,-920
2018-06-01,1778593367,L021010,손목시계,[바보사랑]Gc LadyChic 여성시계(가죽)_Y12002L3,348000,348000,0
2018-06-01,288211878,A011010,쌀,[참쌀닷컴] 임금님표 이천쌀 추청 4kg,17900,17900,0
2018-06-01,1778593368,L021010,손목시계,[바보사랑]Gc B1-Class Lady 여성시계(가죽)_Y17001L1,258000,258000,0
2018-06-01,1778593369,L021010,손목시계,[바보사랑]Gc CableChic 여성시계(실리콘)_Y18011L1,298000,298000,0
2018-06-01,36983373,C011030,남자학생복,[에잇세컨즈][리넨 블렌디드] 그레이 노버튼 카디건 (22835AWY13),39900,39110,-790
2018-06-01,1778593364,L021010,손목시계,[바보사랑]Gc LadyChic 여성시계(메탈)_Y05005M2,548000,548000,0
2018-06-01,683108423,A012060,햄및베이컨,[바스 촙트햄4.536kg]부대찌개 부대햄 부대찌개국물용,36500,36500,0
2018-06-01,1778593365,L021010,손목시계,[바보사랑]Gc LadyChic 여성시계(메탈)_Y06004L1,458000,458000,0
2018-06-01,1778593366,L021010,손목시계,[바보사랑]Gc LadyChic 여성시계(가죽)_Y10001L1,348000,348000,0
2018-06-01,1466244587,L012010,면도기,쉬크 면도날8입+면도기 하이드로5/3 쿼트로티타늄,10500,10500,0
2018-06-01,1968183857,L012060,샴푸,3+1 5초 우유단백질 샴푸/트리트먼트 1L 대용량,8900,8900,0
2018-06-01,395036673,C012040,여자학생복,ME by 레이스 라운드 블라우스 MIWBL8552L/ 미쏘,35900,34110,-1790
2018-06-01,990056329,E041030,솥,PN풍년 빨래삶는솥30,37500,22000,-15500
2018-06-01,1085127593,C013010,점퍼,버튼 루즈핏 점퍼/ 미스티에이치,9000,8100,-900
2018-06-01,395036677,C012040,여자학생복,ME by 프릴 태슬 블라우스 MIWBL8562L/ 미쏘,35900,34110,-1790
2018-06-01,230403325,C014020,유아복,아동바지 플라워통바지 KIDBOK-200 바지 긴유아바지,16780,16780,0
2018-06-01,1091257866,C013020,티셔츠,[티렌]스트라이프 티셔츠(T182PSM204),39000,31200,-7800
2018-06-01,242972662,E041070,밀폐용기,스텐밧드 받드 밧트 바트 밧드 업소용 반찬통 사각 양,4700,4330,-370
2018-06-01,1397511240,A013080,조개,두레생협 새우살(300g/국산) 새우살 새우 두레생협새,35530,34820,-710
2018-06-01,1533063934,A014030,치즈,코리원 체다 슬라이스치즈 100매/치즈/토스트/햄버거,11900,11900,0
2018-06-01,318727873,A017230,마늘,아삭싱싱! 요리필수 2018년 햇 양파 10kg,6900,6900,0
2018-06-01,961216123,C013050,운동복,차량용 봉타입 옷걸이/차량용행거/자동차행거,13500,11180,-2320
2018-06-01,1778593396,L021010,손목시계,[바보사랑]Gc-3 Sport 남성시계(가죽)(Swiss made)_X10002G7S,728000,728000,0
2018-06-01,1778593397,L021010,손목시계,[바보사랑]Gc TurboSport 남성시계(메탈)(Swiss made)_X11001G2S,758000,758000,0
2018-06-01,981296874,C011030,남자학생복,[필골드] SL S1TS604 와펜 저지 집업트레이닝 상의,39800,39800,0
2018-06-01,1778593398,L021010,손목시계,[바보사랑]Gc Diver Chic 여성시계(메탈)(Swiss made)_X35015L4S,528000,528000,0
2018-06-01,1778593399,L021010,손목시계,[바보사랑]Gc TechnoSport 남성시계(가죽)(Swiss made)_X51005G1S,648000,648000,0
2018-06-01,2086534702,F012010,종이기저귀,18년형 쿨썸머그린 밴드/팬티기저귀 1박스,36900,36900,0
2018-06-01,8762858,C011030,남자학생복,[빅사이즈 솔리드 5버튼 가디건411]라운드넥니트 빅사이즈가디건 직장인패션 남성빅사,52030,46310,-5720
2018-06-01,1253138904,C012060,여자내의,빅사이즈/망사/주름/롱/스커트 망사주름롱스커트 빅사,43680,43680,0
2018-06-01,1186344983,C012060,여자내의,[제이빔]쿨터치 8부 슬랙스 JVTS18401,29900,29900,0
2018-06-01,1778593395,L021010,손목시계,[바보사랑]Gc Executive 남성시계(가죽)_Y27002G1,358000,358000,0
2018-06-01,355245728,C021040,실내화,하이탑 운동화 런닝화 농구화 조깅화 스니커즈,23800,20800,-3000
2018-06-01,1310554095,I012010,컴퓨터,프리미엄 렌탈중고컴퓨터세트 + 신품LED/윈도우7 10,270000,259000,-11000
2018-06-01,2142255827,L021030,가방,기라로쉬 쿨러 숄더백/기저귀가방/보냉가방,20000,18900,-1100
2018-06-01,1841369722,A019180,즉석식품,(푸드천국)국탕덮밥/육개장/갈비탕/곰탕/해장국/덮밥,1790,1790,0
2018-06-01,120668723,C013020,티셔츠,반팔 L~3XL 큐티/빅사이즈/롱티/무료배송/라운드티,13900,12900,-1000
2018-06-01,869871699,C013050,운동복,똑똑한 컵홀더모음전/차량용컵홀더/텀블러컵홀더,7000,6260,-740
2018-06-01,1198715671,F012010,종이기저귀,[군] 군(GOO.N)소프트 팬티 기저귀 특대형(XL) 22P x 6팩,46900,46900,0
2018-06-01,1065859842,A013090,전복,부경 냉동반가리비 2.1kg(210gx10),59070,59070,0
2018-06-01,1202719825,C012060,여자내의,[제시뉴욕] 어깨트임프릴점프수트 J74-OP2140NY,152600,141920,-10680
2018-06-01,862496886,A013160,맛살,한성통통맛살H(1kg)간식 맛살 어묵 간편조리식 가공식,13000,12870,-130
2018-06-01,22614967,F011150,건강기능식품,유기농 미숫가루(NON-GMO콩)고소하고 맛있는 미숫가루,9500,9500,0
2018-06-01,1440647733,A014050,달걀,[산지직송] [올계] 유기농 자연방사 유정란 20구,16900,16900,0
2018-06-01,461806221,C021020,구두,[모다아울렛][에스콰이아]에스콰이아 남성 정장구두 PF8SHD038,126000,113400,-12600
2018-06-01,1832367907,L021060,유모차,압도적 슬림함 기내반입 티크미니 휴대용 포켓유모차,260000,260000,0
2018-06-01,1854343680,E011020,침대,침대깔판,20900,20900,0
2018-06-01,1974020120,E051030,디지털도어록,BEE 전자키4+번호키 디지털도어락 도어락 현관문 열쇠,102000,91910,-10090
2018-06-01,895797599,E061010,세탁세제,[LG]LG 테크리필 3.2KG,17500,5000,-12500
2018-06-01,895858952,L012080,화장지,[미래생활]미래생활 잘풀리는집 곽티슈 (200매*3입),5490,5490,0
2018-06-01,1036116930,E061060,살충제,화랑곡나방 트랩 쌀나방 쌀벌레 퇴치,5000,5000,0
2018-06-01,1485707975,C012060,여자내의,피오나 러브고뎃 skirt/m6275/스커트/ 피오나,28600,22030,-6570
2018-06-01,537588513,A018070,파이,롯데제과 초코파이/몽쉘 4개 구성,8900,8900,0
2018-06-01,632161010,I011030,사진기,(컴온탑)니콘 D850 BODY (18년4월/가이드북/캐시백),3792390,3489000,-303390
2018-06-01,623871755,I031070,애완동물관리비,멀티 게임기 미니 당구대 탁구대 에어 하키 포켓볼,130000,118000,-12000
2018-06-01,260339828,I011030,사진기,명품마을 캐논 정품 EOS 800D 바디 DSLR/카메라,771810,771810,0
2018-06-01,461157777,E061020,섬유유연제,엘지생활건강 샤프란 핑크센세이션 2.5L x4개 P,10900,9900,-1000
2018-06-01,313999147,C011030,남자학생복,남성 후드 집업 롱가디건 점퍼 자켓 골지 숄 봄 외투,54500,54500,0
2018-06-01,952880879,A022050,탄산음료,롯데 트로피카나 스파클링 사과 (355ML*6),4500,3900,-600
2018-06-01,989079763,G022010,자동차용품,초L)에탄올 사계절 워셔액 1.8L,2900,2900,0
2018-06-01,989079764,G022010,자동차용품,초L) 에탄올 발수코팅 워셔액 1.8L,3900,3900,0
2018-06-01,1075511542,A016160,과일가공품,미국산 건블루베리 310g 블루베리 건과일 견과류 선물,32000,31680,-320
2018-06-01,170086052,I031010,장난감,[BB하우스]유키두)빙글빙글 수도꼭지(백화점독점상품)(마산점),40000,34920,-5080
2018-06-01,1867387088,C013020,티셔츠,임부복 롱 원피스 티셔츠모음/임부복 빅파라,16800,12800,-4000
2018-06-01,429644819,C012040,여자학생복,제이드 체크 롱 셔츠,15900,15900,0
2018-06-01,952880880,A022050,탄산음료,[롯데]롯데 트로피카나 스파클링 오렌지 (355ML*6),4500,3900,-600
2018-06-01,217559416,E011030,거실장,[까사베르데][멜리사 거실장]tv다이/티비다이/tv장,59000,59000,0
2018-06-01,441094828,C012020,원피스,엄마옷 마담4060 카라단추벨트자켓-XJK805019-,97900,82980,-14920
2018-06-01,989138541,A013150,어묵,초L)부산어묵 쫄깃사각 300G*2,3280,2790,-490
2018-06-01,874892510,E011010,장롱,[이노센트+]라인 미엘슬라이딩 6자/9자옷장/장롱/장농,474700,474700,0
2018-06-01,986213254,F011150,건강기능식품,[풍기][풍기인삼농협][황풍정] 봉밀홍삼절편 20g*10p,48000,48000,0
2018-06-01,1360818426,A018080,설탕,대한제당/갈색설탕5k/하얀설탕5k/푸드림/cj설탕/백설,8300,8300,0
2018-06-01,1721908980,E031110,청소기,시즌2 단후이 로봇청소기+물걸레겸용/최신버전 정품,298000,298000,0
2018-06-01,1089497901,L012090,기초화장품,아이오페 아이디얼 리치 클렌징 크림 200ml,16900,16900,0
2018-06-01,926023689,E021010,침구,봄이불/차렵이불/사계절 간절기이불/순면이불,23900,21990,-1910
2018-06-01,1715862204,F012020,생리대,[쏘피] 입는생리대 안심숙면팬티 L 5P×2팩+L 2P×1팩(사은품증정)/ 바디피트,15900,15900,0
2018-06-01,1409964997,I031040,생화,캠핑용 미국명품 NASHUA DUCT TAPE - 다용도 덕 테이프 각종수리 및 고정시 사용가능,24930,22820,-2110
2018-06-01,895797573,A013180,젓갈,한성 숙성 광천 새우젓 (150G),5680,5680,0
2018-06-01,1715862201,F012020,생리대,[쏘피] 입는생리대 안심숙면팬티 S 5P×2팩+S 2P×1팩(사은품증정)/ 바디피트,15900,15900,0
2018-06-01,430043448,C014010,아동복,[프렌치캣]라임 프릴 롱TS Q62DKT480,18000,15300,-2700
2018-06-01,895797570,A019050,간장,[한라]한라 참치액 900ML,13490,13490,0
2018-06-01,558954852,A017020,상추,용천유기영농의 신선한 유기농쌈채소 600g/1kg,12900,12900,0
2018-06-01,88508791,C013050,운동복,M~4XL빅사이즈 트레이닝반바지 남자반바지 츄리닝바지,5900,5900,0
2018-06-01,559999596,C013010,점퍼,소매 아일렛점퍼(EH2EZ301)/ 에고이스트,79000,63200,-15800
2018-06-01,568747081,E031080,선풍기,한빛 원적외선 전기온풍기 hv-3300(3kw) - 전기히터,542540,482870,-59670
2018-06-01,1920209469,A011080,밀가루,[추천특가] 백제물산 즉석 쌀떡국16개 쌀국수30개 선택구매 /야식/즉석식품/식사대용/,26500,25900,-600
2018-06-01,494627457,C012060,여자내의,(JJ지고트) 언발 플레어 버튼 고리 랩스커트 GI3A0SK21/ 제이제이지고트,179000,161100,-17900
2018-06-01,680887848,C013050,운동복,K-345 스타렉스 2004후사경 차량용후사경 후사경 차량,25470,23210,-2260
2018-06-01,494448740,C021020,구두,1434 4.0cm 여성 슬링백,69600,69600,0
2018-06-01,723582702,C013010,점퍼,[포래즈]착 감기는 바람막이_F17D2JP301,15000,13840,-1160
2018-06-01,309493018,C013010,점퍼,[대구백화점 II관] [레코브]뉴 파스텔 점퍼(LU3186JP505X),47800,43980,-3820
2018-06-01,895858981,E061020,섬유유연제,[LG]LG 샤프란 아로마 2.1L*2입기획,8800,5490,-3310
2018-06-01,306163829,C013020,티셔츠,[앨빈클로]기모 무지 후드티 커플룩 맨투맨 양털집업,25000,14900,-10100
2018-06-01,1931344727,I031070,애완동물관리비,17 윌슨 테니스라켓 블레이드101L (101sq/274g/16x20),198100,165620,-32480
2018-06-01,418764572,C011050,남자내의,(남자옷도매) DP-251 9부스판 면팬츠 (S-XL) 네이비,38670,38670,0
2018-06-01,1668193258,F011130,홍삼,한삼인 순수홍삼(50ML*30입),26290,26290,0
2018-06-01,1257590597,I012010,컴퓨터,할인가67만+리뷰가방증정)삼성 노트북5 NT500R5W-LD5A,799000,729000,-70000
2018-06-01,1646120592,E041050,냄비,샤브냄비모음 경질냄비 스텐냄비 반반냄비 삼중냄비,13000,12800,-200
2018-06-01,279845364,I012010,컴퓨터,애플정품 16년형 New iMac MK462KH/A 5K 레티나/아이맥신형/SG/재고보유,2481390,2481390,0
2018-06-01,1911460354,A013090,전복,국내산 깐 바지락살 (급냉) 250g,6900,6900,0
2018-06-01,1106869200,A019070,양념소스,회 간장4종 사시미간장 치엔 니비시 기꼬만 야마사,3900,3900,0
2018-06-01,506934692,C013010,점퍼,토끼 바람막이 점퍼/ 보니스텔라,29800,27720,-2080
2018-06-01,121702488,A019080,고추장,홍진경 고추장 950g,34900,34900,0
2018-06-01,1127584561,C012060,여자내의,[무료배송 44~110]634357SK_기본 무지 스판 H라인 스커트/단체복/유니폼/오피스룩_,19900,18900,-1000
2018-06-01,1774081313,I031040,생화,키모니 무릎보호대 발목보호대 허벅지 종아리보호대,10000,9020,-980
2018-06-01,989138537,A013150,어묵,초L)부산어묵 얇은사각 200G,1100,1100,0
2018-06-01,977211332,A018100,꿀,마누카꿀 꿀스틱 휴대용꿀 마누카원액 2018.06.26,6000,6000,0
2018-06-01,1959575002,A018040,아이스크림,[초특가] 매그넘 아이스크림 36개+비엔네타,43110,43110,0
2018-06-01,147590635,A018090,잼,18년산 하우스베리 생잼 골드 300g 병,16600,15600,-1000
2018-06-01,121702489,A019080,고추장,홍진경 고추장 450g,22500,22500,0
2018-06-01,418788536,E041050,냄비,퐁듀도자기 소 예쁜도자기퐁듀 도자기퐁듀 심플퐁듀,21800,21800,0
2018-06-01,1908206677,E061020,섬유유연제,(코스트코) 커클랜드 시트형/종이형 섬유유연제 250매,6730,6730,0
2018-06-01,263877531,E051020,건전지,파나소닉 프로 에네루프 충전지 AAA/AA 4알충전건전지,11420,11420,0
2018-06-01,1388449526,C013010,점퍼,AGC후드 집업점퍼 브루클린 배색 오픈 CC집업점퍼후드,49050,49050,0
2018-06-01,1232772030,A017200,토마토,햇 가지 1.5Kg /5Kg,14900,14900,0
2018-06-01,18000537,A013100,마른멸치,(수량한정) 횟감용 중대전복 13미 1kg,39900,39900,0
2018-06-01,1719279817,C012040,여자학생복,뷔스티에/블라우스/오프숄더/플라워/원피스/여자/여름,8900,8900,0
2018-06-01,1354436485,A016090,참외,꿀벌 성주참외 5kg/ 실속가정용,11900,11900,0
2018-06-01,1597092592,E061030,전구,필립스 오스람 장수 두영 FL 형광램프 형광등 직관형,22000,22000,0
2018-06-01,556631748,C013020,티셔츠,[국내제작] 면 스판 골지 크롭탑 민소매 끈 나시,4000,3900,-100
2018-06-01,300566004,C012040,여자학생복,[모다아울렛][막스카라]민소매브라우스M82QWB339MEB1,69000,62100,-6900
2018-06-01,2095152940,C013050,운동복,전차종 콘솔쿠션커버,7590,7590,0
2018-06-01,1500156297,L012090,기초화장품,[은율] 대용량 내츄럴 스킨 토너 500ml / 펌핑식용기,6900,6900,0
2018-06-01,1273275798,C013020,티셔츠,나팔소매원피스티/꽃무늬티/프린트티/미시롱티/프릴티,9900,9900,0
2018-06-01,135855337,A016120,바나나,[대용량]고당도 에스트렐라 바나나 8손/13kg/선별과,39900,35900,-4000
2018-06-01,899345556,E061090,방향제,페브리즈 비치형 리필 바닐라 라벤더 (5.5ML),5100,5100,0
2018-06-01,2000163093,C012030,여자상의,빅사이즈민짱/무료배송/데일리원피스모음/루즈핏/롱,19900,19900,0
2018-06-01,321340160,C013050,운동복,봄신상 남녀공용 엠보싱 트레이닝복 세트 + 무료배송,8900,8900,0
2018-06-01,1368516457,A011030,찹쌀,국산 보리쌀 10kg모음/찰보리/쌀보리/늘보,20900,20900,0
2018-06-01,1360458990,C012060,여자내의,허리밴딩 TR 큐롯팬츠 치마바지 숏팬츠 밴딩팬츠,11500,10700,-800
2018-06-01,408459443,A022020,두유,맛있는두유GT190mlX24팩/32팩/담백/달콤/검은깨/17곡,7900,7900,0
2018-06-01,2031338865,C012060,여자내의,[악녀일기]헤든H스커트(S~L),40320,35090,-5230
2018-06-01,899500305,E031070,에어컨,[신일][신일 공식지정업체]신일 16형 스탠드형 선풍기 SIF-167FSJ/고급스러운 블랙 펄코팅/좌우회전/상하조절,65000,56800,-8200
2018-06-01,1974612818,C012030,여자상의,정품 100% 풍기인견 민소매/캡소매 원피스 블라우스,19900,19900,0
2018-06-01,1313081395,A013080,조개,두레생협 냉동굴(400g) 요리용냉동굴 해물파전용굴 파,20660,20660,0
2018-06-01,790984010,A019110,드레싱,CJ 미니 파인애플 소스(115G),1380,1380,0
2018-06-01,1868036317,C013050,운동복,[JW산업] 중외 에탄올워셔액 워셔액 친환경워셔액 사계절워셔액,2000,1660,-340
2018-06-01,173734860,C012060,여자내의,[에잇세컨즈]블랙 플로럴 캉캉 롱 스커트 (128327Q455),49900,44910,-4990
2018-06-01,1118195819,C013040,청바지,[나나진]신상/남자청바지/스키니/일자/배기/캐쥬얼,19800,19800,0
2018-06-01,18012546,A013090,전복,(맛나)냉동개조개하프1kg/해조은,6600,5940,-660
2018-06-01,456075598,C013040,청바지,[모드나인(mod9)]Red Route 308 - MOD1s(강남점),108000,94290,-13710
2018-06-01,2067201202,A022010,주스,랭거스(망고 자몽)449ml*12병/박스(자몽1.89리터*8병),28900,28100,-800
2018-06-01,354968199,A011040,보리쌀,2018년 햇 병아리콩2kg/렌틸콩2kg/귀리4kg,6200,6200,0
2018-06-01,467907655,C013020,티셔츠,면스판 기본 박스 라운드티 DM-5639 여성반팔티 패션,9770,9770,0
2018-06-01,1870002432,C013020,티셔츠,남자나시/민소매/스포츠/무지나시/조던자수/헬스/운동,8000,8000,0
2018-06-01,393966122,C013060,등산복,[컬럼비아(COLUMBIA)]컬럼비아 남녀 역시즌 다운재킷 모음전(CW4-YL3691 YMM017 WE551,62180,62180,0
2018-06-01,1454522795,F011150,건강기능식품,까스활 75ml x 20병_소화제_부채표 동화약품 소화제,20310,18080,-2230
2018-06-01,2069188680,I011030,사진기,[정품]EOS 750D/18-55mm IS STM렌즈포함/32G 풀패키지,796000,713920,-82080
2018-06-01,983390610,A021010,커피,[동서]동서 카누 마일드 미니(스위트) 100T*2.9G,21900,21900,0
2018-06-01,1147779212,A013170,생선통조림,동원참치 10캔 마일드/살코기/고추/참치캔/DHA,11100,8900,-2200
2018-06-01,366402772,C012020,원피스,오피스룩/린넨/여름정장세트/원피스/블라우스 한번에,43900,43900,0
2018-06-01,323518328,C011050,남자내의,지오다노 테이퍼드 링클프리 팬츠 118505,50830,50830,0
2018-06-01,382048132,C012020,원피스,[르샵]노카라 포켓 바바리 (LI5BY603)(영등포점B),129000,115120,-13880
2018-06-01,1261166671,A019100,식초,오뚜기 식당용케찹 3.3kg 스파우트팩,4100,4100,0
2018-06-01,264656109,A017020,상추,적상추.청상추-1kg.2kg 4kg,19900,19900,0
2018-06-01,1279925032,C013040,청바지,(에끌) 프리미엄 스키니 일자 제깅스 /청바지/레깅스,16900,15900,-1000
2018-06-01,597803049,A012050,소시지,핫바 9종/10개 사조 하림 마니커 어묵 불고기 후랑크,4800,4800,0
2018-06-01,562058444,C013050,운동복,멀티 성에제거기_1544 멀티성에제거 차량성에제거기,8680,7920,-760
2018-06-01,452782909,L012060,샴푸,[제이숲] 리아비책 샴푸/헤어팩/ 헤어토닉 택1,30900,30900,0
2018-06-01,1062971070,A016110,딸기,제이제이 냉동딸기 1kg 냉동식품 냉동딸기 제이제이,13960,13960,0
2018-06-01,599091480,L021020,장신구,14k정품 귀걸이 14k피어싱 골드 TR122_한쪽,21900,21900,0
2018-06-01,704912493,A012060,햄및베이컨,[한성기업] 한성 런천미트 340gx24개 1박스,36990,36990,0
2018-06-01,1738261672,A016020,배,도라지배즙(100mL×20입)/ 초록마을,27000,27000,0
2018-06-01,959556945,E061030,전구,[GE삼성]GE삼성) 직관 형광등 삼파장 18W,4900,4900,0
2018-06-01,1447562081,A016040,포도,동원)황도 슬라이스 400g x 12개 사시사철 맛있는,38450,38450,0
2018-06-01,959556949,A011080,밀가루,풀무원 함흥 비빔냉면 (460G),6450,3490,-2960
2018-06-01,1001698838,C013020,티셔츠,L.LAMO 여름 반팔 티셔츠 빅사이즈 남녀공용 ~4xl,9800,9800,0
2018-06-01,91630709,L012030,칫솔,[조르단]어린이칫솔x12개 유아칫솔 스텝/치간칫솔,13900,13900,0
2018-06-01,464972228,I031040,생화,휴대용 충전식 LED 다용도 램프 K402/랜턴/캠핑등,26800,22790,-4010
2018-06-01,1503371786,I031070,애완동물관리비,[윌슨] 윌슨 MILOS 100 테니스라켓 그라파이트소재 용품 공,89000,88110,-890
2018-06-01,848613329,C013020,티셔츠,30%할인 벨라 스트릿 패션 여름 패션 M-XXL 남여공용,10000,10000,0
2018-06-01,214056078,A019110,드레싱,(참소당 유자폰쯔유0.9L)폰즈소스 샤브샤브소스1.8L,7100,7100,0
2018-06-01,1333927033,A012040,닭고기,오쿡 닭가슴살 5kg (200gx25개)/그릴/오리지날/훈제,46700,46700,0
2018-06-01,1386995365,I011030,사진기,캐논 정품 EOS 750D + 18-135mm IS STM 명품마을,949290,873260,-76030
2018-06-01,933499391,A011180,파스타면,푸실리 트리칼라 500g 판타넬라 삼색 마카로니 파스타,1280,1280,0
2018-06-01,1570917688,I031010,장난감,Step2 멜로디 지붕차 지붕카 승용완구 지붕차 유아승,227280,227280,0
2018-06-01,300542064,C012060,여자내의,[모다아울렛][지컷]주름스커트 7217335003,114500,108780,-5720
2018-06-01,319809780,E031010,전기밥솥,(추천)쿠첸 2중/3중 압력밥솥 고무패킹/압력패킹13종,5430,5110,-320
2018-06-01,1978798157,C013030,스웨터,남자후드집업 데님 후드집업 C0217005 패션후드집업,52410,52410,0
2018-06-01,1199496178,C021040,실내화,[고도리슈즈] 남여 커플 런닝화 가볍고 편안한 운동화 스니커즈,26900,26900,0
2018-06-01,228474101,C012040,여자학생복,린넨 노카라 자켓 LRT027 여성봄자켓 가디건(YA02004),80600,80600,0
2018-06-01,1697779466,E021010,침구,국내산 사계절 차렵이불+패드+베개세트 / 침구3종세트,33900,33900,0
2018-06-01,515248081,E031130,보온매트,@TV홈쇼핑정품@ 명품 일월 온돌마루 피톤치드 나노륨 매트 슈퍼 특대형/고급형/절전형,248000,245520,-2480
2018-06-01,442886320,A013060,게,인풍 오징어채 1kg2개,40220,40220,0
2018-06-01,808582281,E011060,의자,[이디고]마블 프리미엄 게이밍 컴퓨터의자,199000,199000,0
2018-06-01,504743292,C011030,남자학생복,FS-197 가을신상 프루다 셔츠 (M-XL) 블루 남성줄남방,43790,43790,0
2018-06-01,311558928,C013010,점퍼,[블루독](IV)후드쿨매쉬점퍼(28940-620-08),52500,40430,-12070
2018-06-01,2071164140,C012040,여자학생복,슬린 가디건 LBR0632 여성의류 여성가디건 / 참고 여,97500,82880,-14620
2018-06-01,570233774,A016040,포도,[크라운제과] 크라운 마이쭈 자일 용기형포도 110g x 12개 맛있고,59100,59100,0
2018-06-01,492186571,L012090,기초화장품,랑콤 레네르지 이으 멀티 리프트 리프팅 퍼밍 안티 링,155990,151320,-4670
2018-06-01,407221871,C013010,점퍼,스테판조셉 프린티드 레인코트 스포츠B (택1) 우비 캐,65290,62680,-2610
2018-06-01,959556972,A019100,식초,[오뚜기]오뚜기 델리 케찹 300G,1390,1390,0
2018-06-01,491633786,C012040,여자학생복,[핑크시슬리]루칼 Y 쿨가디건/ 핑크시슬리,22900,18320,-4580
2018-06-01,959556974,A019100,식초,[오뚜기]오뚜기 후레쉬 마요네즈 300G,2300,2300,0
2018-06-01,1934279855,C013050,운동복,7인치광택패드세트/드릴연결/잔기스제거/백킹플레이트,29000,26590,-2410
2018-06-01,1907680997,I031010,장난감,loz 나노블럭/미니 마이크로 레고 블록 정품 캐릭터,4500,4400,-100
2018-06-01,590707986,E021020,커튼,Sunflower 국산 문발-현관문발/창문가리개/햇빛가리개,11500,11500,0
2018-06-01,1793821355,C012040,여자학생복,[지지피엑스]단카라 쉬폰 가디건 (IGB5GD722F),35000,27300,-7700
2018-06-01,1395635369,C013010,점퍼,소매 다운 집업점퍼 S~3XL STLD-6629/소매패딩점퍼 패,63860,60670,-3190
2018-06-01,1293926101,C013010,점퍼,아스토레 6018(NVY) 골프 캐주얼 남성 경량 다운자켓,191200,191200,0
2018-06-01,148310628,A018110,물엿,왕비천하늘 도라지 조청 600g/국내산/전통방식/명인,24900,24900,0
2018-06-01,1593265291,E031120,믹서,HMF-600 한일 다용도 만능 미니믹서기 티타늄칼날,27500,27500,0
2018-06-01,1083839197,A013080,조개,왕중왕 냉동굴 900g2개 굴 냉동굴 생굴 냉동식품 수산,45430,40890,-4540
2018-06-01,483072109,D031010,주택수선재료,삼화페인트 목재 가구 방부 방충용 월드스테인 16L,120000,120000,0
2018-06-01,1862552503,E031080,선풍기,@TV홈쇼핑정품!!@넥스코 PTC 세라믹 온풍기 NC-FA2500/난방기/온풍히터/겨울난방/리모,128000,126720,-1280
2018-06-01,1208385511,I031040,생화,생존용품 멀티 공구 캠핑 망치 도끼 비상 담요 재난,8000,7360,-640
2018-06-01,667330809,E011060,의자,캐빈 원목 식탁의자 1+1 인테리어의자 카페,44800,44800,0
2018-06-01,1439847223,A011010,쌀,산청 지리산 청정골 무농약 메뚜기쌀 백미/멥쌀 5kg,19000,19000,0
2018-06-01,1159441573,I011030,사진기,캐논 정품 EOS 750D + 18-55mm IS STM 명품마을,609390,560550,-48840
2018-06-01,2005072254,L021030,가방,▶초특가한정여름신상[정품]LIVITY 빅히트디자인 시즌트랜드 밀리터리 패션 지프조리,12700,12700,0
2018-06-01,1376017905,C012030,여자상의,[하랑이플] 여름신상 냉장고민소매원피스(FC) 빅사이즈원피스잠옷,8900,8900,0
2018-06-01,1391821099,C013050,운동복,여름특가 트레이닝복세트 균일가 반팔티 나시 긴바지,19900,19900,0
2018-06-01,626430013,C013050,운동복,RXTN차량용 헤러드라이기 성애제거/차량용공기청정기,18900,17390,-1510
2018-06-01,1493399584,A013170,생선통조림,유동 번데기캔 280g X 24EA_1BOX 번데기캔 간식번데기,50350,48840,-1510
2018-06-01,1751031051,L021010,손목시계,[Ange odor]앙쥬오도르 여성용 가죽시계 FLORAL no.04,148000,148000,0
2018-06-01,1751031052,L021010,손목시계,[Ange odor]앙쥬오도르 여성용 가죽시계 FLORAL no.05,142000,142000,0
2018-06-01,438262731,C012040,여자학생복,(예사랑)여성 인견 블라우스 16YB31,59050,59050,0
2018-06-01,1751031053,L021010,손목시계,[Ange odor]앙쥬오도르 여성용 가죽시계 FLORAL no.02,148000,148000,0
2018-06-01,1751031054,L021010,손목시계,[Ange odor]앙쥬오도르 여성용 가죽시계 FLORAL no.03,148000,148000,0
2018-06-01,1751031055,L021010,손목시계,[Ange odor]앙쥬오도르 여성용 메탈시계 CITRUS no.03,170000,170000,0
2018-06-01,1751031056,L021010,손목시계,[Ange odor]앙쥬오도르 여성용 가죽시계 FLORAL no.01,142000,142000,0
2018-06-01,580899790,A017080,무,달콤쫄깃한~ 고구마말랭이 더맛난 반시고구마 60g 1팩/ 롯데식품관,940,890,-50
2018-06-01,1997322676,E011020,침대,[골든잼]소나무 천연 황토 더블 돌침대(고재B)/흙침대,2354700,2284060,-70640
2018-06-01,1112334191,C014010,아동복,한국 숄카라 유아정장 옐로우5종세트(3-36개월)202809,70670,70670,0
2018-06-01,1968663089,A012050,소시지,돈육포(신화 450g)X10 식당 업소용 안주 맥줏집 안주,205030,205030,0
2018-06-01,551384358,C013020,티셔츠,마이곰지 린넨 마 리모 후드 티 셔츠,23000,22770,-230
2018-06-01,499959865,A017230,마늘,{한정할인} 18년산 황토 햇 양파/자색양파 5kg,4900,4900,0
2018-06-01,1442293136,E061020,섬유유연제,섬유유연제(후리지아 또는 핑크로즈)2.5Lx4개(총10L),7900,7900,0
2018-06-01,503396486,C014010,아동복,폴로랄프로렌 주니어 잔체크 반팔 남방 14-16세,23000,23000,0
2018-06-01,1273513300,C013020,티셔츠,[체이스컬트][민소매브이넥티셔츠]남녀 이너이지룩홈웨어룩,7000,6650,-350
2018-06-01,2145925671,F012050,의료측정기,아큐라 플러스 혈당측정기+시험지60매+솜100+침210외,20000,20000,0
2018-06-01,1736141177,C012030,여자상의,[체리빌레]여름휴가~ 여신드레스/플라워 롱원피스,24000,19900,-4100
2018-06-01,256807026,A013030,조기,다인 참조기2.5~2.6kg/조기/냉동조기(50~52미),18900,18900,0
2018-06-01,109625290,E061010,세탁세제,헨켈 퍼실 듀오캡스 파워 드럼/일반 겸용 32캡슐,20000,19800,-200
2018-06-01,1361827155,L021030,가방,CN515AP CN515 15.6인치 Targus Classic+ 노트북가방,49000,49000,0
2018-06-01,1639499420,I031070,애완동물관리비,ACME 애크미 모음 호루라기 호각 휘슬 심판휘슬,3800,3340,-460
2018-06-01,1326211599,C012040,여자학생복,[올리비아로렌]올리비아로렌 P01 롱가디건 VOBBCUM3311,99000,99000,0
2018-06-01,984545954,A017300,미역,광천 김자반볶음 50G*2봉기획,4990,4990,0
2018-06-01,1494325748,F011150,건강기능식품,맛있는 숙취해소 음료 레디큐 드링크 1박스 (10병),26900,26900,0
2018-06-01,229473194,F012020,생리대,엘리스 생리대 순수감촉 일반형 소형28Px2팩 + 순수날개 소형2팩/ 엘리스,8500,8080,-420
2018-06-01,1231799487,E061010,세탁세제,계면활성제 없는 친환경 세탁세제 미순수,17000,17000,0
2018-06-01,424290576,C011030,남자학생복,심쿵가디건/베이직/롱/배색/숄가디건/자켓가디건/남자,14800,14800,0
2018-06-01,1362309857,C013020,티셔츠,물결그물롱티/루즈핏/원피스티/망사롱티/시스루티...,9900,9900,0
2018-06-01,661772270,E021010,침구,[슈에뜨룸]시어서커 누비 토퍼세트/여름이불세트/패드,54900,54900,0
2018-06-01,505237946,C014010,아동복,[GAP kids]갭키즈 토들러 여아 반팔 그래픽 티셔츠(인천점),19000,17510,-1490
2018-06-01,908376102,A016120,바나나,바나나 프리미엄 정품4kg(3손)내외/7kg(4손)내외,12900,12900,0
2018-06-01,747254733,C012060,여자내의,밴딩 스판 기모 바지 레깅스 스키니 팬츠 여성 캐주얼,9160,9060,-100
2018-06-01,869819237,C013020,티셔츠,[스토어15%] 브리치X초이스 여름신상 반팔티/원피스,11500,11500,0
2018-06-01,1219867419,C012060,여자내의,[게스]여성 L톤 데님 스커트(OI2D7551),46400,38050,-8350
2018-06-01,1751031047,L021010,손목시계,[Ange odor]앙쥬오도르 여성용 가죽시계 WOODY no.04,130000,130000,0
2018-06-01,2120049865,C014020,유아복,아둘 유아 샌프란시스코 74 커플룩 반팔 티셔츠 12,11100,11100,0
2018-06-01,1751031048,L021010,손목시계,[Ange odor]앙쥬오도르 여성용 가죽시계 WOODY no.03,140000,140000,0
2018-06-01,1751031049,L021010,손목시계,[Ange odor]앙쥬오도르 여성용 가죽시계 WOODY no.02,140000,140000,0
2018-06-01,2118672013,I011010,TV,이엔티비 32인치 TV / 삼성A급패널 / 에너지효율1등급,149900,149900,0
2018-06-01,1520763344,L021020,장신구,로즈골드 반지/곡선라인/큐빅/신상/OPR813,175000,175000,0
2018-06-01,302434910,C021040,실내화,나이키 에어맥스 운동화/신발/런닝화/테아/샥스/NZ/90,58900,58900,0
2018-06-01,1250492488,C012040,여자학생복,MJ_1219 네이비 양털 조끼 남성조끼 퍼조끼 여성조끼,31320,31320,0
2018-06-01,174236182,C021010,아동화,[빔보빔바]꽃보다 예뻐지는 봄맞이 디자이너 슈즈,9900,9900,0
2018-06-01,1751031050,L021010,손목시계,[Ange odor]앙쥬오도르 여성용 가죽시계 WOODY no.01,140000,140000,0
2018-06-01,253935660,E011030,거실장,상일리베가구 푸시도어 멀티거실장 겸 수납장,38810,38810,0
2018-06-01,2110445715,A019070,양념소스,움트리 매운탕찌개장1950G 서더리탕 양념장 얼큰한,10500,10500,0
2018-06-01,1996193966,C011050,남자내의,아디다스 여성 에센셜 리니어 타이츠 ( AY4824 ),45490,45490,0
2018-06-01,2124307644,C012040,여자학생복,수지네 빈티지 Guess 카키 면 야상베스트 여성 M 17-4,32380,32380,0
2018-06-01,863782442,A017180,호박,(맛나)#풋고추(특)10kg,175440,175440,0
2018-06-01,1747444622,C013040,청바지,(BL)5부데님팬츠(27325-414-01DC)/ 블루독,49000,40180,-8820
2018-06-01,1720271741,E011070,식탁,로드퍼니처/화산석 식탁세트/4인용/6인용/원목/대리석,559000,559000,0
2018-06-01,821006904,C013040,청바지,아둘 가족티 쥬니어 상하세트 시그니처 조던 46,25500,25500,0
2018-06-01,1298957639,I031040,생화,에버라스트 C3세이프 맥스 헤드기어,264600,259310,-5290
2018-06-01,1408133815,A013100,마른멸치,완도사랑 참 전복 1kg(13~14미) 사은품(전복죽)1개,40900,40900,0
2018-06-01,983390611,A021010,커피,[동서]동서 카누미니 다크아메리카노 100T + 사은품 증정,21900,21900,0
2018-06-01,983390614,A021010,커피,[남양]남양 프렌치카페 카페믹스 프리미엄(100T*10.9G),16500,16500,0
2018-06-01,983390613,A021010,커피,남양 프렌치카페 카페믹스 프리미엄 50T*10.9G,8480,8480,0
2018-06-01,450965850,A013060,게,인풍 오징어(내장제거) 300g2개 오징어 냉동오징어 수,59140,53230,-5910
2018-06-01,778789862,E011040,소파,아리아퍼니쳐U2541-25/오리털 패브릭소파/쇼파+쿠션,890000,890000,0
2018-06-01,484940505,L021060,유모차,마루스 미니 유모차/기내반입/초경량/휴대용,29800,29800,0
2018-06-01,1886540902,A017230,마늘,햇자색양파 10kg 신선농장 적양파,20000,20000,0
2018-06-01,125227940,E041020,컵,머그컵 머그잔 머그컵세트 판촉물 답례품 커피잔 보틀,1500,1500,0
2018-06-01,558807571,A017080,무,갈아서 끓인 토마토즙 / 과일야채즙 100ml 30/50포,21900,21900,0
2018-06-01,1752732800,E011030,거실장,마로니 엘다원목 거실장세트B,940000,940000,0
2018-06-01,1116618585,F012020,생리대,예지미인 순 슈퍼롱오버나이트 10p,2000,2000,0
2018-06-01,415961518,C012040,여자학생복,롱 청자켓 마커스 지퍼롱청JK KD 청자켓 청카바 데님,79940,78350,-1590
2018-06-01,1752732801,E011030,거실장,마로니 엘다원목 슬라이드 거실장세트B,900000,900000,0
2018-06-01,1829437553,C013050,운동복,트레이닝세트/추리닝세트/트레이닝복/봄신상세트,12900,12900,0
2018-06-01,2083985804,C012030,여자상의,TL_ID003 트위드 원피스 /(참고)고급정장 력셔리 원피,39800,35030,-4770
2018-06-01,462614996,C013050,운동복,우먼스 ZNE 플러스 후드 2 후드집업 짚업트레이닝복,152200,149160,-3040
2018-06-01,426755157,C013040,청바지,여름신상 남자청바지/28-42빅사이즈/스판면바지/행사,10800,10800,0
2018-06-01,617209399,C013010,점퍼,남성 점퍼 항공 블루종 바람막이 자켓 라이더 아노락,26900,26400,-500
2018-06-01,1751031078,L021010,손목시계,[Ange odor]앙쥬오도르 여성용 메탈시계 CITRUS no.02,170000,170000,0
2018-06-01,1751031079,L021010,손목시계,[Ange odor]앙쥬오도르 여성용 메탈시계 탄생석 12월 BLOSSOM no.12,210000,210000,0
2018-06-01,502603953,A016020,배,자연산 야생돌배 600g/300g/건조/절임/지리산 산돌배,24800,24800,0
2018-06-01,1106037424,L021050,우산,독수리표 고급상하우의/작업용우의/작업우의/등산용/레져용/낚시용/비옷/우비/고급원단,15000,14800,-200
2018-06-01,529703564,C012060,여자내의,허리조절 분홍체크 교복치마 교복 예쁜교복 교복쇼핑,49840,48350,-1490
2018-06-01,801122697,A019180,즉석식품,할인특가/베터드 케이준 포테이토 2kg/감자튀김,9800,9300,-500
2018-06-01,1438680139,C013020,티셔츠,레프트오프숄더티/보트넥/루즈핏티/어깨트임/펀칭티.,7900,7900,0
2018-06-01,1171782192,E011020,침대,[안전한 베디스]킹침대 가죽침대 튼튼한침대 혼수침대,279000,279000,0
2018-06-01,1010292873,A013050,오징어,P)제주갈치 (대/마리),29900,29900,0
2018-06-01,202310161,C012060,여자내의,[랩(LAP)][랩]린넨 셋업 반바지(AJ2WP361)(강남점),59000,51040,-7960
2018-06-01,385190092,A017300,미역,[1+1]광천김10봉+10봉총20봉/10봉2박스 선물용 대천김,15500,15500,0
2018-06-01,369761930,C012060,여자내의,[르샵]랩스타일 치마 바지 (LI4PT209)(경기점),59000,52660,-6340
2018-06-01,1474286728,C013010,점퍼,MRBOB 신상 기모 후드티 후드집업 빅사이즈 M~3XL,24800,24800,0
2018-06-01,723340468,C013010,점퍼,[블랙야크키즈]역시즌 특가! 경량 구스다운 자켓 2종 5칼라(광주신세계),65000,53600,-11400
2018-06-01,2125595273,C012030,여자상의,미미프릴랩ops/여름 플라워 프릴 미니 랩 원피스,29900,29900,0
2018-06-01,1751031080,L021010,손목시계,[Ange odor]앙쥬오도르 여성용 메탈시계 CITRUS no.01,148000,148000,0
2018-06-01,1751031081,L021010,손목시계,[Ange odor]앙쥬오도르 여성용 메탈시계 탄생석 10월 BLOSSOM no.10,210000,210000,0
2018-06-01,1241730835,C013030,스웨터,[무료배송]아디다스 ZNE 스톰헤더 후드자켓(BQ5360),167140,167140,0
2018-06-01,1751031082,L021010,손목시계,[Ange odor]앙쥬오도르 여성용 메탈시계 탄생석 11월 BLOSSOM no.11,210000,210000,0
2018-06-01,1751031083,L021010,손목시계,[Ange odor]앙쥬오도르 여성용 메탈시계 탄생석 9월 BLOSSOM no.09,210000,210000,0
2018-06-01,1751031084,L021010,손목시계,[Ange odor]앙쥬오도르 여성용 메탈시계 탄생석 8월 BLOSSOM no.08,210000,210000,0
2018-06-01,1751031085,L021010,손목시계,[Ange odor]앙쥬오도르 여성용 메탈시계 탄생석 7월 BLOSSOM no.07,210000,210000,0
2018-06-01,981510093,A016060,감,[영동곶감]반건시1호1.5kg(30개),46000,38000,-8000
2018-06-01,1751031086,L021010,손목시계,[Ange odor]앙쥬오도르 여성용 메탈시계 탄생석 6월 BLOSSOM no.06,210000,210000,0
2018-06-01,1751031087,L021010,손목시계,[Ange odor]앙쥬오도르 여성용 메탈시계 탄생석 5월 BLOSSOM no.05,210000,210000,0
2018-06-01,981510095,A016060,감,[영동곶감]등채반 3호1.5kg(40~50개),76000,53000,-23000
2018-06-01,466162639,A017250,고사리,커클랜드 노르망디 베지터블 블랜드 2.49kg/코스트코,21990,21990,0
2018-06-01,988068886,A011160,빵,[삼립]삼립 천연효모로만든로만밀식빵 420G,2300,2300,0
2018-06-01,1752732826,E011030,거실장,마로니 자작원목 서랍거실장세트,920000,920000,0
2018-06-01,240479505,C015030,넥타이,(색상 : 네이비) BTIE_097 점자 보타이 정장,13420,13420,0
2018-06-01,262709760,E021020,커튼,마스커튼/암막/창문커튼/작은창커튼/방풍,29400,27050,-2350
2018-06-01,1752732825,E011030,거실장,마로니 소나무원목 AV거실장세트,840000,840000,0
2018-06-01,1752732828,E011030,거실장,마로니 에쉬원목 거실장1200,390000,390000,0
2018-06-01,1752732827,E011030,거실장,마로니 자작원목 AV거실장세트,940000,940000,0
2018-06-01,213578730,C013020,티셔츠,[화이트폭스] 여름신상 데일리 반팔티/캐주얼/슬림핏,10500,10500,0
2018-06-01,1431090799,A019170,냉동식품,오양 물만두2.8kg,16900,16900,0
2018-06-01,1752732829,E011030,거실장,마로니 에쉬원목 TV대,320000,320000,0
2018-06-01,1692447137,E031010,전기밥솥,쿠쿠 내솥 [O202] CRP-HNXT1010FB 밥솥 교체용,61960,61960,0
2018-06-01,1345397344,C012060,여자내의,스타일 멜빵 데님팬츠-M1054 데님팬츠 와이드 힙합청바지 멜빵청바지 데님스커트,36160,32190,-3970
2018-06-01,245761451,C012040,여자학생복,(예사랑)여성 인견 조끼 17YB12,59000,58410,-590
2018-06-01,1752732824,E011030,거실장,마로니 소나무원목 서랍거실장세트,840000,840000,0
2018-06-01,1752732823,E011030,거실장,마로니 엘다원목 슬라이드 거실장세트A,900000,900000,0
2018-06-01,832028260,A022010,주스,웅진)자연은 포도주스(180mlX12병)M806009 녹차 커피,19110,19110,0
2018-06-01,1608375741,L021020,장신구,실버)컨스텔레이션 라운드 목걸이 20대 30대 선물 추,17760,17760,0
2018-06-01,1209526155,I012060,저장장치,앱코 HACKER K3000 PBT 스페셜 축교환 키보드 추천,49000,49000,0
2018-06-01,204031496,C013050,운동복,차량용 비상 삼각대 반사 리플렉터 타입 안전삼각대,10100,9800,-300
2018-06-01,745570374,C012020,원피스,빅사이즈/크런치/조끼 빅사이즈,46530,44670,-1860
2018-06-01,1685384985,A016030,복숭아,산초가루(산초 맷돌 50g)X10개/산초,26510,24920,-1590
2018-06-01,1811301154,E011060,의자,네오 메쉬 허리보호 책상/학생/컴퓨터/사무용의자,40000,35910,-4090
2018-06-01,450601232,C012040,여자학생복,입새 여자 롱셔츠 KD 여자옷 롱셔츠 여자롱셔츠 여성,69220,69220,0
2018-06-01,318519021,C013050,운동복,LED 손전등 겸용 경광봉 지시봉 신호봉 안전봉 블루,12900,12520,-380
2018-06-01,1752732831,E011030,거실장,마로니 엘다원목 TV대,280000,280000,0
2018-06-01,218906355,A019110,드레싱,ISFI향신료모음전/천연향신료/월계수잎/로즈마리/바질,3900,3900,0
2018-06-01,356207807,A017250,고사리,[비트판매전문]2018년 싱싱한 국내산 레드비트/ 10kg,25900,24900,-1000
2018-06-01,1752732830,E011030,거실장,마로니 엘다원목 거실장1200,360000,360000,0
2018-06-01,2012551927,E041020,컵,최고인기 커피잔세트/찻잔 부부잔 머그컵 쇼핑천국,23800,23800,0
2018-06-01,1752732832,E011030,거실장,마로니 에쉬원목 수납 거실장 1800,670000,670000,0
2018-06-01,989080820,E061090,방향제,그레이드자동분사기리필(라벤더)1+1,8500,8500,0
2018-06-01,868605569,A013120,낙지,정화 맥반석 오징어. ( S ) 30gx5.,21580,19210,-2370
2018-06-01,895773426,A019090,카레,[오뚜기]오뚜기 바몬드 골드카레 순한맛 100g,2650,2390,-260
2018-06-01,176403661,E031080,선풍기,나무액자 초절전 원적외선히터 SUNION 1060,228600,228600,0
2018-06-01,895773424,A019100,식초,[오뚜기]오뚜기 델리 케찹 500g,1990,1990,0
2018-06-01,895773421,A018090,잼,[오뚜기]오뚜기 후르츠쨈 (500g),4800,3990,-810
2018-06-01,2083116820,C013040,청바지,남자청바지 디스트로이드 슬림 밴딩 바지 BX0717002 /,51600,43860,-7740
2018-06-01,895797411,A011170,떡,풀무원 한입 떡볶이떡 (400G),2200,2200,0
2018-06-01,958421046,A013170,생선통조림,오뚜기 살코기마일드참치150G*2+2기획,10500,7890,-2610
2018-06-01,378907629,F011120,인삼,A급 강원도 산양산삼 5~6년근10뿌리특가 무료배송,72000,69000,-3000
2018-06-01,833510455,L012040,치약,레드씰 프로폴리스치약4개/베이킹치약5개,19900,19900,0
2018-06-01,1348683576,L021050,우산,명품아놀드파마 3단/2단/자동/골프/장우산 도매특가,9900,9900,0
2018-06-01,1131028998,E031120,믹서,총알발송) HC-BL5000 해피콜 초고속블렌더Z 블랜더,318990,318990,0
2018-06-01,1325006272,A013170,생선통조림,참치캔 모음전/오뚜기 고추참치 150gx10개세트/동원/,16400,16400,0
2018-06-01,2033877374,C012040,여자학생복,프린팅 반팔 카라 블라우스 BA6U6WRB131_110/ 예스비,32000,32000,0
2018-06-01,1382314963,E031120,믹서,일본 가전 레꼴뜨 솔로 블렌더 솔렌 보틀 2개 세트,49000,49000,0
2018-06-01,350214122,C013020,티셔츠,T2031-여성 데일리 라팔 리본 커프스 티셔츠 라운드티,12400,12400,0
2018-06-01,1864283068,C021040,실내화,나이키 여성 에어 줌 스트럭쳐20 런닝화(849577-004),150570,138530,-12040
2018-06-01,467016992,C013010,점퍼,USD361_3205_OR 남자등산복 남성잠바 등산복 등산바람,86210,86210,0
2018-06-01,986213073,F011150,건강기능식품,[풍기][풍기인삼농협][황풍정] 6년근 홍삼액 수(秀) 50ml*30포,53000,53000,0
2018-06-01,833994660,C013060,등산복,[역시즌특가]남여 오래곤 에비뉴 구스 다운 자켓 CX4-YMP375/ 컬럼비아,199000,169150,-29850
2018-06-01,1752732860,E011030,거실장,미로니 자작원목 론다 거실장 1800,490000,490000,0
2018-06-01,1778593310,L021010,손목시계,[바보사랑][공식  백화점AS가능]머져 여성시계(가죽)_W0924G1,148000,148000,0
2018-06-01,1778593311,L021010,손목시계,[바보사랑][공식  백화점AS가능]키스매트 남녀공용시계(메탈)_W0929L3,248000,248000,0
2018-06-01,952131567,F011130,홍삼,[김포파주인삼농협/산지직송] 홍삼진골드 80ml*30,40200,40200,0
2018-06-01,895773457,L012030,칫솔,[P&G]오랄비 스테이지 1단계 칫솔(4-24개월)2개,6490,6490,0
2018-06-01,1188171259,E021010,침구,[아망떼]순면/안티알러지 이불커버세트/단품SS/Q,27900,23900,-4000
2018-06-01,1644075666,C013040,청바지,[제이로드]7부 5부 남자청바지 여름 반바지 카고바지,19900,19900,0
2018-06-01,988030259,L012030,칫솔,[P&G]P&G) 오랄비 크로스 액션 토탈케어 3+1,9900,9900,0
2018-06-01,508099607,E061010,세탁세제,유한양행 아름다운세탁세제BOL 2.8Lx4+사은품,28800,28800,0
2018-06-01,841924179,E061030,전구,g LED 전구 램프 특별전 벌브 볼전구 촛대구 MR16,1150,1150,0
2018-06-01,1752732859,E011030,거실장,마로니 엘다원목 론다 거실장 1800,540000,540000,0
2018-06-01,1752732858,E011030,거실장,마로니 에쉬+소노클린원목 론다 거실장 1800,570000,570000,0
2018-06-01,1465788681,C013020,티셔츠,3+1클라비M~4XL 남여 무지티/반팔티/프린트/반팔/단체,8800,8800,0
2018-06-01,988068827,A012050,소시지,[목우촌]목우촌 원칙을지키는비엔나 (240G*2),11400,6990,-4410
2018-06-01,1780617168,L021020,장신구,[바보사랑]엠마테슬화이트 초커목걸이,4900,4900,0
2018-06-01,988068826,A012050,소시지,[목우촌]목우촌 원칙을지키는프랑크 (250G*2),11400,6990,-4410
2018-06-01,1780617169,L021020,장신구,[바보사랑]엠마테슬블랙 초커목걸이,4900,4900,0
2018-06-01,1497633338,I031040,생화,캠핑미니테이블/캠핑테이블/야외테이블/화로대테이블,77900,67070,-10830
2018-06-01,306572568,E031110,청소기,LG 공식인증점 코드제로 R9 로봇청소기 R958DA,1402170,1290000,-112170
2018-06-01,1092339963,I053030,복사용지,삼성 A4 복사용지(A4용지) 75g 2500매 2BOX/더블에이,39300,33800,-5500
2018-06-01,1752732855,E011030,거실장,마로니 엘다원목 수납 거실장 1800,650000,650000,0
2018-06-01,1006723115,A013170,생선통조림,유동 번데기탕 캔 구수한맛 280g X 24EA_1BOX 유동번,52340,52340,0
2018-06-01,1752732854,E011030,거실장,마로니 자작원목 수납 거실장 1800,625000,625000,0
2018-06-01,1752732857,E011030,거실장,마로니 자작+멀바우원목 론다 거실장 1800,490000,490000,0
2018-06-01,1752732856,E011030,거실장,마로니 자작+소노클린원목 론다 거실장 1800,490000,490000,0
2018-06-01,1778593302,L021010,손목시계,[바보사랑][공식  백화점AS가능]제트 남성시계(메탈)_W0674G8,228000,228000,0
2018-06-01,1778593303,L021010,손목시계,[바보사랑][공식  백화점AS가능]메트로폴리탄 남성시계(가죽)_W0792G5,168000,168000,0
2018-06-01,266607917,C013010,점퍼,AGC빅사이즈 폴라폴리스 자켓 MC 1210 큰재킷 빅사이,79080,75130,-3950
2018-06-01,989102733,A013170,생선통조림,유동 순살왕꼬막&골뱅이 280G,6990,6990,0
2018-06-01,989102732,A013170,생선통조림,유동 순살왕꼬막 280G,5990,5990,0
2018-06-01,989080817,E061090,방향제,그레이드공기탈취제(레몬)320ML,4500,4500,0
2018-06-01,895834929,E061030,전구,GE PL 55W2입(주광),15100,15100,0
2018-06-01,709916202,E021020,커튼,이케아 SCHOTTIS 암막 주름식 블라인드  다크그레이,10800,10800,0
2018-06-01,1567228190,C012020,원피스,트랜디한체크롱자켓(N181MSF007)/ 나이스클랍,199500,163590,-35910
2018-06-01,440288826,A015020,식용유,(무)해표 카놀라유18LX1개해표 식자재 카놀라유 콩기,87400,76920,-10480
2018-06-01,606452530,F012020,생리대,좋은느낌 울트라 날개 중형 19x3 견본증정,12500,12500,0
2018-06-01,1474996392,C012030,여자상의,[특가SALE] 뷔스티에 플라워 비치 바캉스 원피스,12800,12800,0
2018-06-01,1934147925,C012040,여자학생복,[모니즈][모니즈] 니트 단가라 숄 가디건 CCAD023,23800,22610,-1190
2018-06-01,2065252050,E031040,전기레인지,미니바 자판기냉장고.무소음 냉장고 자판기냉장고 미,691570,691570,0
2018-06-01,876973535,C012040,여자학생복,[배드블러드]시애라 크롭 가디건/기모/에슬레저/블랙,28000,24900,-3100
2018-06-01,1752732862,E011030,거실장,마로니 에쉬+멀바우원목 론다 거실장 1800,570000,570000,0
2018-06-01,1778593309,L021010,손목시계,[바보사랑][공식  백화점AS가능]벡스터 남성시계(가죽)_W0874G2,168000,168000,0
2018-06-01,1752732861,E011030,거실장,마로니 에쉬원목 론다 거실장 1800,570000,570000,0
2018-06-01,989080816,E061090,방향제,그레이드자동분사기획(오션이스케이프),13900,13900,0
2018-06-01,115728023,E011060,의자,유니크 식탁의자/패브릭의자/의자/화장대의자/소파,37500,34500,-3000
2018-06-01,1778593305,L021010,손목시계,[바보사랑][공식  백화점AS가능]제트 남성시계(메탈)_W0798G3,198000,198000,0
2018-06-01,1778593306,L021010,손목시계,[바보사랑][공식  백화점AS가능]퓨울 남녀공용시계(메탈)_W0801G2,338000,338000,0
2018-06-01,1778593307,L021010,손목시계,[바보사랑][공식  백화점AS가능]에비에이터 남성시계(메탈)_W0863G3,198000,198000,0
2018-06-01,1778593308,L021010,손목시계,[바보사랑][공식  백화점AS가능]퓨울 남성시계(가죽)_W0867G1,278000,278000,0
2018-06-01,390815717,C013020,티셔츠,[올트]데일리 스트링 티셔츠_무료배송,18000,18000,0
2018-06-01,1778593334,L021010,손목시계,[바보사랑][공식  백화점AS] Gc-3 남성시계(가죽)_X12002G1S,478000,478000,0
2018-06-01,1778593335,L021010,손목시계,[바보사랑][공식  백화점AS] Diver Chic 여성시계(가죽)_X35006L1S,698000,698000,0
2018-06-01,990032207,A014040,발효유,파스퇴르 쾌변(레이디) 150ML,1200,990,-210
2018-06-01,34153112,E041070,밀폐용기,스텐 김치통 모음/4.7~11.2L/국산/밀폐용기/사은품,31400,31400,0
2018-06-01,1778593333,L021010,손목시계,[바보사랑][공식  백화점AS가능]델리아 여성시계(가죽)_W0951L3,138000,138000,0
2018-06-01,2069453700,C013050,운동복,폴로 남아 여아 아동 24 25 트레이닝 면 쭈리 반바지,16340,16340,0
2018-06-01,1447466271,E021020,커튼,로만쉐이드/총집합47종/암막/창문/안방/커텐/커튼/,27800,27800,0
2018-06-01,1742934718,E031110,청소기,[LG전자] LG판매점 (JS) LG K83BGY 슈퍼싸이킹 진공청소기,256980,239000,-17980
2018-06-01,111473892,E061050,청소용세제,홈스타 뿌리면 곰팡이싹 500mlx4 락스 곰팡이제거제,10000,9900,-100
2018-06-01,717743940,A017230,마늘,싱싱아삭! 요리용 2018년 무안 햇양파 5kg/깐마늘 외,4500,4500,0
2018-06-01,506694700,D031010,주택수선재료,[룸앤홈] DIY 데크타일 모음 / 데코타일 베란다 타일,28770,28770,0
2018-06-01,1516535457,C011050,남자내의,[7컬러 맞춤 옆밴딩 슬랙스]남자슬랙스/밴딩슬랙스,18900,18900,0
2018-06-01,122160803,L021030,가방,13인치 15인치 노트북 파우치 LG그램 삼성 PEN 맥북,28000,28000,0
2018-06-01,503636434,L021010,손목시계,BELCARINO 패션시계 모던 손목시계 MV207101S 캐주얼,51280,51280,0
2018-06-01,1684999522,L021030,가방,[대구백화점 I관] [에스티코]포멀 브리프케이스(SBAOZ14-TSN),49000,45080,-3920
2018-06-01,1778593338,L021010,손목시계,[바보사랑][공식  백화점AS] Gc TechnoSport 남녀공용시계(메탈)_X51002G5S,718000,718000,0
2018-06-01,1778593339,L021010,손목시계,[바보사랑][공식  백화점AS] Gc Femme Bijou 여성시계(메탈)_X52003L1S,528000,528000,0
2018-06-01,589210891,E011020,침대,파로마 평상형 침대 시리즈/와이드형/통깔판/혼수가구,119000,119000,0
2018-06-01,942707762,I031010,장난감,슬림 PS4 랜트/ 게임포함 1일 3500원~/플스4 랜탈,3500,3500,0
2018-06-01,1751031025,L021010,손목시계,[Ange odor]앙쥬오도르 여성용 가죽시계 WOODY no.05,130000,130000,0
2018-06-01,1895057007,C012040,여자학생복,[비키]레이스 오픈 롱 가디건 (TMCCF2942)_C7U5,41600,39520,-2080
2018-06-01,910305370,A019060,된장,초이스엘 재래식 집된장(500G),2800,2800,0
2018-06-01,2046948826,C012060,여자내의,[모조에스핀]옆트임 체크스커트_S174MSD037(MX5),89000,84550,-4450
2018-06-01,2120049840,C014020,유아복,아둘 유아 샌프란시스코 74 커플룩 반팔 티셔츠 11,11100,11100,0
2018-06-01,2046948825,C012060,여자내의,[모조에스핀]옆트임 체크스커트_S174MSD037(MX1),89000,84550,-4450
2018-06-01,608508546,A019080,고추장,조청 고추장 만들기 DIY 세트 찹쌀 메주가루 고추가루,59900,59900,0
2018-06-01,1780617171,L021020,장신구,[바보사랑]아일리큐빅 초커목걸이,6900,6900,0
2018-06-01,2094322855,C014010,아동복,[알로봇]로비포켓티셔츠184B9-332-03컬러:그레이,19000,15200,-3800
2018-06-01,521342507,A017180,호박,청피망(특)10kg 1박스 두리반농산,30000,30000,0
2018-06-01,1780617170,L021020,장신구,[바보사랑]이프레이어드 초커목걸이,8500,8500,0
2018-06-01,1780617173,L021020,장신구,[바보사랑]러미즈블랙 초커목걸이,5900,5900,0
2018-06-01,1248801167,C012060,여자내의,[ab.f.z][17S/S]허리뒤밴딩린넨반팬츠(AFR3GP53F)[갤러리아],29000,24650,-4350
2018-06-01,1780617172,L021020,장신구,[바보사랑]러미즈화이트 초커목걸이,5900,5900,0
2018-06-01,1780617175,L021020,장신구,[바보사랑]제니아플라워 초커목걸이,7500,7500,0
2018-06-01,988068819,E061020,섬유유연제,리치퍼퓸시그니처(플라워페스티벌)2L,10900,10900,0
2018-06-01,1780617174,L021020,장신구,[바보사랑]발레리화이트 초커목걸이,7500,7500,0
2018-06-01,1780617177,L021020,장신구,[바보사랑]소프트하트 초커목걸이,6900,6900,0
2018-06-01,1780617176,L021020,장신구,[바보사랑]소프트원 초커목걸이,6900,6900,0
2018-06-01,1999161053,C013020,티셔츠,필골드 티셔츠로 멋내기 훈남들의 V넥/카라티 27종,26200,16800,-9400
2018-06-01,1175486037,C011030,남자학생복,[지오다노]여 V넥 롤업 슬리브 반팔 티 328517,15800,12640,-3160
2018-06-01,1574139451,L021030,가방,[칼린(Carlyn)]칼린 Poppy Bag 하트 포피백 H78164020(인천점),220000,192060,-27940
2018-06-01,426973274,E031020,가스레인지,린나이 스마트플러스센서 펄크리스탈 4구그릴 가스오븐레인지 RSF-BM81C,850000,775000,-75000
2018-06-01,1574441215,A016090,참외,성주꿀참외 8kg 벌크/ 고당도,9900,9900,0
2018-06-01,1671050884,F012010,종이기저귀,보솜이 액티브팬티 5단계 특대 26매 (남녀선택),7900,7900,0
2018-06-01,619653270,L021020,장신구,스와로브스키 귀걸이 이어링 귀고리 은침 유색 크리스탈 비즈 여성악세사리선물 실버침,10700,10380,-320
2018-06-01,1549344608,C013040,청바지,[블루독베이비][이월] BL) 스포티브우븐 팬츠 (47314-412-01)(본점),43000,36290,-6710
2018-06-01,1778593341,L021010,손목시계,[바보사랑][공식  백화점AS] Gc-3 남성시계(메탈)_X72038G2S,838000,838000,0
2018-06-01,1778593342,L021010,손목시계,[바보사랑]Gc Sport Class XXL 남성시계(메탈)_X76001G1S,788000,788000,0
2018-06-01,1285607014,A012010,국산쇠고기,실속형 한우선물세트 5호x2.4kg 1등급 한우 한우세트,260000,257400,-2600
2018-06-01,1694580745,A012050,소시지,오뗄 카스테라 핫도그 10+10+10개/간식/치킨/가라아게,15400,15400,0
2018-06-01,362058440,C013020,티셔츠,탑텐 (MSY2WC1538) 남성 RAYON 카바나 플러워패턴 프린트 반팔 셔츠,37900,34870,-3030
2018-06-01,1778593340,L021010,손목시계,[바보사랑][공식  백화점AS] Gc SlimClass 여성시계(가죽)_X60016G1S,348000,348000,0
2018-06-01,511064748,A019090,카레,[MCC]80년전통 일본고베카레(비프/치킨/매운맛선택),1790,1790,0
2018-06-01,2002173116,C012040,여자학생복,[티탁]난리난 블라우스 루즈핏 셔츠 롱티셔츠/데일리,12900,9900,-3000
2018-06-01,1625767220,A013070,굴,선주직송 울진붉은대게 2kg 3kg 홍게 일반형,32000,32000,0
2018-06-01,1780617199,L021020,장신구,[바보사랑]셜리진주골드 초커목걸이,8900,8900,0
2018-06-01,1257577438,C012030,여자상의,[공구우먼] 디안 플레어 원피스 29490 빅사이즈 여성의류,22000,22000,0
2018-06-01,1557469504,A013120,낙지,정화 맥반석 오징어. ( S ) 30gx5.,21600,19230,-2370
2018-06-01,1777317690,A014010,우유,매일 멸균우유 초코우유 딸기우유 바나나우유 24팩,11700,11700,0
2018-06-01,1750408769,C013040,청바지,남자 밴딩청바지 밴딩팬츠 남성 빅사이즈 밴드팬츠,19800,19800,0
2018-06-01,626540466,L012060,샴푸,라온 바오밥 프리미엄 샴푸/트리트먼트 1000ml 약산성,10700,10700,0
2018-06-01,604985412,F012010,종이기저귀,[마미포코] 마미포코 쿨썸머그린 밴드기저귀 중형 60매x2팩,36900,36900,0
2018-06-01,521560677,C013020,티셔츠,[MRBOB] 두꺼운 헤비 기모 후드티 후드집업 M~3XL,36800,33800,-3000
2018-06-01,820367068,E031010,전기밥솥,[쿠첸正品] 쿠첸/원터치분리형/내외측한세트/압력패킹,18000,18000,0
2018-06-01,1824178046,A014010,우유,일회용핫소스(태원 4gx1000),38000,38000,0
2018-06-01,1260806634,A019030,생강,백초생강 (참존 1.2k) X10,45550,40540,-5010
2018-06-01,1141091664,C011050,남자내의,남 라이트웨이트 테이퍼드 플리츠 치노 (슬라우치) 118526/ 지오다노,29800,24440,-5360
2018-06-01,1356277354,C013020,티셔츠,빅사이즈 차이나넥라인남자긴팔남방 / 참고 남자봄신,58500,49730,-8770
2018-06-01,2081143626,C011050,남자내의,여름신상 남성 반바지 5부 7부 허리조절밴딩 44까지,17800,17800,0
2018-06-01,417899858,C015040,장갑,아놀드파마_APGW-BY1207(가죽장갑_여성용) 여성장갑,27420,27420,0
2018-06-01,2123308560,G022020,자동차타이어,미쉐린타이어 프라이머시 LC 215/55R17,124000,105400,-18600
2018-06-01,498682126,A012060,햄및베이컨,(냉동)쉐프솔루션베이컨 1kgX4개식품 베이컨 소시지,136500,111930,-24570
2018-06-01,79783736,A011010,쌀,당일도정 2017 햅쌀 철원오대쌀 현미 찹쌀 10kg 20kg,29800,29800,0
2018-06-01,1689326146,F012010,종이기저귀,[하기스] NEW 신제품! 매직핏 밴드기저귀 1~5단계 2팩,32900,32900,0
2018-06-01,1076414941,C013020,티셔츠,[크루클린] 후드티/맨투맨/레이어드/오버핏/기모,19800,13800,-6000
2018-06-01,1808652464,C021040,실내화,[푸마(PUMA)]푸마 바스켓 플랫폼 367260-01 02 Basket Platform Trace KR(강남점),119000,98120,-20880
2018-06-01,378655704,L021020,장신구,(럭셔리 큐빅 블랙 귀걸이) 데일리 쥬얼리 연예인,15400,13860,-1540
2018-06-01,994328669,A017200,토마토,(무)(면)냉동삶은배추시래기10kgX1개,17650,17650,0
2018-06-01,386489104,C011030,남자학생복,오투아이스_쿨링프리미엄얼음조끼+머플러세트형,73270,68880,-4390
2018-06-01,986154389,A014030,치즈,동원 덴마크 구워먹는치즈_125G,7090,5290,-1800
2018-06-01,994328665,A017200,토마토,(무)(면)냉동청학 청피망1kgX10개,65000,65000,0
2018-06-01,1248801239,F012010,종이기저귀,스웨덴 친환경 네띠 기저귀 밴드형 팬티형 1팩,11900,11900,0
2018-06-01,457062613,E031080,선풍기,한빛 공기청정슬림형 전기온풍기hv-2500(3.0kw) - 전,462120,411290,-50830
2018-06-01,801266335,C011020,남자상의,OMJ-002 레더배색 누빔 하프코트 M-XL 그레이패딩 라,111700,111700,0
2018-06-01,1954198498,L012040,치약,유니레버 클로즈업 치약 160g 9개,9900,9900,0
2018-06-01,1906017981,I031040,생화,센서작동/8종/헤드랜턴/5400루멘 /3발 /5발/,17800,15800,-2000
2018-06-01,127357890,L012110,색조화장품,2018 AHC 내츄럴 퍼팩션 썬스틱 22g+22g특가 선스틱,20700,20700,0
2018-06-01,2116529009,C013020,티셔츠,[PL_홈쇼핑]레드 카라배색 반목티셔츠,6900,6560,-340
2018-06-01,68479397,C013040,청바지,28~42 봄신상 남자 청바지/빅사이즈/스판/일자/밴딩,17800,17800,0
2018-06-01,375950921,C013010,점퍼,에디션앤드지 BEY2KG1601 (3종택일) 면혼방캐주얼자켓,129000,107070,-21930
2018-06-01,555788404,A019060,된장,청정원) 양념듬뿍 쌈장500G / 쌈장 /고추장/된장,2850,2850,0
2018-06-01,1269757655,C013010,점퍼,bb99 숨김 원버튼 fur 도톰 자켓 크림 여자자켓 여성,49780,49780,0
2018-06-01,589523765,C012020,원피스,정장스커트H라인A라인S부터엑스라지까지,16900,16900,0
2018-06-01,989080880,L012040,치약,센소다인치약(멀티케어)100G*2,11900,8290,-3610
2018-06-01,483818071,C011030,남자학생복,밀란시아 베이직 양기모 집업후드가디건 is12-1 남성,45500,44590,-910
2018-06-01,1952019517,A018050,비스킷,미주라 인기11종/토스트/비스켓/도너츠/쿠키/수입과자,3500,3500,0
2018-06-01,1748720628,E011020,침대,리버퍼니쳐 100T 순면패팅 싱글 요 매트리스 매트리스,73980,73980,0
2018-06-01,177162724,A011090,국수,[2종선택]컵라면24개/육개장/산라면/컵누들/사발면,15900,15900,0
2018-06-01,1299907787,E031130,보온매트,지브라 극세사 전기매트/더블/온열매트/전기장판/침대,153600,150530,-3070
2018-06-01,497878804,C013050,운동복,아디다스 여성 아디제로 트랙자켓(CE0330) 여성트랙자,134660,134660,0
2018-06-01,1141522176,L021060,유모차,라이푸체어 푸쉬체어 휴대용 유모차 마이크로트라이크,30000,29000,-1000
2018-06-01,1135431469,C013050,운동복,유비콘솔박스 대 차량용 트렁크콘솔박스 트렁크정리함,20830,20210,-620
2018-06-01,956753805,A018040,아이스크림,조안나 5리터 바닐라,15000,12000,-3000
2018-06-01,1525055093,A012010,국산쇠고기,횡성한우 갈비혼합세트4호 2.1Kg 소갈비세트 한우세트,294600,294600,0
2018-06-01,2104413931,C013010,점퍼,여성 기모 후드 집업점퍼 AG집업점퍼후드점퍼후드집업,25220,25220,0
2018-06-01,5199762,L021050,우산,F552- 제비표 코트형 EVA 일반형 비옷 우의 우비 판초,4000,3900,-100
2018-06-01,880537676,A011070,혼식곡,백설 밀가루 (다목적용)(1KG),1180,1180,0
2018-06-01,667330725,E061010,세탁세제,(초특가) 스파크 10kg x 2개 / 수퍼타이 세탁세제,25900,25900,0
2018-06-01,1834808745,A016160,과일가공품,[7종균일특가][베리필드]A등급 아이스 블루베리 1kg외,6500,6500,0
2018-06-01,1425745980,A018100,꿀,유기농 로얄젤리 로열젤리 생 천연 젤리 제리 앰플,129900,129900,0
2018-06-01,410002236,A021010,커피,A-650 / A-750 자판기다이/정수기다이/테이블/수납함/프린터테이블/사무용서랍/종이컵,39000,39000,0
2018-06-01,1485658350,C013020,티셔츠,신상나시 모음 나시 나시티 끈나시 롱나시 여자나시,3900,3900,0
2018-06-01,1375861268,A021010,커피,맥심 아이스 블랙 커피믹스220T,20900,20900,0
2018-06-01,1547635281,E041010,식기,코렐 정품 전 품목 낱개특가 그릇/접시/공기/국그릇,5900,5430,-470
2018-06-01,994328695,A017200,토마토,(무)(면)냉동삶은무청시래기10kgX1개,22730,22730,0
2018-06-01,1488606756,A012010,국산쇠고기,[무항생제] 불고기샤브샤브 600g 1+등급,36100,36100,0
2018-06-01,1804923502,C013010,점퍼,제너럴 레이스 프릴 블루종- 레이스블루종 레이스항공,67760,65730,-2030
2018-06-01,895773479,L012030,칫솔,[P&G]오랄비 스테이지 2단계 (2개),6490,6490,0
2018-06-01,1908123916,C021040,실내화,[골라클래식] 신학기 맞이 특가 스니커즈  가방 모음,29000,29000,0
2018-06-01,119472463,A017250,고사리,[참맘] 냉동 콜리플라워 - 1kg (드라이아이스 포함),3650,3650,0
2018-06-01,1320738552,A022010,주스,매일 썬업 과일야채샐러드 녹황 레드 야채 200mlx24팩,16500,16500,0
2018-06-01,2052486788,C013040,청바지,[컨셉원] 118501 라이트 웨이트 쿨 울 슬랙스 (10118501),79800,63840,-15960
2018-06-01,238719975,C015040,장갑,(옵션 : 블랙) 낫소 성인용 니트장갑(NWT-V1,8270,8270,0
2018-06-01,1267650060,A013060,게,한치 마른화살오징어(M 30미)1kg,117740,117740,0
2018-06-01,507392955,C012040,여자학생복,[대구백화점 I관] [애녹]옆끈롱가디건(AU517G),45000,40050,-4950
2018-06-01,1164790733,E011050,책상,무인도접이식테이블/수강용/회의용/책상/밥상/학원,65000,64000,-1000
2018-06-01,674963553,F012010,종이기저귀,[치쿨] 더블 울트라씬 기저귀 4팩 특가,18900,18900,0
2018-06-01,1945918831,A012060,햄및베이컨,[CJ직배송] 백설 햄스빌 베이컨 160gX4개,12900,12900,0
2018-06-01,1438608785,A022040,기능성음료,포카리스웨트 340ml(뚱캔) x 24캔 /게토레이/파워,10600,10600,0
2018-06-01,986213128,F011150,건강기능식품,[풍기][풍기인삼농협][황풍정] 6년근 풍기진홍삼액골드 70ml*30포,42000,42000,0
2018-06-01,1085357889,A016020,배,판매1위 명불허전나주배 15kg 대용량 (당도보장),17900,17900,0
2018-06-01,772627328,E011030,거실장,[아이솔] 프리미엄 TV거실장세트/TV장/공장직판,249800,249800,0
2018-06-01,989080876,L012060,샴푸,[LG]LG) 리엔허브창포 샴푸 500ML,8900,6990,-1910
2018-06-01,385601896,F011150,건강기능식품,12곡미숫가루/여름별미/쌀/콩/혼합곡물/선식/생식/대용식/다이어트/미용식/쉐이크/사은,5600,5600,0
2018-06-01,441067111,C013050,운동복,화이어킬러 270g-스프레이 소화기 가정용 사무실용,25560,23290,-2270
2018-06-01,83321145,L021030,가방,[케빈] 케빈 델피슨 남성 서류가방/정장가방/크로스백,67800,67800,0
2018-06-01,73067441,A011040,보리쌀,캐나다 정품 흰강낭콩/네이비빈 해군콩/실속구성 외,5900,5900,0
2018-06-01,429365243,E061010,세탁세제,퍼실 파워젤 2.7L x2개+버넬 10주+쿨러백 증정,27300,27300,0
2018-06-01,866740109,C021010,아동화,캐릭터 아동운동화 아쿠아우븐메쉬운동화슬리퍼샌들,9900,9900,0
2018-06-01,1424276803,E061060,살충제,살충제 파비 지네 진드기 파리 먼지다듬이 거미,49800,49800,0
2018-06-01,897710708,A013160,맛살,대림 김밥애쏘옥 231G*2입,4380,4380,0
2018-06-01,925506704,E021020,커튼,아크릴비즈발/비즈발/커튼/문장식/문발/문커튼/문장식,5800,5800,0
2018-06-01,2084933374,A021010,커피,네스프레소 캡슐 모음[당일발송],26500,26500,0
2018-06-01,1852093555,E041050,냄비,독일 가이타이너 스텐 냄비 2종세트/편수/양수,29900,29900,0
2018-06-01,874841068,L012090,기초화장품,브리올옴므 화이트닝 수분크림 (미백기능성),32000,32000,0
2018-06-01,1339159257,C015040,장갑,웨이브 포인트 피혁장갑(남성) 남성가죽장갑 남성장갑,12700,12700,0
2018-06-01,1089821793,E031130,보온매트,세일피엠씨_나플나플 프리미엄 온열 싱글매트 페블,218000,218000,0
2018-06-01,952880783,A019180,즉석식품,CJ 햇반 210G*12입 기획,14900,14900,0
2018-06-01,1401938543,C013020,티셔츠,국내30수 기본 무지 면티 반팔 티셔츠 반팔티 흰색,3500,3500,0
2018-06-01,990056231,A011040,보리쌀,[월드그린] 한드레 찰보리 4kg,18500,9400,-9100
2018-06-01,1867928008,A015020,식용유,만토바 올리브오일 스프레이오일 에어프라이어 필수템,9600,9600,0
2018-06-01,64026274,A018110,물엿,[두레촌] 식품 명인 쌀 조청 세트(4병) 물엿 꿀 조미료 엿 기름,25000,25000,0
2018-06-01,1862493698,E031080,선풍기,#TV홈쇼핑정품#벽걸이히터/넥스코 PTC 세라믹 온풍기 NC-FA2500/난방기/온풍히터/겨울,128000,126720,-1280
2018-06-01,304743590,A012050,소시지,한성 켄터키후랑크1kg,4900,4900,0
2018-06-01,102662716,E041020,컵,리자인 도자기 매트 머그컵 카페 머그잔 모음,4500,4280,-220
2018-06-01,1261888103,C012040,여자학생복,30%쿠폰! 블루레이스외 봄/여름신상 98종단독가,12800,12800,0
2018-06-01,417812378,A016070,귤,동결건조 무농약 밀감가루 80g 4개 감귤 귤 가루,32000,31680,-320
2018-06-01,1294528436,C013020,티셔츠,추가할인!슈프림/반팔티/5부/오버핏/티셔츠/남자/여자,7900,7900,0
2018-06-01,212156369,I053030,복사용지,한솔 A4 복사용지(A4용지) 80g 2500매 2BOX/더블에이,38960,33510,-5450
2018-06-01,1316222756,E061060,살충제,잡스에서 개발한 바퀴벌레 개미 좀벌레 벼룩 빈대에,12290,12290,0
2018-06-01,1156831424,I031010,장난감,*** 우리 아기 첫 자동차 !!! 스마트베베 루비 붕붕카,19500,15500,-4000
2018-06-01,880537638,A011070,혼식곡,백설 박력밀가루(1KG),1570,1570,0
2018-06-01,899380021,A016130,키위,제수용 배 (3입/팩),9900,9900,0
2018-06-01,1234588039,C011020,남자상의,MJ_1133 차콜 래글런코트 자켓 겨울자켓 겨울잠바 남,93080,93080,0
2018-06-01,895773481,L012030,칫솔,[P&G]오랄비 스테이지 4단계 2개,6490,6490,0
2018-06-01,895773480,L012030,칫솔,[P&G]오랄비 스테이지 3단계 (2개),6490,6490,0
2018-06-01,821476575,A017200,토마토,국내산/건조가지/500g/말린가지/열매채소,14000,14000,0
2018-06-01,1532630551,E011040,소파,[포홈] 콤팩트형 패브릭 콤보 1인용 소파,99000,99000,0
2018-06-01,450603921,C012040,여자학생복,MJ_1219 네이비 양털 조끼 남여공용조끼 남성털조끼,31080,31080,0
2018-06-01,219484362,C012060,여자내의,포근포근 양털반바지 SD-1254,7930,7300,-630
2018-06-01,1293625142,C012060,여자내의,허리밴딩 끈조걸 큐롯팬츠 치마같은바지 숏팬츠,8100,7700,-400
2018-06-01,945873746,E061020,섬유유연제,다우니 섬유유연제 1L 2L 700ml 리필 퍼퓸 아로마쥬얼,5600,5600,0
2018-06-01,900243152,A011110,당면,풀무원 국산콩 두부기획 (국산부침300G+국산찌개300G),4290,3990,-300
2018-06-01,849225252,A019080,고추장,ⓒ 해찬들 우리쌀 태양초 고추장(2KG),11780,11780,0
2018-06-01,607739622,C015020,모자,군모/스냅백/힙합모자/여자/남자/빈티지/여름모자,4900,4800,-100
2018-06-01,2120615727,A019180,즉석식품,김하진 특갈비탕 11팩,59900,56900,-3000
2018-06-01,1218350207,C014010,아동복,하트 리본 원피스 3종 세트(3-24개월)800004 유아정장,60590,58780,-1810
2018-06-01,1668589006,C013050,운동복,여름 高 기능성 스판 트레이닝 팬츠 츄리닝 작업복,13800,13800,0
2018-06-01,900243156,A012030,돼지고기,E-제주돼지 냉장 삼겹살 구이용 (100G),2790,2187,-603
2018-06-01,2030447400,A019040,소금,백설명품천일염(오천년의신비)가는입자/굵은/중간10kg,26500,26500,0
2018-06-01,231451216,C014010,아동복,[블루독베이비] 별전판나시상하복 (47470-672-03),26000,21320,-4680
2018-06-01,1377230074,C012020,원피스,김발 겉대x10,10380,10380,0
2018-06-01,1546036951,E061080,키친타월,코디 키친타올 150매 x 16롤/총2400매 화장지 휴지,11900,11900,0
2018-06-01,1728101679,C012040,여자학생복,ADN457/에블데이 레이온100% 끈나시/ 아덴,4600,3500,-1100
2018-06-01,734919886,C012030,여자상의,[리리앤코]설레나 신상 원피스/44-110/플라워/린,42800,26800,-16000
2018-06-01,572497998,L021010,손목시계,다니엘 A-IVORY 남자시계 팔찌시계 손목시계 학생손목,67650,67650,0
2018-06-01,1717159162,A014020,분유,[아이배냇] 순산양분유 2단계 800g,32900,32900,0
2018-06-01,1850479069,F012050,의료측정기,MT-200 마이크로라이프 디지털 막대형 체온계,8160,7160,-1000
2018-06-01,1089821786,E031080,선풍기,한솔넥스코_욕실히터 HNK-B02,53000,53000,0
2018-06-01,393858461,E011050,책상,심플 라인 컴퓨터 책상 1200 책상세트 컴퓨터책상 독,56520,50870,-5650
2018-06-01,2146285577,E031070,에어컨,정품/벽걸이선풍기 모음전/신일선풍기/리모컨/타이머,46000,45500,-500
2018-06-01,330659844,C015020,모자,단체모자 전문 제작 / 모자도매 행사모자 모자제작,6000,6000,0
2018-06-01,1193456076,A017140,콩나물,거제 무농약 삶은죽순 1kg 일반삶은죽순 2kg 26500원,17900,17900,0
2018-06-01,868701378,C012040,여자학생복,Mixxo 여름 블라우스 티셔츠 원피스 스커트 균일가,7500,7500,0
2018-06-01,451589581,A019050,간장,순창 진간장 13L,13900,13900,0
2018-06-01,988127570,A011170,떡,[CJ직배송] 밀당의고수 국물떡볶이 421.5g X4개,18700,18700,0
2018-06-01,1266183438,A019170,냉동식품,사은품증정/1+1 아하 양짓말 감자찐만두/만두/간식,18900,18900,0
2018-06-01,2053747198,L021050,우산,방수 작업복 다용도 우의 비옷 모음전 오토바이우의,29900,29900,0
2018-06-01,1323419315,L021030,가방,[Macknite정품]서류가방/전면쿠션패드삽입/노트북남성,29800,29800,0
2018-06-01,271075854,I053010,공책,노트 10권 1봉 학생공책 학습노트 디자인노트 학습공,15580,15580,0
2018-06-01,493942138,A018030,껌,무료배송(최저가)크라운_5400마이쮸(1박스)/프루팁스,37300,37300,0
2018-06-01,1438836280,C012060,여자내의,[모다아울렛][에이치커넥트]랩 스커트30171-152-406-52,19900,19900,0
2018-06-01,1283673306,C013020,티셔츠,T1822-여성 데일리 산드라 뜨게짜임 티셔츠 레이스티,39080,37130,-1950
2018-06-01,1155594954,F011150,건강기능식품,비타하임/에너하임/벨런하임/발포비타민 총집합/독일,18700,18500,-200
2018-06-01,40065273,F012050,의료측정기,시티즌 혈압계 CH-453 부정맥감지 전자동 혈압측정기,39000,36800,-2200
2018-06-01,2120517391,C012020,원피스,남여공용 기모골지 포켓 롱가디건 1개 여자가디건 여,35880,34810,-1070
2018-06-01,1407616716,A017160,오이,착한송이송향버섯 고급형1kg,40000,32000,-8000
2018-06-01,2084162355,C012030,여자상의,#NAME?,68200,60020,-8180
2018-06-01,687660725,C021040,실내화,아디다스 운동화/런닝화/스니커즈/슬리퍼,17500,17500,0
2018-06-01,801087771,C021040,실내화,[UNSEX ORIGINALS]코트밴티지 BY9235 BY9236/ 아디다스,39500,33580,-5920
2018-06-01,988152520,A022050,탄산음료,코카 토레타 1.5L,2650,1300,-1350
2018-06-01,1319049995,C011050,남자내의,조절 4계절 하복 스판 네이비 교복바지 남자 고등학교,58070,58070,0
2018-06-01,5873374,C013050,운동복,차량 그물망 사이드포켓 수납/홀더/보관 휴대폰거치대,1200,1110,-90
2018-06-01,1458721608,G022020,자동차타이어,넥센타이어 고급형 CP672 225/45R18 정품 무료배송,77900,65790,-12110
2018-06-01,989907088,A014020,분유,떠먹는 군단호박 90G,3300,3300,0
2018-06-01,989907089,A014020,분유,떠먹는 군고구마 90G,3300,3300,0
2018-06-01,1089821764,E031080,선풍기,한솔넥스코_욕실히터 HNK-B03,79000,79000,0
2018-06-01,1089821761,E031080,선풍기,닥터훅_고구마 전기스토브(영업용/가정용) NS-9293 (1.4KW),78000,78000,0
2018-06-01,983627077,E061010,세탁세제,[CJ]비트 리필 1.5KG,4990,4990,0
2018-06-01,1388449684,C013010,점퍼,AGC후드 집업점퍼 블랙앤화이트 오픈 CC집업점퍼후드,45990,45990,0
2018-06-01,62488236,C014020,유아복,HelloGeeks PopArt top패션 여성의류 티셔츠 프린트티,24330,24330,0
2018-06-01,239124020,C012020,원피스,[오빵스타일]트렌치 코트 롱 코트 웬즈데이 케이프 트렌치코트,72500,68880,-3620
2018-06-01,937008096,A017160,오이,[민서네버섯농장] 말린건표고버섯 슬라이스 150g,12900,12900,0
2018-06-01,483760259,C011030,남자학생복,밀란시아 기모 도이치란트 집업후드가디건 vi11-1 기,36200,35480,-720
2018-06-01,1750083443,E011030,거실장,모네3인소파,549000,549000,0
2018-06-01,987079055,E061090,방향제,훠링)핸드폰 거치대(컴팩트멀티),12500,12500,0
2018-06-01,1167892244,C013010,점퍼,바람막이 옷 수선 접착 테이프 패치 패딩 간절기 점퍼,9000,9000,0
2018-06-01,958570928,A011100,라면,[오뚜기]오뚜기 옛날 잡채 73G,1590,1590,0
2018-06-01,1315235660,E031040,전기레인지,닥터아토 알러지케어 세제리필 1500ML 2개 + 유연제,36720,36720,0
2018-06-01,1006157275,C013020,티셔츠,L~3XL 큐티/여성 롱티셔츠/후드티/무료배송/빅사이즈,17900,17900,0
2018-06-01,1266570761,C013020,티셔츠,쿨론 V넥 반팔(4XL/5XL)/냉감/단체티/티셔츠(쿨론티)/,12400,12400,0
2018-06-01,2095764023,F012010,종이기저귀,하기스 매직핏 밴드 1~5단계 3팩/팬티 3~6단계 4팩,45500,45500,0
2018-06-01,1089821731,E031080,선풍기,화인_열받은곰돌이시즌9,43000,43000,0
2018-06-01,614132823,E031070,에어컨,2018년형 상가/학교추천 신일 벽걸이선풍기 SIF-16WBC,48000,45600,-2400
2018-06-01,892489880,L021020,장신구,8부 천연루비반지/인기/화이트골드/3611,280000,280000,0
2018-06-01,362154295,E031130,보온매트,한일 카페트매트 183x300cm 좌우분리 전기장판 전기매,230000,227700,-2300
2018-06-01,2115991147,A013120,낙지,베네푸드 구운 오징어채 250g / 코스트코 구매대행,19900,19900,0
2018-06-01,121702513,A019060,된장,더된장 450g,18700,18700,0
2018-06-01,957617612,A019120,혼합조미료,백설 다시다 명품골드 (250G),6990,6990,0
2018-06-01,121702512,A019060,된장,더된장 950g,29500,29500,0
2018-06-01,957617611,A019120,혼합조미료,백설 다시다 명품 골드 (100G),2950,2950,0
2018-06-01,1086584447,F012010,종이기저귀,보솜이 소프트슬림 밴드/팬티 4팩,30900,30900,0
2018-06-01,576405870,F012050,의료측정기,로슈 아큐첵 퍼포마 혈당측정기+시험지60+침110+솜100,51500,51500,0
2018-06-01,933003203,A022050,탄산음료,콜라/사이다/탄산/과즙/옥수수/커피/캔음료/음료수,6000,6000,0
2018-06-01,351998328,A011160,빵,코리원/에버웰 페스츄리도우5장x5개=총25장/도우/피자,55500,55500,0
2018-06-01,1717160119,A014020,분유,[아이배냇] 순산양유아식 3단계 800g,32900,32900,0
2018-06-01,211434100,E041010,식기,[포트메리온] 보타닉가든 사각접시소1p,11000,11000,0
2018-06-01,380356917,A014030,치즈,모짜렐라 슬라이스 자연치즈 100% R좀더예쁜 모짜렐라,16800,15120,-1680
2018-06-01,694918735,C011050,남자내의,퍼플 라인 트랙 팬츠,42000,28900,-13100
2018-06-01,1242765952,C012030,여자상의,[무료배송]DWW1217 모이플리 원피스 802S 레이스원피,46230,46230,0
2018-06-01,906657488,A011140,부침가루,[삼립] 삼립 냉동 달콤한 초코슈 (8입),2680,2680,0
2018-06-01,218896540,C011050,남자내의,[필골드]HG-021 여름 사방스판 슬림핏 스키니트레킹 팬츠,16800,15960,-840
2018-06-01,466678030,A013050,오징어,오뚜기 꽁치 280g X 24EA 통조림 식품 재료 가공음식,73290,71100,-2190
2018-06-01,61778079,L012040,치약,가글 블루그린골드 350ml 4병 치주질환 잇몸질환예방,145000,145000,0
2018-06-01,2041099580,A017140,콩나물,도라지 250g (경북 영주 재배산) 도라지티 건도라지,18990,18990,0
2018-06-01,461938030,A019180,즉석식품,CJ 비비고 육개장/곰탕/찌개/덮밥/국밥 가격인하,1000,1000,0
2018-06-01,1914200021,F011120,인삼,(장생농산장수산삼 10년근 3주(3뿌리) 스승의날 7년근,272090,263930,-8160
2018-06-01,1010228394,E021010,침구,마이크로)양면차렵이불(17s),24900,24900,0
2018-06-01,1981966005,A019070,양념소스,매밀국수소스 1.8L 모밀소바육수 모밀국수소스 원액,14100,14100,0
2018-06-01,2092662574,C012030,여자상의,[미아마스빈]플로럴로맨스 dress,22800,22800,0
2018-06-01,92254651,I031040,생화,각종 야전용품 모음 야전삽 손 도끼 약초 괭이 곡 야,5000,4510,-490
2018-06-01,198586687,C012040,여자학생복,[더리스우먼]더리스 여성 베이직 오픈 숄 반팔 가디건 (NKWCD692S),12600,11970,-630
2018-06-01,749252942,A011140,부침가루,[삼립] 삼립 케이크 소프트 치즈케익 50g,650,650,0
2018-06-01,1372396411,C013050,운동복,홀트 타이어웰드 타이어펑크액 펑크수리제 L0001,14400,14400,0
2018-06-01,989909696,C012040,여자학생복,[코코애비뉴][코코애비뉴]시스루로하가디건_80501,20900,20070,-830
2018-06-01,2126800927,C021040,실내화,[나이키] 탄준 812654_001,64800,62210,-2590
2018-06-01,1176835548,C013050,운동복,아동트레이닝복 남아 유아 단체복 체육복 운동복,23900,23900,0
2018-06-01,957798322,L021020,장신구,실버925% 팔찌 발찌 이니셜팔찌 커플 은체인 은발찌,32100,32100,0
2018-06-01,994328639,A017200,토마토,(무)(면)냉동청학 열무1kgX10개,30150,30150,0
2018-06-01,371846723,A018030,껌,롯데/ 자일리톨껌 / 오리지날112gx3개 /후레쉬민트,10300,10300,0
2018-06-01,871366855,A017210,파,붉은 과일의 여왕! 정품 찰토마토 3kg,9900,9900,0
2018-06-01,994328635,A017200,토마토,(무)(면)냉동청학 아욱1kgX10개,41330,41330,0
2018-06-01,1742344899,F012020,생리대,시크릿데이 생리대 러브중형16PX8팩,17500,16630,-870
2018-06-01,815914770,A014010,우유,매일 상하목장 유기농우유/멸균우유/125ml 200mlx48팩,37900,37900,0
2018-06-01,92482145,A012050,소시지,진주햄 천하장사 소시지 Q500g x 3,10900,10900,0
2018-06-01,251876073,A012060,햄및베이컨,[코스트코 냉장냉동]델리카슨 수제바베큐 햄 1kg,12100,12100,0
2018-06-01,712991445,E011040,소파,레이디가구 파미에 천연 소가죽 4인 소파 쇼파,482790,434520,-48270
2018-06-01,1185298931,C012040,여자학생복,[블루종][블루종]썸머 포켓 루즈핏 가디건_[B1806CD033B],23200,22040,-1160
2018-06-01,1104221358,C012020,원피스,베니토 퍼펙트 라인 원피스/블랙/슬림/핀턱/스판,49500,49500,0
2018-06-01,1419074830,I053040,기타문구,3M 포스트잇 모양 노트 메모지 인덱스탭 플래그 팝업,1200,1200,0
2018-06-01,1846168415,C015040,장갑,등산장갑 마운틴장갑 라이딩장갑 MTB장갑 다용도 레져,6900,6180,-720
2018-06-01,1549765216,D031010,주택수선재료,예쁜 디자인 초인종 문 현관 도어 벨 종 딸랑이 장식,6930,6930,0
2018-06-01,2035836006,I031040,생화,특대형 3단접이식 캠핑 침대의자 야전침대 낚시의자,20620,20620,0
2018-06-01,2036764380,L012010,면도기,도루코 일회용 면도기 모음 100개입/10종택1,12000,11800,-200
2018-06-01,1728380756,I031010,장난감,ps2 플스2 플레이스테이션2 게임기 최저가 무상서비스,40000,40000,0
2018-06-01,2098158562,E031130,보온매트,#TV홈쇼핑정품#순면 황토 소프트매트 싱글(100x200),128000,126720,-1280
2018-06-01,1908723188,A013050,오징어,펭귄 꽁치캔 (1.8K) x6,79070,79070,0
2018-06-01,2031336140,C012060,여자내의,[악녀일기]NEW런지H스커트(S~L),31360,27290,-4070
2018-06-01,1180904021,A019110,드레싱,오니기리와 이규동 밥도둑 덮밥소스 150g X 24팩,63900,53900,-10000
